id,name,is_real_startup,country,city,sector,founded_year,website,description,employees,crunchbase_id,fiscal_year,currency,revenue,cogs,gross_profit,operating_expenses,ebitda,depreciation,ebit,interest_expense,taxes,net_income,cash,total_assets,total_liabilities,equity,mrr,arr,cac,ltv,churn_rate,customers_count,arpu,burn_rate_monthly,runway_months,gross_margin_pct
1,Stripe,True,US,San Francisco,Fintech,2010,https://stripe.com,Online payments infrastructure for the internet,8000,stripe,2023,USD,1876417,625612,1250805,1148221,102584,35460,67124,18764,37528,29596,74234,1180708,357958,822750,,1876417,20.0,75.7,0.0035,7818,20.0,97281.72,0.76,0.6666
2,Rodriguez Figueroa and Sanchez,False,BR,Lake Curtis,Fintech,2008,https://rodriguezfigueroaandsanchez.com,Beautiful instead ahead despite measure ago current practice nation determine.,29,rodriguez-figueroa-and-sanchez,2023,USD,1039517,366602,672915,356608,316307,0,316307,10395,20790,295517,46214,568719,119050,449669,,1039517,20.0,83.91,0.178,4331,20.0,37601.99,1.23,0.6473
3,Ramirez Booth and Blake,False,ZA,Lake Roberto,AgriTech,2015,https://ramirezboothandblake.com,Choice whatever from behavior benefit suggest page.,15,ramirez-booth-and-blake,2023,USD,174784,81046,93738,91369,2369,0,2369,1747,3495,-1126,3600,108151,34354,73797,,174784,20.0,68.35,0.001,73,198.71,1000.0,3.6,0.5363
4,Blair PLC,False,DE,South Christianport,HealthTech,2011,https://blairplc.com,Peace technology officer relate animal direction eye bag do big everyone.,21,blair-plc,2023,EUR,955072,321020,634052,357888,276164,0,276164,9550,19101,257063,23247,510051,225525,284526,79589.33,955072,10.0,54.43,0.0047,1489,53.44,19557.49,1.19,0.6639
5,Flowers Martin and Kelly,False,BR,Jacquelineland,Cybersecurity,2010,https://flowersmartinandkelly.com,Play move each left establish understand read detail food shoulder.,19,flowers-martin-and-kelly,2023,USD,2541707,1096319,1445388,1587575,-142187,8472,-150659,25417,50834,-201493,246446,1525691,607567,918124,,2541707,1279.72,3384.27,0.0295,10590,20.0,155892.24,1.58,0.5687
6,Perez Inc,False,KE,Richardland,Energy,2009,https://perezinc.com,Tree note responsibility defense material those.,20,perez-inc,2023,USD,668364,311962,356402,433700,-77298,34908,-112206,6683,13367,-125573,46865,472029,150998,321031,,668364,520.39,1443.12,0.1817,2784,20.0,15639.85,3.0,0.5332
7,Ellis Baker and Wright,False,US,Juliechester,Fintech,2014,https://ellisbakerandwright.com,Human despite young meeting before another body physical society instead.,23,ellis-baker-and-wright,2023,USD,2632031,1643616,988415,2252308,-1263893,21474,-1285367,26320,52640,-1338007,176414,1666058,881887,784171,,2632031,663.0,1286.54,0.0757,1045,209.85,189633.88,0.93,0.3755
8,Cruz PLC,False,DE,Riceside,AI/ML,2008,https://cruzplc.com,Quite boy those seem.,17,cruz-plc,2023,EUR,2152048,651956,1500092,181032,1319060,10922,1308138,21520,43040,1265098,139700,1404849,70242,1334607,,2152048,83.59,202.43,0.0726,1267,141.46,11764.78,11.87,0.6971
9,Peterson Carter and Moore,False,NG,Lake Nancyview,EdTech,2021,https://petersoncarterandmoore.com,Seven medical blood personal success medical current hear claim.,17,peterson-carter-and-moore,2023,USD,171179,88752,82427,76236,6191,0,6191,1711,3423,2768,3421,182274,27611,154663,14264.92,171179,174.75,1131.34,0.001,441,32.33,13113.45,0.26,0.4815
10,Sellers George and Burns,False,DE,West Natashaport,Mobility,2016,https://sellersgeorgeandburns.com,Around there water beat magazine attorney set.,19,sellers-george-and-burns,2023,EUR,5912767,1528360,4384407,2910056,1474351,0,1474351,59127,118255,1356096,151546,3276158,2065810,1210348,,5912767,869.49,6417.63,0.001,24636,20.0,231178.71,0.66,0.7415
11,Anderson Group,False,AU,West Allison,SaaS,2013,https://andersongroup.com,Institution deep much role cut find yet practice just military.,22,anderson-group,2023,USD,247685,88727,158958,45679,113279,14471,98808,2476,4953,93855,4938,229469,151446,78023,20640.42,247685,477.94,1111.13,0.0503,297,69.28,42446.38,0.12,0.6418
12,Wright Inc,False,ZA,Andrewside,Energy,2018,https://wrightinc.com,Open according remain arrive attack all form.,16,wright-inc,2023,USD,2142989,753397,1389592,1166734,222858,6256,216602,21429,42859,173743,176941,1278290,79243,1199047,,2142989,1439.52,1822.01,0.0809,735,242.89,121569.25,1.46,0.6484
13,Young Caldwell and Lewis,False,IN,Lake Selena,HealthTech,2014,https://youngcaldwellandlewis.com,Office drug list imagine behind probably great in tell approach.,12,young-caldwell-and-lewis,2023,USD,980704,442972,537732,484181,53551,0,53551,9807,19614,33937,140034,742682,456765,285917,81725.33,980704,192.41,1286.52,0.008,16345,5.0,21150.52,6.62,0.5483
14,Joyce Garcia and Powell,False,AU,Laurenville,E-commerce,2011,https://joycegarciaandpowell.com,Court movie cell contain leg themselves away.,20,joyce-garcia-and-powell,2023,USD,2432877,466556,1966321,1532948,433373,11317,422056,24328,48657,373399,129073,1421724,457539,964185,,2432877,1440.28,720.14,0.0925,990,204.66,135632.47,0.95,0.8082
15,Garcia Pearson and Fernandez,False,FR,North Sarabury,Energy,2011,https://garciapearsonandfernandez.com,Image loss ten total clearly able.,16,garcia-pearson-and-fernandez,2023,EUR,5682146,2259294,3422852,284107,3138745,137,3138608,56821,113642,3024966,394088,3268989,1475343,1793646,,5682146,992.27,2078.88,0.0889,5564,85.1,44587.01,8.84,0.6024
16,Baker-Bowers,False,CA,Mitchellside,E-commerce,2016,https://baker-bowers.com,Choice father why often my security arm once me.,17,baker-bowers,2023,USD,661471,287880,373591,312954,60637,17601,43036,6614,13229,29807,192803,560169,267213,292956,,661471,20.0,29.97,0.001,2756,20.0,2418.71,79.71,0.5648
17,Moore Yu and Miller,False,AU,North Brooke,SaaS,2022,https://mooreyuandmiller.com,Identify walk now often always bank price.,25,moore-yu-and-miller,2023,USD,1498997,844641,654356,424612,229744,0,229744,14989,29979,199765,144548,1004673,63113,941560,124916.42,1498997,540.67,3194.28,0.0495,1714,72.84,29078.95,4.97,0.4365
18,Mills Donovan and Harris,False,NG,Johnfurt,Fintech,2020,https://millsdonovanandharris.com,Public feel first sell authority leader.,18,mills-donovan-and-harris,2023,USD,2375941,693195,1682746,1117805,564941,51293,513648,23759,47518,466130,18359,1387701,527280,860421,,2375941,683.54,341.77,0.0983,1693,116.91,82931.53,0.22,0.7082
19,Ferrell Jones and Lewis,False,FR,Davidstad,AI/ML,2017,https://ferrelljonesandlewis.com,These hard citizen street region.,19,ferrell-jones-and-lewis,2023,EUR,642473,125316,517157,166158,350999,13446,337553,6424,12849,324704,8685,433402,21670,411732,,642473,1729.04,4031.27,0.0341,2676,20.0,20201.84,0.43,0.8049
20,Riggs Roman and Rice,False,BR,Sarahville,IoT,2019,https://riggsromanandrice.com,Enough threat score choice example decision.,23,riggs-roman-and-rice,2023,USD,140600,55575,85025,121314,-36289,0,-36289,1406,2812,-39101,63199,200714,42952,157762,,140600,175.48,314.47,0.0225,171,68.39,32045.43,1.97,0.6047
21,Harris-Walters,False,KE,Williamview,EdTech,2010,https://harris-walters.com,Begin interest everybody about side.,19,harris-walters,2023,USD,298720,123357,175363,372431,-197068,6683,-203751,2987,5974,-209725,39504,377615,248808,128807,24893.33,298720,218.27,1155.59,0.0338,594,41.9,1000.0,39.5,0.587
22,Whitney Martin and Ramos,False,US,Hoffmanville,Marketplaces,2015,https://whitneymartinandramos.com,War real chance along hard.,22,whitney-martin-and-ramos,2023,USD,2216239,958350,1257889,1036630,221259,13786,207473,22162,44324,163149,99418,1276986,276090,1000896,,2216239,20.0,10.0,0.0555,9234,20.0,77785.33,1.28,0.5676
23,Hernandez Anderson and Parker,False,AU,West Jasonbury,AgriTech,2010,https://hernandezandersonandparker.com,Government nice themselves wind see.,18,hernandez-anderson-and-parker,2023,USD,1215867,282392,933475,170759,762716,0,762716,12158,24317,738399,427844,1074290,367388,706902,,1215867,645.84,2987.48,0.0815,487,207.95,1000.0,427.84,0.7677
24,Hancock and Sons,False,DE,Johnsonmouth,Fintech,2020,https://hancockandsons.com,Soon ten specific environment skin blue the teach.,23,hancock-and-sons,2023,EUR,724813,251866,472947,347425,125522,30553,94969,7248,14496,80473,20057,572566,221066,351500,,724813,1011.58,786.68,0.0069,264,228.52,44763.96,0.45,0.6525
25,Gonzalez Group,False,IN,Kevinbury,Mobility,2019,https://gonzalezgroup.com,Age cover foreign ten whom evidence political.,18,gonzalez-group,2023,USD,109598,37352,72246,33162,39084,0,39084,1095,2191,36893,6627,120589,65938,54651,,109598,1252.18,626.09,0.0277,27,329.48,29098.46,0.23,0.6592
26,Frazier-Anthony,False,GB,Sheilaville,E-commerce,2019,https://frazier-anthony.com,Condition while enter board its rock finish.,24,frazier-anthony,2023,USD,306555,81575,224980,137274,87706,0,87706,3065,6131,81575,90025,281404,200566,80838,,306555,472.06,1494.29,0.0371,171,148.55,35109.15,2.56,0.7339
27,Joyce Wilson and Lam,False,DE,West Bradley,Marketplaces,2016,https://joycewilsonandlam.com,Ability understand Mrs rest score provide hair attorney professional.,16,joyce-wilson-and-lam,2023,EUR,168610,60612,107998,120585,-12587,9749,-22336,1686,3372,-25708,7280,262919,116128,146791,,168610,229.24,830.26,0.1238,702,20.0,27201.94,0.27,0.6405
28,Hanson-Alvarado,False,ZA,Lake Rachelhaven,Marketplaces,2010,https://hanson-alvarado.com,Project for recent never court professor here.,13,hanson-alvarado,2023,USD,606154,210807,395347,229026,166321,11454,154867,6061,12123,142744,13252,368553,47600,320953,,606154,20.0,10.0,0.0529,263,191.39,2203.35,6.01,0.6522
29,Orr Gilbert and Turner,False,KE,West Justinchester,Marketplaces,2013,https://orrgilbertandturner.com,Parent focus kid put memory soldier where save probably exist.,19,orr-gilbert-and-turner,2023,USD,729330,289326,440004,279442,160562,2923,157639,7293,14586,143053,84772,563502,77050,486452,,729330,20.0,24.11,0.1263,1401,43.37,30625.02,2.77,0.6033
30,Schultz Rogers and Cardenas,False,NG,Lake Lance,Cybersecurity,2015,https://schultzrogersandcardenas.com,Challenge animal worker particularly shoulder lay.,31,schultz-rogers-and-cardenas,2023,USD,1328243,325329,1002914,519725,483189,0,483189,13282,26564,456625,40638,766288,60927,705361,,1328243,20.0,10.0,0.0338,3355,32.99,10108.07,4.02,0.7551
31,Johnston Higgins and Cruz,False,GB,Sancheztown,Mobility,2020,https://johnstonhigginsandcruz.com,Sing despite sound receive let.,19,johnston-higgins-and-cruz,2023,USD,558964,168568,390396,486953,-96557,0,-96557,5589,11179,-107736,32214,480660,267935,212725,,558964,174.22,625.62,0.001,510,91.17,47397.86,0.68,0.6984
32,Wright Charles and Bryant,False,IN,Contrerasside,Marketplaces,2015,https://wrightcharlesandbryant.com,Fish sense kind spring throughout interview trade knowledge city technology.,20,wright-charles-and-bryant,2023,USD,647622,218225,429397,282446,146951,10187,136764,6476,12952,123812,43812,465765,192783,272982,,647622,1676.91,7046.56,0.0178,438,123.19,50656.57,0.86,0.663
33,Green-Wright,False,BR,Katiehaven,E-commerce,2009,https://green-wright.com,Phone ever back experience even floor music catch discuss.,16,green-wright,2023,USD,419358,99660,319698,223640,96058,0,96058,4193,8387,87671,647,260248,77123,183125,,419358,454.01,3233.23,0.1378,144,241.52,13657.38,0.05,0.7624
34,Hernandez Lewis and Perry,False,DE,Amychester,SaaS,2018,https://hernandezlewisandperry.com,Deal information toward once receive.,14,hernandez-lewis-and-perry,2023,EUR,2397469,1024786,1372683,1899173,-526490,0,-526490,23974,47949,-574439,238051,1518102,593005,925097,199789.08,2397469,683.17,4473.39,0.0039,3843,51.98,160592.64,1.48,0.5726
35,James Smith and Bell,False,TN,Castanedachester,AgriTech,2010,https://jamessmithandbell.com,Section national owner determine detail job ahead from quickly identify.,23,james-smith-and-bell,2023,USD,654090,220801,433289,330327,102962,0,102962,6540,13081,89881,86154,468678,224565,244113,,654090,868.88,434.44,0.1103,351,155.29,35039.01,2.46,0.6624
36,Pittman and Sons,False,DE,South Brittanytown,IoT,2018,https://pittmanandsons.com,Poor career left anyone here.,18,pittman-and-sons,2023,EUR,174600,110179,64421,30474,33947,37235,-3288,1746,3492,-6780,4435,149978,37078,112900,,174600,349.86,1717.91,0.001,727,20.0,15080.93,0.29,0.369
37,Gibson LLC,False,DE,Ramirezchester,Marketplaces,2023,https://gibsonllc.com,Strong like see appear weight difference attention.,15,gibson-llc,2023,EUR,434349,110696,323653,183834,139819,0,139819,4343,8686,131133,12484,321523,35503,286020,,434349,433.71,1747.49,0.1102,412,87.77,32346.59,0.39,0.7451
38,Williams Johnson and Wright,False,TN,New Elijahberg,Marketplaces,2022,https://williamsjohnsonandwright.com,Prove nor design record short cold parent security boy.,23,williams-johnson-and-wright,2023,USD,400515,113876,286639,57268,229371,52482,176889,4005,8010,168879,14677,288620,203807,84813,,400515,720.18,1030.56,0.0736,256,130.3,18021.3,0.81,0.7157
39,Oconnell Inc,False,GB,West Barbarafurt,AgriTech,2012,https://oconnellinc.com,Walk cup option store drug recent feeling range.,18,oconnell-inc,2023,USD,390755,113845,276910,201231,75679,0,75679,3907,7815,67864,4103,334148,130764,203384,,390755,1105.31,3298.31,0.124,107,302.46,18316.62,0.22,0.7087
40,Hogan PLC,False,DE,West Amandastad,Cybersecurity,2016,https://hoganplc.com,Media game support state black.,21,hogan-plc,2023,EUR,506695,114275,392420,203901,188519,0,188519,5066,10133,178386,6355,445327,29818,415509,,506695,20.0,59.14,0.0191,246,171.45,1000.0,6.36,0.7745
41,Reid-Poole,False,ZA,South Gregory,IoT,2021,https://reid-poole.com,Whole establish space Mrs low itself room environmental system store.,20,reid-poole,2023,USD,701695,322039,379656,314220,65436,14028,51408,7016,14033,37375,79330,483618,224084,259534,,701695,1695.69,8251.27,0.0119,169,345.2,14893.86,5.33,0.5411
42,Ramirez Group,False,KE,Port Steven,Energy,2019,https://ramirezgroup.com,Property from management foot maintain great election evidence other they new.,19,ramirez-group,2023,USD,608732,179555,429177,227252,201925,0,201925,6087,12174,189751,67584,373778,187954,185824,,608732,1105.54,552.77,0.0126,500,101.3,1000.0,67.58,0.705
43,Vaughan Miller and Cortez,False,DE,Petersbury,HealthTech,2024,https://vaughanmillerandcortez.com,Position make society behavior develop reality fill ok list.,21,vaughan-miller-and-cortez,2023,EUR,1406087,321270,1084817,1472833,-388016,0,-388016,14060,28121,-416137,56805,843372,322089,521283,117173.92,1406087,18.8,78.46,0.0253,1806,64.85,146091.72,0.39,0.7715
44,Cooper Barajas and Pierce,False,EG,Jacquelineview,Fintech,2009,https://cooperbarajasandpierce.com,Edge building court build movie several continue.,16,cooper-barajas-and-pierce,2023,USD,1508778,599489,909289,520157,389132,10795,378337,15087,30175,348162,601077,1376077,707371,668706,,1508778,20.0,136.28,0.0776,6286,20.0,49257.43,12.2,0.6027
45,Rodgers LLC,False,FR,Tinaborough,HealthTech,2013,https://rodgersllc.com,Dinner conference add move ever window network.,22,rodgers-llc,2023,EUR,4831229,775206,4056023,712000,3344023,0,3344023,48312,96624,3247399,114436,2622313,946612,1675701,402602.42,4831229,286.08,1238.84,0.0471,27556,14.61,41837.2,2.74,0.8395
46,Raymond Little and Mullins,False,AU,Port Alexanderport,Marketplaces,2021,https://raymondlittleandmullins.com,Long future whole education technology box assume man officer.,24,raymond-little-and-mullins,2023,USD,488209,227461,260748,229709,31039,0,31039,4882,9764,21275,36555,347315,188944,158371,,488209,118.3,254.27,0.0474,218,186.49,55961.28,0.65,0.5341
47,Brown Hernandez and Hart,False,KE,Christopherbury,Fintech,2020,https://brownhernandezandhart.com,Newspaper indicate other peace simply herself.,24,brown-hernandez-and-hart,2023,USD,159135,68602,90533,161410,-70877,0,-70877,1591,3182,-74059,239134,444809,171895,272914,,159135,20.0,94.78,0.1178,69,190.84,21719.53,11.01,0.5689
48,Evans-Chapman,False,TN,Torreston,IoT,2022,https://evans-chapman.com,Whether between several personal enough ball dream necessary choose impact ready.,16,evans-chapman,2023,USD,3248815,443637,2805178,2677059,128119,18087,110032,32488,64976,45056,153657,1911579,566273,1345306,,3248815,914.68,5606.45,0.1102,5733,47.22,236536.75,0.65,0.8634
49,Carter-Hall,False,NG,Jacquelinemouth,AgriTech,2008,https://carter-hall.com,Reach under skin person product.,18,carter-hall,2023,USD,223058,65482,157576,77933,79643,0,79643,2230,4461,75182,6946,302720,163582,139138,,223058,819.16,1494.01,0.0433,45,404.64,27914.35,0.25,0.7064
50,Coleman PLC,False,BR,Lake Edward,Cybersecurity,2011,https://colemanplc.com,Step author coach film see notice eye.,19,coleman-plc,2023,USD,651022,209898,441124,395193,45931,30402,15529,6510,13020,2509,14358,376237,98312,277925,,651022,247.27,896.59,0.001,493,109.92,38476.38,0.37,0.6776
51,Harrison LLC,False,BR,Benderhaven,AI/ML,2016,https://harrisonllc.com,Management ball always it focus economy before while structure offer.,24,harrison-llc,2023,USD,491358,133348,358010,275823,82187,5284,76903,4913,9827,67076,239389,641057,32052,609005,,491358,447.37,1354.57,0.0488,100,408.8,26946.95,8.88,0.7286
52,Key Ltd,False,AU,Barbaraburgh,Marketplaces,2018,https://keyltd.com,Million kind everything young job sport why like impact.,16,key-ltd,2023,USD,614713,212733,401980,193108,208872,0,208872,6147,12294,196578,34187,405620,161016,244604,,614713,20.0,171.84,0.1296,161,318.16,15733.86,2.17,0.6539
53,Santiago-Hodge,False,FR,Robertfort,AgriTech,2021,https://santiago-hodge.com,Production hundred set already because education break.,13,santiago-hodge,2023,EUR,331140,108589,222551,191547,31004,0,31004,3311,6622,24382,68154,339671,127379,212292,,331140,20.0,29.18,0.0188,111,246.66,67389.7,1.01,0.6721
54,Hancock-Bryan,False,GB,Lake Mollymouth,Mobility,2008,https://hancock-bryan.com,Approach million performance material kind appear environment capital.,18,hancock-bryan,2023,USD,1143512,419881,723631,794252,-70621,22239,-92860,11435,22870,-115730,106647,765530,376787,388743,,1143512,111.23,591.59,0.001,621,153.31,78506.38,1.36,0.6328
55,Kim-Wolfe,False,ZA,North Teresabury,Cybersecurity,2016,https://kim-wolfe.com,Financial add impact different success box.,17,kim-wolfe,2023,USD,1475253,294853,1180400,1004657,175743,1301,174442,14752,29505,144937,43734,884505,495147,389358,,1475253,1270.83,6824.89,0.0165,2733,44.98,102715.74,0.43,0.8001
56,Holland and Sons,False,NG,Cantuport,HealthTech,2024,https://hollandandsons.com,Relate indeed lot line lead certain course out second carry.,24,holland-and-sons,2023,USD,578086,222064,356022,265710,90312,0,90312,5780,11561,78751,25598,474242,370405,103837,48173.83,578086,13.14,41.57,0.001,626,76.89,24158.85,1.06,0.6159
57,Hill Group,False,FR,Sarahhaven,Marketplaces,2017,https://hillgroup.com,Star executive fear only your majority chance.,17,hill-group,2023,EUR,161490,67215,94275,153640,-59365,19351,-78716,1614,3229,-81945,6255,127809,58202,69607,,161490,20.0,96.46,0.0042,274,49.09,27035.79,0.23,0.5838
58,Washington Cook and Hines,False,BR,Gibsonmouth,AI/ML,2014,https://washingtoncookandhines.com,Wonder draw him task improve fish.,20,washington-cook-and-hines,2023,USD,271218,84405,186813,199553,-12740,0,-12740,2712,5424,-18164,58097,295077,111964,183113,,271218,1059.53,2914.53,0.0874,308,73.3,46648.85,1.25,0.6888
59,Thornton-Shepherd,False,GB,Mcneilberg,E-commerce,2013,https://thornton-shepherd.com,Who call whole forward beyond suddenly between treat address.,30,thornton-shepherd,2023,USD,185505,62168,123337,26343,96994,7904,89090,1855,3710,85380,12661,260543,103314,157229,,185505,1189.7,2731.14,0.0621,772,20.0,8596.91,1.47,0.6649
60,Ortiz Ltd,False,NG,North Terrance,AI/ML,2008,https://ortizltd.com,Full realize power system system teacher here.,20,ortiz-ltd,2023,USD,665825,108559,557266,232975,324291,14994,309297,6658,13316,295981,56706,410199,20509,389690,,665825,20.0,50.95,0.1032,233,237.3,21806.7,2.6,0.837
61,Sims-Clay,False,KE,Brennanton,E-commerce,2023,https://sims-clay.com,Attention piece TV young section its better plant their kitchen really.,23,sims-clay,2023,USD,2864177,1367544,1496633,963978,532655,17658,514997,28641,57283,457714,31116,1553804,525836,1027968,,2864177,566.15,2005.96,0.001,1574,151.55,58710.37,0.53,0.5225
62,Williams Inc,False,US,Michaelchester,Fintech,2019,https://williamsinc.com,Each include radio conference company participant.,29,williams-inc,2023,USD,3096149,1094173,2001976,1416299,585677,23765,561912,30961,61922,499990,92400,1727786,164461,1563325,,3096149,20.0,169.68,0.054,956,269.68,138291.24,0.67,0.6466
63,Harvey-Allen,False,AU,East Steven,AgriTech,2015,https://harvey-allen.com,Least project together let explain national available.,19,harvey-allen,2023,USD,996506,386781,609725,957242,-347517,14703,-362220,9965,19930,-382150,57617,635143,439972,195171,,996506,1196.69,4203.16,0.049,1124,73.83,92588.24,0.62,0.6119
64,Huerta-Evans,False,US,Vaughnmouth,EdTech,2010,https://huerta-evans.com,Current his low down occur offer yeah.,12,huerta-evans,2023,USD,342661,118933,223728,106634,117094,0,117094,3426,6853,110241,30230,343248,89553,253695,28555.08,342661,673.87,1990.8,0.0174,264,108.14,3250.47,9.3,0.6529
65,Johnson-Greer,False,FR,Hillshire,Cybersecurity,2023,https://johnson-greer.com,Treat seat strategy total simply.,18,johnson-greer,2023,EUR,445563,114894,330669,196639,134030,9684,124346,4455,8911,115435,105015,370797,55741,315056,,445563,1041.49,3695.22,0.0525,1674,22.17,21256.5,4.94,0.7421
66,Lawson LLC,False,FR,Lake James,AI/ML,2012,https://lawsonllc.com,Question return process stuff pick tough position.,23,lawson-llc,2023,EUR,2074930,1009620,1065310,761713,303597,17362,286235,20749,41498,244737,62692,1265386,281487,983899,,2074930,20.0,37.78,0.0181,4766,36.28,87256.41,0.72,0.5134
67,Kramer-Johnson,False,GB,Jessicaland,Marketplaces,2023,https://kramer-johnson.com,Force indeed customer skill theory hand maybe.,19,kramer-johnson,2023,USD,330947,134553,196394,103237,93157,17658,75499,3309,6618,68881,20270,376535,18826,357709,,330947,20.0,52.76,0.001,1378,20.0,7222.63,2.81,0.5934
68,Rivas-Scott,False,NG,Coffeyport,HealthTech,2016,https://rivas-scott.com,Sound life away senior difficult put purpose however.,28,rivas-scott,2023,USD,675728,158205,517523,159908,357615,5911,351704,6757,13514,338190,17976,462372,226077,236295,56310.67,675728,10.0,22.6,0.0662,7438,7.57,20188.37,0.89,0.7659
69,Diaz Gibbs and Smith,False,NG,South Miguelview,IoT,2021,https://diazgibbsandsmith.com,Herself police he push likely people wall foreign particular positive.,18,diaz-gibbs-and-smith,2023,USD,137204,55637,81567,69974,11593,11111,482,1372,2744,-2262,25421,290177,126034,164143,,137204,20.0,72.71,0.0185,258,44.26,9728.22,2.61,0.5945
70,Colon Blankenship and Turner,False,DE,Wilsonton,AI/ML,2014,https://colonblankenshipandturner.com,Fight manage best thought career.,31,colon-blankenship-and-turner,2023,EUR,780229,222343,557886,475723,82163,36346,45817,7802,15604,30213,54979,536752,208377,328375,,780229,20.0,89.85,0.0823,615,105.57,82908.68,0.66,0.715
71,Watson-Avery,False,ZA,Matthewsberg,AgriTech,2020,https://watson-avery.com,Pressure street past voice evidence real describe know door.,24,watson-avery,2023,USD,375488,202498,172990,160024,12966,10580,2386,3754,7509,-5123,34480,358380,138808,219572,,375488,793.43,3158.52,0.0198,938,33.33,8655.52,3.98,0.4607
72,Garcia-Jennings,False,BR,Bruceview,Marketplaces,2019,https://garcia-jennings.com,Why we station begin deep police.,11,garcia-jennings,2023,USD,3689350,1031594,2657756,3422614,-764858,27073,-791931,36893,73787,-865718,1035758,2907516,941431,1966085,,3689350,985.7,5086.35,0.001,15372,20.0,277087.98,3.74,0.7204
73,Williams LLC,False,EG,East Kristin,AI/ML,2022,https://williamsllc.com,Attention share debate democratic thank forget.,19,williams-llc,2023,USD,1613510,755892,857618,1178609,-320991,31210,-352201,16135,32270,-384471,64587,924610,111515,813095,,1613510,20.0,106.54,0.0035,6722,20.0,82611.38,0.78,0.5315
74,Kramer PLC,False,FR,West Micheleberg,EdTech,2015,https://kramerplc.com,Music sometimes body term capital group.,26,kramer-plc,2023,EUR,711684,149747,561937,776457,-214520,0,-214520,7116,14233,-228753,41518,513032,214727,298305,59307.0,711684,370.93,1815.86,0.0493,868,68.27,91287.8,0.45,0.7896
75,Chapman Inc,False,FR,West Brian,E-commerce,2008,https://chapmaninc.com,Moment second live sing message board mean war analysis.,14,chapman-inc,2023,EUR,1074127,467331,606796,459260,147536,33802,113734,10741,21482,92252,27306,668470,474739,193731,,1074127,28.49,14.24,0.1077,2875,31.13,9203.14,2.97,0.5649
76,Boyd Ellis and Maynard,False,KE,South Melaniechester,AI/ML,2015,https://boydellisandmaynard.com,Make travel available ball part.,19,boyd-ellis-and-maynard,2023,USD,5277403,2055123,3222280,2279464,942816,23036,919780,52774,105548,814232,944007,3755468,1593919,2161549,,5277403,380.66,707.26,0.0368,2792,157.46,181889.54,5.19,0.6106
77,Martinez PLC,False,KE,Oscarhaven,EdTech,2008,https://martinezplc.com,Law painting between reduce table prepare shoulder.,20,martinez-plc,2023,USD,641535,361694,279841,148143,131698,5753,125945,6415,12830,113115,24506,458028,152419,305609,53461.25,641535,10.0,58.39,0.0466,10692,5.0,14380.53,1.7,0.4362
78,Glenn Jordan and Beasley,False,FR,Morganmouth,Cybersecurity,2009,https://glennjordanandbeasley.com,Indeed believe interview professor hear check type attack.,30,glenn-jordan-and-beasley,2023,EUR,859573,322570,537003,575977,-38974,34517,-73491,8595,17191,-90682,197233,660339,323331,337008,,859573,1116.15,4766.34,0.1025,486,147.22,37293.38,5.29,0.6247
79,Davis Inc,False,DE,Lisaside,Fintech,2009,https://davisinc.com,Only no form business government.,21,davis-inc,2023,EUR,7768338,2076457,5691881,6867140,-1175259,8958,-1184217,77683,155366,-1339583,202484,4165801,1054875,3110926,,7768338,1243.49,7887.51,0.0398,32368,20.0,568540.54,0.36,0.7327
80,Pugh Henderson and Moon,False,CA,West Carolinestad,Fintech,2024,https://pughhendersonandmoon.com,Official defense prevent difference board.,9,pugh-henderson-and-moon,2023,USD,3067338,1259813,1807525,153366,1654159,0,1654159,30673,61346,1592813,151302,1693917,422715,1271202,,3067338,1272.84,3536.63,0.0966,2038,125.39,30243.67,5.0,0.5893
81,Richardson Farmer and Andrews,False,DE,Bruceside,AgriTech,2023,https://richardsonfarmerandandrews.com,Participant price really ahead event.,19,richardson-farmer-and-andrews,2023,EUR,73564,43418,30146,31165,-1019,40616,-41635,735,1471,-43106,1953,56513,13305,43208,,73564,20.0,33.1,0.001,306,20.0,1000.0,1.95,0.4098
82,Dorsey-Bell,False,DE,Port Douglas,AI/ML,2012,https://dorsey-bell.com,Attorney scientist will begin most heavy law church.,24,dorsey-bell,2023,EUR,1576079,865572,710507,1211864,-501357,9612,-510969,15760,31521,-542490,7708,822663,283727,538936,,1576079,834.88,1885.8,0.0886,545,240.73,44017.81,0.18,0.4508
83,Griffith-Frank,False,ZA,North Ericton,IoT,2023,https://griffith-frank.com,Evening product magazine kind event.,18,griffith-frank,2023,USD,432997,93371,339626,54700,284926,28216,256710,4329,8659,248051,13562,373720,156701,217019,,432997,20.0,53.98,0.0998,1804,20.0,1000.0,13.56,0.7844
84,Wilson Jordan and Campbell,False,DE,Roseport,Mobility,2021,https://wilsonjordanandcampbell.com,Determine worker area daughter war.,22,wilson-jordan-and-campbell,2023,EUR,172567,105743,66824,23299,43525,0,43525,1725,3451,40074,2203,124432,64631,59801,,172567,1371.61,3869.25,0.0681,58,246.7,30974.77,0.07,0.3872
85,Duran LLC,False,DE,Davidfort,Fintech,2011,https://duranllc.com,Compare herself region matter street south author technology amount.,26,duran-llc,2023,EUR,894159,253839,640320,413187,227133,0,227133,8941,17883,209250,39221,645776,92351,553425,,894159,1017.51,2073.8,0.001,243,305.89,3542.96,11.07,0.7161
86,Stevens Inc,False,BR,Barbarashire,Energy,2019,https://stevensinc.com,Remember individual boy again foot soon peace story.,20,stevens-inc,2023,USD,2359739,524174,1835565,1116041,719524,6277,713247,23597,47194,666053,133108,1434840,323192,1111648,,2359739,247.45,849.96,0.0935,596,329.68,102917.05,1.29,0.7779
87,Davis-Richard,False,TN,South Brianna,Energy,2022,https://davis-richard.com,Bad that second develop single baby plan most create simply.,29,davis-richard,2023,USD,13046750,4476153,8570597,6526959,2043638,26013,2017625,130467,260935,1756690,1970589,8656926,5085130,3571796,,13046750,1852.3,1889.25,0.028,5417,200.7,511643.88,3.85,0.6569
88,Luna-Fuentes,False,ZA,East Curtis,SaaS,2011,https://luna-fuentes.com,Culture own set pretty concern significant management.,24,luna-fuentes,2023,USD,2311527,641401,1670126,851390,818736,29463,789273,23115,46230,743043,231403,1454369,813550,640819,192627.25,2311527,416.44,2194.97,0.0687,2645,72.8,65721.17,3.52,0.7225
89,Wolf Cole and Glass,False,US,Michellemouth,Energy,2018,https://wolfcoleandglass.com,Key light place someone option goal.,14,wolf-cole-and-glass,2023,USD,474850,72533,402317,108602,293715,36051,257664,4748,9497,248167,5025,336130,97239,238891,,474850,372.24,231.92,0.0656,621,63.64,34433.71,0.15,0.8473
90,Collins Group,False,AU,North Miguelport,Fintech,2015,https://collinsgroup.com,Popular within bed order his.,20,collins-group,2023,USD,2248548,346994,1901554,1107955,793599,0,793599,22485,44970,748629,65970,1348282,632278,716004,,2248548,1007.14,3587.82,0.0552,925,202.41,91077.72,0.72,0.8457
91,Spencer Conner and Huang,False,DE,Stoutshire,EdTech,2022,https://spencerconnerandhuang.com,Focus little character artist billion tonight.,18,spencer-conner-and-huang,2023,EUR,87165,29479,57686,17681,40005,0,40005,871,1743,38262,11970,177551,111573,65978,7263.75,87165,56.18,260.25,0.028,120,60.17,6828.68,1.75,0.6618
92,Haas-Miller,False,GB,North John,Energy,2013,https://haas-miller.com,Yard model particular hair truth hold simple quickly appear.,14,haas-miller,2023,USD,4896042,1396161,3499881,2831798,668083,23978,644105,48960,97920,546185,126259,2711793,871111,1840682,,4896042,781.6,390.8,0.0624,2086,195.55,280992.26,0.45,0.7148
93,Holland Jones and Davis,False,IN,Mitchellberg,Mobility,2015,https://hollandjonesanddavis.com,Bank professional true financial prevent product can remember.,21,holland-jones-and-davis,2023,USD,385407,156978,228429,244709,-16280,0,-16280,3854,7708,-23988,26451,346988,226212,120776,,385407,1115.94,2689.53,0.1124,1605,20.0,6922.6,3.82,0.5927
94,Collins Group,False,FR,Lisahaven,Mobility,2011,https://collinsgroup.com,Position interest gun guy Congress.,22,collins-group,2023,EUR,1285431,266711,1018720,678007,340713,17675,323038,12854,25708,297330,97214,756943,66332,690611,,1285431,20.0,30.4,0.0779,913,117.31,32701.68,2.97,0.7925
95,Peterson Group,False,US,East Zoe,Marketplaces,2008,https://petersongroup.com,Baby such big side strong this.,16,peterson-group,2023,USD,1275843,209310,1066533,377071,689462,42929,646533,12758,25516,621017,352192,1045867,279764,766103,,1275843,20.0,10.0,0.0782,779,136.32,9407.0,37.44,0.8359
96,Stanley PLC,False,FR,New Nicholas,EdTech,2013,https://stanleyplc.com,Congress realize person total return analysis.,18,stanley-plc,2023,EUR,210881,54600,156281,96660,59621,0,59621,2108,4217,55404,21262,272258,129665,142593,17573.42,210881,10.0,54.66,0.001,3514,5.0,4273.37,4.98,0.7411
97,Rhodes-Young,False,TN,Bishopmouth,Mobility,2023,https://rhodes-young.com,Move finally speak light strong happy water.,10,rhodes-young,2023,USD,172733,47420,125313,42105,83208,8228,74980,1727,3454,71526,11168,166444,70837,95607,,172733,20.0,55.55,0.0048,119,120.32,1000.0,11.17,0.7255
98,Murray-Campbell,False,DE,Shawchester,Energy,2009,https://murray-campbell.com,Stage soon catch economic political them.,22,murray-campbell,2023,EUR,4562857,998911,3563946,1692354,1871592,29261,1842331,45628,91257,1751074,262877,2642757,799920,1842837,,4562857,740.14,2717.29,0.0578,7252,52.43,190344.18,1.38,0.7811
99,Villa Dawson and Black,False,GB,West Christopherburgh,Energy,2008,https://villadawsonandblack.com,Last message store begin treat stage this.,15,villa-dawson-and-black,2023,USD,1154583,347600,806983,185671,621312,0,621312,11545,23091,598221,17037,678744,140000,538744,,1154583,20.0,146.23,0.001,4810,20.0,32199.06,0.53,0.6989
100,Perry Group,False,TN,Joeland,AgriTech,2022,https://perrygroup.com,Different five between research friend certainly although true.,25,perry-group,2023,USD,308561,91756,216805,228821,-12016,16368,-28384,3085,6171,-34555,28100,222841,70196,152645,,308561,829.21,997.59,0.0514,1285,20.0,18886.04,1.49,0.7026
101,Horton-Taylor,False,IN,Westtown,Energy,2023,https://horton-taylor.com,Affect democratic change vote participant.,22,horton-taylor,2023,USD,1466591,657226,809365,1169682,-360317,16156,-376473,14665,29331,-405804,74092,989571,86718,902853,,1466591,1198.25,3449.71,0.001,758,161.23,65848.35,1.13,0.5519
102,Rodriguez-Roberts,False,GB,Davidbury,EdTech,2017,https://rodriguez-roberts.com,Police performance artist student matter movie place offer responsibility.,14,rodriguez-roberts,2023,USD,413213,180612,232601,138534,94067,0,94067,4132,8264,85803,72578,319106,26726,292380,34434.42,413213,176.28,183.23,0.0494,563,61.13,39030.69,1.86,0.5629
103,Patterson-Mendez,False,DE,New Robert,SaaS,2009,https://patterson-mendez.com,Model guess well name skill.,17,patterson-mendez,2023,EUR,528235,239044,289191,310143,-20952,0,-20952,5282,10564,-31516,120902,439842,272550,167292,44019.58,528235,557.19,3286.92,0.001,652,67.48,1000.0,120.9,0.5475
104,Spencer Myers and Harrison,False,ZA,Zavalaview,E-commerce,2009,https://spencermyersandharrison.com,Ground attack drop price.,19,spencer-myers-and-harrison,2023,USD,2086582,437319,1649263,104329,1544934,15829,1529105,20865,41731,1487374,222896,1342560,407420,935140,,2086582,709.57,4069.61,0.001,8694,20.0,20282.07,10.99,0.7904
105,Ingram Ltd,False,US,Dennisstad,IoT,2023,https://ingramltd.com,Full poor store range wonder long consider care respond want.,22,ingram-ltd,2023,USD,872656,418126,454530,366003,88527,0,88527,8726,17453,71074,98684,557432,49271,508161,,872656,367.93,1963.43,0.0069,3636,20.0,1000.0,98.68,0.5209
106,Carter Inc,False,NG,North Leslie,AI/ML,2013,https://carterinc.com,Middle writer myself education send course ground.,19,carter-inc,2023,USD,603015,231670,371345,302576,68769,27846,40923,6030,12060,28863,9829,492131,152776,339355,,603015,329.89,1090.43,0.0794,923,54.43,35388.03,0.28,0.6158
107,Glenn LLC,False,US,Davidstad,AI/ML,2010,https://glennllc.com,Threat sea thus hit wind many marriage under mind.,20,glenn-llc,2023,USD,231346,73316,158030,96946,61084,24522,36562,2313,4626,31936,11224,299960,120537,179423,,231346,547.74,273.87,0.0014,343,56.16,32087.11,0.35,0.6831
108,Acosta Inc,False,GB,Morrisonburgh,Fintech,2010,https://acostainc.com,Family bill foreign fast knowledge response coach know language risk.,22,acosta-inc,2023,USD,664391,327069,337322,418392,-81070,24920,-105990,6643,13287,-119277,15585,475676,146381,329295,,664391,378.27,1569.3,0.0346,644,85.91,48604.93,0.32,0.5077
109,Mendez-Graham,False,BR,North Emilyfurt,EdTech,2020,https://mendez-graham.com,Message seek civil all support question just call.,14,mendez-graham,2023,USD,386977,88298,298679,178104,120575,21589,98986,3869,7739,91247,6612,348077,147185,200892,32248.08,386977,136.89,384.72,0.001,446,72.27,1000.0,6.61,0.7718
110,Osborne LLC,False,FR,Patrickshire,IoT,2015,https://osbornellc.com,Painting quickly we head several.,16,osborne-llc,2023,EUR,103942,39004,64938,42497,22441,0,22441,1039,2078,20363,24917,201335,100513,100822,,103942,641.87,320.94,0.001,152,56.78,17110.8,1.46,0.6248
111,Taylor Richardson and Edwards,False,KE,Johnville,IoT,2009,https://taylorrichardsonandedwards.com,Save material hit no energy.,21,taylor-richardson-and-edwards,2023,USD,525647,160986,364661,127671,236990,23186,213804,5256,10512,203292,148233,555185,227647,327538,,525647,20.0,38.86,0.0793,296,147.96,35404.91,4.19,0.6937
112,Padilla-Lewis,False,KE,Heatherfort,Fintech,2021,https://padilla-lewis.com,But table later together knowledge because.,23,padilla-lewis,2023,USD,1223194,463456,759738,1346028,-586290,16310,-602600,12231,24463,-627063,10514,804795,307861,496934,,1223194,257.11,1294.57,0.0603,5096,20.0,88066.16,0.12,0.6211
113,Ponce Downs and Contreras,False,BR,New Amberport,IoT,2024,https://poncedownsandcontreras.com,Republican until point soldier meeting building.,26,ponce-downs-and-contreras,2023,USD,748032,244089,503943,94712,409231,26559,382672,7480,14960,367712,79911,610497,284966,325531,,748032,1589.4,9978.07,0.1813,3116,20.0,12511.34,6.39,0.6737
114,Conner and Sons,False,CA,Johnsonside,AgriTech,2014,https://connerandsons.com,Hard sound necessary partner beat finally yourself rest moment shoulder.,25,conner-and-sons,2023,USD,371134,166727,204407,241033,-36626,27527,-64153,3711,7422,-71575,40644,231321,91673,139648,,371134,169.93,189.78,0.1105,1546,20.0,32466.83,1.25,0.5508
115,Jones Compton and Day,False,BR,Owenshaven,Cybersecurity,2018,https://jonescomptonandday.com,Campaign stop necessary onto should can me than.,16,jones-compton-and-day,2023,USD,771612,231931,539681,68565,471116,0,471116,7716,15432,455684,39717,494645,279505,215140,,771612,20.0,134.45,0.1443,558,115.17,38332.33,1.04,0.6994
116,Holmes LLC,False,DE,East Marcus,AgriTech,2020,https://holmesllc.com,Generation wait thus suffer economy play nearly.,24,holmes-llc,2023,EUR,709512,247729,461783,552072,-90289,27318,-117607,7095,14190,-131797,18533,542222,249777,292445,,709512,20.0,74.78,0.0681,1450,40.75,34424.39,0.54,0.6508
117,Weber PLC,False,GB,New Danielleshire,Marketplaces,2017,https://weberplc.com,Child probably result painting successful nor stay agreement animal political.,16,weber-plc,2023,USD,1403704,639900,763804,323184,440620,0,440620,14037,28074,412546,65880,895778,720360,175418,,1403704,20.0,45.11,0.1044,1606,72.82,64623.73,1.02,0.5441
118,Baker Clark and Armstrong,False,EG,South Pamelaside,E-commerce,2010,https://bakerclarkandarmstrong.com,Politics few each southern image law read.,15,baker-clark-and-armstrong,2023,USD,3609461,1324334,2285127,180473,2104654,11463,2093191,36094,72189,2021002,155707,2043806,547159,1496647,,3609461,20.0,10.0,0.001,1840,163.45,1000.0,155.71,0.6331
119,Gonzales Group,False,US,Harrisberg,Mobility,2011,https://gonzalesgroup.com,Technology floor write generation human set middle blood.,29,gonzales-group,2023,USD,645273,236828,408445,246134,162311,0,162311,6452,12905,149406,30575,507535,260158,247377,,645273,20.0,74.2,0.0389,2688,20.0,3705.54,8.25,0.633
120,Owens LLC,False,FR,Wrightville,AI/ML,2014,https://owensllc.com,Face his past eat tend.,24,owens-llc,2023,EUR,392229,112518,279711,175128,104583,7032,97551,3922,7844,89707,6328,304746,96373,208373,,392229,1029.58,1253.75,0.001,288,113.31,17355.74,0.36,0.7131
121,Li PLC,False,NG,Jamesburgh,AgriTech,2012,https://liplc.com,You level these market bed hotel lead drive on.,26,li-plc,2023,USD,465171,193811,271360,197176,74184,52111,22073,4651,9303,12770,10063,269576,127283,142293,,465171,371.49,185.74,0.1082,248,155.97,1739.5,5.78,0.5834
122,Williams Group,False,CA,Mitchelltown,Fintech,2015,https://williamsgroup.com,Issue think road shake hand.,25,williams-group,2023,USD,578737,132010,446727,269355,177372,13576,163796,5787,11574,152222,57871,525071,208905,316166,,578737,20.0,82.06,0.0382,177,271.52,45452.06,1.27,0.7719
123,Williams-Hoffman,False,CA,Angelaland,AgriTech,2013,https://williams-hoffman.com,Mean share evidence writer quite budget window hour.,14,williams-hoffman,2023,USD,250389,83378,167011,104964,62047,27385,34662,2503,5007,29655,5390,318982,175634,143348,,250389,445.61,760.0,0.0471,77,267.67,1000.0,5.39,0.667
124,Grant-Diaz,False,EG,East Carrie,AI/ML,2017,https://grant-diaz.com,Matter and case four listen lead paper middle.,17,grant-diaz,2023,USD,1547853,757568,790285,399204,391081,0,391081,15478,30957,360124,85104,955498,148286,807212,,1547853,1666.08,6264.02,0.1414,831,155.14,73646.32,1.16,0.5106
125,Velazquez-Flores,False,KE,Ewingport,Marketplaces,2024,https://velazquez-flores.com,From stock mother remember feel staff happy purpose woman on.,13,velazquez-flores,2023,USD,352751,59284,293467,113021,180446,29153,151293,3527,7055,144238,1946,282171,40211,241960,,352751,20.0,96.77,0.0166,258,113.59,46884.37,0.04,0.8319
126,Wiggins Soto and Carlson,False,US,Tammyshire,Marketplaces,2017,https://wigginssotoandcarlson.com,Dinner anything lose modern return simple herself start drug occur.,24,wiggins-soto-and-carlson,2023,USD,1850337,662684,1187653,1227131,-39478,14694,-54172,18503,37006,-91178,39687,1045112,540073,505039,,1850337,187.56,744.02,0.0227,3168,48.67,91946.58,0.43,0.6419
127,Rodriguez Smith and Edwards,False,BR,South Hannah,Fintech,2012,https://rodriguezsmithandedwards.com,Maybe particularly likely summer road relationship million night.,27,rodriguez-smith-and-edwards,2023,USD,1002749,210995,791754,266780,524974,9073,515901,10027,20054,495847,60720,642779,255985,386794,,1002749,367.19,424.1,0.1087,4178,20.0,4993.26,12.16,0.7896
128,Mendoza Bennett and Frye,False,IN,Barrmouth,Fintech,2011,https://mendozabennettandfrye.com,Great sign return poor really particular court east newspaper different.,23,mendoza-bennett-and-frye,2023,USD,1664480,477906,1186574,225865,960709,14675,946034,16644,33289,912745,65767,1029724,153111,876613,,1664480,1453.69,4017.8,0.001,585,236.79,6665.64,9.87,0.7129
129,Wise-Bush,False,ZA,Stewartstad,AI/ML,2012,https://wise-bush.com,Value somebody event business quality here woman stand west source.,20,wise-bush,2023,USD,366142,105971,260171,241710,18461,15934,2527,3661,7322,-4795,14416,215586,59638,155948,,366142,737.18,2871.11,0.001,234,129.9,59020.04,0.24,0.7106
130,Williams-Moses,False,IN,West Sandraview,AgriTech,2014,https://williams-moses.com,Degree still even no even body scientist dream anything.,23,williams-moses,2023,USD,69627,20383,49244,42932,6312,0,6312,696,1392,4920,5089,181461,48919,132542,,69627,20.0,91.1,0.1188,35,162.91,25250.92,0.2,0.7073
131,Perez Hall and Garcia,False,ZA,Jenniferville,E-commerce,2014,https://perezhallandgarcia.com,Accept nearly upon imagine various there.,20,perez-hall-and-garcia,2023,USD,2271530,436111,1835419,1433114,402305,18349,383956,22715,45430,338526,33797,1296250,669962,626288,,2271530,20.0,10.0,0.021,3474,54.48,100389.16,0.34,0.808
132,Santos-Avila,False,BR,Manuelton,Marketplaces,2016,https://santos-avila.com,Present discussion school sure also.,19,santos-avila,2023,USD,532629,162282,370347,237499,132848,0,132848,5326,10652,122196,24895,325727,139296,186431,,532629,1074.73,4288.63,0.0519,2219,20.0,22877.9,1.09,0.6953
133,Butler and Sons,False,NG,Port Randyfort,Mobility,2016,https://butlerandsons.com,View while unit theory across nothing.,21,butler-and-sons,2023,USD,7239658,2996086,4243572,594210,3649362,0,3649362,72396,144793,3504569,66114,3732676,1700833,2031843,,7239658,1023.39,5219.52,0.0068,30165,20.0,58083.76,1.14,0.5862
134,Hebert LLC,False,US,Shawnside,Fintech,2021,https://hebertllc.com,Management voice surface life cover both class learn either control.,21,hebert-llc,2023,USD,2695392,1180895,1514497,775375,739122,6662,732460,26953,53907,678553,84475,1497258,629864,867394,,2695392,20.0,91.44,0.0468,840,267.18,34184.03,2.47,0.5619
135,Rogers Phillips and Craig,False,IN,East Cheryl,SaaS,2008,https://rogersphillipsandcraig.com,Still middle beautiful protect continue cell food easy.,23,rogers-phillips-and-craig,2023,USD,364809,122870,241939,74180,167759,0,167759,3648,7296,160463,76386,336792,99587,237205,30400.75,364809,10.0,35.08,0.0047,573,53.02,49600.52,1.54,0.6632
136,Reyes-Griffin,False,CA,Stephanieport,HealthTech,2016,https://reyes-griffin.com,Reveal activity president realize artist brother fill if maybe time.,30,reyes-griffin,2023,USD,682876,242579,440297,596671,-156374,0,-156374,6828,13657,-170031,41479,540501,200653,339848,56906.33,682876,141.41,651.8,0.001,1822,31.22,19057.09,2.18,0.6448
137,Carrillo Vaughn and Fowler,False,GB,Michaelbury,Cybersecurity,2022,https://carrillovaughnandfowler.com,Whatever long lawyer writer health reduce tree.,20,carrillo-vaughn-and-fowler,2023,USD,114134,20088,94046,122250,-28204,0,-28204,1141,2282,-30486,31867,147491,55194,92297,,114134,630.99,1501.91,0.001,70,135.75,1000.0,31.87,0.824
138,Pham Petersen and Gill,False,NG,New Seanstad,Cybersecurity,2021,https://phampetersenandgill.com,True born stock total dark.,19,pham-petersen-and-gill,2023,USD,827151,371820,455331,251901,203430,21994,181436,8271,16543,164893,23265,627068,232459,394609,,827151,385.15,1984.41,0.03,3446,20.0,7933.81,2.93,0.5505
139,Hernandez Murphy and Meyer,False,NG,Lake Jamieshire,SaaS,2011,https://hernandezmurphyandmeyer.com,Before member speak law message lead around left southern.,19,hernandez-murphy-and-meyer,2023,USD,2113223,693607,1419616,1358813,60803,35626,25177,21132,42264,-17087,265465,1508546,364352,1144194,176101.92,2113223,360.55,2032.51,0.001,2136,82.43,124993.01,2.12,0.6718
140,Johnson Scott and Smith,False,FR,New Charles,Cybersecurity,2012,https://johnsonscottandsmith.com,General as yes various attorney value all important shoulder.,13,johnson-scott-and-smith,2023,EUR,2922222,1345302,1576920,1398224,178696,0,178696,29222,58444,120252,59631,1666190,639368,1026822,,2922222,20.0,116.44,0.0451,1591,153.03,116895.66,0.51,0.5396
141,Good Brewer and Fisher,False,NG,Westfurt,SaaS,2019,https://goodbrewerandfisher.com,Bag who themselves card team budget year hotel.,21,good-brewer-and-fisher,2023,USD,576261,226689,349572,94546,255026,7171,247855,5762,11525,236330,27871,318283,98151,220132,48021.75,576261,54.3,54.3,0.052,305,157.12,24988.03,1.12,0.6066
142,Luna and Sons,False,KE,Port Andrewport,AI/ML,2012,https://lunaandsons.com,Pull name mother statement easy get every visit right.,25,luna-and-sons,2023,USD,2866900,1636501,1230399,755805,474594,0,474594,28669,57338,417256,47974,1673545,113903,1559642,,2866900,20.0,10.0,0.1248,1533,155.8,72128.35,0.67,0.4292
143,Johnson Ltd,False,TN,Mendeztown,HealthTech,2009,https://johnsonltd.com,Deal beyond almost our reflect any scientist.,20,johnson-ltd,2023,USD,1198126,271308,926818,492889,433929,13611,420318,11981,23962,396356,5715,725012,302257,422755,99843.83,1198126,50.52,114.63,0.0363,989,100.95,43217.29,0.13,0.7736
144,Gonzales-Fernandez,False,IN,East Williamport,E-commerce,2009,https://gonzales-fernandez.com,Staff rule five our pull fly few.,25,gonzales-fernandez,2023,USD,2642330,627338,2014992,1282759,732233,0,732233,26423,52846,679387,145672,1474434,489994,984440,,2642330,192.96,1195.83,0.078,3960,55.6,100986.98,1.44,0.7626
145,Odom PLC,False,CA,South Kevin,EdTech,2015,https://odomplc.com,News option same compare quickly.,17,odom-plc,2023,USD,1149723,453401,696322,486533,209789,13954,195835,11497,22994,172841,11949,697469,86937,610532,95810.25,1149723,319.17,467.24,0.0337,1944,49.27,53674.04,0.22,0.6056
146,Simpson Compton and David,False,BR,Floydmouth,Fintech,2019,https://simpsoncomptonanddavid.com,Impact feel contain Mrs drive different tax certain leg.,18,simpson-compton-and-david,2023,USD,771534,190408,581126,454595,126531,45665,80866,7715,15430,65436,42013,427918,21395,406523,,771534,20.0,69.57,0.1537,338,189.75,19495.22,2.16,0.7532
147,Hart Group,False,AU,South John,AI/ML,2021,https://hartgroup.com,Form bad last he movie stop.,20,hart-group,2023,USD,2424203,1418162,1006041,345721,660320,14933,645387,24242,48484,596903,76112,1378981,453423,925558,,2424203,617.14,2169.82,0.001,1240,162.85,1000.0,76.11,0.415
148,Adams Ltd,False,KE,Port Charlesshire,Cybersecurity,2012,https://adamsltd.com,Describe decade trade field training deep couple scientist section senior.,19,adams-ltd,2023,USD,3074844,1196778,1878066,2635917,-757851,8227,-766078,30748,61496,-827574,103594,1839584,598005,1241579,,3074844,389.22,1471.66,0.0628,12811,20.0,240577.68,0.43,0.6108
149,Dominguez Ltd,False,DE,South Rose,HealthTech,2013,https://dominguezltd.com,Focus executive letter possible final growth third letter sort reveal.,18,dominguez-ltd,2023,EUR,1422854,374164,1048690,725823,322867,0,322867,14228,28457,294410,1075600,1948485,576861,1371624,118571.17,1422854,486.55,3999.79,0.001,2592,45.74,86099.94,12.49,0.737
150,Rocha-Wood,False,TN,Williamsbury,SaaS,2013,https://rocha-wood.com,Administration network once result far cultural.,11,rocha-wood,2023,USD,1410092,259234,1150858,974052,176806,0,176806,14100,28201,148605,23950,750822,351918,398904,117507.67,1410092,396.77,1741.61,0.0294,23501,5.0,73400.63,0.33,0.8162
151,James and Sons,False,ZA,Piercemouth,E-commerce,2021,https://jamesandsons.com,Shake major rich science leave run goal.,23,james-and-sons,2023,USD,448902,179042,269860,92961,176899,0,176899,4489,8978,167921,11993,286291,149580,136711,,448902,512.75,2778.35,0.001,136,273.63,11358.41,1.06,0.6012
152,Cortez Group,False,AU,New Veronica,Marketplaces,2015,https://cortezgroup.com,Model stuff avoid stand any.,23,cortez-group,2023,USD,797749,426598,371151,220148,151003,24237,126766,7977,15954,110812,12918,512110,159671,352439,,797749,485.43,1325.45,0.0515,1944,34.19,30517.82,0.42,0.4652
153,Gutierrez Ltd,False,IN,North Jasmine,HealthTech,2011,https://gutierrezltd.com,Despite lay art point.,17,gutierrez-ltd,2023,USD,2963513,1038326,1925187,1200807,724380,6650,717730,29635,59270,658460,126094,1618200,336724,1281476,246959.42,2963513,98.29,98.29,0.0073,3682,67.06,90681.78,1.39,0.6496
154,Durham Hopkins and Smith,False,TN,Smithhaven,SaaS,2023,https://durhamhopkinsandsmith.com,Movie expert maybe recently issue vote conference.,25,durham-hopkins-and-smith,2023,USD,533679,160757,372922,55653,317269,0,317269,5336,10673,306596,47829,331234,16561,314673,44473.25,533679,740.15,4794.61,0.0363,775,57.35,1000.0,47.83,0.6988
155,Warren and Sons,False,DE,New Alisha,EdTech,2022,https://warrenandsons.com,Environment however health image north wrong difficult range.,16,warren-and-sons,2023,EUR,614117,252191,361926,439125,-77199,60193,-137392,6141,12282,-149674,45461,427282,106054,321228,51176.42,614117,191.57,894.72,0.0016,10235,5.0,24069.95,1.89,0.5893
156,Valdez Ltd,False,CA,North Richardfurt,AgriTech,2015,https://valdezltd.com,Live PM reflect bar suddenly population former with wind thus.,17,valdez-ltd,2023,USD,304181,75128,229053,222477,6576,0,6576,3041,6083,493,6989,191481,107980,83501,,304181,1086.81,3589.51,0.0444,206,122.76,31364.76,0.22,0.753
157,Hall Ltd,False,DE,Nelsonland,SaaS,2014,https://hallltd.com,Tonight nor allow up fire which onto.,18,hall-ltd,2023,EUR,509519,199225,310294,239263,71031,0,71031,5095,10190,60841,10971,351446,151858,199588,42459.92,509519,570.84,2384.58,0.0359,479,88.62,7585.55,1.45,0.609
158,Nicholson Hickman and Evans,False,TN,New Mary,E-commerce,2016,https://nicholsonhickmanandevans.com,Quality music himself science so ready bad seat.,24,nicholson-hickman-and-evans,2023,USD,677174,225679,451495,228514,222981,5010,217971,6771,13543,204428,61769,467270,28832,438438,,677174,20.0,10.0,0.1118,753,74.87,12640.99,4.89,0.6667
159,Brown-Kim,False,FR,West Cassiefurt,AgriTech,2019,https://brown-kim.com,Ahead event yeah make green wait it quickly.,25,brown-kim,2023,EUR,214916,129477,85439,82043,3396,12302,-8906,2149,4298,-13204,28373,193336,129622,63714,,214916,268.47,1005.24,0.0206,99,180.75,1000.0,28.37,0.3975
160,James Barton and Phillips,False,BR,Lake Charles,AI/ML,2020,https://jamesbartonandphillips.com,Child Republican plant science first blood accept.,21,james-barton-and-phillips,2023,USD,5274400,1917857,3356543,1963719,1392824,15288,1377536,52744,105488,1272048,475615,3299747,1643818,1655929,,5274400,217.12,219.57,0.001,11443,38.41,159822.69,2.98,0.6364
161,Wallace-Juarez,False,BR,East Christopherchester,AI/ML,2018,https://wallace-juarez.com,News mention billion bed never others six tell activity.,20,wallace-juarez,2023,USD,884533,281682,602851,403007,199844,15942,183902,8845,17690,166212,13578,475455,272371,203084,,884533,20.0,29.47,0.0568,3685,20.0,3089.81,4.39,0.6815
162,Hughes-Miller,False,US,New Adriana,Fintech,2016,https://hughes-miller.com,College especially environmental certainly cold every feel site.,15,hughes-miller,2023,USD,354913,72844,282069,46114,235955,0,235955,3549,7098,228857,36869,275565,150936,124629,,354913,936.18,4076.06,0.001,1478,20.0,1000.0,36.87,0.7948
163,King-Wright,False,GB,Wheelerborough,IoT,2016,https://king-wright.com,Blood fight we forward per sound forget friend spring.,17,king-wright,2023,USD,307387,78186,229201,266772,-37571,2848,-40419,3073,6147,-46566,7670,273580,93500,180080,,307387,746.38,3493.07,0.1491,72,355.17,8814.28,0.87,0.7456
164,Mccann Taylor and Flores,False,US,South Leon,Fintech,2021,https://mccanntaylorandflores.com,Why fact reason make office drug heavy staff.,23,mccann-taylor-and-flores,2023,USD,2114992,451641,1663351,455037,1208314,5427,1202887,21149,42299,1160588,154285,1397107,611480,785627,,2114992,1394.55,1676.77,0.0147,8812,20.0,39166.06,3.94,0.7865
165,Diaz-Frederick,False,CA,New Wendy,Cybersecurity,2018,https://diaz-frederick.com,Race nearly well left remain just.,23,diaz-frederick,2023,USD,1095233,484927,610306,54761,555545,0,555545,10952,21904,533641,27222,727535,436842,290693,,1095233,579.7,2714.77,0.0191,2506,36.41,48753.0,0.56,0.5572
166,Guerra-Jones,False,TN,Chambersberg,IoT,2024,https://guerra-jones.com,Drug probably resource smile available wrong look.,19,guerra-jones,2023,USD,109060,35543,73517,15482,58035,13957,44078,1090,2181,41897,14493,214074,42314,171760,,109060,376.45,2844.71,0.0773,66,137.19,2747.52,5.27,0.6741
167,Ferguson-Mclean,False,FR,Stephensstad,Energy,2014,https://ferguson-mclean.com,Order trial body eat professor coach partner none population position.,20,ferguson-mclean,2023,EUR,3146752,1070945,2075807,1018244,1057563,0,1057563,31467,62935,994628,268683,2001132,1004323,996809,,3146752,1666.58,8499.51,0.0341,13111,20.0,70272.08,3.82,0.6597
168,Sheppard-Jordan,False,IN,North Jonathanhaven,SaaS,2021,https://sheppard-jordan.com,Newspaper reach determine hear leg quickly real character young lot.,16,sheppard-jordan,2023,USD,2567985,1072077,1495908,1423474,72434,27754,44680,25679,51359,-6679,182133,1615217,854313,760904,213998.75,2567985,53.01,261.72,0.0716,42799,5.0,119944.74,1.52,0.5825
169,Perry-Nixon,False,US,Port Sheliaberg,AI/ML,2014,https://perry-nixon.com,Find lay deal lot live just recent five.,16,perry-nixon,2023,USD,1993943,645772,1348171,893685,454486,17300,437186,19939,39878,397308,5477,1030930,773273,257657,,1993943,20.0,10.0,0.1004,614,270.35,60781.15,0.09,0.6761
170,Williams-Page,False,CA,Port Matthewville,Energy,2010,https://williams-page.com,Upon scientist might necessary former interview.,21,williams-page,2023,USD,3055759,625389,2430370,1933351,497019,5285,491734,30557,61115,430619,58857,1705210,322635,1382575,,3055759,20.0,88.34,0.1342,1343,189.53,150570.16,0.39,0.7953
171,Hall-Sullivan,False,BR,East Danielle,E-commerce,2018,https://hall-sullivan.com,How scene third last involve above Democrat everything region.,21,hall-sullivan,2023,USD,2071471,607296,1464175,819291,644884,0,644884,20714,41429,603455,428606,1639211,398421,1240790,,2071471,20.0,76.36,0.001,3045,56.69,57259.83,7.49,0.7068
172,Ray PLC,False,BR,West Mark,Fintech,2017,https://rayplc.com,Box provide majority whole finish home hotel box goal.,25,ray-plc,2023,USD,476505,167413,309092,298964,10128,30312,-20184,4765,9530,-29714,16476,299823,65783,234040,,476505,450.54,2532.38,0.0198,161,245.61,23937.47,0.69,0.6487
173,Williamson-Cervantes,False,NG,Samanthashire,AgriTech,2021,https://williamson-cervantes.com,Public finish draw bring health.,18,williamson-cervantes,2023,USD,2654329,1202233,1452096,1079295,372801,0,372801,26543,53086,319715,55801,1495195,716382,778813,,2654329,20.0,87.17,0.001,11059,20.0,103267.5,0.54,0.5471
174,Dixon Group,False,CA,New Patrick,Energy,2017,https://dixongroup.com,Main Mr try us community cold.,19,dixon-group,2023,USD,2274584,1122036,1152548,465626,686922,0,686922,22745,45491,641431,180527,1448248,108117,1340131,,2274584,603.09,3701.69,0.0323,4279,44.29,18038.78,10.01,0.5067
175,Taylor-Edwards,False,NG,Harveystad,HealthTech,2014,https://taylor-edwards.com,Machine crime himself no.,19,taylor-edwards,2023,USD,165847,60695,105152,61165,43987,51007,-7020,1658,3316,-10336,16086,177967,57079,120888,13820.58,165847,441.01,1793.44,0.0013,155,88.82,1000.0,16.09,0.634
176,Simpson Cohen and Perry,False,TN,Burnsland,Marketplaces,2020,https://simpsoncohenandperry.com,Air set factor ever Mrs collection leader score she near.,28,simpson-cohen-and-perry,2023,USD,806277,386878,419399,563493,-144094,21321,-165415,8062,16125,-181540,37430,506510,156519,349991,,806277,913.45,705.45,0.0869,731,91.85,69780.4,0.54,0.5202
177,Armstrong LLC,False,BR,Amberton,Cybersecurity,2013,https://armstrongllc.com,National wrong bill stop seem fear yourself last give.,19,armstrong-llc,2023,USD,933045,106542,826503,46652,779851,7881,771970,9330,18660,753310,31298,501993,205802,296191,,933045,114.38,546.82,0.0788,3887,20.0,15013.31,2.08,0.8858
178,Gonzales Inc,False,KE,East Lisa,IoT,2017,https://gonzalesinc.com,Ready technology particular into pattern size spend south now mother.,15,gonzales-inc,2023,USD,627488,57477,570011,454482,115529,0,115529,6274,12549,102980,13239,354781,192822,161959,,627488,20.0,60.11,0.0713,1599,32.69,34209.67,0.39,0.9084
179,Ryan Morris and Padilla,False,TN,Ashleyhaven,AI/ML,2008,https://ryanmorrisandpadilla.com,Career seek in arrive everyone.,22,ryan-morris-and-padilla,2023,USD,632266,189236,443030,275887,167143,202,166941,6322,12645,154296,21912,357597,33605,323992,,632266,251.66,125.83,0.0799,238,221.09,9518.12,2.3,0.7007
180,Martinez Cline and Wright,False,IN,Mariafurt,AgriTech,2014,https://martinezclineandwright.com,Central plan physical heart away some shoulder idea seek.,18,martinez-cline-and-wright,2023,USD,243167,89915,153252,106961,46291,19018,27273,2431,4863,22410,28593,326518,90787,235731,,243167,69.23,243.73,0.0018,1013,20.0,1000.0,28.59,0.6302
181,Mayer Wood and Clements,False,TN,Brandiland,IoT,2018,https://mayerwoodandclements.com,Play recently sure somebody huge why station manager follow.,11,mayer-wood-and-clements,2023,USD,487635,116589,371046,327958,43088,25704,17384,4876,9752,7632,3848,373820,61343,312477,,487635,20.0,128.23,0.056,336,120.84,43353.11,0.09,0.7609
182,Morgan-Lane,False,EG,Kramerton,Mobility,2022,https://morgan-lane.com,Between six least buy tax.,23,morgan-lane,2023,USD,6684459,1388299,5296160,3584369,1711791,40314,1671477,66844,133689,1537788,178381,3582452,2327578,1254874,,6684459,1351.93,6796.63,0.001,2230,249.73,317218.66,0.56,0.7923
183,Bryant-Braun,False,BR,Harrisberg,EdTech,2024,https://bryant-braun.com,City usually ever pressure economy head tough.,17,bryant-braun,2023,USD,329654,126328,203326,285506,-82180,19494,-101674,3296,6593,-108267,6943,232042,159894,72148,27471.17,329654,151.14,816.56,0.032,367,74.85,38239.93,0.18,0.6168
184,Williams Ltd,False,EG,Jessicabury,Cybersecurity,2013,https://williamsltd.com,Pretty region ability live car difficult quite act receive.,22,williams-ltd,2023,USD,491757,210253,281504,83885,197619,38992,158627,4917,9835,148792,24252,348643,137735,210908,,491757,294.82,1371.53,0.0282,736,55.66,1000.0,24.25,0.5724
185,Mcneil Group,False,BR,South Chad,Fintech,2017,https://mcneilgroup.com,Become south billion happen federal him spend themselves.,23,mcneil-group,2023,USD,5794719,2988768,2805951,735548,2070403,18794,2051609,57947,115894,1935715,175211,3116334,1254939,1861395,,5794719,854.35,1369.34,0.0065,3374,143.1,95395.95,1.84,0.4842
186,Haney Thomas and Moreno,False,NG,New Debramouth,Marketplaces,2018,https://haneythomasandmoreno.com,Reveal physical character in rather team beautiful beyond.,21,haney-thomas-and-moreno,2023,USD,533979,213028,320951,300701,20250,0,20250,5339,10679,9571,32831,400117,20005,380112,,533979,85.11,505.52,0.0799,400,111.1,13342.1,2.46,0.6011
187,Lawrence Group,False,FR,Sylviamouth,EdTech,2017,https://lawrencegroup.com,Easy popular easy over return expect.,18,lawrence-group,2023,EUR,983247,316163,667084,701710,-34626,13721,-48347,9832,19664,-68011,1281285,1942486,659320,1283166,81937.25,983247,457.88,1477.0,0.0286,2924,28.02,58983.6,21.72,0.6785
188,Johnson Boone and Liu,False,DE,New Catherine,EdTech,2012,https://johnsonbooneandliu.com,Security far approach today west manager.,11,johnson-boone-and-liu,2023,EUR,71076,20670,50406,57636,-7230,0,-7230,710,1421,-8651,22551,89870,32218,57652,5923.0,71076,456.82,2702.36,0.0237,601,9.84,30358.44,0.74,0.7092
189,Allen Ltd,False,US,New Pamelatown,SaaS,2015,https://allenltd.com,Value car team nothing half raise several west.,24,allen-ltd,2023,USD,910545,403891,506654,45527,461127,12068,449059,9105,18210,430849,34703,559438,213204,346234,75878.75,910545,501.66,857.3,0.001,3259,23.28,19152.73,1.81,0.5564
190,Smith Inc,False,EG,West Jasonton,IoT,2010,https://smithinc.com,Media pick may indeed reduce bar Mr pattern.,26,smith-inc,2023,USD,604900,289012,315888,30245,285643,0,285643,6049,12098,273545,30681,497057,191348,305709,,604900,88.48,546.97,0.001,420,119.76,12180.4,2.52,0.5222
191,Miller-Miller,False,EG,Port Eric,Energy,2014,https://miller-miller.com,Hospital plant strong race at recognize role suffer.,22,miller-miller,2023,USD,589871,259105,330766,281973,48793,39892,8901,5898,11797,-2896,22268,417180,181470,235710,,589871,1867.14,4649.77,0.0331,209,234.27,5531.88,4.03,0.5607
192,Sanchez Group,False,ZA,South Cherylton,Cybersecurity,2020,https://sanchezgroup.com,Program price compare actually case activity market.,16,sanchez-group,2023,USD,695275,343368,351907,175569,176338,10170,166168,6952,13905,152263,36118,392083,19604,372479,,695275,1896.77,7168.33,0.0066,2896,20.0,25323.33,1.43,0.5061
193,Mills-Logan,False,EG,Garyberg,Energy,2015,https://mills-logan.com,Run brother tonight friend investment model enjoy.,20,mills-logan,2023,USD,2014768,928631,1086137,395954,690183,6713,683470,20147,40295,643175,39928,1084470,434955,649515,,2014768,20.0,41.09,0.001,1104,152.02,30354.43,1.32,0.5391
194,Burton Crawford and Dixon,False,GB,South Micheleburgh,Marketplaces,2008,https://burtoncrawfordanddixon.com,Church significant thus purpose boy scientist able teach.,20,burton-crawford-and-dixon,2023,USD,820701,282744,537957,212358,325599,45572,280027,8207,16414,263613,107007,659084,314433,344651,,820701,1132.33,5827.83,0.0388,478,142.89,50205.85,2.13,0.6555
195,Sanchez Group,False,AU,Patrickberg,Fintech,2021,https://sanchezgroup.com,Use tax need trial scientist information.,26,sanchez-group,2023,USD,846547,227876,618671,601935,16736,67437,-50701,8465,16930,-67631,29478,583581,346101,237480,,846547,349.18,1911.72,0.0271,3527,20.0,49304.78,0.6,0.7308
196,Wright-Moon,False,DE,Josephland,HealthTech,2024,https://wright-moon.com,Head maybe top conference source wonder west attention let executive.,18,wright-moon,2023,EUR,842886,233644,609242,423820,185422,29001,156421,8428,16857,139564,25769,449594,151332,298262,70240.5,842886,245.3,842.23,0.0764,2587,27.15,51541.2,0.5,0.7228
197,Murphy-Tran,False,EG,West Jamesshire,SaaS,2015,https://murphy-tran.com,Science drug happy will young simply run.,18,murphy-tran,2023,USD,889217,269044,620173,359422,260751,18023,242728,8892,17784,224944,60967,553583,227592,325991,74101.42,889217,653.9,4442.07,0.0424,1219,60.74,44974.45,1.36,0.6974
198,Hodges Sanchez and Smith,False,FR,Johnsonside,Mobility,2012,https://hodgessanchezandsmith.com,Player really act friend serve heavy scene film.,20,hodges-sanchez-and-smith,2023,EUR,1753588,839810,913778,1458190,-544412,0,-544412,17535,35071,-579483,148787,1149749,138164,1011585,,1753588,20.0,32.42,0.001,7306,20.0,161312.02,0.92,0.5211
199,Moreno and Sons,False,AU,Vasquezton,Mobility,2024,https://morenoandsons.com,Republican behavior TV today mind red.,20,moreno-and-sons,2023,USD,509761,74412,435349,126795,308554,35108,273446,5097,10195,263251,7263,433387,182293,251094,,509761,20.0,60.62,0.0951,764,55.54,1000.0,7.26,0.854
200,Ellis-Adkins,False,NG,New Dennisfurt,IoT,2018,https://ellis-adkins.com,Option artist production candidate factor.,25,ellis-adkins,2023,USD,2354974,638338,1716636,1562834,153802,0,153802,23549,47099,106703,286804,1647240,308688,1338552,,2354974,1437.94,4642.67,0.001,1043,188.08,124359.23,2.31,0.7289
201,Howe-Long,False,AU,Louisview,Mobility,2024,https://howe-long.com,Avoid dark sister once choice clearly letter.,22,howe-long,2023,USD,868614,440385,428229,551419,-123190,21326,-144516,8686,17372,-161888,28804,466859,116025,350834,,868614,793.23,1526.12,0.0533,1204,60.08,21244.71,1.36,0.493
202,Martinez-Howard,False,TN,South Kyle,AI/ML,2022,https://martinez-howard.com,System bed space fight relate owner Democrat.,18,martinez-howard,2023,USD,2567257,754008,1813249,1568997,244252,0,244252,25672,51345,192907,145507,1464638,1230137,234501,,2567257,20.0,13.61,0.0352,10696,20.0,152737.3,0.95,0.7063
203,Hernandez-Dawson,False,GB,Randyton,Cybersecurity,2023,https://hernandez-dawson.com,Employee wrong all identify laugh security economic.,17,hernandez-dawson,2023,USD,434634,210190,224444,199402,25042,0,25042,4346,8692,16350,3771,348402,17420,330982,,434634,419.12,962.79,0.1282,308,117.39,1000.0,3.77,0.5164
204,Garcia-Leon,False,EG,North Bryanbury,AgriTech,2015,https://garcia-leon.com,Cup hundred rather visit base only.,16,garcia-leon,2023,USD,1191434,469565,721869,59571,662298,17510,644788,11914,23828,620960,144374,819859,394268,425591,,1191434,49.91,255.41,0.0601,985,100.7,18047.77,8.0,0.6059
205,Johnson Inc,False,BR,Lake Scott,AgriTech,2024,https://johnsoninc.com,Begin suggest speak business walk anything.,35,johnson-inc,2023,USD,1275805,500876,774929,460869,314060,30566,283494,12758,25516,257978,17026,714749,569838,144911,,1275805,1464.69,6873.84,0.075,653,162.77,18800.53,0.91,0.6074
206,Hamilton Ramsey and Crawford,False,EG,Vegaburgh,Marketplaces,2015,https://hamiltonramseyandcrawford.com,Democrat cost evidence third alone people early far.,19,hamilton-ramsey-and-crawford,2023,USD,11013010,1667728,9345282,6439301,2905981,8022,2897959,110130,220260,2677699,1183671,6714695,2610945,4103750,,11013010,96.12,322.5,0.0582,45887,20.0,534480.04,2.21,0.8486
207,Andrade-Mendoza,False,IN,West Patrickchester,Mobility,2010,https://andrade-mendoza.com,Poor something eat yes myself affect.,22,andrade-mendoza,2023,USD,2118706,1159446,959260,1187416,-228156,5029,-233185,21187,42374,-275559,38466,1203505,780356,423149,,2118706,20.0,70.13,0.091,851,207.44,98279.08,0.39,0.4528
208,Casey-Howard,False,ZA,Coopershire,AgriTech,2015,https://casey-howard.com,Focus establish ago others ahead specific exactly speak line.,25,casey-howard,2023,USD,451714,130106,321608,181084,140524,882,139642,4517,9034,130608,10705,319576,69692,249884,,451714,20.0,50.76,0.001,1882,20.0,5834.02,1.83,0.712
209,Wang-Key,False,IN,North John,E-commerce,2018,https://wang-key.com,Entire staff true argue you detail suffer.,24,wang-key,2023,USD,361027,93382,267645,128027,139618,0,139618,3610,7220,132398,70985,267849,32754,235095,,361027,629.38,1272.8,0.0361,242,123.92,21333.43,3.33,0.7413
210,Kelly-Combs,False,NG,East Joel,Fintech,2012,https://kelly-combs.com,South recently trial agreement red way nor none.,22,kelly-combs,2023,USD,2577946,1370028,1207918,1085384,122534,0,122534,25779,51558,70976,41801,1451521,480318,971203,,2577946,335.52,447.55,0.0958,10741,20.0,79457.86,0.53,0.4686
211,Copeland Group,False,GB,Gregoryton,EdTech,2020,https://copelandgroup.com,Argue own after long forward.,11,copeland-group,2023,USD,1913005,595807,1317198,1737274,-420076,21283,-441359,19130,38260,-479619,154897,1251957,530512,721445,159417.08,1913005,307.35,307.35,0.0896,1440,110.67,159711.3,0.97,0.6885
212,Harris Anderson and Love,False,ZA,Brianberg,HealthTech,2014,https://harrisandersonandlove.com,Relate center book money half authority relate product only from.,23,harris-anderson-and-love,2023,USD,4653561,1743372,2910189,1788949,1121240,12469,1108771,46535,93071,1015700,114533,2474267,622742,1851525,387796.75,4653561,278.59,415.04,0.0195,6078,63.8,202772.57,0.56,0.6254
213,Taylor-Moore,False,FR,Connerfort,Energy,2021,https://taylor-moore.com,Company why really up skin development open compare.,22,taylor-moore,2023,EUR,227286,103109,124177,51575,72602,13041,59561,2272,4545,55016,3123,192251,78471,113780,,227286,1338.43,6282.91,0.0402,196,96.33,32635.68,0.1,0.5463
214,Gross-Phillips,False,CA,Lake Aaron,AI/ML,2022,https://gross-phillips.com,Hot yes whole allow own TV whose determine not view.,21,gross-phillips,2023,USD,4856694,1295969,3560725,3157759,402966,29764,373202,48566,97133,276069,101027,2709946,660568,2049378,,4856694,20.0,87.25,0.0704,2560,158.07,256990.41,0.39,0.7332
215,Rivera Inc,False,TN,West Toni,SaaS,2014,https://riverainc.com,Player white start prove role from.,16,rivera-inc,2023,USD,1618234,805035,813199,470377,342822,14167,328655,16182,32364,296291,10037,933090,217481,715609,134852.83,1618234,10.0,54.03,0.0354,13471,10.01,47790.58,0.21,0.5025
216,Baker and Sons,False,TN,West Jonathanville,Energy,2008,https://bakerandsons.com,Answer just information coach.,23,baker-and-sons,2023,USD,5124838,1842877,3281961,4371218,-1089257,12194,-1101451,51248,102496,-1203947,303332,2915400,1703562,1211838,,5124838,20.0,15.6,0.1705,7604,56.16,368698.0,0.82,0.6404
217,Snyder-Gray,False,AU,Garciafort,IoT,2020,https://snyder-gray.com,Prepare reach class available suffer far five weight avoid color.,27,snyder-gray,2023,USD,334013,116978,217035,155010,62025,0,62025,3340,6680,55345,55428,372962,114226,258736,,334013,1005.91,1714.81,0.001,156,177.91,43555.5,1.27,0.6498
218,Martin-Jones,False,EG,West Brookefort,SaaS,2019,https://martin-jones.com,Issue president parent its approach.,27,martin-jones,2023,USD,841079,317071,524008,480564,43444,0,43444,8410,16821,26623,66794,676631,164375,512256,70089.92,841079,10.0,55.16,0.0506,1089,64.34,77019.18,0.87,0.623
219,Harris-Lee,False,IN,Donnaport,Energy,2021,https://harris-lee.com,Benefit hotel near make approach about because.,28,harris-lee,2023,USD,1638409,828223,810186,442848,367338,19900,347438,16384,32768,314670,67427,910297,306917,603380,,1638409,1762.26,1425.9,0.0773,557,245.01,54374.33,1.24,0.4945
220,Weber Castillo and Davis,False,NG,East Danielle,Cybersecurity,2015,https://webercastilloanddavis.com,List break size likely thus.,21,weber-castillo-and-davis,2023,USD,287155,123837,163318,111609,51709,0,51709,2871,5743,45966,1899,202365,110946,91419,,287155,20.0,10.0,0.0446,106,224.61,1000.0,1.9,0.5687
221,Davis-Stephens,False,EG,West Nicole,EdTech,2016,https://davis-stephens.com,Cost and keep enjoy student nor character recent.,17,davis-stephens,2023,USD,262401,55481,206920,46221,160699,10967,149732,2624,5248,144484,12415,149313,66739,82574,21866.75,262401,10.0,64.12,0.0533,514,42.52,14333.42,0.87,0.7886
222,Miller LLC,False,TN,Arellanoshire,Mobility,2008,https://millerllc.com,Network subject stand industry movement term little.,24,miller-llc,2023,USD,3931046,928237,3002809,3486211,-483402,23643,-507045,39310,78620,-585665,155147,2198633,650725,1547908,,3931046,20.0,96.96,0.0249,1912,171.27,280662.48,0.55,0.7639
223,Alvarez Inc,False,TN,Orrton,E-commerce,2020,https://alvarezinc.com,Number might number work challenge we last we cold.,18,alvarez-inc,2023,USD,1106301,614572,491729,480503,11226,0,11226,11063,22126,-10900,120709,699760,34988,664772,,1106301,1857.74,928.87,0.001,386,238.24,40903.58,2.95,0.4445
224,Stokes and Sons,False,ZA,South Christianchester,HealthTech,2022,https://stokesandsons.com,Young physical street election treat trial.,20,stokes-and-sons,2023,USD,635057,328391,306666,31752,274914,21283,253631,6350,12701,240930,15525,519286,64370,454916,52921.42,635057,654.92,3408.36,0.0322,361,146.47,1000.0,15.52,0.4829
225,Miller PLC,False,GB,Arnoldview,IoT,2008,https://millerplc.com,Leader them skill performance mission information increase challenge onto serve.,20,miller-plc,2023,USD,756654,152078,604576,403708,200868,1894,198974,7566,15133,183841,5614,554467,98652,455815,,756654,158.69,79.34,0.0383,545,115.54,5313.66,1.06,0.799
226,Buckley PLC,False,TN,Port Justinside,IoT,2008,https://buckleyplc.com,There enough pressure occur list common idea peace.,21,buckley-plc,2023,USD,1080094,433709,646385,603067,43318,0,43318,10800,21601,21717,38879,626037,70829,555208,,1080094,47.52,241.46,0.0566,727,123.68,66965.17,0.58,0.5985
227,Steele Williams and Preston,False,FR,Hannahton,Marketplaces,2021,https://steelewilliamsandpreston.com,Tv today after stage field exactly man receive better.,15,steele-williams-and-preston,2023,EUR,2686263,1080845,1605418,728974,876444,22939,853505,26862,53725,799780,78796,1618941,639707,979234,,2686263,427.55,213.78,0.0171,5766,38.82,69818.01,1.13,0.5976
228,Taylor Ltd,False,GB,Schroedermouth,Mobility,2013,https://taylorltd.com,Rock painting become kid tree imagine machine.,23,taylor-ltd,2023,USD,413100,96860,316240,164557,151683,17204,134479,4131,8262,126217,24165,379174,210962,168212,,413100,989.8,808.45,0.0182,131,261.5,1000.0,24.16,0.7655
229,Camacho Nicholson and Robertson,False,US,North Larry,AgriTech,2020,https://camachonicholsonandrobertson.com,Idea sister modern notice community themselves customer arm almost.,19,camacho-nicholson-and-robertson,2023,USD,2449753,1432193,1017560,549095,468465,0,468465,24497,48995,419470,195234,1597981,79899,1518082,,2449753,166.2,549.49,0.1009,10207,20.0,46042.8,4.24,0.4154
230,Hull Ltd,False,CA,West Micheal,EdTech,2022,https://hullltd.com,Measure play buy air head order concern that only.,16,hull-ltd,2023,USD,96809,49803,47006,78160,-31154,34289,-65443,968,1936,-67379,5703,243180,28391,214789,8067.42,96809,290.69,1600.44,0.0181,1613,5.0,1197.82,4.76,0.4856
231,Cooper-Monroe,False,CA,Kaitlynland,E-commerce,2020,https://cooper-monroe.com,Agree anyone take sister Democrat determine different.,24,cooper-monroe,2023,USD,219523,65914,153609,10976,142633,12246,130387,2195,4390,125997,9504,191320,74729,116591,,219523,735.69,935.97,0.114,206,88.66,25834.49,0.37,0.6997
232,Adams Group,False,IN,Port Kimberlytown,Energy,2016,https://adamsgroup.com,Treatment positive over across education source figure whom poor.,30,adams-group,2023,USD,2536169,672523,1863646,1683734,179912,37989,141923,25361,50723,91200,369920,1700997,746227,954770,,2536169,20.0,18.86,0.001,10567,20.0,165537.53,2.23,0.7348
233,Woodard-York,False,FR,Kingmouth,Mobility,2008,https://woodard-york.com,Quality station however bill memory production successful.,15,woodard-york,2023,EUR,3843917,1125811,2718106,922087,1796019,505,1795514,38439,76878,1718636,61920,2022224,847051,1175173,,3843917,113.58,309.07,0.087,2015,158.94,38653.46,1.6,0.7071
234,Hoffman-Wheeler,False,ZA,Kennethville,AI/ML,2009,https://hoffman-wheeler.com,As write political technology end represent throughout federal change.,17,hoffman-wheeler,2023,USD,2947954,419363,2528591,2428331,100260,5826,94434,29479,58959,35475,229553,1839524,1537527,301997,,2947954,20.0,75.3,0.001,959,256.04,203569.77,1.13,0.8577
235,Yoder PLC,False,CA,Guerreroberg,EdTech,2010,https://yoderplc.com,Pretty young else industry home.,13,yoder-plc,2023,USD,262371,73978,188393,43833,144560,0,144560,2623,5247,139313,3102,228133,118963,109170,21864.25,262371,10.0,39.78,0.0103,283,77.09,1000.0,3.1,0.718
236,Aguilar PLC,False,AU,West Jessica,Marketplaces,2009,https://aguilarplc.com,Rather point little wait grow feel color.,19,aguilar-plc,2023,USD,381132,144929,236203,58497,177706,17168,160538,3811,7622,152916,38928,359529,247044,112485,,381132,20.0,10.0,0.0461,225,141.0,3217.54,12.1,0.6197
237,Walter White and Davis,False,AU,Lake Jonathan,SaaS,2015,https://walterwhiteanddavis.com,Several consumer quite friend become great season film small former.,25,walter-white-and-davis,2023,USD,2641117,740917,1900200,334220,1565980,0,1565980,26411,52822,1513158,63207,1528698,422919,1105779,220093.08,2641117,10.0,50.33,0.0592,2735,80.45,20341.79,3.11,0.7195
238,Richards-Ford,False,DE,South Brianshire,SaaS,2012,https://richards-ford.com,Want author threat matter test high fear approach take case.,15,richards-ford,2023,EUR,2898280,1501806,1396474,477004,919470,0,919470,28982,57965,861505,117898,1687655,673677,1013978,241523.33,2898280,572.26,1484.73,0.098,48304,5.0,42077.6,2.8,0.4818
239,Cooper PLC,False,DE,Thomasburgh,HealthTech,2023,https://cooperplc.com,Maintain piece computer play above.,19,cooper-plc,2023,EUR,3198311,1543852,1654459,3219115,-1564656,5218,-1569874,31983,63966,-1633840,151126,1782112,487329,1294783,266525.92,3198311,583.66,1222.98,0.0097,4525,58.89,252806.39,0.6,0.5173
240,Clark-Ayala,False,BR,South Kristen,Fintech,2014,https://clark-ayala.com,Can its investment investment local.,26,clark-ayala,2023,USD,2533227,1160339,1372888,1425716,-52828,28669,-81497,25332,50664,-132161,38996,1320825,196467,1124358,,2533227,377.83,852.78,0.0419,3595,58.72,126910.48,0.31,0.542
241,Johnson and Sons,False,EG,Stephaniemouth,Cybersecurity,2016,https://johnsonandsons.com,Course quality phone eat really general can himself open cold.,22,johnson-and-sons,2023,USD,2182759,433937,1748822,785569,963253,0,963253,21827,43655,919598,56569,1242491,519945,722546,,2182759,20.0,51.64,0.0767,2770,65.66,59128.78,0.96,0.8012
242,Evans LLC,False,AU,Lunahaven,E-commerce,2013,https://evansllc.com,Its rather card you majority seek close trade.,12,evans-llc,2023,USD,881896,316693,565203,336731,228472,33865,194607,8818,17637,176970,4854,555777,449509,106268,,881896,63.71,351.39,0.0693,867,84.73,53694.1,0.09,0.6409
243,Smith-Walker,False,KE,East Jessica,IoT,2011,https://smith-walker.com,Mean but represent society heart policy side perhaps order answer.,15,smith-walker,2023,USD,1143728,111157,1032571,622280,410291,11224,399067,11437,22874,376193,65328,716459,231811,484648,,1143728,961.5,4564.55,0.0251,463,205.73,77938.44,0.84,0.9028
244,Valdez Inc,False,AU,Lake Darrellmouth,HealthTech,2017,https://valdezinc.com,Buy education reduce day rate act inside big.,16,valdez-inc,2023,USD,4186010,1062140,3123870,1490871,1632999,0,1632999,41860,83720,1549279,194937,2477269,825726,1651543,348834.17,4186010,404.79,1364.41,0.001,69766,5.0,142690.52,1.37,0.7463
245,Nelson Obrien and Taylor,False,FR,New Jenniferville,IoT,2008,https://nelsonobrienandtaylor.com,Box blood cup current enjoy mission cut.,17,nelson-obrien-and-taylor,2023,EUR,212720,78996,133724,102270,31454,23486,7968,2127,4254,3714,6824,147937,87132,60805,,212720,1602.74,3750.03,0.0394,886,20.0,1000.0,6.82,0.6286
246,Ortiz Martin and Kelley,False,IN,Lake Sarah,IoT,2020,https://ortizmartinandkelley.com,Doctor actually become book off management we single.,19,ortiz-martin-and-kelley,2023,USD,462985,232990,229995,247468,-17473,0,-17473,4629,9259,-26732,7898,334303,197636,136667,,462985,20.0,44.04,0.0042,162,237.02,27154.82,0.29,0.4968
247,Cummings Inc,False,TN,Dawnmouth,Cybersecurity,2014,https://cummingsinc.com,Enough anyone spend them system growth quality.,21,cummings-inc,2023,USD,2793966,1252723,1541243,1257201,284042,26666,257376,27939,55879,201497,294275,1874994,1196038,678956,,2793966,20.0,101.81,0.0675,5191,44.85,98845.83,2.98,0.5516
248,Rodgers-Davis,False,FR,North Melissaburgh,IoT,2015,https://rodgers-davis.com,Group just perform there behavior spring consumer husband.,32,rodgers-davis,2023,EUR,483374,317365,166009,139913,26096,0,26096,4833,9667,16429,26320,354233,70796,283437,,483374,340.6,909.94,0.052,425,94.63,26789.4,0.98,0.3434
249,Nelson-Cruz,False,FR,Marshburgh,Cybersecurity,2017,https://nelson-cruz.com,Car risk word such billion.,17,nelson-cruz,2023,EUR,5034524,2420249,2614275,876462,1737813,7712,1730101,50345,100690,1629411,691625,3305794,1652264,1653530,,5034524,205.85,194.99,0.1115,2271,184.73,53744.39,12.87,0.5193
250,Webb Carroll and Kim,False,BR,Maxwelltown,IoT,2011,https://webbcarrollandkim.com,Low maintain thought key as pressure.,24,webb-carroll-and-kim,2023,USD,2598140,1121024,1477116,1080179,396937,0,396937,25981,51962,344975,92380,1431925,71596,1360329,,2598140,287.02,1630.44,0.0499,1015,213.23,75573.56,1.22,0.5685
251,Bush Ltd,False,AU,Lake Morgan,IoT,2009,https://bushltd.com,Mission red believe product eat generation put his stuff next.,13,bush-ltd,2023,USD,791719,274214,517505,195781,321724,49366,272358,7917,15834,256524,14989,597432,29871,567561,,791719,808.69,6379.89,0.0229,546,120.7,1000.0,14.99,0.6536
252,Brown Schneider and Moore,False,CA,Christianburgh,AI/ML,2021,https://brownschneiderandmoore.com,Seem fly former everything medical.,18,brown-schneider-and-moore,2023,USD,3441753,742971,2698782,1240146,1458636,0,1458636,34417,68835,1389801,338473,2199342,431374,1767968,,3441753,136.45,269.04,0.0636,4178,68.64,66149.91,5.12,0.7841
253,Schneider Powell and Young,False,BR,Wallaceshire,E-commerce,2010,https://schneiderpowellandyoung.com,Because material firm wonder seat adult idea along near.,22,schneider-powell-and-young,2023,USD,705945,222567,483378,345391,137987,25387,112600,7059,14118,98482,25521,464929,249568,215361,,705945,1591.29,12002.94,0.0298,366,160.67,38611.17,0.66,0.6847
254,Conner PLC,False,NG,Pamelaside,Marketplaces,2018,https://connerplc.com,Pressure lay future stay staff such.,34,conner-plc,2023,USD,1168954,470290,698664,58447,640217,18641,621576,11689,23379,598197,66307,691480,315109,376371,,1168954,1072.67,2454.95,0.001,383,253.77,22404.98,2.96,0.5977
255,Castro-Harvey,False,US,Moranstad,Energy,2023,https://castro-harvey.com,Box service develop game stop who factor miss reduce.,21,castro-harvey,2023,USD,1278626,239533,1039093,691816,347277,9529,337748,12786,25572,312176,41763,722926,321139,401787,,1278626,1251.15,4385.45,0.1192,5327,20.0,66535.3,0.63,0.8127
256,Prince Group,False,FR,Port Jennifer,Energy,2019,https://princegroup.com,Blood particularly could us hotel lead sit response.,24,prince-group,2023,EUR,4041661,1667872,2373789,1719812,653977,50448,603529,40416,80833,522696,491624,2635553,914570,1720983,,4041661,799.27,3298.52,0.0896,5630,59.82,133152.46,3.69,0.5873
257,Sherman Inc,False,BR,Port Patriciamouth,Mobility,2012,https://shermaninc.com,What care material morning any very stuff lot meet TV.,21,sherman-inc,2023,USD,1474042,403541,1070501,867820,202681,0,202681,14740,29480,173201,206494,1041143,294929,746214,,1474042,129.05,336.11,0.0595,6141,20.0,57764.89,3.57,0.7262
258,Holt and Sons,False,TN,North Paul,HealthTech,2024,https://holtandsons.com,Paper focus thing industry participant realize eat huge garden family.,12,holt-and-sons,2023,USD,806844,380519,426325,398779,27546,15939,11607,8068,16136,-4529,43217,453109,174472,278637,67237.0,806844,76.45,325.97,0.0164,13447,5.0,28858.52,1.5,0.5284
259,Taylor PLC,False,BR,Meganside,AgriTech,2023,https://taylorplc.com,Republican very plan cut person fact generation public.,15,taylor-plc,2023,USD,314446,70035,244411,85134,159277,0,159277,3144,6288,152989,41799,357375,17868,339507,,314446,801.96,2150.96,0.0291,1310,20.0,1000.0,41.8,0.7773
260,Santos Mullen and Gordon,False,EG,Jenniferstad,Energy,2016,https://santosmullenandgordon.com,Lose number project individual security subject experience suggest space mission.,22,santos-mullen-and-gordon,2023,USD,5532492,2287585,3244907,2568396,676511,4491,672020,55324,110649,561371,99719,2906609,1378167,1528442,,5532492,20.0,165.8,0.0051,2050,224.82,187789.35,0.53,0.5865
261,James Inc,False,CA,East Josephburgh,EdTech,2010,https://jamesinc.com,Raise chair artist six daughter must grow.,25,james-inc,2023,USD,101179,14746,86433,30418,56015,26558,29457,1011,2023,27434,5746,190369,127515,62854,8431.58,101179,211.55,975.72,0.0535,430,19.59,44369.53,0.13,0.8543
262,Garcia-Parrish,False,IN,Lake Deborah,Mobility,2015,https://garcia-parrish.com,Down six sometimes explain professor unit hold what.,22,garcia-parrish,2023,USD,665795,246269,419526,208038,211488,0,211488,6657,13315,198173,218880,580533,362031,218502,,665795,20.0,39.14,0.1071,2774,20.0,1000.0,218.88,0.6301
263,Edwards Arnold and Smith,False,AU,Jamesmouth,Mobility,2020,https://edwardsarnoldandsmith.com,Treatment relate positive sense national owner simply.,21,edwards-arnold-and-smith,2023,USD,10103847,1889566,8214281,1018129,7196152,11773,7184379,101038,202076,6982303,1685156,6766399,1523659,5242740,,10103847,1618.38,5052.35,0.001,24341,34.59,81423.55,20.7,0.813
264,Phillips and Sons,False,CA,East Sydneyhaven,SaaS,2023,https://phillipsandsons.com,Help investment news candidate once effort.,15,phillips-and-sons,2023,USD,384235,173038,211197,156272,54925,0,54925,3842,7684,47241,15757,315468,150827,164641,32019.58,384235,166.06,232.74,0.037,583,54.92,1000.0,15.76,0.5497
265,Owens-Pineda,False,CA,East Sarahton,HealthTech,2023,https://owens-pineda.com,Past product make of group six fish detail contain attention measure.,21,owens-pineda,2023,USD,1895350,675122,1220228,961451,258777,26486,232291,18953,37907,194384,118601,1244342,660501,583841,157945.83,1895350,566.34,1097.92,0.0041,2333,67.68,61237.0,1.94,0.6438
266,Daniels-Powell,False,DE,Jeffreyborough,E-commerce,2016,https://daniels-powell.com,Former family wear peace little no sell power.,15,daniels-powell,2023,EUR,581213,125242,455971,29060,426911,37038,389873,5812,11624,378249,156003,460784,125451,335333,,581213,1132.79,5096.12,0.0805,327,147.93,38181.91,4.09,0.7845
267,Caldwell Group,False,CA,Lake Christina,AgriTech,2016,https://caldwellgroup.com,During always those high someone box either rich agency might side.,21,caldwell-group,2023,USD,206869,91894,114975,39839,75136,0,75136,2068,4137,70999,20054,317092,15854,301238,,206869,20.0,110.37,0.1073,45,376.44,1000.0,20.05,0.5558
268,Lang Griffin and Williams,False,NG,West Willie,SaaS,2024,https://langgriffinandwilliams.com,Cold what Mrs account assume.,26,lang-griffin-and-williams,2023,USD,2475444,966258,1509186,973173,536013,0,536013,24754,49508,486505,60300,1309794,65489,1244305,206287.0,2475444,803.61,3433.3,0.0353,26930,7.66,93844.52,0.64,0.6097
269,Soto Lewis and Jennings,False,DE,East Amandachester,Fintech,2015,https://sotolewisandjennings.com,Section child learn forward beautiful.,24,soto-lewis-and-jennings,2023,EUR,299997,54822,245175,101631,143544,0,143544,2999,5999,137545,13916,164645,73614,91031,,299997,20.0,32.51,0.001,243,102.66,34274.47,0.41,0.8173
270,Thompson LLC,False,ZA,New Lorraineview,Energy,2023,https://thompsonllc.com,Hold picture item admit pull movement political peace.,16,thompson-llc,2023,USD,2983687,745935,2237752,866554,1371198,7188,1364010,29836,59673,1304337,160925,1713198,744057,969141,,2983687,128.7,481.35,0.0438,1883,132.02,81368.95,1.98,0.75
271,Richards Haynes and Jones,False,NG,West Kristinport,EdTech,2023,https://richardshaynesandjones.com,Beat she join house produce listen mouth carry hospital something.,18,richards-haynes-and-jones,2023,USD,164104,56747,107357,40574,66783,0,66783,1641,3282,63501,12951,254425,99874,154551,13675.33,164104,464.79,1459.94,0.0565,622,21.97,8060.45,1.61,0.6542
272,Phillips Walters and Evans,False,BR,Susantown,Cybersecurity,2023,https://phillipswaltersandevans.com,Themselves center among of hour natural be decide scientist rise.,16,phillips-walters-and-evans,2023,USD,765244,231808,533436,310995,222441,0,222441,7652,15304,207137,34302,569041,336081,232960,,765244,1053.49,2262.33,0.0701,330,193.05,11476.98,2.99,0.6971
273,Gutierrez Ltd,False,EG,East Jack,SaaS,2010,https://gutierrezltd.com,Strong create consider son system surface usually yes leave near fact.,23,gutierrez-ltd,2023,USD,1645471,503367,1142104,656655,485449,41130,444319,16454,32909,411410,57936,900679,504379,396300,137122.58,1645471,493.51,766.72,0.0808,1915,71.57,19933.5,2.91,0.6941
274,King and Sons,False,IN,Lynnstad,EdTech,2020,https://kingandsons.com,Provide doctor expect attorney cover magazine.,20,king-and-sons,2023,USD,754163,250340,503823,465254,38569,42037,-3468,7541,15083,-18551,28468,456041,239165,216876,62846.92,754163,28.48,132.87,0.058,1680,37.4,34316.75,0.83,0.6681
275,Jensen-Torres,False,ZA,New Ashley,EdTech,2017,https://jensen-torres.com,When collection finish size Republican political everybody growth.,22,jensen-torres,2023,USD,175348,43761,131587,72752,58835,11152,47683,1753,3506,44177,5918,234807,145683,89124,14612.33,175348,10.0,32.61,0.019,253,57.55,1000.0,5.92,0.7504
276,Quinn Humphrey and Ford,False,BR,Kimfort,IoT,2019,https://quinnhumphreyandford.com,Board population bank exactly step through cultural safe phone road.,14,quinn-humphrey-and-ford,2023,USD,578295,191922,386373,167842,218531,0,218531,5782,11565,206966,7151,443330,22166,421164,,578295,1519.43,3397.65,0.0755,155,309.5,4291.02,1.67,0.6681
277,Atkinson Ltd,False,EG,Port Bonniefurt,AI/ML,2024,https://atkinsonltd.com,Defense already end thus music president chance hotel through operation.,22,atkinson-ltd,2023,USD,202869,64053,138816,95567,43249,38024,5225,2028,4057,1168,24863,155967,7798,148169,,202869,944.61,1328.24,0.1824,391,43.18,21874.38,1.14,0.6843
278,Anderson-Mason,False,CA,South Michaeltown,Energy,2018,https://anderson-mason.com,Summer southern pass coach method land condition.,17,anderson-mason,2023,USD,20111145,9040476,11070669,13577928,-2507259,12466,-2519725,201111,402222,-2921947,1888786,12072228,1822547,10249681,,20111145,20.0,67.14,0.1214,21425,78.22,1102011.36,1.71,0.5505
279,Hopkins Faulkner and Fitzgerald,False,CA,Crosbyton,Cybersecurity,2022,https://hopkinsfaulknerandfitzgerald.com,Seven discussion enough doctor protect military social.,23,hopkins-faulkner-and-fitzgerald,2023,USD,3396918,1006211,2390707,940733,1449974,0,1449974,33969,67938,1382036,188355,1920500,1456536,463964,,3396918,427.82,814.47,0.0521,3194,88.61,66689.9,2.82,0.7038
280,Harrison-Gibson,False,IN,North Tinamouth,AgriTech,2016,https://harrison-gibson.com,Region miss stop strong enjoy.,21,harrison-gibson,2023,USD,741646,289531,452115,379354,72761,25489,47272,7416,14832,32440,27855,597106,92507,504599,,741646,931.76,1764.9,0.1001,241,256.42,21661.42,1.29,0.6096
281,Hudson Bennett and Gray,False,DE,New Johnbury,Fintech,2014,https://hudsonbennettandgray.com,Image stage generation society thought according think key discover method.,16,hudson-bennett-and-gray,2023,EUR,243743,99102,144641,12187,132454,0,132454,2437,4874,127580,1529,260552,86708,173844,,243743,20.0,23.18,0.0254,1015,20.0,1000.0,1.53,0.5934
282,Lewis-Lopez,False,CA,Carolynville,Fintech,2013,https://lewis-lopez.com,Increase form box push look opportunity positive.,22,lewis-lopez,2023,USD,1555956,635141,920815,518202,402613,0,402613,15559,31119,371494,84706,879246,608408,270838,,1555956,253.61,201.72,0.001,1625,79.75,41417.12,2.05,0.5918
283,Johnson-Williams,False,DE,East Crystal,EdTech,2023,https://johnson-williams.com,Three chair coach two might.,14,johnson-williams,2023,EUR,294133,103007,191126,138768,52358,54789,-2431,2941,5882,-8313,10482,258558,172196,86362,24511.08,294133,384.19,2500.55,0.024,1940,12.63,1000.0,10.48,0.6498
284,Greene-Elliott,False,IN,Lake Jessicaport,Cybersecurity,2024,https://greene-elliott.com,Describe paper likely loss detail.,22,greene-elliott,2023,USD,5366633,2724630,2642003,1822501,819502,0,819502,53666,107332,712170,154244,2893390,935053,1958337,,5366633,845.84,2310.59,0.0702,2992,149.45,140887.89,1.09,0.4923
285,Burke-Norton,False,KE,New Donna,AgriTech,2011,https://burke-norton.com,Cold rate two others attention her car.,18,burke-norton,2023,USD,881169,152329,728840,312725,416115,0,416115,8811,17623,398492,58236,673493,351808,321685,,881169,945.71,3192.59,0.0836,224,326.8,36807.62,1.58,0.8271
286,Harris PLC,False,DE,Serranoville,AgriTech,2015,https://harrisplc.com,Live pass although six me brother.,21,harris-plc,2023,EUR,689351,279361,409990,297653,112337,20683,91654,6893,13787,77867,235376,727198,488499,238699,,689351,1272.69,2639.71,0.0425,288,199.39,1000.0,235.38,0.5947
287,Hopkins-Winters,False,CA,Port Erikachester,HealthTech,2017,https://hopkins-winters.com,Inside themselves recently investment voice lot shoulder go source traditional.,24,hopkins-winters,2023,USD,2568477,557722,2010755,921116,1089639,1974,1087665,25684,51369,1036296,31802,1433965,671482,762483,214039.75,2568477,10.0,44.3,0.001,3652,58.6,88074.01,0.36,0.7829
288,Johnston Coleman and Scott,False,US,Port Christopher,Cybersecurity,2012,https://johnstoncolemanandscott.com,Theory impact country remember smile official brother according pressure reach.,19,johnston-coleman-and-scott,2023,USD,743536,212263,531273,533212,-1939,8466,-10405,7435,14870,-25275,14287,477284,230311,246973,,743536,1202.71,3901.15,0.1273,3098,20.0,92718.68,0.15,0.7145
289,Ortiz-Rodriguez,False,IN,Pearsonview,SaaS,2009,https://ortiz-rodriguez.com,Talk interest hand every quite sense including.,15,ortiz-rodriguez,2023,USD,801221,337702,463519,626148,-162629,0,-162629,8012,16024,-178653,58653,513938,165906,348032,66768.42,801221,727.91,2701.43,0.0196,571,116.86,22041.53,2.66,0.5785
290,Olson Wood and Peters,False,NG,Vanessashire,AgriTech,2012,https://olsonwoodandpeters.com,Similar huge catch tell budget discover situation we.,26,olson-wood-and-peters,2023,USD,298852,174648,124204,124865,-661,19575,-20236,2988,5977,-26213,3694,322559,16127,306432,,298852,514.44,2417.47,0.0846,309,80.55,22056.84,0.17,0.4156
291,Lewis Group,False,BR,Laurenton,Mobility,2011,https://lewisgroup.com,Home player source statement likely outside.,18,lewis-group,2023,USD,702052,330101,371951,560492,-188541,19210,-207751,7020,14041,-221792,53926,550165,234330,315835,,702052,366.71,983.71,0.0191,1051,55.66,26104.54,2.07,0.5298
292,Brown and Sons,False,US,Christopherton,IoT,2017,https://brownandsons.com,Us husband prevent expert white arm similar compare.,22,brown-and-sons,2023,USD,5206172,1109149,4097023,3197969,899054,9592,889462,52061,104123,785339,103535,2746717,897346,1849371,,5206172,20.0,10.0,0.053,1447,299.78,285487.88,0.36,0.787
293,Gonzales-Harris,False,EG,Jameshaven,Mobility,2022,https://gonzales-harris.com,Recognize past purpose growth pretty wish beautiful every human prove.,23,gonzales-harris,2023,USD,393639,130850,262789,251208,11581,0,11581,3936,7872,3709,23599,251733,149276,102457,,393639,341.97,853.91,0.1047,99,328.94,28977.85,0.81,0.6676
294,Willis-Holmes,False,CA,North Andreaside,HealthTech,2009,https://willis-holmes.com,Give white everybody paper create upon offer end imagine blood.,20,willis-holmes,2023,USD,683103,268742,414361,492590,-78229,0,-78229,6831,13662,-91891,19161,430823,115269,315554,56925.25,683103,361.29,1754.56,0.0216,657,86.54,15468.55,1.24,0.6066
295,Gordon LLC,False,IN,Port Williamview,Mobility,2011,https://gordonllc.com,Spend offer reason whom none show serious which learn leave.,15,gordon-llc,2023,USD,7139816,2987733,4152083,2176486,1975597,0,1975597,71398,142796,1832801,325305,4001524,1208858,2792666,,7139816,592.51,489.86,0.0052,5125,116.08,162417.54,2.0,0.5815
296,Atkins Olson and Scott,False,FR,Schultzbury,Energy,2023,https://atkinsolsonandscott.com,Son include good movie red enjoy expert.,13,atkins-olson-and-scott,2023,EUR,2586686,1085404,1501282,1515446,-14164,0,-14164,25866,51733,-65897,125784,1544992,418014,1126978,,2586686,678.05,2151.72,0.0678,10777,20.0,130118.71,0.97,0.5804
297,Nunez-Nicholson,False,FR,New Sarahfort,IoT,2009,https://nunez-nicholson.com,Government thus especially water raise travel material current.,24,nunez-nicholson,2023,EUR,1000467,224145,776322,791009,-14687,37812,-52499,10004,20009,-72508,1169751,1802730,225884,1576846,,1000467,20.0,36.36,0.0882,556,149.82,54817.17,21.34,0.776
298,Allen Baker and Perez,False,GB,Port Christine,HealthTech,2017,https://allenbakerandperez.com,Single build bad what manage according.,20,allen-baker-and-perez,2023,USD,2650061,1167127,1482934,1601458,-118524,86,-118610,26500,53001,-171611,313638,1801364,1056761,744603,220838.42,2650061,191.08,555.62,0.0479,14111,15.65,128808.74,2.43,0.5596
299,Rubio Charles and Watson,False,FR,Travisshire,EdTech,2011,https://rubiocharlesandwatson.com,Make worker trouble exactly develop office approach.,23,rubio-charles-and-watson,2023,EUR,3439750,1359564,2080186,1461919,618267,0,618267,34397,68795,549472,80399,1887114,612656,1274458,286645.83,3439750,155.29,521.16,0.0148,2933,97.72,113495.43,0.71,0.6047
300,Mendoza-Fernandez,False,NG,Phillipburgh,Energy,2015,https://mendoza-fernandez.com,With recently least ready activity decision ok foot party.,24,mendoza-fernandez,2023,USD,4109397,499009,3610388,595324,3015064,12594,3002470,41093,82187,2920283,1183119,3391674,833765,2557909,,4109397,351.12,665.68,0.1342,17122,20.0,86488.31,13.68,0.8786
301,Lopez-Baker,False,AU,Thomasmouth,AI/ML,2020,https://lopez-baker.com,Contain interest industry sell half hundred late number.,18,lopez-baker,2023,USD,701841,176916,524925,353976,170949,0,170949,7018,14036,156913,46456,556137,307665,248472,,701841,2118.79,13225.39,0.0443,2924,20.0,10226.33,4.54,0.7479
302,Parks Olsen and Le,False,EG,New Ryan,Mobility,2017,https://parksolsenandle.com,Cultural son school list act instead care throw.,28,parks-olsen-and-le,2023,USD,353674,160863,192811,156465,36346,23537,12809,3536,7073,5736,160271,363046,194769,168277,,353674,960.56,8288.97,0.0448,587,50.19,20904.89,7.67,0.5452
303,Holmes Le and Floyd,False,KE,Johnshire,Energy,2017,https://holmesleandfloyd.com,Huge real art sport live.,21,holmes-le-and-floyd,2023,USD,2269840,847515,1422325,442791,979534,9127,970407,22698,45396,925011,489766,1815693,798409,1017284,,2269840,20.0,84.52,0.0069,1627,116.21,18581.3,26.36,0.6266
304,Davis Garner and Green,False,KE,Annview,IoT,2009,https://davisgarnerandgreen.com,After building test white current office power company.,25,davis-garner-and-green,2023,USD,215356,50427,164929,187283,-22354,23196,-45550,2153,4307,-49857,2489,159034,50470,108564,,215356,850.51,425.26,0.0454,60,294.38,10689.34,0.23,0.7658
305,Kelly-Nunez,False,KE,Hamptonmouth,Cybersecurity,2011,https://kelly-nunez.com,High expert place certain cold.,20,kelly-nunez,2023,USD,847280,259779,587501,294984,292517,34427,258090,8472,16945,241145,29447,485239,174654,310585,,847280,513.15,2923.81,0.1249,3530,20.0,19945.48,1.48,0.6934
306,Fisher-Salazar,False,AU,Sweeneyland,EdTech,2014,https://fisher-salazar.com,Class direction first fact environment.,20,fisher-salazar,2023,USD,121253,40125,81128,27498,53630,0,53630,1212,2425,51205,17574,191968,90051,101917,10104.42,121253,160.35,664.58,0.001,382,26.4,1000.0,17.57,0.6691
307,Foster Barron and Norman,False,IN,Juliehaven,Marketplaces,2010,https://fosterbarronandnorman.com,Including contain age road product wait red bag cold.,22,foster-barron-and-norman,2023,USD,661628,250872,410756,249062,161694,32131,129563,6616,13232,116331,27075,494590,196039,298551,,661628,20.0,36.47,0.1209,2756,20.0,1000.0,27.08,0.6208
308,Davis Group,False,GB,North Kellihaven,EdTech,2013,https://davisgroup.com,Billion peace base use hope.,23,davis-group,2023,USD,2687956,893933,1794023,994167,799856,0,799856,26879,53759,746097,121803,1522885,347934,1174951,223996.33,2687956,487.34,2151.71,0.0392,5032,44.51,60936.86,2.0,0.6674
309,Wright LLC,False,NG,Simsberg,Fintech,2013,https://wrightllc.com,Stuff agreement professional team foot live window music evening know.,22,wright-llc,2023,USD,619179,339771,279408,241005,38403,5045,33358,6191,12383,20975,90290,441829,267031,174798,,619179,442.22,1459.52,0.001,172,299.45,17950.24,5.03,0.4513
310,Ryan Garza and Bryant,False,US,Millsside,Energy,2022,https://ryangarzaandbryant.com,Training loss dinner become film include choose.,18,ryan-garza-and-bryant,2023,USD,4219845,1249238,2970607,3726017,-755410,1987,-757397,42198,84396,-841793,291266,2535751,1290565,1245186,,4219845,20.0,52.85,0.0343,1531,229.56,318904.48,0.91,0.704
311,Smith and Sons,False,ZA,Justinside,IoT,2023,https://smithandsons.com,Reach man sense federal.,15,smith-and-sons,2023,USD,367602,169744,197858,171975,25883,0,25883,3676,7352,18531,28616,269805,148195,121610,,367602,202.89,1008.92,0.0144,476,64.31,1000.0,28.62,0.5382
312,Yates-Harper,False,IN,New Nathanielchester,SaaS,2015,https://yates-harper.com,Join economic resource position stock determine bad personal might son.,15,yates-harper,2023,USD,865396,284675,580721,495764,84957,4814,80143,8653,17307,62836,58817,602055,202105,399950,72116.33,865396,10.0,14.45,0.0359,2971,24.27,78699.05,0.75,0.671
313,Aguirre Cohen and Mitchell,False,IN,Robertland,Cybersecurity,2017,https://aguirrecohenandmitchell.com,Carry book lay laugh red man.,22,aguirre-cohen-and-mitchell,2023,USD,2020163,674901,1345262,101008,1244254,0,1244254,20201,40403,1203851,38318,1086278,413806,672472,,2020163,1149.2,574.6,0.1819,2083,80.81,26282.23,1.46,0.6659
314,Smith-Williams,False,ZA,East Teresaport,Mobility,2010,https://smith-williams.com,By just account bed address describe inside.,27,smith-williams,2023,USD,794616,342687,451929,393837,58092,5217,52875,7946,15892,36983,69629,488332,265923,222409,,794616,240.27,120.14,0.0662,580,114.14,30297.67,2.3,0.5687
315,Bolton-Ford,False,BR,West Christopherberg,EdTech,2016,https://bolton-ford.com,Entire hotel myself consider time.,25,bolton-ford,2023,USD,1213293,473717,739576,228596,510980,0,510980,12132,24265,486715,26593,647629,399391,248238,101107.75,1213293,527.25,1293.11,0.0761,2164,46.72,3034.52,8.76,0.6096
316,Roth-Clayton,False,AU,Port Jenniferfurt,Marketplaces,2014,https://roth-clayton.com,East yes current same behind program decade home which.,24,roth-clayton,2023,USD,224325,83322,141003,125346,15657,44085,-28428,2243,4486,-32914,38939,166224,122286,43938,,224325,20.0,87.5,0.0724,131,141.95,4287.45,9.08,0.6286
317,Moore-Chandler,False,TN,West Timothyport,Fintech,2015,https://moore-chandler.com,Growth appear project wind door its.,13,moore-chandler,2023,USD,753138,236642,516496,238765,277731,0,277731,7531,15062,262669,16211,561513,239895,321618,,753138,803.59,401.8,0.001,2350,26.7,48598.83,0.33,0.6858
318,Jackson LLC,False,BR,South Kristinatown,HealthTech,2016,https://jacksonllc.com,Ok real read choice side.,20,jackson-llc,2023,USD,585250,75481,509769,393883,115886,0,115886,5852,11705,104181,58850,427683,79781,347902,48770.83,585250,110.87,368.83,0.0316,601,81.03,5955.04,9.88,0.871
319,Moore Inc,False,GB,Sarahton,Fintech,2009,https://mooreinc.com,Green child movie blue maintain.,25,moore-inc,2023,USD,2878309,1457610,1420699,1036168,384531,15484,369047,28783,57566,311481,313605,1839960,610403,1229557,,2878309,209.83,104.92,0.0049,11992,20.0,78727.41,3.98,0.4936
320,Holden-Kramer,False,GB,Lindamouth,AgriTech,2017,https://holden-kramer.com,Again help right economy always religious.,16,holden-kramer,2023,USD,490501,60574,429927,147589,282338,44017,238321,4905,9810,228511,32162,436410,126099,310311,,490501,730.1,1310.67,0.0543,845,48.32,44198.15,0.73,0.8765
321,Phillips Terry and Lopez,False,EG,New Michael,Fintech,2022,https://phillipsterryandlopez.com,Every story trial never attention choice fast enjoy happen.,24,phillips-terry-and-lopez,2023,USD,3540162,1490566,2049596,1279633,769963,25810,744153,35401,70803,673350,137857,2022099,706921,1315178,,3540162,884.48,3553.15,0.0285,1049,281.1,76954.95,1.79,0.579
322,Parsons PLC,False,ZA,Grosstown,AgriTech,2020,https://parsonsplc.com,Task simply draw return probably much hold model marriage necessary party.,12,parsons-plc,2023,USD,248678,123044,125634,16961,108673,0,108673,2486,4973,103700,14107,276261,55510,220751,,248678,1719.83,2688.16,0.0207,1036,20.0,1000.0,14.11,0.5052
323,Ortiz-Morris,False,IN,New Donnaton,AI/ML,2023,https://ortiz-morris.com,Condition all blood court all politics.,30,ortiz-morris,2023,USD,323414,78544,244870,269479,-24609,5654,-30263,3234,6468,-36731,17901,243357,90317,153040,,323414,1302.33,4309.39,0.0332,1347,20.0,22059.11,0.81,0.7571
324,Barrett-Fox,False,EG,Brandonbury,Fintech,2009,https://barrett-fox.com,Responsibility actually TV pretty up story life police guess sea.,18,barrett-fox,2023,USD,1089570,281651,807919,772587,35332,0,35332,10895,21791,13541,134066,839036,320660,518376,,1089570,20.0,131.98,0.001,4539,20.0,25083.09,5.34,0.7415
325,Short-Bauer,False,TN,Port Christinahaven,Cybersecurity,2018,https://short-bauer.com,Same strong back democratic mind.,21,short-bauer,2023,USD,1237105,179352,1057753,307792,749961,15977,733984,12371,24742,709242,364120,1060183,453230,606953,,1237105,44.4,169.23,0.0404,1093,94.28,32552.36,11.19,0.855
326,Hardy PLC,False,KE,Lopezhaven,AgriTech,2008,https://hardyplc.com,Now way next newspaper second short office.,10,hardy-plc,2023,USD,139632,18644,120988,79658,41330,0,41330,1396,2792,38538,8481,132659,6782,125877,,139632,604.52,2775.78,0.0234,55,209.57,5223.84,1.62,0.8665
327,Ellis Ortega and Andrade,False,FR,Port Henry,EdTech,2008,https://ellisortegaandandrade.com,Measure price move outside value total nearly you.,20,ellis-ortega-and-andrade,2023,EUR,827679,228360,599319,520613,78706,0,78706,8276,16553,62153,6211,581408,202611,378797,68973.25,827679,10.0,29.99,0.0432,1042,66.14,44959.97,0.14,0.7241
328,Gutierrez-Schultz,False,AU,Charleneshire,Marketplaces,2016,https://gutierrez-schultz.com,Degree she unit effect which language however risk work other.,19,gutierrez-schultz,2023,USD,1807335,825324,982011,976502,5509,13511,-8002,18073,36146,-44148,273668,1273425,699290,574135,,1807335,168.62,84.31,0.1084,7530,20.0,73127.48,3.74,0.5433
329,Taylor Zamora and Smith,False,KE,East Melissa,SaaS,2013,https://taylorzamoraandsmith.com,Sign wall state try.,20,taylor-zamora-and-smith,2023,USD,806990,162265,644725,657422,-12697,1367,-14064,8069,16139,-30203,211605,748065,427236,320829,67249.17,806990,482.84,2401.94,0.0622,721,93.2,37199.51,5.69,0.7989
330,Hawkins Howe and Moore,False,EG,South Michaelberg,AI/ML,2022,https://hawkinshoweandmoore.com,Happen old do specific begin hundred truth.,27,hawkins-howe-and-moore,2023,USD,1231675,414055,817620,435722,381898,15818,366080,12316,24633,341447,147904,863014,284052,578962,,1231675,1021.32,2949.3,0.001,4307,23.83,57128.45,2.59,0.6638
331,Jones Nguyen and Olson,False,IN,Petersenshire,HealthTech,2021,https://jonesnguyenandolson.com,Organization feel room office bad.,20,jones-nguyen-and-olson,2023,USD,752413,284120,468293,37620,430673,0,430673,7524,15048,415625,115860,690976,416720,274256,62701.08,752413,10.0,47.01,0.0047,4485,13.98,7049.69,16.43,0.6224
332,Weeks LLC,False,BR,Nicholechester,Mobility,2010,https://weeksllc.com,Us building side section support up plant place approach.,19,weeks-llc,2023,USD,647559,244260,403299,200491,202808,0,202808,6475,12951,189857,64932,544353,110550,433803,,647559,20.0,109.41,0.086,2698,20.0,1000.0,64.93,0.6228
333,Williams Fernandez and Hernandez,False,EG,East Brent,E-commerce,2021,https://williamsfernandezandhernandez.com,Wife send offer bed it skill challenge from.,20,williams-fernandez-and-hernandez,2023,USD,1361959,843470,518489,1205148,-686659,20622,-707281,13619,27239,-734520,156047,1028375,549725,478650,,1361959,298.57,319.22,0.0367,671,168.92,80670.35,1.93,0.3807
334,Duncan-Williams,False,CA,Bakerfurt,E-commerce,2011,https://duncan-williams.com,Its recently seven lose cup house number night young.,20,duncan-williams,2023,USD,953681,147102,806579,332960,473619,15082,458537,9536,19073,439464,105187,626705,79055,547650,,953681,20.0,103.78,0.0814,365,217.67,54924.7,1.92,0.8458
335,Sanchez Jones and Frank,False,GB,Gailshire,E-commerce,2021,https://sanchezjonesandfrank.com,Both including half couple general.,12,sanchez-jones-and-frank,2023,USD,281183,58545,222638,14059,208579,23840,184739,2811,5623,179116,40882,358262,165065,193197,,281183,759.92,3645.52,0.001,132,176.53,8989.71,4.55,0.7918
336,Johnson Torres and Huerta,False,ZA,Hansonmouth,Mobility,2017,https://johnsontorresandhuerta.com,Under do rate choose rock.,15,johnson-torres-and-huerta,2023,USD,929737,265846,663891,266397,397494,22278,375216,9297,18594,356622,45945,701725,338923,362802,,929737,761.64,1855.07,0.001,3873,20.0,40818.94,1.13,0.7141
337,Rodriguez Inc,False,BR,New Sara,Energy,2009,https://rodriguezinc.com,Add really born late age decade Mrs.,25,rodriguez-inc,2023,USD,335104,105563,229541,132667,96874,10404,86470,3351,6702,79768,4452,233719,107232,126487,,335104,344.37,215.58,0.1029,156,178.93,1000.0,4.45,0.685
338,Payne LLC,False,EG,Deanberg,Fintech,2018,https://paynellc.com,Heavy town money eight.,13,payne-llc,2023,USD,516998,169911,347087,114668,232419,0,232419,5169,10339,222080,36465,339529,233344,106185,,516998,528.83,2873.97,0.0423,733,58.75,4734.58,7.7,0.6714
339,Campbell Ltd,False,IN,Briantown,E-commerce,2011,https://campbellltd.com,Home even system process ten.,15,campbell-ltd,2023,USD,286356,78557,207799,110191,97608,0,97608,2863,5727,91881,4542,318182,113501,204681,,286356,1359.9,1112.68,0.0897,103,230.86,5544.74,0.82,0.7257
340,Carter Ltd,False,AU,Hallfurt,Energy,2024,https://carterltd.com,With between firm term mother cost may leader unit again.,18,carter-ltd,2023,USD,1698654,243449,1455205,84932,1370273,26382,1343891,16986,33973,1309918,39190,971566,473853,497713,,1698654,20.0,151.73,0.0314,1564,90.48,19322.32,2.03,0.8567
341,Nielsen LLC,False,US,Tracyburgh,Marketplaces,2022,https://nielsenllc.com,Get goal personal door.,18,nielsen-llc,2023,USD,1253473,595835,657638,441937,215701,0,215701,12534,25069,190632,53004,705768,273754,432014,,1253473,526.37,3401.25,0.0083,526,198.26,32617.86,1.62,0.5247
342,Hill Brown and Scott,False,TN,Zamoratown,SaaS,2014,https://hillbrownandscott.com,We difficult game hotel case role minute question their rather.,24,hill-brown-and-scott,2023,USD,887044,318301,568743,368641,200102,0,200102,8870,17740,182362,49627,655583,143472,512111,73920.33,887044,139.84,332.13,0.0442,4216,17.53,1000.0,49.63,0.6412
343,Allen-Hernandez,False,NG,Reneemouth,E-commerce,2023,https://allen-hernandez.com,My deal catch must son television finally relate model.,14,allen-hernandez,2023,USD,2804170,1276499,1527671,782575,745096,20285,724811,28041,56083,668728,118517,1570883,78544,1492339,,2804170,1135.13,2361.85,0.001,1049,222.58,52942.83,2.24,0.5448
344,Jordan and Sons,False,BR,West Carlos,Mobility,2009,https://jordanandsons.com,We brother fish they risk she they increase in kitchen.,18,jordan-and-sons,2023,USD,1193173,416448,776725,584084,192641,0,192641,11931,23863,168778,217003,830783,436684,394099,,1193173,873.42,4128.43,0.0668,1411,70.44,44564.37,4.87,0.651
345,Mahoney Hill and Maxwell,False,DE,East Jackview,AgriTech,2012,https://mahoneyhillandmaxwell.com,Note discuss discussion reach grow read live maybe painting Republican.,15,mahoney-hill-and-maxwell,2023,EUR,319826,102991,216835,112749,104086,0,104086,3198,6396,97690,5722,305440,77221,228219,,319826,417.96,1031.84,0.1018,1332,20.0,1000.0,5.72,0.678
346,White-Hughes,False,IN,Taylorborough,Mobility,2023,https://white-hughes.com,Allow share address establish including score write.,21,white-hughes,2023,USD,1453167,466828,986339,657108,329231,38095,291136,14531,29063,262073,40410,791523,219562,571961,,1453167,367.33,1225.57,0.0255,706,171.34,33460.33,1.21,0.6788
347,Jones Group,False,FR,Wattsmouth,SaaS,2015,https://jonesgroup.com,Into simply part station result hour voice.,19,jones-group,2023,EUR,5225312,2751799,2473513,1497971,975542,6205,969337,52253,104506,864831,195941,3004974,1130030,1874944,435442.67,5225312,10.0,56.28,0.0339,87088,5.0,120317.79,1.63,0.4734
348,Wheeler Fox and Liu,False,ZA,New Danielmouth,HealthTech,2017,https://wheelerfoxandliu.com,There early Mrs worker always.,23,wheeler-fox-and-liu,2023,USD,2792614,510690,2281924,1232554,1049370,0,1049370,27926,55852,993518,111009,1587337,213971,1373366,232717.83,2792614,254.75,1314.01,0.0269,46543,5.0,121387.76,0.91,0.8171
349,Black-Mccoy,False,NG,East Kellyfurt,SaaS,2021,https://black-mccoy.com,Similar experience coach family try ready tough.,19,black-mccoy,2023,USD,798299,268856,529443,592324,-62881,2903,-65784,7982,15965,-81749,29724,559922,91077,468845,66524.92,798299,10.0,49.61,0.001,874,76.09,65815.99,0.45,0.6632
350,Gallegos-Hayes,False,FR,East Kimberlyside,EdTech,2011,https://gallegos-hayes.com,Hotel food agent law to time.,24,gallegos-hayes,2023,EUR,168187,76251,91936,86251,5685,373,5312,1681,3363,1949,5619,253247,134096,119151,14015.58,168187,10.0,25.12,0.0104,147,95.21,1000.0,5.62,0.5466
351,Davis-Nguyen,False,EG,Lake Jessica,Fintech,2012,https://davis-nguyen.com,Box last guy model himself.,16,davis-nguyen,2023,USD,382147,76553,305594,143868,161726,10416,151310,3821,7642,143668,29475,301212,74787,226425,,382147,610.46,656.61,0.0663,163,194.65,13266.06,2.22,0.7997
352,Salazar Moore and Pierce,False,EG,Port Georgemouth,Cybersecurity,2017,https://salazarmooreandpierce.com,The television class certain shoulder anything final role which eye.,8,salazar-moore-and-pierce,2023,USD,394856,195530,199326,286496,-87170,0,-87170,3948,7897,-95067,10433,212918,98636,114282,,394856,29.41,133.48,0.0563,985,33.39,1000.0,10.43,0.5048
353,Wilson and Sons,False,NG,North Cindy,Cybersecurity,2016,https://wilsonandsons.com,Activity marriage material space part management describe.,21,wilson-and-sons,2023,USD,1137887,360914,776973,568566,208407,15350,193057,11378,22757,170300,7449,600198,463634,136564,,1137887,1213.46,4461.47,0.0261,577,164.18,34424.7,0.22,0.6828
354,Alvarez Ortiz and Miller,False,TN,East Nicoleview,Mobility,2023,https://alvarezortizandmiller.com,Pick star debate continue area give certainly allow official owner former.,25,alvarez-ortiz-and-miller,2023,USD,384051,117898,266153,215991,50162,0,50162,3840,7681,42481,23332,309146,120155,188991,,384051,1014.67,1776.89,0.001,1463,21.87,20572.31,1.13,0.693
355,Williams Group,False,DE,East Emily,Mobility,2012,https://williamsgroup.com,Produce record occur no whom see growth along shoulder follow today.,24,williams-group,2023,EUR,6043507,3585786,2457721,2470097,-12376,0,-12376,60435,120870,-133246,542230,3667382,1012031,2655351,,6043507,635.98,317.99,0.114,14055,35.83,192532.97,2.82,0.4067
356,Chang PLC,False,TN,West Thomasville,EdTech,2024,https://changplc.com,Forget including decide decade around number without.,22,chang-plc,2023,USD,765996,329863,436133,418272,17861,0,17861,7659,15319,2542,49155,572440,186236,386204,63833.0,765996,276.37,1716.61,0.001,6663,9.58,26717.66,1.84,0.5694
357,Benitez Webb and Barker,False,ZA,Ronaldmouth,HealthTech,2010,https://benitezwebbandbarker.com,Moment yet government can none mind place.,18,benitez-webb-and-barker,2023,USD,2663111,1053492,1609619,1919578,-309959,0,-309959,26631,53262,-363221,85472,1488212,472972,1015240,221925.92,2663111,241.26,1157.21,0.0365,2875,77.19,164065.13,0.52,0.6044
358,Morton-Stephenson,False,IN,Lake Kelly,Energy,2018,https://morton-stephenson.com,Ability agency personal brother summer son.,20,morton-stephenson,2023,USD,3083186,1160379,1922807,1148018,774789,985,773804,30831,61663,712141,43897,1630402,553727,1076675,,3083186,2119.64,14131.57,0.0125,3071,83.64,54789.43,0.8,0.6236
359,Gutierrez-Cook,False,AU,North Danielle,AI/ML,2016,https://gutierrez-cook.com,Effort attack feel nearly short box four.,32,gutierrez-cook,2023,USD,414867,104829,310038,350827,-40789,0,-40789,4148,8297,-49086,40224,383653,62895,320758,,414867,20.0,100.05,0.0019,375,92.14,7911.25,5.08,0.7473
360,Ramsey-Gilbert,False,US,Port Gregorymouth,AgriTech,2017,https://ramsey-gilbert.com,Two look listen along career choice leave tend.,25,ramsey-gilbert,2023,USD,2552658,1033997,1518661,859939,658722,0,658722,25526,51053,607669,94664,1413712,486655,927057,,2552658,944.17,2457.01,0.001,10636,20.0,78310.95,1.21,0.5949
361,Ford-Olsen,False,KE,Port Adrianashire,IoT,2023,https://ford-olsen.com,New affect officer forward trouble somebody at chance.,23,ford-olsen,2023,USD,426841,156837,270004,197471,72533,34796,37737,4268,8536,29201,9489,251995,64779,187216,,426841,879.08,2285.49,0.0625,1778,20.0,36015.93,0.26,0.6326
362,Morgan Group,False,GB,New Catherine,Mobility,2023,https://morgangroup.com,Organization ten seem relate fire all.,22,morgan-group,2023,USD,256192,26507,229685,265997,-36312,11427,-47739,2561,5123,-52862,7937,282462,14123,268339,,256192,824.82,2720.05,0.1091,52,405.88,69039.5,0.11,0.8965
363,Miller-Wiley,False,CA,Shannonport,E-commerce,2020,https://miller-wiley.com,Modern company hear also dark begin.,10,miller-wiley,2023,USD,1970547,914053,1056494,951128,105366,2169,103197,19705,39410,63787,61223,1108753,204872,903881,,1970547,659.75,1873.55,0.0148,989,165.88,85488.52,0.72,0.5361
364,Johnson Webb and Porter,False,EG,West Sandra,E-commerce,2014,https://johnsonwebbandporter.com,Financial force show better word might yeah day already hold.,22,johnson-webb-and-porter,2023,USD,259387,35936,223451,96000,127451,0,127451,2593,5187,122264,8672,139906,121559,18347,,259387,37.51,75.52,0.0934,91,236.5,1000.0,8.67,0.8615
365,Wilson Collins and Williams,False,ZA,West Steventon,EdTech,2020,https://wilsoncollinsandwilliams.com,Minute probably fine officer fine.,16,wilson-collins-and-williams,2023,USD,676669,286680,389989,178545,211444,0,211444,6766,13533,197911,52802,585975,111461,474514,56389.08,676669,491.48,2817.57,0.0069,1081,52.14,14271.67,3.7,0.5763
366,Flores and Sons,False,DE,Joshuamouth,Energy,2009,https://floresandsons.com,Provide evening church boy when nice bill my near.,17,flores-and-sons,2023,EUR,3065319,1333351,1731968,1633160,98808,0,98808,30653,61306,37502,341153,1953783,945987,1007796,,3065319,86.5,83.43,0.001,1481,172.45,128631.3,2.65,0.565
367,Thomas-Bush,False,CA,Audreyburgh,Cybersecurity,2023,https://thomas-bush.com,Find throughout music anything ahead.,24,thomas-bush,2023,USD,703583,148864,554719,363724,190995,0,190995,7035,14071,176924,20951,422924,260121,162803,,703583,398.08,199.04,0.0512,744,78.72,10042.97,2.09,0.7884
368,Williams Reyes and Miller,False,ZA,Whiteshire,Energy,2020,https://williamsreyesandmiller.com,Structure record pattern fine stage require provide move wind sense letter.,18,williams-reyes-and-miller,2023,USD,287501,77603,209898,80458,129440,5044,124396,2875,5750,118646,84083,342730,91060,251670,,287501,1164.75,3817.24,0.0012,515,46.45,1000.0,84.08,0.7301
369,Davis Ltd,False,BR,Davisport,Marketplaces,2012,https://davisltd.com,Like water century time election guy contain true form.,14,davis-ltd,2023,USD,655843,310303,345540,68899,276641,6755,269886,6558,13116,256770,81878,457618,152278,305340,,655843,20.0,83.49,0.0397,250,217.92,7398.23,11.07,0.5269
370,Chavez-Johnson,False,EG,Rodriguezfort,SaaS,2012,https://chavez-johnson.com,Suffer executive give offer meet if research blood news.,21,chavez-johnson,2023,USD,519257,135644,383613,60414,323199,0,323199,5192,10385,312814,40091,405294,145195,260099,43271.42,519257,151.5,421.32,0.001,406,106.41,1561.92,25.67,0.7388
371,Sparks PLC,False,NG,Moraleschester,IoT,2018,https://sparksplc.com,Per nature wind himself future sport opportunity.,13,sparks-plc,2023,USD,479062,137401,341661,86593,255068,25717,229351,4790,9581,219770,80479,418283,232685,185598,,479062,20.0,30.92,0.001,178,224.06,1000.0,80.48,0.7132
372,Bradley-Peterson,False,FR,East Elaine,Mobility,2011,https://bradley-peterson.com,School Republican student boy other.,19,bradley-peterson,2023,EUR,3247368,1307676,1939692,162368,1777324,0,1777324,32473,64947,1712377,508126,2233872,1569514,664358,,3247368,20.0,10.0,0.0637,3182,85.04,1000.0,508.13,0.5973
373,Peters-Short,False,NG,West Stephanie,Mobility,2008,https://peters-short.com,Our rate others star force.,17,peters-short,2023,USD,2799128,1321788,1477340,809653,667687,746,666941,27991,55982,610959,28387,1559991,77999,1481992,,2799128,853.42,1438.23,0.0476,2705,86.22,81699.29,0.35,0.5278
374,Keller Davis and Montoya,False,ZA,Port Dwayneberg,HealthTech,2021,https://kellerdavisandmontoya.com,Most hope official crime race first now tree fight.,16,keller-davis-and-montoya,2023,USD,13177036,3941895,9235141,4436002,4799139,0,4799139,131770,263540,4535599,473621,7175794,2954644,4221150,1098086.33,13177036,547.93,2754.64,0.036,50696,21.66,373178.53,1.27,0.7009
375,Robbins-Herman,False,BR,New Alanhaven,HealthTech,2010,https://robbins-herman.com,Summer system artist too whose a nice without.,19,robbins-herman,2023,USD,1162516,333135,829381,58125,771256,0,771256,11625,23250,748006,21072,741938,161973,579965,96876.33,1162516,136.9,136.9,0.001,19375,5.0,1000.0,21.07,0.7134
376,Callahan Inc,False,EG,South Jacqueline,AgriTech,2018,https://callahaninc.com,Personal Republican image itself deep community cause new.,15,callahan-inc,2023,USD,770006,314876,455130,536820,-81690,15169,-96859,7700,15400,-112259,31879,576481,235324,341157,,770006,889.41,5582.02,0.1022,188,340.51,71983.04,0.44,0.5911
377,Larsen-Moore,False,KE,East Alexander,Cybersecurity,2020,https://larsen-moore.com,Century those price window.,17,larsen-moore,2023,USD,6002369,1432395,4569974,3918628,651346,32573,618773,60023,120047,498726,251528,3411669,434662,2977007,,6002369,382.37,2005.04,0.0407,25009,20.0,341133.61,0.74,0.7614
378,Miller Ltd,False,BR,Daltonchester,Fintech,2018,https://millerltd.com,Conference meeting need last green control painting official suggest door maybe.,16,miller-ltd,2023,USD,1646036,335808,1310228,279196,1031032,19187,1011845,16460,32920,978925,83918,1017430,547373,470057,,1646036,20.0,42.44,0.001,2575,53.25,1000.0,83.92,0.796
379,House-Johnston,False,BR,North Ashleystad,AI/ML,2020,https://house-johnston.com,Oil which bag room money.,27,house-johnston,2023,USD,1185819,415493,770326,328215,442111,3910,438201,11858,23716,414485,38292,812766,40638,772128,,1185819,1574.66,4605.88,0.1251,4940,20.0,38786.59,0.99,0.6496
380,Marshall-Miller,False,CA,East Thomasland,Marketplaces,2023,https://marshall-miller.com,Something fine apply gas sing light mention light safe inside.,16,marshall-miller,2023,USD,347779,129669,218110,96876,121234,0,121234,3477,6955,114279,79677,322487,118318,204169,,347779,1165.04,8911.79,0.0491,1449,20.0,18173.42,4.38,0.6272
381,Roberts-Johnson,False,NG,Jessicashire,SaaS,2010,https://roberts-johnson.com,Article list college appear wrong speak person.,11,roberts-johnson,2023,USD,194235,51531,142704,19813,122891,39082,83809,1942,3884,79925,8912,238168,66881,171287,16186.25,194235,305.43,1209.81,0.0498,207,78.19,20827.71,0.43,0.7347
382,Washington-Martinez,False,DE,Port Kristenview,Marketplaces,2017,https://washington-martinez.com,Past every either scientist page travel.,18,washington-martinez,2023,EUR,1054167,335048,719119,85442,633677,9480,624197,10541,21083,603114,216108,902200,434263,467937,,1054167,1704.59,6006.43,0.0898,332,263.9,35047.0,6.17,0.6822
383,Hernandez Griffin and Morton,False,DE,Kimberlybury,Cybersecurity,2010,https://hernandezgriffinandmorton.com,Congress month almost worker whose other start study sell.,18,hernandez-griffin-and-morton,2023,EUR,1044472,145788,898684,388022,510662,11287,499375,10444,20889,478486,39642,574214,184713,389501,,1044472,344.29,1507.41,0.0158,1259,69.09,26860.58,1.48,0.8604
384,Townsend-Young,False,TN,Barberburgh,Fintech,2011,https://townsend-young.com,Official success approach enough standard apply.,25,townsend-young,2023,USD,1184686,470457,714229,667447,46782,0,46782,11846,23693,23089,62285,842562,219964,622598,,1184686,905.7,1589.06,0.0288,2988,33.03,76781.03,0.81,0.6029
385,Ross-Turner,False,EG,South Frances,HealthTech,2017,https://ross-turner.com,Listen certain that activity until large question which.,25,ross-turner,2023,USD,1640679,342572,1298107,696413,601694,24798,576896,16406,32813,544083,24166,995657,432057,563600,136723.25,1640679,409.03,1969.45,0.0305,27344,5.0,79281.55,0.3,0.7912
386,Blanchard Davis and Schmidt,False,US,Stephaniechester,SaaS,2018,https://blancharddavisandschmidt.com,Truth teach friend environment better pressure hospital significant see same open.,16,blanchard-davis-and-schmidt,2023,USD,2979332,751133,2228199,2172927,55272,0,55272,29793,59586,-4314,128364,1781552,906667,874885,248277.67,2979332,48.93,180.98,0.007,2791,88.94,158516.0,0.81,0.7479
387,Meyer Ltd,False,AU,West Amy,SaaS,2017,https://meyerltd.com,Story activity best billion.,15,meyer-ltd,2023,USD,688552,158765,529787,404469,125318,41028,84290,6885,13771,70519,9367,517409,25870,491539,57379.33,688552,810.13,3957.48,0.001,11475,5.0,30460.33,0.31,0.7694
388,Bell-Hardy,False,CA,Jamestown,E-commerce,2021,https://bell-hardy.com,Begin voice prevent structure wear point remain build task candidate prevent.,28,bell-hardy,2023,USD,535512,228927,306585,274949,31636,5105,26531,5355,10710,15821,78740,450581,85438,365143,,535512,217.58,1278.86,0.0055,2231,20.0,1000.0,78.74,0.5725
389,Knight Coffey and Kemp,False,GB,West Kenneth,EdTech,2024,https://knightcoffeyandkemp.com,Police two everybody interview tough.,25,knight-coffey-and-kemp,2023,USD,236074,72745,163329,121808,41521,1889,39632,2360,4721,34911,32089,232102,194373,37729,19672.83,236074,818.66,4508.25,0.0129,3934,5.0,13582.64,2.36,0.6919
390,Scott-Norman,False,TN,Kimberlyfurt,IoT,2013,https://scott-norman.com,Four art western enough key man up particular.,15,scott-norman,2023,USD,746820,208017,538803,362539,176264,12096,164168,7468,14936,149232,280233,674995,166872,508123,,746820,1827.82,5532.63,0.0388,3111,20.0,11635.74,24.08,0.7215
391,Brewer Inc,False,GB,New Kayla,HealthTech,2010,https://brewerinc.com,Pass blood kid else alone audience.,20,brewer-inc,2023,USD,543836,217480,326356,326330,26,24158,-24132,5438,10876,-35008,165757,568373,256467,311906,45319.67,543836,593.87,2284.68,0.0073,779,58.15,1000.0,165.76,0.6001
392,King Griffin and Mosley,False,KE,Lake Danielle,Energy,2015,https://kinggriffinandmosley.com,Professor entire record toward off.,19,king-griffin-and-mosley,2023,USD,2687652,1106250,1581402,285149,1296253,0,1296253,26876,53753,1242500,175673,1655893,870122,785771,,2687652,647.87,2800.23,0.03,2931,76.39,40077.72,4.38,0.5884
393,Zimmerman Wise and Mendoza,False,EG,Anthonyland,IoT,2012,https://zimmermanwiseandmendoza.com,Difficult his ready sister building movement yard four field area.,15,zimmerman-wise-and-mendoza,2023,USD,151804,43960,107844,37362,70482,0,70482,1518,3036,67446,18441,181127,9056,172071,,151804,1376.36,2354.08,0.0991,270,46.83,30921.67,0.6,0.7104
394,Davis Nichols and Woodward,False,DE,Port Steveport,Mobility,2016,https://davisnicholsandwoodward.com,Computer always his course receive to.,17,davis-nichols-and-woodward,2023,EUR,656883,250694,406189,496312,-90123,15369,-105492,6568,13137,-118629,364307,797633,485081,312552,,656883,20.0,87.96,0.0295,133,410.55,57026.51,6.39,0.6184
395,Barker Tucker and Mcclure,False,EG,Mossberg,AgriTech,2008,https://barkertuckerandmcclure.com,Cover rest or majority as.,23,barker-tucker-and-mcclure,2023,USD,79865,15850,64015,20447,43568,6579,36989,798,1597,35392,5267,199229,95990,103239,,79865,20.0,132.19,0.0427,332,20.0,29930.91,0.18,0.8015
396,Schneider Porter and Hanna,False,AU,Levytown,Mobility,2017,https://schneiderporterandhanna.com,Fund front return if deep.,18,schneider-porter-and-hanna,2023,USD,237204,69316,167888,23525,144363,12385,131978,2372,4744,127234,18316,198697,149567,49130,,237204,1011.58,1051.09,0.0642,118,167.47,10151.5,1.8,0.7078
397,Contreras Ellis and Gregory,False,BR,Lake Beth,AI/ML,2013,https://contrerasellisandgregory.com,Already center president likely truth.,19,contreras-ellis-and-gregory,2023,USD,233218,71923,161295,161727,-432,0,-432,2332,4664,-5096,78534,295708,18565,277143,,233218,191.75,95.88,0.039,916,21.2,9603.14,8.18,0.6916
398,Sanchez Ltd,False,FR,North Gerald,Mobility,2019,https://sanchezltd.com,Toward star best particularly structure.,15,sanchez-ltd,2023,EUR,1626221,780754,845467,817299,28168,8967,19201,16262,32524,-13323,80567,1037633,691008,346625,,1626221,438.55,425.42,0.001,2744,49.38,74607.38,1.08,0.5199
399,Meyers Inc,False,KE,South Brookebury,AgriTech,2021,https://meyersinc.com,Source international specific word question.,32,meyers-inc,2023,USD,156337,53635,102702,133580,-30878,36198,-67076,1563,3126,-70202,92446,320281,217000,103281,,156337,155.62,235.06,0.0335,85,152.21,17862.43,5.18,0.6569
400,Martinez-Sutton,False,ZA,West Mary,AgriTech,2022,https://martinez-sutton.com,Share or friend building center indeed.,15,martinez-sutton,2023,USD,683497,321220,362277,154099,208178,10216,197962,6834,13669,184293,33336,540626,159506,381120,,683497,20.0,61.36,0.0807,2847,20.0,20350.7,1.64,0.53
401,Wood Martin and Sanchez,False,IN,East Craigfurt,EdTech,2020,https://woodmartinandsanchez.com,Administration main according conference become prepare.,25,wood-martin-and-sanchez,2023,USD,246123,112574,133549,12306,121243,0,121243,2461,4922,116321,2019,136054,40140,95914,20510.25,246123,547.88,2821.05,0.001,164,124.32,16563.84,0.12,0.5426
402,Butler-Aguirre,False,EG,Schwartzborough,Fintech,2015,https://butler-aguirre.com,Policy mission include visit particular also.,21,butler-aguirre,2023,USD,1923414,915889,1007525,1139317,-131792,0,-131792,19234,38468,-170260,97454,1098428,349951,748477,,1923414,756.96,2299.77,0.0238,497,322.41,105719.42,0.92,0.5238
403,Love PLC,False,TN,Lake Margaretport,IoT,2019,https://loveplc.com,Industry newspaper court worry with peace television would.,16,love-plc,2023,USD,1113089,369391,743698,507790,235908,0,235908,11130,22261,213647,37306,773428,111351,662077,,1113089,1185.63,7629.13,0.1305,4637,20.0,61615.42,0.61,0.6681
404,Robinson Townsend and Hopkins,False,KE,Brianville,AgriTech,2017,https://robinsontownsendandhopkins.com,Rate why listen computer prove amount.,20,robinson-townsend-and-hopkins,2023,USD,651997,189384,462613,436914,25699,0,25699,6519,13039,12660,39538,523939,194156,329783,,651997,20.0,92.13,0.062,460,117.92,51070.59,0.77,0.7095
405,Diaz Clark and King,False,US,Williamston,Marketplaces,2020,https://diazclarkandking.com,Compare size machine break time return or for cup quality.,31,diaz-clark-and-king,2023,USD,127433,49364,78069,19504,58565,0,58565,1274,2548,56017,17063,170285,62702,107583,,127433,20.0,10.01,0.001,36,294.17,1320.57,12.92,0.6126
406,Hall-Rodriguez,False,IN,North Joel,SaaS,2009,https://hall-rodriguez.com,Thank heart determine likely machine three certain until.,15,hall-rodriguez,2023,USD,193997,94870,99127,92951,6176,47420,-41244,1939,3879,-45123,7959,112805,35629,77176,16166.42,193997,10.0,31.57,0.001,3233,5.0,23612.9,0.34,0.511
407,Thompson-Brooks,False,KE,Cortezstad,Cybersecurity,2023,https://thompson-brooks.com,Dark camera realize arrive carry surface learn.,10,thompson-brooks,2023,USD,1603238,630303,972935,80161,892774,0,892774,16032,32064,860710,39902,961019,152983,808036,,1603238,1323.38,1509.89,0.0536,690,193.58,12658.94,3.15,0.6069
408,Wolf and Sons,False,IN,Cassandraburgh,EdTech,2019,https://wolfandsons.com,Wife talk beat tax majority yet option student evidence role.,26,wolf-and-sons,2023,USD,503173,105675,397498,421036,-23538,24637,-48175,5031,10063,-58238,9583,289430,110711,178719,41931.08,503173,14.75,56.8,0.001,307,136.45,58299.53,0.16,0.79
409,Salas Wright and Hamilton,False,DE,New Sophia,Marketplaces,2014,https://salaswrightandhamilton.com,Together individual analysis yard safe mean international hour special recent.,24,salas-wright-and-hamilton,2023,EUR,1648972,1041972,607000,1009696,-402696,0,-402696,16489,32979,-435675,129774,1121474,222219,899255,,1648972,20.0,84.79,0.001,6870,20.0,107824.95,1.2,0.3681
410,Chavez and Sons,False,KE,New Karenchester,AgriTech,2012,https://chavezandsons.com,Car fast positive before look fight.,31,chavez-and-sons,2023,USD,762287,315169,447118,320756,126362,0,126362,7622,15245,111117,100269,556954,149149,407805,,762287,96.99,694.96,0.0715,285,222.59,1216.01,82.46,0.5865
411,Stevens Hudson and Silva,False,BR,Fordberg,Fintech,2009,https://stevenshudsonandsilva.com,Continue the phone region ability physical his real.,11,stevens-hudson-and-silva,2023,USD,166522,90244,76278,104207,-27929,15664,-43593,1665,3330,-46923,11798,127642,9394,118248,,166522,20.0,102.12,0.0462,693,20.0,28523.81,0.41,0.4581
412,Johnson Simmons and Nelson,False,IN,Port Gail,Mobility,2009,https://johnsonsimmonsandnelson.com,Thing save area war push thousand book half people half compare.,24,johnson-simmons-and-nelson,2023,USD,719039,177581,541458,411479,129979,764,129215,7190,14380,114835,86565,518342,272345,245997,,719039,979.17,620.77,0.001,357,167.5,7897.55,10.96,0.753
413,Bush Castro and Ayala,False,KE,West John,E-commerce,2012,https://bushcastroandayala.com,Power say sell that reflect.,23,bush-castro-and-ayala,2023,USD,2213895,653128,1560767,1161880,398887,0,398887,22138,44277,354610,159342,1355399,165874,1189525,,2213895,410.43,1084.15,0.0445,787,234.24,122664.54,1.3,0.705
414,Hodges Flores and Hurst,False,FR,Ramirezland,AgriTech,2018,https://hodgesfloresandhurst.com,Generation main money but report question mouth factor.,21,hodges-flores-and-hurst,2023,EUR,152860,50558,102302,164358,-62056,0,-62056,1528,3057,-65113,7020,177273,40485,136788,,152860,20.0,144.69,0.0293,65,193.65,26566.6,0.26,0.6693
415,Richardson Nunez and Steele,False,ZA,East Patriciamouth,Energy,2013,https://richardsonnunezandsteele.com,Bag today eye what body.,21,richardson-nunez-and-steele,2023,USD,1844810,531661,1313149,1125106,188043,17344,170699,18448,36896,133803,78801,1096250,143660,952590,,1844810,439.1,219.55,0.001,798,192.49,97957.14,0.8,0.7118
416,Rodriguez-Hernandez,False,DE,Port James,HealthTech,2019,https://rodriguez-hernandez.com,Age indicate radio use listen information scene again country against soon.,20,rodriguez-hernandez,2023,EUR,630964,186996,443968,337149,106819,0,106819,6309,12619,94200,34620,382263,144594,237669,52580.33,630964,103.0,414.98,0.0493,1129,46.57,16352.48,2.12,0.7036
417,Newman Jenkins and Cooper,False,NG,Toddhaven,AI/ML,2016,https://newmanjenkinsandcooper.com,Knowledge fight car smile commercial employee machine wife show another.,26,newman-jenkins-and-cooper,2023,USD,367467,26214,341253,226985,114268,55059,59209,3674,7349,51860,18238,299890,117072,182818,,367467,706.12,3707.03,0.001,1531,20.0,27104.19,0.67,0.9287
418,Mitchell-Huber,False,GB,Lake Amanda,AgriTech,2023,https://mitchell-huber.com,Win stuff realize project child draw.,31,mitchell-huber,2023,USD,233872,76573,157299,99185,58114,722,57392,2338,4677,52715,30856,185204,58562,126642,,233872,461.41,230.7,0.0592,101,192.24,1000.0,30.86,0.6726
419,Chaney PLC,False,AU,South Jorge,AgriTech,2018,https://chaneyplc.com,Day religious program within challenge large.,21,chaney-plc,2023,USD,326633,73234,253399,128201,125198,24402,100796,3266,6532,94264,7512,198460,68169,130291,,326633,332.7,1210.47,0.0598,1360,20.0,36739.42,0.2,0.7758
420,Ferguson Inc,False,AU,South Sarahberg,Fintech,2022,https://fergusoninc.com,Until choose wife national medical positive far time wide.,24,ferguson-inc,2023,USD,12429677,5351817,7077860,9256369,-2178509,55869,-2234378,124296,248593,-2482971,227212,6511459,2476181,4035278,,12429677,20.0,88.28,0.1542,7626,135.81,751205.85,0.3,0.5694
421,Estrada Marsh and Chandler,False,FR,Morganville,HealthTech,2015,https://estradamarshandchandler.com,Too cause nearly final husband subject land begin area.,24,estrada-marsh-and-chandler,2023,EUR,1623561,459231,1164330,81178,1083152,32183,1050969,16235,32471,1018498,173668,1117385,55869,1061516,135296.75,1623561,193.88,1381.67,0.0719,27059,5.0,14309.54,12.14,0.7171
422,Lee Fox and Harrington,False,BR,Jamesland,Cybersecurity,2020,https://leefoxandharrington.com,Support quality whatever wish hour make owner memory argue project.,17,lee-fox-and-harrington,2023,USD,675537,194798,480739,483347,-2608,0,-2608,6755,13510,-16118,104272,628945,233215,395730,,675537,20.0,21.3,0.0298,408,137.78,24339.13,4.28,0.7116
423,Hernandez-Nash,False,AU,Paultown,AI/ML,2019,https://hernandez-nash.com,General final knowledge night democratic thousand score.,20,hernandez-nash,2023,USD,277986,93449,184537,94779,89758,0,89758,2779,5559,84199,30825,242761,123620,119141,,277986,1476.12,5490.4,0.0251,190,121.55,1000.0,30.82,0.6638
424,Lara-Roberts,False,FR,Chandlerchester,Energy,2008,https://lara-roberts.com,Structure our century field write moment.,20,lara-roberts,2023,EUR,1102770,311308,791462,84351,707111,30102,677009,11027,22055,654954,33521,662177,195814,466363,,1102770,421.26,1038.83,0.0472,746,123.14,15570.54,2.15,0.7177
425,Jones-Choi,False,IN,Davischester,AI/ML,2011,https://jones-choi.com,Increase new report sense carry control high.,21,jones-choi,2023,USD,1787536,209160,1578376,1075211,503165,0,503165,17875,35750,467415,33588,1012209,280969,731240,,1787536,1081.26,6012.27,0.0368,1028,144.86,53534.57,0.63,0.883
426,Henry Carson and Turner,False,EG,Troymouth,E-commerce,2016,https://henrycarsonandturner.com,Agree able enjoy what strong line president.,26,henry-carson-and-turner,2023,USD,1144706,450340,694366,606639,87727,646,87081,11447,22894,64187,84053,752619,63215,689404,,1144706,20.0,103.29,0.0322,323,295.11,75344.8,1.12,0.6066
427,Butler-Vasquez,False,KE,North David,Energy,2019,https://butler-vasquez.com,Manage wife out gun lose job election.,18,butler-vasquez,2023,USD,250646,30478,220168,62118,158050,42792,115258,2506,5012,110246,8312,175055,66354,108701,,250646,20.0,60.82,0.001,148,140.6,1000.0,8.31,0.8784
428,Alvarez Benson and Wilson,False,FR,Port Jordanshire,Marketplaces,2015,https://alvarezbensonandwilson.com,Certainly leave really group apply.,23,alvarez-benson-and-wilson,2023,EUR,973747,338720,635027,200494,434533,4094,430439,9737,19474,410965,14186,700127,44740,655387,,973747,1589.55,1251.63,0.0439,389,208.11,12388.87,1.15,0.6521
429,Barnes-Barr,False,EG,Brandonport,SaaS,2018,https://barnes-barr.com,Police baby create physical share out cold follow first suddenly.,23,barnes-barr,2023,USD,373347,116936,256411,308321,-51910,0,-51910,3733,7466,-59376,7322,205346,82672,122674,31112.25,373347,349.66,355.73,0.0795,876,35.48,37190.59,0.2,0.6868
430,Nelson-Wolfe,False,KE,Codyshire,EdTech,2010,https://nelson-wolfe.com,Statement actually million health machine future treat bill.,23,nelson-wolfe,2023,USD,246946,76642,170304,97754,72550,34869,37681,2469,4938,32743,102761,357300,127140,230160,20578.83,246946,10.0,26.31,0.0437,264,77.92,50110.6,2.05,0.6896
431,Gordon and Sons,False,BR,South Stevenland,Mobility,2017,https://gordonandsons.com,Standard type look find guy.,29,gordon-and-sons,2023,USD,908214,529551,378663,45410,333253,6892,326361,9082,18164,308197,8937,628462,31423,597039,,908214,1582.4,5455.86,0.0234,555,136.25,16102.64,0.56,0.4169
432,Preston-Harper,False,BR,Geraldport,Energy,2011,https://preston-harper.com,Season budget campaign reason read.,23,preston-harper,2023,USD,710854,321797,389057,93523,295534,0,295534,7108,14217,281317,22775,543231,203949,339282,,710854,20.0,61.45,0.0595,695,85.16,46418.65,0.49,0.5473
433,Martinez-Anderson,False,GB,South Hannahville,SaaS,2009,https://martinez-anderson.com,Affect machine issue cultural allow.,17,martinez-anderson,2023,USD,389045,94492,294553,133546,161007,0,161007,3890,7780,153227,44260,405648,51433,354215,32420.42,389045,120.43,489.84,0.0381,6484,5.0,1000.0,44.26,0.7571
434,Palmer Brown and Wilson,False,IN,Bradleyport,Mobility,2011,https://palmerbrownandwilson.com,Senior site turn day.,17,palmer-brown-and-wilson,2023,USD,2936504,989358,1947146,1346662,600484,8211,592273,29365,58730,533543,573280,2122903,1073274,1049629,,2936504,20.0,102.77,0.001,1428,171.34,119616.65,4.79,0.6631
435,Lopez LLC,False,FR,North Dustinview,EdTech,2012,https://lopezllc.com,Girl civil may rock drop now between official add describe.,20,lopez-llc,2023,EUR,576334,383018,193316,28816,164500,3922,160578,5763,11526,149052,4111,384694,65848,318846,48027.83,576334,592.74,592.74,0.0425,1008,47.63,1000.0,4.11,0.3354
436,Brandt and Sons,False,TN,Lake Coreyborough,Mobility,2019,https://brandtandsons.com,Surface listen recently continue pull blue strong wonder interest.,23,brandt-and-sons,2023,USD,1759184,425517,1333667,87959,1245708,0,1245708,17591,35183,1210525,67732,949310,147039,802271,,1759184,177.54,88.77,0.0691,797,183.71,14386.75,4.71,0.7581
437,Perez Rodriguez and Rollins,False,BR,South Danielberg,Cybersecurity,2021,https://perezrodriguezandrollins.com,Several relate news American foreign break exist outside find.,20,perez-rodriguez-and-rollins,2023,USD,1211263,447217,764046,1028145,-264099,0,-264099,12112,24225,-288324,96847,745762,353005,392757,,1211263,775.53,2168.65,0.0983,2080,48.51,85043.33,1.14,0.6308
438,Perez-Russell,False,KE,Lopezland,Cybersecurity,2012,https://perez-russell.com,Voice happen actually purpose public how mission put budget.,13,perez-russell,2023,USD,6885253,2695808,4189445,4953717,-764272,26401,-790673,68852,137705,-928378,406744,3924517,2307892,1616625,,6885253,1217.96,2354.48,0.001,1987,288.66,419069.68,0.97,0.6085
439,Morales-Garza,False,TN,Lake Saraburgh,Marketplaces,2011,https://morales-garza.com,Hair current customer such identify.,20,morales-garza,2023,USD,116774,31413,85361,47184,38177,0,38177,1167,2335,35842,769,102900,34001,68899,,116774,569.3,690.06,0.0762,80,121.05,1000.0,0.77,0.731
440,Massey Ltd,False,EG,Ramirezshire,IoT,2021,https://masseyltd.com,Event smile popular hundred live owner identify machine everything should.,21,massey-ltd,2023,USD,321820,119258,202562,16091,186471,0,186471,3218,6436,180035,31880,203926,10196,193730,,321820,937.91,3126.35,0.109,1340,20.0,13065.49,2.44,0.6294
441,Martinez Group,False,IN,Hallberg,SaaS,2019,https://martinezgroup.com,Between apply attention question will.,17,martinez-group,2023,USD,1097050,79332,1017718,952634,65084,13834,51250,10970,21941,29309,187107,772903,38645,734258,91420.83,1097050,545.82,1372.35,0.001,2266,40.34,74534.84,2.51,0.9277
442,Jacobs-Murphy,False,DE,Christyville,Mobility,2022,https://jacobs-murphy.com,Produce mind man letter family.,19,jacobs-murphy,2023,EUR,1232102,487959,744143,671181,72962,18743,54219,12321,24642,29577,42108,807388,529375,278013,,1232102,360.78,1480.03,0.0064,2606,39.39,60512.74,0.7,0.604
443,Henry-Green,False,DE,Lisaside,E-commerce,2011,https://henry-green.com,Adult shake wrong they budget late table kind along computer.,21,henry-green,2023,EUR,984641,481324,503317,647387,-144070,0,-144070,9846,19692,-163762,10461,586364,234195,352169,,984641,1036.15,1513.62,0.0663,476,172.36,53998.96,0.19,0.5112
444,Dalton Turner and Mccarthy,False,BR,Jordanport,E-commerce,2019,https://daltonturnerandmccarthy.com,Maintain body push process rate occur live take.,20,dalton-turner-and-mccarthy,2023,USD,4585043,1765948,2819095,685935,2133160,14063,2119097,45850,91700,2027397,289455,2663992,400429,2263563,,4585043,1993.1,7545.53,0.1295,1296,294.79,45778.29,6.32,0.6148
445,Brown Baker and Garza,False,US,Jensenstad,Energy,2016,https://brownbakerandgarza.com,Fly agreement and student give score agree.,20,brown-baker-and-garza,2023,USD,2218679,671642,1547037,1296689,250348,11127,239221,22186,44373,194848,40879,1271934,577150,694784,,2218679,197.18,684.01,0.0615,1105,167.26,116462.76,0.35,0.6973
446,Peterson Davis and Reed,False,DE,Robertton,Fintech,2022,https://petersondavisandreed.com,Easy possible or travel assume figure front.,24,peterson-davis-and-reed,2023,EUR,1571464,670806,900658,574801,325857,3040,322817,15714,31429,291388,268862,1124113,56205,1067908,,1571464,1279.59,3355.82,0.001,3830,34.19,52425.35,5.13,0.5731
447,Ryan Inc,False,FR,Barrettchester,Marketplaces,2014,https://ryaninc.com,Method inside after like against first now follow best major.,23,ryan-inc,2023,EUR,1426143,551449,874694,964452,-89758,2312,-92070,14261,28522,-120592,66127,829390,565468,263922,,1426143,457.02,1519.46,0.001,537,220.97,77689.81,0.85,0.6133
448,Leonard Rogers and Shaw,False,BR,Garrettport,Marketplaces,2008,https://leonardrogersandshaw.com,Wide cut player wind away sure degree enter.,16,leonard-rogers-and-shaw,2023,USD,478904,118155,360749,253511,107238,44602,62636,4789,9578,53058,20081,318380,163662,154718,,478904,1163.27,6324.65,0.1601,201,198.08,14004.08,1.43,0.7533
449,Davies-Morales,False,US,New Julia,E-commerce,2015,https://davies-morales.com,Response official option event note.,24,davies-morales,2023,USD,268239,66167,202072,213060,-10988,25400,-36388,2682,5364,-41752,9327,209986,109377,100609,,268239,664.7,2046.02,0.0873,221,101.03,1000.0,9.33,0.7533
450,Alvarez Clark and Flynn,False,GB,Williamport,IoT,2014,https://alvarezclarkandflynn.com,Professional finish increase economy middle public natural thing physical.,28,alvarez-clark-and-flynn,2023,USD,263733,138655,125078,257163,-132085,4891,-136976,2637,5274,-142250,73293,238776,43663,195113,,263733,1093.75,2193.29,0.0788,94,231.67,1000.0,73.29,0.4743
451,Huffman Ray and Lewis,False,FR,Adamsside,AI/ML,2014,https://huffmanrayandlewis.com,Table trade various risk art customer leg drive second she such.,29,huffman-ray-and-lewis,2023,EUR,4183868,1077353,3106515,545625,2560890,0,2560890,41838,83677,2477213,54964,2265109,1398323,866786,,4183868,1286.92,3837.11,0.0389,12394,28.13,31851.36,1.73,0.7425
452,Flores-Greer,False,KE,Lake Jameschester,EdTech,2015,https://flores-greer.com,Statement position either over image box court.,17,flores-greer,2023,USD,73781,18799,54982,41185,13797,0,13797,737,1475,12322,11701,193098,82972,110126,6148.42,73781,410.99,1543.41,0.0794,102,59.82,55832.4,0.21,0.7452
453,Robles LLC,False,CA,Washingtonchester,HealthTech,2008,https://roblesllc.com,Positive already city carry election sound probably compare system.,14,robles-llc,2023,USD,1510535,570013,940522,915604,24918,0,24918,15105,30210,-5292,90431,1043385,212574,830811,125877.92,1510535,518.86,4501.45,0.0042,8870,14.19,86984.49,1.04,0.6226
454,Tucker Smith and Heath,False,IN,West Carolynland,HealthTech,2012,https://tuckersmithandheath.com,To public though however style successful door number.,17,tucker-smith-and-heath,2023,USD,415941,169566,246375,96395,149980,860,149120,4159,8318,140802,7417,274171,198984,75187,34661.75,415941,230.9,1137.35,0.0212,439,78.8,8755.2,0.85,0.5923
455,Fitzpatrick Boyd and Calderon,False,NG,Tylerland,AgriTech,2013,https://fitzpatrickboydandcalderon.com,Outside significant finish strategy say south season.,12,fitzpatrick-boyd-and-calderon,2023,USD,305771,120489,185282,177119,8163,13746,-5583,3057,6115,-11698,4007,190097,113269,76828,,305771,1067.8,701.54,0.001,1274,20.0,15329.19,0.26,0.606
456,Robinson-Rodriguez,False,FR,West Scott,Marketplaces,2008,https://robinson-rodriguez.com,Television argue mouth record both nation little.,20,robinson-rodriguez,2023,EUR,713824,66604,647220,295177,352043,31552,320491,7138,14276,306215,325085,772552,288529,484023,,713824,20.0,82.74,0.0918,367,161.82,11779.13,27.6,0.9067
457,Richmond and Sons,False,GB,Thomasstad,SaaS,2019,https://richmondandsons.com,Again whom paper success production wait real.,19,richmond-and-sons,2023,USD,406614,67698,338916,307058,31858,5457,26401,4066,8132,18269,12589,387786,21395,366391,33884.5,406614,10.0,41.85,0.001,776,43.66,28456.7,0.44,0.8335
458,Allen Tran and Parker,False,AU,Rebeccaville,EdTech,2018,https://allentranandparker.com,Term tax home travel hotel within eight bed state dog.,18,allen-tran-and-parker,2023,USD,876412,472852,403560,260347,143213,27718,115495,8764,17528,97967,37566,488606,145594,343012,73034.33,876412,10.0,10.0,0.0359,14606,5.0,17008.21,2.21,0.4605
459,Villarreal and Sons,False,US,Welchchester,HealthTech,2016,https://villarrealandsons.com,Ever bag single man say.,22,villarreal-and-sons,2023,USD,87169,22124,65045,56365,8680,0,8680,871,1743,6937,14794,226185,42963,183222,7264.08,87169,91.67,425.49,0.0048,104,69.49,18482.78,0.8,0.7462
460,Love-Mcdowell,False,US,Port Ethanview,HealthTech,2021,https://love-mcdowell.com,At inside role natural force receive seven political contain.,20,love-mcdowell,2023,USD,509825,61396,448429,417338,31091,20941,10150,5098,10196,-46,35705,403759,96719,307040,42485.42,509825,887.57,6865.29,0.001,6953,6.11,66420.5,0.54,0.8796
461,Gibbs-Taylor,False,NG,Gonzalezport,Fintech,2010,https://gibbs-taylor.com,Office book economic require should power candidate order.,22,gibbs-taylor,2023,USD,1133573,307005,826568,788924,37644,7517,30127,11335,22671,7456,35192,658152,58629,599523,,1133573,20.0,38.0,0.0898,223,421.97,69893.12,0.5,0.7292
462,Sparks-Flores,False,EG,Russoberg,Mobility,2019,https://sparks-flores.com,Community or foreign example base happen hour.,20,sparks-flores,2023,USD,682668,234985,447683,346553,101130,0,101130,6826,13653,87477,6938,477904,97992,379912,,682668,34.8,193.8,0.1022,2844,20.0,28452.51,0.24,0.6558
463,Duffy-Wilkerson,False,NG,North Stacy,IoT,2011,https://duffy-wilkerson.com,Positive phone trade wind cup red collection husband investment employee.,19,duffy-wilkerson,2023,USD,1223435,263953,959482,1091005,-131523,0,-131523,12234,24468,-155991,26073,748244,346051,402193,,1223435,798.23,3252.65,0.0821,3719,27.41,57031.97,0.46,0.7843
464,Rubio and Sons,False,EG,North Jenniferchester,AI/ML,2015,https://rubioandsons.com,Still management difference data watch spend entire second high.,17,rubio-and-sons,2023,USD,2226844,1484293,742551,1170136,-427585,0,-427585,22268,44536,-472121,12271,1226284,615335,610949,,2226844,90.2,72.62,0.0672,1405,132.0,77743.44,0.16,0.3335
465,Gates-Greene,False,KE,Jessicaborough,SaaS,2024,https://gates-greene.com,Congress society agreement wish dog late eat old positive.,11,gates-greene,2023,USD,6243295,2453520,3789775,2374467,1415308,10285,1405023,62432,124865,1280158,143892,3336006,909859,2426147,520274.58,6243295,246.17,889.39,0.0263,6867,75.76,176588.05,0.81,0.607
466,Smith and Sons,False,IN,Terrifurt,Mobility,2008,https://smithandsons.com,Require remain save eight believe arrive.,24,smith-and-sons,2023,USD,204101,63350,140751,172827,-32076,1469,-33545,2041,4082,-37627,1446,154964,46754,108210,,204101,804.45,3115.21,0.001,61,276.01,27976.81,0.05,0.6896
467,Galvan-Ruiz,False,US,Wendyton,Mobility,2020,https://galvan-ruiz.com,Effect people few house.,17,galvan-ruiz,2023,USD,731912,204719,527193,288812,238381,0,238381,7319,14638,223743,95463,584571,336442,248129,,731912,1022.39,5728.64,0.0154,529,115.13,41291.36,2.31,0.7203
468,Anderson-Mcclain,False,TN,New Harryburgh,Marketplaces,2011,https://anderson-mcclain.com,Manage fund life bed report item employee finish without.,19,anderson-mcclain,2023,USD,264874,114657,150217,47197,103020,1958,101062,2648,5297,95765,62131,323069,174929,148140,,264874,1386.72,4138.84,0.0306,252,87.27,31121.44,2.0,0.5671
469,Savage-Davenport,False,EG,Saraport,Cybersecurity,2022,https://savage-davenport.com,Party seven enough fine throughout firm yes.,16,savage-davenport,2023,USD,690836,293110,397726,551293,-153567,7222,-160789,6908,13816,-174605,129071,586594,45968,540626,,690836,619.18,2370.01,0.0762,405,141.88,62122.43,2.08,0.5757
470,Peters Ltd,False,FR,Brownberg,Fintech,2018,https://petersltd.com,Discover along employee relationship job.,20,peters-ltd,2023,EUR,699866,302434,397432,303277,94155,20478,73677,6998,13997,59680,64909,526040,286519,239521,,699866,20.0,18.62,0.0442,333,174.87,1000.0,64.91,0.5679
471,Williams-Kelly,False,KE,Ellisville,HealthTech,2010,https://williams-kelly.com,Buy behavior test Congress collection meet.,21,williams-kelly,2023,USD,790457,244152,546305,237203,309102,0,309102,7904,15809,293293,6986,587462,428978,158484,65871.42,790457,537.43,1598.76,0.0505,766,85.93,47572.02,0.15,0.6911
472,Elliott-Alvarado,False,GB,New Whitney,AgriTech,2018,https://elliott-alvarado.com,Moment number indicate baby.,18,elliott-alvarado,2023,USD,1498761,376930,1121831,514523,607308,0,607308,14987,29975,577333,62103,919466,592024,327442,,1498761,1290.29,3180.52,0.0128,6244,20.0,27440.88,2.26,0.7485
473,Rhodes-Clay,False,TN,West Erinville,IoT,2024,https://rhodes-clay.com,Health upon black food ahead least remain look.,18,rhodes-clay,2023,USD,227049,84377,142672,135658,7014,0,7014,2270,4540,2474,50864,336228,80800,255428,,227049,20.0,36.29,0.1185,100,188.72,9717.06,5.23,0.6284
474,Moses Wheeler and Smith,False,IN,Lake Cindymouth,Mobility,2024,https://moseswheelerandsmith.com,Water yourself trade someone can tell soon executive.,15,moses-wheeler-and-smith,2023,USD,1581264,409064,1172200,859949,312251,0,312251,15812,31625,280626,64004,887469,150371,737098,,1581264,493.46,246.73,0.094,668,197.11,42986.3,1.49,0.7413
475,Manning PLC,False,KE,Davisview,Energy,2011,https://manningplc.com,Drive side human after decade home.,14,manning-plc,2023,USD,1079346,443085,636261,626411,9850,31739,-21889,10793,21586,-43475,49705,602689,247880,354809,,1079346,20.0,121.43,0.0965,1740,51.67,71776.13,0.69,0.5895
476,Mitchell-Goodwin,False,AU,North Kenneth,Cybersecurity,2011,https://mitchell-goodwin.com,Save TV tough page grow benefit happen customer knowledge.,19,mitchell-goodwin,2023,USD,878424,313523,564901,280508,284393,0,284393,8784,17568,266825,62025,556399,168800,387599,,878424,582.21,291.1,0.0786,441,165.78,6164.27,10.06,0.6431
477,Alvarez-Hart,False,BR,Davischester,Marketplaces,2014,https://alvarez-hart.com,Pass its international American game less difference rather.,18,alvarez-hart,2023,USD,576275,131400,444875,28813,416062,0,416062,5762,11525,404537,17641,370607,118601,252006,,576275,175.07,702.15,0.0764,2401,20.0,1000.0,17.64,0.772
478,Arias PLC,False,TN,West Taylorland,Mobility,2015,https://ariasplc.com,Feel worker range feel eat into notice necessary true.,22,arias-plc,2023,USD,890976,395680,495296,200909,294387,0,294387,8909,17819,276568,28087,600109,136802,463307,,890976,728.45,1067.44,0.0345,3712,20.0,8020.88,3.5,0.5559
479,Rodriguez Coleman and Davis,False,TN,Michaelshire,E-commerce,2022,https://rodriguezcolemananddavis.com,Shoulder administration scientist leg skill.,18,rodriguez-coleman-and-davis,2023,USD,4252952,1872473,2380479,3849877,-1469398,18292,-1487690,42529,85059,-1572749,170475,2478544,412743,2065801,,4252952,103.65,279.34,0.0327,10969,32.31,314289.51,0.54,0.5597
480,Williams-Butler,False,TN,Leemouth,Energy,2011,https://williams-butler.com,Perhaps enter whom the cost continue section page the.,24,williams-butler,2023,USD,1101539,111760,989779,769241,220538,62222,158316,11015,22030,136286,74217,681683,170594,511089,,1101539,20.0,40.9,0.0687,4589,20.0,65384.63,1.14,0.8985
481,Hamilton Inc,False,CA,South Darrylburgh,Energy,2018,https://hamiltoninc.com,Least if price season rise field spend pattern real.,24,hamilton-inc,2023,USD,245586,94977,150609,101748,48861,0,48861,2455,4911,43950,17678,178804,54723,124081,,245586,705.14,3521.84,0.1091,1023,20.0,7150.02,2.47,0.6133
482,Leonard Ballard and Miller,False,BR,North James,AgriTech,2019,https://leonardballardandmiller.com,Receive could agree loss.,18,leonard-ballard-and-miller,2023,USD,217350,87511,129839,23363,106476,26307,80169,2173,4347,75822,8395,308981,94016,214965,,217350,20.0,34.34,0.001,237,76.32,1000.0,8.4,0.5974
483,Santos Group,False,GB,North Kevin,Marketplaces,2023,https://santosgroup.com,Challenge instead bring total school knowledge machine after last.,27,santos-group,2023,USD,1565616,234838,1330778,523250,807528,53846,753682,15656,31312,722370,76534,999658,621146,378512,,1565616,2432.31,7629.43,0.135,763,170.8,6454.59,11.86,0.85
484,Harris PLC,False,FR,Williamstown,Fintech,2010,https://harrisplc.com,Piece require woman support say.,18,harris-plc,2023,EUR,336269,109729,226540,249445,-22905,15023,-37928,3362,6725,-44653,17001,328032,105613,222419,,336269,1402.93,4427.07,0.0012,250,111.77,34030.38,0.5,0.6737
485,Simon Duarte and Johnson,False,FR,Tuckershire,Energy,2011,https://simonduarteandjohnson.com,Very toward test discussion art affect office network environmental possible threat.,20,simon-duarte-and-johnson,2023,EUR,1843012,424745,1418267,1172320,245947,18095,227852,18430,36860,190992,96769,1030204,362986,667218,,1843012,104.54,52.27,0.0091,1397,109.89,105517.52,0.92,0.7695
486,Simpson Ltd,False,ZA,Shanechester,Cybersecurity,2019,https://simpsonltd.com,Claim risk light just.,26,simpson-ltd,2023,USD,1856909,738469,1118440,488619,629821,0,629821,18569,37138,592683,22829,1110439,364637,745802,,1856909,948.23,5503.54,0.0349,662,233.45,67640.25,0.34,0.6023
487,Robinson Stout and Morgan,False,AU,Andersonport,HealthTech,2009,https://robinsonstoutandmorgan.com,Where strategy pull same somebody son suddenly perform.,24,robinson-stout-and-morgan,2023,USD,784416,341117,443299,642262,-198963,1131,-200094,7844,15688,-215782,48793,459896,279512,180384,65368.0,784416,189.6,1034.77,0.0478,932,70.13,52818.96,0.92,0.5651
488,Vazquez-Miller,False,KE,Andersonborough,AI/ML,2018,https://vazquez-miller.com,Paper beyond indeed year field decide.,22,vazquez-miller,2023,USD,568301,104697,463604,287119,176485,0,176485,5683,11366,165119,10830,450808,353718,97090,,568301,1566.34,7525.03,0.0624,2367,20.0,25527.16,0.42,0.8158
489,Kidd LLC,False,BR,Michaelburgh,Fintech,2021,https://kiddllc.com,Still thus allow as issue pay.,26,kidd-llc,2023,USD,1157709,304076,853633,782027,71606,36695,34911,11577,23154,11757,8425,780344,640988,139356,,1157709,20.0,41.76,0.0014,962,100.22,82322.63,0.1,0.7373
490,Hoffman Group,False,CA,Victoriastad,Marketplaces,2021,https://hoffmangroup.com,Show news to table them.,21,hoffman-group,2023,USD,147186,32902,114284,104002,10282,16939,-6657,1471,2943,-9600,9619,266360,142131,124229,,147186,978.68,6156.64,0.1063,67,182.45,5518.41,1.74,0.7765
491,Caldwell Mccarthy and House,False,ZA,Lloydville,SaaS,2017,https://caldwellmccarthyandhouse.com,Sit participant teach big none.,31,caldwell-mccarthy-and-house,2023,USD,1130383,491287,639096,56519,582577,42616,539961,11303,22607,517354,60075,694423,34721,659702,94198.58,1130383,295.24,983.6,0.0514,18839,5.0,15252.13,3.94,0.5654
492,Garcia Soto and Pitts,False,KE,Ericport,AgriTech,2019,https://garciasotoandpitts.com,Seven marriage that child hair standard but dark wide.,18,garcia-soto-and-pitts,2023,USD,160309,70535,89774,81748,8026,32970,-24944,1603,3206,-28150,6707,212468,42053,170415,,160309,705.95,352.98,0.0301,253,52.77,5982.9,1.12,0.56
493,Sanchez Group,False,FR,Justinburgh,IoT,2024,https://sanchezgroup.com,Entire resource increase picture early.,22,sanchez-group,2023,EUR,278323,75054,203269,57173,146096,40969,105127,2783,5566,99561,24190,201156,32724,168432,,278323,20.0,70.91,0.0897,1159,20.0,12525.2,1.93,0.7303
494,Fisher Perez and Pham,False,DE,Hardinmouth,HealthTech,2023,https://fisherperezandpham.com,Some gun ahead certainly act south want be fire word.,27,fisher-perez-and-pham,2023,EUR,964385,389384,575001,338913,236088,18090,217998,9643,19287,198711,21705,670336,346316,324020,80365.42,964385,459.27,459.27,0.0084,3241,24.79,9761.49,2.22,0.5962
495,Hamilton Group,False,DE,Lake Sandraberg,Fintech,2019,https://hamiltongroup.com,Around place require produce mind fast I race network fight.,19,hamilton-group,2023,EUR,1698077,737507,960570,866391,94179,0,94179,16980,33961,60218,122797,1101328,412840,688488,,1698077,379.51,189.76,0.0116,7075,20.0,73989.69,1.66,0.5657
496,Edwards Cooper and Wilcox,False,NG,Lake Richard,E-commerce,2011,https://edwardscooperandwilcox.com,Thought person peace kind generation speech.,17,edwards-cooper-and-wilcox,2023,USD,956114,210209,745905,377461,368444,47595,320849,9561,19122,301727,138031,619105,371542,247563,,956114,135.27,472.77,0.0645,346,229.84,29720.07,4.64,0.7801
497,Sullivan Gonzalez and Turner,False,AU,New Matthewberg,AgriTech,2015,https://sullivangonzalezandturner.com,Yeah exist behavior necessary miss serious civil agreement someone or.,19,sullivan-gonzalez-and-turner,2023,USD,191240,9562,181678,47891,133787,0,133787,1912,3824,129963,9604,191358,18994,172364,,191240,20.0,43.46,0.0516,227,70.08,34245.09,0.28,0.95
498,Collier LLC,False,AU,Benitezville,Energy,2008,https://collierllc.com,Success employee medical buy series.,22,collier-llc,2023,USD,1154949,603018,551931,601946,-50015,0,-50015,11549,23098,-73113,91551,755357,393305,362052,,1154949,218.61,740.2,0.0639,387,248.28,71228.69,1.29,0.4779
499,West PLC,False,KE,South Matthewbury,Marketplaces,2016,https://westplc.com,Not thus physical mouth other go expect size resource public.,18,west-plc,2023,USD,1038145,411095,627050,437082,189968,12475,177493,10381,20762,156731,52965,644291,245847,398444,,1038145,20.0,24.63,0.14,4325,20.0,23049.42,2.3,0.604
500,Gray Mclaughlin and Garcia,False,US,Port Kimberly,HealthTech,2016,https://graymclaughlinandgarcia.com,Better Republican stock bank artist thousand live land hard.,12,gray-mclaughlin-and-garcia,2023,USD,1868041,427318,1440723,546936,893787,3510,890277,18680,37360,852917,170485,1216086,182093,1033993,155670.08,1868041,10.0,50.36,0.0148,11874,13.11,41987.71,4.06,0.7712
501,Powell Hansen and Maxwell,False,ZA,Breannachester,AgriTech,2018,https://powellhansenandmaxwell.com,Ready way rule indicate clear media machine leader whose.,17,powell-hansen-and-maxwell,2023,USD,236439,93131,143308,11821,131487,0,131487,2364,4728,126759,16711,202326,90723,111603,,236439,704.16,2734.81,0.0169,985,20.0,38353.68,0.44,0.6061
502,Boyer Wilson and Lewis,False,CA,Johnsonburgh,SaaS,2013,https://boyerwilsonandlewis.com,Hard weight own impact building occur American check he yard.,11,boyer-wilson-and-lewis,2023,USD,2661525,1458977,1202548,1185034,17514,6700,10814,26615,53230,-42416,143076,1474157,315169,1158988,221793.75,2661525,10.0,39.16,0.001,3793,58.46,76435.96,1.87,0.4518
503,Carter-Johnson,False,GB,East Kristen,IoT,2020,https://carter-johnson.com,Any thus threat democratic standard major business give that.,19,carter-johnson,2023,USD,493707,221805,271902,496342,-224440,8541,-232981,4937,9874,-242855,31200,343222,122851,220371,,493707,187.53,819.3,0.0289,384,106.94,60890.46,0.51,0.5507
504,Olson-Collins,False,FR,Mcculloughfurt,HealthTech,2008,https://olson-collins.com,Strong street car catch PM seven project chance road.,22,olson-collins,2023,EUR,288783,98005,190778,97183,93595,22801,70794,2887,5775,65019,7867,195972,68876,127096,24065.25,288783,109.33,617.67,0.001,313,76.76,1000.0,7.87,0.6606
505,Marsh Ltd,False,FR,Hughesfurt,Cybersecurity,2024,https://marshltd.com,Must when three save position tend religious occur.,21,marsh-ltd,2023,EUR,190967,66010,124957,93092,31865,19459,12406,1909,3819,8587,56928,248710,34251,214459,,190967,34.88,17.44,0.1094,795,20.0,41604.26,1.37,0.6543
506,Parker Brewer and Schneider,False,DE,East Stephanieside,Energy,2021,https://parkerbrewerandschneider.com,Serious whatever miss seek me affect probably mother while ever.,16,parker-brewer-and-schneider,2023,EUR,184890,60840,124050,129493,-5443,0,-5443,1848,3697,-9140,9155,226770,169716,57054,,184890,20.0,82.29,0.0875,48,320.07,1000.0,9.15,0.6709
507,Sanchez Ltd,False,EG,Millerside,E-commerce,2013,https://sanchezltd.com,Fly open man value future Congress agency month high before.,30,sanchez-ltd,2023,USD,234254,81643,152611,95291,57320,0,57320,2342,4685,52635,18228,281430,56244,225186,,234254,234.43,582.78,0.0966,97,199.29,1000.0,18.23,0.6515
508,Weaver LLC,False,CA,East Jonathan,AgriTech,2018,https://weaverllc.com,Child weight question arrive which.,22,weaver-llc,2023,USD,1419569,588695,830874,1494139,-663265,0,-663265,14195,28391,-691656,6878,755327,453896,301431,,1419569,1417.03,6401.54,0.001,706,167.5,137729.53,0.05,0.5853
509,Johnson Inc,False,AU,Petermouth,IoT,2010,https://johnsoninc.com,Include food heart still building dark.,22,johnson-inc,2023,USD,1235063,509839,725224,762473,-37249,14376,-51625,12350,24701,-76326,96057,792260,235096,557164,,1235063,1241.69,4052.22,0.0534,431,238.71,71711.64,1.34,0.5872
510,Willis Vasquez and Goodwin,False,US,Averyview,HealthTech,2013,https://willisvasquezandgoodwin.com,Five network assume ahead plant.,22,willis-vasquez-and-goodwin,2023,USD,2153105,524585,1628520,1965361,-336841,12346,-349187,21531,43062,-392249,71016,1168495,58424,1110071,179425.42,2153105,141.73,284.35,0.0061,20694,8.67,153796.84,0.46,0.7564
511,Adams PLC,False,AU,East Kathrynberg,IoT,2009,https://adamsplc.com,Nothing land suffer matter situation central music.,17,adams-plc,2023,USD,2046403,867098,1179305,1311715,-132410,4317,-136727,20464,40928,-177655,281240,1450808,753781,697027,,2046403,20.0,31.19,0.001,8526,20.0,108483.76,2.59,0.5763
512,Casey PLC,False,BR,Aliside,Fintech,2016,https://caseyplc.com,Among spend which per president cold art two event.,20,casey-plc,2023,USD,318309,127543,190766,106141,84625,0,84625,3183,6366,78259,21218,363548,88835,274713,,318309,713.78,356.89,0.0796,1326,20.0,6500.29,3.26,0.5993
513,Franco-James,False,EG,Meganborough,Marketplaces,2021,https://franco-james.com,Subject example claim move attorney bed recognize store rise your.,16,franco-james,2023,USD,311017,93678,217339,106472,110867,21126,89741,3110,6220,83521,34498,256957,187836,69121,,311017,346.16,1216.03,0.0456,287,90.1,55457.73,0.62,0.6988
514,Clark-Wagner,False,EG,Nicolemouth,IoT,2022,https://clark-wagner.com,Woman remain event production focus decision where.,18,clark-wagner,2023,USD,698194,244393,453801,238184,215617,0,215617,6981,13963,201654,32914,561431,108653,452778,,698194,597.98,1782.38,0.0939,287,202.38,29460.84,1.12,0.65
515,Smith-Holt,False,TN,New Thomastown,AgriTech,2014,https://smith-holt.com,Including time reflect several Mrs skin.,19,smith-holt,2023,USD,203794,39508,164286,69851,94435,24295,70140,2037,4075,66065,37388,142345,77159,65186,,203794,1271.21,635.6,0.038,849,20.0,1000.0,37.39,0.8061
516,Curtis Ryan and Stafford,False,AU,Chambersstad,AI/ML,2011,https://curtisryanandstafford.com,Still group concern should recent across leg view.,14,curtis-ryan-and-stafford,2023,USD,2089742,903198,1186544,104487,1082057,10617,1071440,20897,41794,1029646,330416,1518057,1016462,501595,,2089742,952.74,2892.46,0.0502,7805,22.31,1000.0,330.42,0.5678
517,Smith-Paul,False,CA,Erinstad,Energy,2011,https://smith-paul.com,Bed party field response doctor management.,21,smith-paul,2023,USD,1636458,456227,1180231,560578,619653,16778,602875,16364,32729,570146,102988,1059218,396883,662335,,1636458,20.0,13.35,0.0495,1298,105.02,44454.96,2.32,0.7212
518,Johnson-Vasquez,False,IN,North James,Marketplaces,2023,https://johnson-vasquez.com,Book everyone matter color create school public owner.,21,johnson-vasquez,2023,USD,1440296,232980,1207316,549164,658152,14273,643879,14402,28805,615074,124573,940460,622632,317828,,1440296,20.0,112.38,0.0362,6001,20.0,32329.25,3.85,0.8382
519,Jones and Sons,False,NG,East Jordanshire,Marketplaces,2017,https://jonesandsons.com,Thing rock ever summer age wide question.,18,jones-and-sons,2023,USD,198134,119064,79070,88048,-8978,3840,-12818,1981,3962,-16780,18005,191541,103905,87636,,198134,20.0,11.05,0.0305,190,86.87,1000.0,18.0,0.3991
520,King Castro and Gibson,False,US,Davidsonton,EdTech,2020,https://kingcastroandgibson.com,Item yet ever quite level guess service this.,25,king-castro-and-gibson,2023,USD,284809,102194,182615,309534,-126919,0,-126919,2848,5696,-132615,19481,357342,128811,228531,23734.08,284809,377.84,2583.61,0.0738,447,53.08,52602.63,0.37,0.6412
521,Williams Group,False,KE,Stewartfurt,SaaS,2008,https://williamsgroup.com,Free they space wrong difficult ready.,22,williams-group,2023,USD,1482961,576968,905993,1499244,-593251,0,-593251,14829,29659,-622910,59869,844272,506984,337288,123580.08,1482961,209.79,1316.38,0.042,4456,27.73,131146.46,0.46,0.6109
522,Stark and Sons,False,DE,West Lance,AgriTech,2014,https://starkandsons.com,Personal agreement it agency something various subject east list when strategy.,21,stark-and-sons,2023,EUR,108771,20264,88507,34483,54024,15018,39006,1087,2175,36831,3744,97936,41483,56453,,108771,541.49,1175.77,0.1157,190,47.6,1000.0,3.74,0.8137
523,Stone-Young,False,AU,Port Carolmouth,HealthTech,2016,https://stone-young.com,Personal often beat art almost.,32,stone-young,2023,USD,1928489,539559,1388930,456209,932721,0,932721,19284,38569,894152,17414,1009111,441707,567404,160707.42,1928489,430.87,2687.23,0.001,32141,5.0,44586.08,0.39,0.7202
524,Wu-Steele,False,IN,North Samantha,E-commerce,2011,https://wu-steele.com,Area particularly it big argue appear sure I pay.,25,wu-steele,2023,USD,2330541,116527,2214014,1688591,525423,5599,519824,23305,46610,473214,90043,1363981,517064,846917,,2330541,154.55,77.28,0.146,725,267.68,151372.08,0.59,0.95
525,Hall-Greene,False,US,South Patrickchester,Mobility,2021,https://hall-greene.com,People fund visit situation law foreign court bill organization attack smile.,21,hall-greene,2023,USD,512179,146941,365238,361263,3975,32234,-28259,5121,10243,-38502,9414,341451,219962,121489,,512179,1403.61,6458.58,0.153,227,187.83,41279.73,0.23,0.7131
526,Strong and Sons,False,GB,Michaelfort,HealthTech,2020,https://strongandsons.com,Know during someone art find job where senior find those simply.,25,strong-and-sons,2023,USD,694909,178226,516683,199458,317225,0,317225,6949,13898,303327,4235,544984,132190,412794,57909.08,694909,21.81,90.84,0.055,581,99.56,25583.12,0.17,0.7435
527,Harrison PLC,False,NG,Kellytown,Cybersecurity,2015,https://harrisonplc.com,Only question arm medical strong teach instead crime customer training.,21,harrison-plc,2023,USD,395218,122754,272464,209107,63357,0,63357,3952,7904,55453,18320,309707,156452,153255,,395218,1103.31,3213.0,0.1044,1646,20.0,20930.49,0.88,0.6894
528,Peterson Ltd,False,NG,Nealmouth,AI/ML,2019,https://petersonltd.com,Realize system not friend federal forget bit then treat many.,18,peterson-ltd,2023,USD,158211,19873,138338,34917,103421,0,103421,1582,3164,100257,40390,215503,76198,139305,,158211,1468.82,734.41,0.0969,263,49.97,33341.9,1.21,0.8744
529,Fowler Ltd,False,FR,South Claire,Energy,2009,https://fowlerltd.com,Lose shoulder spring southern heavy hundred step.,19,fowler-ltd,2023,EUR,7484057,1807215,5676842,9158295,-3481453,0,-3481453,74840,149681,-3631134,443565,4228864,1460316,2768548,,7484057,1447.89,4128.38,0.0408,5061,123.21,775037.84,0.57,0.7585
530,Cox Inc,False,TN,Anthonyville,SaaS,2022,https://coxinc.com,Fact create one she analysis ahead.,26,cox-inc,2023,USD,1093498,297099,796399,324993,471406,0,471406,10934,21869,449537,211552,937860,46893,890967,91124.83,1093498,49.56,198.77,0.0159,2253,40.44,57715.6,3.67,0.7283
531,Mitchell and Sons,False,FR,Jennifermouth,E-commerce,2021,https://mitchellandsons.com,Early cultural compare energy big story case pressure those full.,20,mitchell-and-sons,2023,EUR,1896194,823298,1072896,1226492,-153596,23622,-177218,18961,37923,-215141,51825,1012126,131276,880850,,1896194,20.0,25.82,0.0298,658,240.13,107652.4,0.48,0.5658
532,Torres and Sons,False,KE,Lisaburgh,Energy,2021,https://torresandsons.com,With young think there assume certain under some court her.,16,torres-and-sons,2023,USD,1424643,371708,1052935,599775,453160,42957,410203,14246,28492,381711,63569,932160,301728,630432,,1424643,1644.09,5302.6,0.001,5936,20.0,51609.7,1.23,0.7391
533,Stewart-Jordan,False,IN,North Kathryn,Fintech,2020,https://stewart-jordan.com,Country movement smile foreign apply somebody their surface why though.,14,stewart-jordan,2023,USD,2015677,657222,1358455,753107,605348,32248,573100,20156,40313,532787,17697,1056688,358981,697707,,2015677,1791.76,895.88,0.0278,418,400.9,111288.19,0.16,0.6739
534,Acosta Group,False,US,East Williamhaven,E-commerce,2013,https://acostagroup.com,Material less focus hear reason resource manager environmental.,20,acosta-group,2023,USD,536605,172744,363861,357321,6540,3195,3345,5366,10732,-7387,43998,348582,149064,199518,,536605,584.0,292.0,0.1054,372,120.08,53218.47,0.83,0.6781
535,Little-Gibbs,False,AU,East Jeffreyborough,IoT,2022,https://little-gibbs.com,Tell how fill thousand number very hear nearly care.,16,little-gibbs,2023,USD,538019,281181,256838,166011,90827,28685,62142,5380,10760,51382,28424,300354,147924,152430,,538019,851.03,1546.5,0.1278,440,101.68,1000.0,28.42,0.4774
536,Phillips PLC,False,ZA,Jerryton,E-commerce,2010,https://phillipsplc.com,Mention from later it happen marriage event agent kid.,19,phillips-plc,2023,USD,188125,61235,126890,231284,-104394,4759,-109153,1881,3762,-112915,3260,254166,143444,110722,,188125,20.0,18.22,0.067,783,20.0,1000.0,3.26,0.6745
537,Brewer-Howard,False,TN,West Meganhaven,Fintech,2015,https://brewer-howard.com,Poor skill unit better author although customer cultural forget few.,18,brewer-howard,2023,USD,238165,82563,155602,11908,143694,14706,128988,2381,4763,124225,8006,231517,52138,179379,,238165,117.85,207.24,0.0153,256,77.43,10837.6,0.74,0.6533
538,Bruce Lee and Munoz,False,TN,Port Karen,IoT,2020,https://bruceleeandmunoz.com,Treatment across federal state situation identify if oil pretty line.,19,bruce-lee-and-munoz,2023,USD,2073050,1021682,1051368,1470549,-419181,24359,-443540,20730,41461,-485001,264254,1468627,725257,743370,,2073050,333.53,1433.43,0.0208,542,318.37,171593.15,1.54,0.5072
539,Hays Lynn and Grimes,False,NG,East Jennifer,Fintech,2020,https://hayslynnandgrimes.com,Listen middle skill serious reveal left.,28,hays-lynn-and-grimes,2023,USD,7153429,2513898,4639531,3910397,729134,32185,696949,71534,143068,553881,308732,3977893,869866,3108027,,7153429,1106.59,553.29,0.0346,29805,20.0,337131.95,0.92,0.6486
540,Edwards and Sons,False,IN,Carrillochester,Cybersecurity,2018,https://edwardsandsons.com,Just table air catch them figure.,20,edwards-and-sons,2023,USD,3279350,1486880,1792470,1019045,773425,6818,766607,32793,65587,701020,7750,1715019,511662,1203357,,3279350,260.69,1675.81,0.1343,1338,204.24,78317.02,0.1,0.5466
541,Smith Cochran and Flowers,False,DE,Jeremiahchester,E-commerce,2013,https://smithcochranandflowers.com,Several real federal only nothing allow cause with.,18,smith-cochran-and-flowers,2023,EUR,892766,210968,681798,159077,522721,29995,492726,8927,17855,474871,132738,654086,369234,284852,,892766,20.0,10.0,0.0388,1418,52.45,18380.34,7.22,0.7637
542,Carroll-Lloyd,False,FR,Bairdborough,AI/ML,2011,https://carroll-lloyd.com,As hit little forget while police fight commercial.,25,carroll-lloyd,2023,EUR,190701,81581,109120,103618,5502,17424,-11922,1907,3814,-15736,5634,173777,37847,135930,,190701,34.64,127.41,0.0728,415,38.21,1000.0,5.63,0.5722
543,Tran Johnson and Barker,False,NG,Johnsonborough,AI/ML,2014,https://tranjohnsonandbarker.com,Treat history day fact modern.,23,tran-johnson-and-barker,2023,USD,349752,81605,268147,118019,150128,0,150128,3497,6995,143133,21876,231950,11597,220353,,349752,1095.57,6154.43,0.0527,1457,20.0,18360.54,1.19,0.7667
544,Brown-Stone,False,AU,West Michele,E-commerce,2019,https://brown-stone.com,Hospital writer can industry sea home tough deal.,21,brown-stone,2023,USD,2236643,1111095,1125548,1299505,-173957,4309,-178266,22366,44732,-222998,183419,1494156,707959,786197,,2236643,182.88,378.95,0.1105,1682,110.77,107946.62,1.7,0.5032
545,Collins Ltd,False,ZA,Mooreshire,Marketplaces,2012,https://collinsltd.com,Onto maybe range every account central ask.,20,collins-ltd,2023,USD,482976,134191,348785,127539,221246,15282,205964,4829,9659,196305,6617,283214,52771,230443,,482976,1804.49,6167.58,0.0913,260,154.46,40530.74,0.16,0.7222
546,Jacobs-Wright,False,DE,Reneefort,Fintech,2012,https://jacobs-wright.com,Leg although before position try get successful society hospital.,30,jacobs-wright,2023,EUR,1161188,496991,664197,116416,547781,10914,536867,11611,23223,513644,58019,726551,143904,582647,,1161188,1247.65,2357.36,0.1019,538,179.64,24985.6,2.32,0.572
547,Perry and Sons,False,IN,Ellisburgh,EdTech,2013,https://perryandsons.com,Believe recognize analysis those citizen think Mrs project at risk.,19,perry-and-sons,2023,USD,125736,36380,89356,63146,26210,6164,20046,1257,2514,17532,6747,211494,10574,200920,10478.0,125736,243.69,1157.26,0.057,106,98.2,22179.19,0.3,0.7107
548,Kerr Group,False,KE,West Charlesville,HealthTech,2010,https://kerrgroup.com,Short for late education media left available reason see.,16,kerr-group,2023,USD,587972,243302,344670,331704,12966,9271,3695,5879,11759,-8064,23989,318919,103114,215805,48997.67,587972,738.82,3547.19,0.0463,1072,45.7,38294.98,0.63,0.5862
549,Cooper-Ross,False,GB,South Benjamin,Marketplaces,2023,https://cooper-ross.com,Boy true force security machine attention nature.,16,cooper-ross,2023,USD,4426752,1083232,3343520,1949536,1393984,35629,1358355,44267,88535,1269820,1531977,3812899,1949118,1863781,,4426752,959.57,479.78,0.109,6714,54.94,183505.56,8.35,0.7553
550,Reeves Group,False,EG,South Lori,IoT,2022,https://reevesgroup.com,Color adult beyond family movement hospital.,27,reeves-group,2023,USD,654990,409142,245848,32749,213099,20640,192459,6549,13099,179360,13161,513925,279225,234700,,654990,20.0,64.6,0.001,2729,20.0,17221.53,0.76,0.3753
551,Powers Inc,False,BR,Ericstad,IoT,2018,https://powersinc.com,Describe alone push democratic recent student.,17,powers-inc,2023,USD,294923,109755,185168,114327,70841,7249,63592,2949,5898,57694,12619,272255,76093,196162,,294923,20.0,68.04,0.001,206,119.1,25672.47,0.49,0.6279
552,Davidson Moran and Prince,False,BR,Vaughnmouth,E-commerce,2012,https://davidsonmoranandprince.com,Our any help cut economic.,21,davidson-moran-and-prince,2023,USD,927311,387562,539749,388544,151205,0,151205,9273,18546,132659,118981,721543,154298,567245,,927311,675.04,1777.36,0.1177,696,110.89,7951.25,14.96,0.5821
553,Gonzalez Inc,False,EG,Johnsontown,Fintech,2023,https://gonzalezinc.com,Star quite as when benefit structure professional right.,21,gonzalez-inc,2023,USD,961311,309323,651988,48065,603923,0,603923,9613,19226,584697,33739,579757,223334,356423,,961311,262.78,221.42,0.0592,768,104.29,12842.14,2.63,0.6782
554,Perry Inc,False,EG,Marcusborough,Marketplaces,2017,https://perryinc.com,Debate must voice building degree ground community I first home learn.,26,perry-inc,2023,USD,459515,51917,407598,109708,297890,9268,288622,4595,9190,279432,13567,280918,28851,252067,,459515,323.73,2091.5,0.001,151,252.93,13050.4,1.04,0.887
555,Barrett LLC,False,AU,Bradleyborough,AgriTech,2009,https://barrettllc.com,Feeling out work big movie wrong sure commercial.,19,barrett-llc,2023,USD,244897,94398,150499,75991,74508,0,74508,2448,4897,69611,8734,270774,60793,209981,,244897,20.0,55.05,0.0314,198,102.7,16170.76,0.54,0.6145
556,Greene Ltd,False,CA,Gregoryberg,AI/ML,2010,https://greeneltd.com,Compare seven reach within project attack adult treatment.,19,greene-ltd,2023,USD,342627,142841,199786,146610,53176,6744,46432,3426,6852,39580,3847,321133,160785,160348,,342627,20.0,10.0,0.0603,254,111.98,1000.0,3.85,0.5831
557,Reyes-Davidson,False,IN,New Briana,Mobility,2022,https://reyes-davidson.com,Discussion pattern to final.,17,reyes-davidson,2023,USD,4808452,3070583,1737869,2424911,-687042,0,-687042,48084,96169,-783211,74081,2536172,1125319,1410853,,4808452,1083.19,1720.82,0.0094,20035,20.0,212657.31,0.35,0.3614
558,Patterson Sanchez and Miller,False,US,West Victor,SaaS,2019,https://pattersonsanchezandmiller.com,Charge daughter also type our watch.,25,patterson-sanchez-and-miller,2023,USD,990491,279463,711028,49524,661504,31664,629840,9904,19809,610031,21634,583496,182516,400980,82540.92,990491,118.85,746.98,0.0908,1122,73.56,1000.0,21.63,0.7179
559,Wiley Taylor and Stewart,False,IN,New Latoyachester,Fintech,2010,https://wileytaylorandstewart.com,Seek director run garden day approach truth.,24,wiley-taylor-and-stewart,2023,USD,389574,153728,235846,50108,185738,0,185738,3895,7791,177947,2509,198510,54302,144208,,389574,20.0,110.89,0.0404,1623,20.0,10826.5,0.23,0.6054
560,Solis Ltd,False,KE,New Monique,IoT,2024,https://solisltd.com,Focus kind accept thank attorney court plant center daughter begin.,18,solis-ltd,2023,USD,357850,67660,290190,237075,53115,34851,18264,3578,7157,11107,18571,234673,98192,136481,,357850,20.0,13.83,0.0928,90,330.07,25042.05,0.74,0.8109
561,Dunn Pope and Harris,False,TN,South Jessicaport,Mobility,2009,https://dunnpopeandharris.com,Return each computer eat experience large.,20,dunn-pope-and-harris,2023,USD,457866,148517,309349,30598,278751,0,278751,4578,9157,269594,60539,339657,178169,161488,,457866,20.0,31.53,0.0435,1907,20.0,1000.0,60.54,0.6756
562,Harris Huffman and Olson,False,EG,Raymondburgh,IoT,2014,https://harrishuffmanandolson.com,Kid measure same set standard soldier after high take.,24,harris-huffman-and-olson,2023,USD,1143475,195535,947940,430852,517088,23828,493260,11434,22869,470391,159746,889905,303905,586000,,1143475,20.0,30.5,0.0371,4764,20.0,34817.6,4.59,0.829
563,Larson-Hernandez,False,CA,West Oscar,IoT,2023,https://larson-hernandez.com,Law heart paper author carry light choice.,24,larson-hernandez,2023,USD,671266,205133,466133,410105,56028,16238,39790,6712,13425,26365,7843,537005,184511,352494,,671266,1310.8,906.97,0.001,638,87.66,13414.35,0.58,0.6944
564,Smith PLC,False,NG,Travischester,HealthTech,2009,https://smithplc.com,Wife health majority political open impact although TV.,19,smith-plc,2023,USD,2007818,905022,1102796,874189,228607,27574,201033,20078,40156,160877,13120,1097810,57965,1039845,167318.17,2007818,342.52,1963.47,0.0452,4957,33.75,67816.93,0.19,0.5493
565,Frederick-Martin,False,EG,Kruegerstad,Fintech,2018,https://frederick-martin.com,Remember play happy around history interest east local TV guess.,17,frederick-martin,2023,USD,1416948,623420,793528,841892,-48364,16981,-65345,14169,28338,-93683,125768,933507,130934,802573,,1416948,20.0,103.9,0.0835,1919,61.51,118934.8,1.06,0.56
566,Rhodes Terry and Brewer,False,ZA,Catherineberg,Fintech,2024,https://rhodesterryandbrewer.com,Easy official production claim bring begin represent.,16,rhodes-terry-and-brewer,2023,USD,2543820,739446,1804374,720773,1083601,7175,1076426,25438,50876,1025550,27300,1323491,671776,651715,,2543820,20.0,10.0,0.0329,3018,70.23,78093.1,0.35,0.7093
567,Sanders-Willis,False,BR,New Reneechester,HealthTech,2009,https://sanders-willis.com,Stop education few whose probably him.,21,sanders-willis,2023,USD,716095,197294,518801,35804,482997,32257,450740,7160,14321,436419,60055,582536,514412,68124,59674.58,716095,91.51,628.78,0.001,9782,6.1,1000.0,60.06,0.7245
568,Gross-Goodwin,False,DE,North Daisystad,Cybersecurity,2022,https://gross-goodwin.com,Especially decide security recognize according collection.,20,gross-goodwin,2023,EUR,1192158,552490,639668,371783,267885,0,267885,11921,23843,244042,460480,1067776,53388,1014388,,1192158,649.47,958.43,0.1048,2900,34.25,16139.18,28.53,0.5366
569,Smith-Jones,False,EG,Warrenport,AI/ML,2024,https://smith-jones.com,Color hear region cup consider way late sport control.,16,smith-jones,2023,USD,361109,129009,232100,44061,188039,0,188039,3611,7222,180817,18610,272243,17568,254675,,361109,1293.49,646.74,0.0159,962,31.26,1000.0,18.61,0.6427
570,Brady and Sons,False,KE,Tonyachester,HealthTech,2019,https://bradyandsons.com,Phone person than coach fall help everybody garden one.,26,brady-and-sons,2023,USD,987751,332793,654958,62699,592259,0,592259,9877,19755,572504,49089,586519,228370,358149,82312.58,987751,83.12,384.14,0.0756,3429,24.0,7256.62,6.76,0.6631
571,Washington-Hodges,False,CA,North Josephtown,AgriTech,2020,https://washington-hodges.com,Smile among decision social heart mind while entire magazine series.,17,washington-hodges,2023,USD,541630,62286,479344,102546,376798,9252,367546,5416,10832,356714,4914,465743,133899,331844,,541630,271.9,1151.96,0.1228,161,279.16,29178.58,0.17,0.885
572,Jordan Wood and Wu,False,TN,Lisastad,E-commerce,2009,https://jordanwoodandwu.com,Her arm green form beyond lead recognize rise.,25,jordan-wood-and-wu,2023,USD,253247,115739,137508,43476,94032,0,94032,2532,5064,88968,34233,275236,22581,252655,,253247,707.23,4141.01,0.0771,84,249.57,8460.31,4.05,0.543
573,Johnson Inc,False,AU,Stephaniebury,Marketplaces,2018,https://johnsoninc.com,Later rather thank method produce about point walk.,22,johnson-inc,2023,USD,1853200,540086,1313114,754062,559052,0,559052,18532,37064,521988,52921,1094837,556263,538574,,1853200,108.44,802.76,0.001,586,263.45,31912.94,1.66,0.7086
574,Smith-Ward,False,FR,Port Jillmouth,E-commerce,2011,https://smith-ward.com,Parent hundred partner bank into use us.,18,smith-ward,2023,EUR,2963604,1061762,1901842,1861284,40558,412,40146,29636,59272,-19126,172137,1814733,667144,1147589,,2963604,20.0,63.61,0.1424,2973,83.06,153032.32,1.12,0.6417
575,Vincent Stein and Navarro,False,NG,Catherineberg,Marketplaces,2020,https://vincentsteinandnavarro.com,Then size respond all marriage beautiful strategy you would level.,18,vincent-stein-and-navarro,2023,USD,1379123,363911,1015212,608984,406228,14457,391771,13791,27582,364189,36292,741183,37059,704124,,1379123,1513.54,4606.88,0.0658,612,187.58,66949.21,0.54,0.7361
576,Friedman-Olson,False,IN,East Jason,AgriTech,2012,https://friedman-olson.com,Black year ahead upon force.,21,friedman-olson,2023,USD,156242,28299,127943,19604,108339,31284,77055,1562,3124,73931,20406,156116,53755,102361,,156242,302.78,1791.66,0.127,651,20.0,9157.61,2.23,0.8189
577,Miranda-Robinson,False,CA,Elizabethville,Fintech,2012,https://miranda-robinson.com,Two plant man somebody four difference.,22,miranda-robinson,2023,USD,2512183,604478,1907705,1345599,562106,10934,551172,25121,50243,500929,66445,1365352,572930,792422,,2512183,560.21,1625.06,0.1049,684,305.67,93427.99,0.71,0.7594
578,Miranda Burke and Schneider,False,CA,Kentfurt,AgriTech,2020,https://mirandaburkeandschneider.com,Whom join do else fact born future or could walk.,19,miranda-burke-and-schneider,2023,USD,201173,116842,84331,125346,-41015,0,-41015,2011,4023,-45038,33223,215447,81624,133823,,201173,20.0,32.8,0.0102,838,20.0,14283.29,2.33,0.4192
579,Richardson Castaneda and Finley,False,GB,West Bryanside,IoT,2010,https://richardsoncastanedaandfinley.com,Suggest woman floor half quickly someone.,11,richardson-castaneda-and-finley,2023,USD,881915,491022,390893,758282,-367389,0,-367389,8819,17638,-385027,78526,666722,209614,457108,,881915,1536.79,2072.01,0.0214,3674,20.0,34096.86,2.3,0.4432
580,Alvarado Garza and Rodriguez,False,IN,New Melissamouth,AI/ML,2020,https://alvaradogarzaandrodriguez.com,Staff father despite quite challenge exist.,24,alvarado-garza-and-rodriguez,2023,USD,1145935,204216,941719,623095,318624,13239,305385,11459,22918,282467,105955,686098,100724,585374,,1145935,1055.24,3407.54,0.1043,1707,55.92,45091.65,2.35,0.8218
581,Ortega Solis and Warner,False,BR,Kyleville,E-commerce,2012,https://ortegasolisandwarner.com,You religious long stock manager region heavy.,27,ortega-solis-and-warner,2023,USD,365947,224410,141537,18297,123240,0,123240,3659,7318,115922,24203,276036,151051,124985,,365947,925.77,6194.6,0.0995,1524,20.0,26074.98,0.93,0.3868
582,Hernandez-Moran,False,BR,Lake Jill,Cybersecurity,2024,https://hernandez-moran.com,Task road federal spring treatment city.,17,hernandez-moran,2023,USD,2088695,698973,1389722,1205526,184196,15628,168568,20886,41773,126795,372511,1556201,656787,899414,,2088695,20.0,25.8,0.001,1055,164.96,82741.09,4.5,0.6654
583,Kelley LLC,False,FR,Gregorystad,Marketplaces,2021,https://kelleyllc.com,Hospital month executive recent crime task hour capital.,20,kelley-llc,2023,EUR,4446421,1635120,2811301,426557,2384744,0,2384744,44464,88928,2295816,140505,2562236,375324,2186912,,4446421,910.0,3949.62,0.0856,1822,203.36,62348.1,2.25,0.6323
584,Glenn Brown and Michael,False,NG,Stephenburgh,E-commerce,2008,https://glennbrownandmichael.com,Case receive fact certain design security same across rise offer.,21,glenn-brown-and-michael,2023,USD,447687,100361,347326,60335,286991,29479,257512,4476,8953,248559,28752,303001,145684,157317,,447687,20.0,34.55,0.1288,237,157.23,1000.0,28.75,0.7758
585,Floyd Garrison and Bennett,False,CA,Sheltonburgh,AgriTech,2013,https://floydgarrisonandbennett.com,Benefit wind conference appear woman.,14,floyd-garrison-and-bennett,2023,USD,158496,91921,66575,76214,-9639,15339,-24978,1584,3169,-28147,8936,224631,11231,213400,,158496,211.81,889.5,0.0556,403,32.72,24551.45,0.36,0.42
586,Morgan Hamilton and Hernandez,False,DE,Sanchezville,E-commerce,2023,https://morganhamiltonandhernandez.com,However few other common seat simply yard.,25,morgan-hamilton-and-hernandez,2023,EUR,873308,249103,624205,773044,-148839,21462,-170301,8733,17466,-187767,14539,648664,97345,551319,,873308,20.0,156.24,0.1128,1909,38.11,78154.52,0.19,0.7148
587,Barrett Strickland and Hancock,False,DE,Hillmouth,EdTech,2012,https://barrettstricklandandhancock.com,Activity bring business political training different only would.,18,barrett-strickland-and-hancock,2023,EUR,286933,92152,194781,75393,119388,0,119388,2869,5738,113650,19380,361469,182006,179463,23911.08,286933,586.76,1973.67,0.048,4782,5.0,1000.0,19.38,0.6788
588,Hill-Mcgee,False,GB,South Todd,Fintech,2017,https://hill-mcgee.com,Fear by foot research television Mr if red hour.,28,hill-mcgee,2023,USD,1363566,528581,834985,107515,727470,17165,710305,13635,27271,683034,261925,1017635,308376,709259,,1363566,1036.95,3711.0,0.0674,1233,92.15,22371.85,11.71,0.6124
589,Logan Moreno and Brown,False,AU,Port Karenville,Fintech,2024,https://loganmorenoandbrown.com,Television receive accept language fire always.,19,logan-moreno-and-brown,2023,USD,847349,206790,640559,481996,158563,0,158563,8473,16946,141617,45706,649237,337881,311356,,847349,20.0,38.03,0.0289,638,110.63,66462.1,0.69,0.756
590,Harris Martin and Hart,False,AU,North Tinahaven,AI/ML,2024,https://harrismartinandhart.com,Hair name institution war a feel watch.,24,harris-martin-and-hart,2023,USD,2457538,1010253,1447285,1814826,-367541,0,-367541,24575,49150,-416691,63911,1359010,67950,1291060,,2457538,1442.47,1718.33,0.0272,1270,161.23,180310.92,0.35,0.5889
591,Conway Carter and Ferguson,False,US,New Tracy,Marketplaces,2018,https://conwaycarterandferguson.com,Mission worry goal Mrs decide between standard down.,11,conway-carter-and-ferguson,2023,USD,210319,100630,109689,84733,24956,0,24956,2103,4206,20750,2182,282941,67250,215691,,210319,20.0,63.2,0.066,817,21.43,1000.0,2.18,0.5215
592,Thomas and Sons,False,AU,New Andrea,IoT,2012,https://thomasandsons.com,Grow campaign performance avoid effort high tough hundred bar effect.,17,thomas-and-sons,2023,USD,1150168,274348,875820,372617,503203,3542,499661,11501,23003,476658,380394,976035,499162,476873,,1150168,650.1,2191.69,0.0064,4792,20.0,70051.33,5.43,0.7615
593,Bentley-Thomas,False,KE,North Crystal,Energy,2012,https://bentley-thomas.com,Yet recent cover head price star painting.,16,bentley-thomas,2023,USD,594850,196537,398313,614889,-216576,0,-216576,5948,11897,-228473,49962,408473,220620,187853,,594850,444.2,2043.24,0.0471,1183,41.9,84122.69,0.59,0.6696
594,Underwood-Stewart,False,GB,Graybury,HealthTech,2013,https://underwood-stewart.com,Establish mother range image forget.,20,underwood-stewart,2023,USD,237841,108689,129152,92214,36938,0,36938,2378,4756,32182,4612,209599,188639,20960,19820.08,237841,10.0,13.07,0.001,1098,18.05,3911.05,1.18,0.543
595,Cox LLC,False,ZA,Dustinbury,Mobility,2009,https://coxllc.com,Act help why her bit understand compare.,19,cox-llc,2023,USD,747361,369220,378141,238334,139807,5422,134385,7473,14947,119438,14868,573701,394147,179554,,747361,290.41,207.97,0.053,3114,20.0,1000.0,14.87,0.506
596,Hutchinson Chapman and Roman,False,TN,New Michaelshire,E-commerce,2015,https://hutchinsonchapmanandroman.com,Necessary parent to color water hope generation.,15,hutchinson-chapman-and-roman,2023,USD,969727,291121,678606,800498,-121892,33227,-155119,9697,19394,-174513,106338,732496,36624,695872,,969727,1587.57,793.78,0.1099,3089,26.16,66350.84,1.6,0.6998
597,Byrd Kramer and Arnold,False,EG,Woodsberg,IoT,2017,https://byrdkramerandarnold.com,Act message choice call her save apply.,26,byrd-kramer-and-arnold,2023,USD,816677,192183,624494,314334,310160,12411,297749,8166,16333,281416,48734,539588,226543,313045,,816677,1016.4,4493.9,0.1286,3402,20.0,35772.73,1.36,0.7647
598,Fowler Wood and Waters,False,AU,Mannburgh,Cybersecurity,2022,https://fowlerwoodandwaters.com,Worry sometimes maybe every into walk thing sport figure.,19,fowler-wood-and-waters,2023,USD,772222,350470,421752,605099,-183347,1628,-184975,7722,15444,-200419,223821,775231,299706,475525,,772222,484.22,1598.51,0.001,3217,20.0,70338.79,3.18,0.5462
599,Meza Group,False,DE,Meganland,AI/ML,2015,https://mezagroup.com,Role war close arm sea.,20,meza-group,2023,EUR,2566671,1183443,1383228,1177032,206196,0,206196,25666,51333,154863,331008,1671667,810656,861011,,2566671,20.0,113.54,0.001,10694,20.0,84652.32,3.91,0.5389
600,Noble Stokes and Smith,False,IN,Rhodesberg,Mobility,2014,https://noblestokesandsmith.com,Marriage rate quality mother by add couple story account.,33,noble-stokes-and-smith,2023,USD,6358593,1490353,4868240,317929,4550311,5949,4544362,63585,127171,4417191,53628,3429638,416373,3013265,,6358593,928.34,2511.42,0.0516,26494,20.0,23002.33,2.33,0.7656
601,Park-Brady,False,CA,Lake Donna,Marketplaces,2022,https://park-brady.com,Range amount large collection us shake tough company happen card.,20,park-brady,2023,USD,875708,246572,629136,645705,-16569,29487,-46056,8757,17514,-63570,42199,496541,115764,380777,,875708,20.0,77.16,0.1102,896,81.36,68274.04,0.62,0.7184
602,Farley-Henderson,False,EG,Jacksonville,AgriTech,2020,https://farley-henderson.com,Trial economic much short brother federal family defense.,20,farley-henderson,2023,USD,687603,193350,494253,327820,166433,30451,135982,6876,13752,122230,53350,529486,26474,503012,,687603,20.0,53.61,0.001,2865,20.0,34097.85,1.56,0.7188
603,Welch Long and Leblanc,False,NG,South Patriciafort,AI/ML,2021,https://welchlongandleblanc.com,Green past forget government accept.,20,welch-long-and-leblanc,2023,USD,2511461,523318,1988143,1393047,595096,4720,590376,25114,50229,540147,89963,1411634,744003,667631,,2511461,20.0,35.18,0.093,1040,201.2,102745.2,0.88,0.7916
604,Lopez Gomez and Garcia,False,GB,Gonzalezhaven,EdTech,2012,https://lopezgomezandgarcia.com,Together improve tree according show economic likely hear hair throughout.,23,lopez-gomez-and-garcia,2023,USD,331559,74881,256678,300055,-43377,15412,-58789,3315,6631,-65420,12841,250860,118035,132825,27629.92,331559,669.83,669.83,0.0701,628,43.94,18126.52,0.71,0.7742
605,Cain Rodriguez and Gonzales,False,IN,Martinstad,SaaS,2023,https://cainrodriguezandgonzales.com,Accept third remember book expect card inside former all.,16,cain-rodriguez-and-gonzales,2023,USD,1519792,198771,1321021,994667,326354,0,326354,15197,30395,295959,19587,931885,104144,827741,126649.33,1519792,36.71,109.81,0.001,1843,68.69,101414.07,0.19,0.8692
606,Gonzalez Mendoza and Ortega,False,CA,Davidfort,AI/ML,2011,https://gonzalezmendozaandortega.com,Many race camera seem sister hundred rise score stay capital.,14,gonzalez-mendoza-and-ortega,2023,USD,635868,255818,380050,165017,215033,2165,212868,6358,12717,200151,76484,557311,199372,357939,,635868,2544.41,5473.56,0.0167,272,194.57,20156.51,3.79,0.5977
607,Sparks and Sons,False,ZA,West Vincent,AI/ML,2011,https://sparksandsons.com,Appear stop involve others account lose executive.,25,sparks-and-sons,2023,USD,434860,139215,295645,290944,4701,11167,-6466,4348,8697,-15163,69442,467557,122821,344736,,434860,20.0,10.0,0.0613,158,227.96,29292.71,2.37,0.6799
608,Hodges and Sons,False,IN,Lake William,Fintech,2013,https://hodgesandsons.com,Exactly boy enjoy red project investment listen.,22,hodges-and-sons,2023,USD,480454,211168,269286,138265,131021,0,131021,4804,9609,121412,162642,449481,118464,331017,,480454,20.0,76.82,0.1193,2001,20.0,11265.89,14.44,0.5605
609,Haynes PLC,False,IN,East Victoria,Mobility,2024,https://haynesplc.com,Pick chance build husband event court certainly adult current ten.,25,haynes-plc,2023,USD,276547,34953,241594,24730,216864,22071,194793,2765,5530,189263,15087,221873,94364,127509,,276547,82.94,157.86,0.0541,94,244.5,9754.73,1.55,0.8736
610,Russell-Torres,False,GB,East Matthew,Energy,2010,https://russell-torres.com,Article interview appear body hair wall represent east time.,12,russell-torres,2023,USD,1241074,469872,771202,137555,633647,0,633647,12410,24821,608826,42972,821295,41064,780231,,1241074,1740.76,4741.97,0.0171,772,133.82,1000.0,42.97,0.6214
611,Williams Inc,False,DE,Jasonfort,Mobility,2019,https://williamsinc.com,Training beyond continue way hair fight best.,18,williams-inc,2023,EUR,716009,340110,375899,436314,-60415,0,-60415,7160,14320,-74735,17796,569873,366494,203379,,716009,20.0,102.24,0.0894,2983,20.0,54641.04,0.33,0.525
612,Vega and Sons,False,US,Michaelstad,Energy,2009,https://vegaandsons.com,More he practice decide himself thought candidate sea build only.,19,vega-and-sons,2023,USD,617006,231709,385297,276055,109242,1522,107720,6170,12340,95380,117652,505335,202307,303028,,617006,180.1,104.43,0.0304,2570,20.0,22367.5,5.26,0.6245
613,Roth Lee and Griffin,False,TN,North Shellymouth,AI/ML,2019,https://rothleeandgriffin.com,Rise writer dark result analysis court nearly.,15,roth-lee-and-griffin,2023,USD,830447,228288,602159,595481,6678,12725,-6047,8304,16608,-22655,14733,599225,287494,311731,,830447,20.0,59.27,0.0176,3460,20.0,23901.75,0.62,0.7251
614,Snow-Malone,False,DE,Patriciamouth,Energy,2010,https://snow-malone.com,Response treat attack industry use mean against out recent can animal.,23,snow-malone,2023,EUR,764965,283472,481493,456511,24982,0,24982,7649,15299,9683,17264,543605,237826,305779,,764965,20.0,103.5,0.1338,249,255.55,39329.02,0.44,0.6294
615,Brown Compton and Lee,False,CA,Simpsonside,EdTech,2008,https://browncomptonandlee.com,Will close seek his single husband even contain civil design.,19,brown-compton-and-lee,2023,USD,225093,96338,128755,104356,24399,0,24399,2250,4501,19898,20902,286908,120819,166089,18757.75,225093,483.32,2079.88,0.001,1906,9.84,1000.0,20.9,0.572
616,Smith Mcfarland and Hunt,False,CA,Kevinbury,Fintech,2018,https://smithmcfarlandandhunt.com,Remain need commercial animal draw although challenge.,22,smith-mcfarland-and-hunt,2023,USD,215824,96385,119439,215306,-95867,22647,-118514,2158,4316,-122830,30150,181877,71501,110376,,215824,1801.31,3796.14,0.1058,146,123.17,22614.31,1.33,0.5534
617,Ho-Nelson,False,AU,Lake Tinaborough,HealthTech,2012,https://ho-nelson.com,Break possible plan win foot watch this enough card together.,19,ho-nelson,2023,USD,463258,222907,240351,350604,-110253,12077,-122330,4632,9265,-131595,13732,333738,56002,277736,38604.83,463258,166.96,530.57,0.0521,535,72.05,24709.09,0.56,0.5188
618,Nguyen-Brown,False,US,Port Michaelview,AgriTech,2023,https://nguyen-brown.com,Eight administration price test voice on.,19,nguyen-brown,2023,USD,102929,54778,48151,59350,-11199,0,-11199,1029,2058,-13257,10245,125998,45366,80632,,102929,509.09,1533.18,0.1819,146,58.62,34791.55,0.29,0.4678
619,Reese Reyes and Valdez,False,ZA,Port Scott,HealthTech,2023,https://reesereyesandvaldez.com,Environmental ok space send choose discussion risk happy.,18,reese-reyes-and-valdez,2023,USD,397239,80197,317042,42865,274177,1432,272745,3972,7944,264801,9479,384780,66121,318659,33103.25,397239,148.62,620.46,0.0295,591,55.95,56671.47,0.17,0.7981
620,Davis-White,False,EG,Port Michelle,IoT,2008,https://davis-white.com,Now wall Congress example financial those.,20,davis-white,2023,USD,181222,55241,125981,95869,30112,16677,13435,1812,3624,9811,36114,234663,78759,155904,,181222,846.62,881.01,0.0547,40,370.88,1000.0,36.11,0.6952
621,Mcdaniel-Lopez,False,FR,North Ronald,SaaS,2016,https://mcdaniel-lopez.com,Training wife beyond money risk space owner help again.,18,mcdaniel-lopez,2023,EUR,875893,385834,490059,628059,-138000,0,-138000,8758,17517,-155517,32338,504688,225756,278932,72991.08,875893,321.56,436.38,0.0158,716,101.83,47766.55,0.68,0.5595
622,Hines Ltd,False,DE,East Johnland,HealthTech,2024,https://hinesltd.com,Central physical add whom whatever blood save.,13,hines-ltd,2023,EUR,799191,273195,525996,296875,229121,26694,202427,7991,15983,186444,14772,571924,214291,357633,66599.25,799191,689.04,3266.52,0.0123,13319,5.0,1000.0,14.77,0.6582
623,Farrell-Miller,False,TN,South Kathleen,Fintech,2017,https://farrell-miller.com,Spring film look during myself environment myself again and.,19,farrell-miller,2023,USD,564778,258383,306395,384794,-78399,8373,-86772,5647,11295,-98067,55537,517153,177105,340048,,564778,20.0,10.0,0.001,212,221.62,31236.63,1.78,0.5425
624,Phillips Hunt and Copeland,False,DE,North Rhonda,AgriTech,2011,https://phillipshuntandcopeland.com,Dinner history government expert TV.,18,phillips-hunt-and-copeland,2023,EUR,354830,123846,230984,245917,-14933,0,-14933,3548,7096,-22029,25921,207665,112032,95633,,354830,819.53,3789.17,0.0548,1478,20.0,55632.5,0.47,0.651
625,Cruz Henson and Carson,False,US,South Gavinville,EdTech,2021,https://cruzhensonandcarson.com,Big what ground past brother type turn.,23,cruz-henson-and-carson,2023,USD,127435,56821,70614,52808,17806,0,17806,1274,2548,15258,1898,81835,24375,57460,10619.58,127435,675.38,3474.27,0.0822,312,33.97,7410.62,0.26,0.5541
626,Munoz and Sons,False,BR,Morenoburgh,IoT,2022,https://munozandsons.com,Change project feeling stage give billion trouble product usually.,13,munoz-and-sons,2023,USD,989176,411710,577466,337333,240133,17890,222243,9891,19783,202460,27957,686629,482242,204387,,989176,20.0,41.25,0.001,1037,79.45,23925.79,1.17,0.5838
627,Lindsey Mccormick and Hensley,False,FR,Port Diana,Fintech,2023,https://lindseymccormickandhensley.com,Challenge land someone with spring both into risk.,21,lindsey-mccormick-and-hensley,2023,EUR,7533750,3070078,4463672,3659707,803965,0,803965,75337,150675,653290,493283,4437719,1437500,3000219,,7533750,20.0,64.12,0.0796,31390,20.0,314638.17,1.57,0.5925
628,Davis and Sons,False,KE,Port Paul,AI/ML,2008,https://davisandsons.com,Management loss win own PM catch want TV.,18,davis-and-sons,2023,USD,790432,253836,536596,405612,130984,8677,122307,7904,15808,106499,225104,665664,46931,618733,,790432,748.92,3144.03,0.001,248,265.42,59664.56,3.77,0.6789
629,Barnes-Crawford,False,BR,Patelbury,AI/ML,2015,https://barnes-crawford.com,Base resource money since specific despite beautiful gun.,16,barnes-crawford,2023,USD,224708,76595,148113,74915,73198,0,73198,2247,4494,68704,5549,250774,123954,126820,,224708,20.0,62.49,0.001,146,127.43,24076.19,0.23,0.6591
630,Mcknight Inc,False,ZA,Angelaberg,HealthTech,2017,https://mcknightinc.com,Arrive glass support term standard.,17,mcknight-inc,2023,USD,338644,158155,180489,82039,98450,0,98450,3386,6772,91678,16900,246485,43072,203413,28220.33,338644,437.3,612.79,0.0769,336,83.91,6345.3,2.66,0.533
631,Stevens-Conley,False,TN,Sanchezbury,SaaS,2019,https://stevens-conley.com,Section bring receive central run.,17,stevens-conley,2023,USD,663415,265305,398110,246597,151513,0,151513,6634,13268,138245,27409,534228,26711,507517,55284.58,663415,488.45,3076.29,0.0113,605,91.37,41222.33,0.66,0.6001
632,Hanna Watson and Miles,False,DE,South Maryburgh,IoT,2021,https://hannawatsonandmiles.com,Chair center each actually store.,14,hanna-watson-and-miles,2023,EUR,375300,86404,288896,18765,270131,29474,240657,3753,7506,233151,9297,315331,41667,273664,,375300,929.84,2860.27,0.1355,100,312.21,25630.87,0.36,0.7698
633,Hernandez-White,False,GB,Lake Allison,Marketplaces,2010,https://hernandez-white.com,Like reveal know population actually born art.,11,hernandez-white,2023,USD,975388,123302,852086,267867,584219,26708,557511,9753,19507,538004,13289,637083,125413,511670,,975388,1758.1,6441.96,0.0823,460,176.63,15906.57,0.84,0.8736
634,Johnson Potter and Gordon,False,NG,South Marissamouth,E-commerce,2010,https://johnsonpotterandgordon.com,Represent election occur fill dinner use even begin help week.,20,johnson-potter-and-gordon,2023,USD,264160,94382,169778,246083,-76305,6625,-82930,2641,5283,-88213,42934,186404,53434,132970,,264160,436.99,218.5,0.0538,1100,20.0,29918.89,1.44,0.6427
635,Lewis Montgomery and Robinson,False,NG,Port Julie,AI/ML,2024,https://lewismontgomeryandrobinson.com,Painting baby realize local present if herself area he interest.,26,lewis-montgomery-and-robinson,2023,USD,2568845,874019,1694826,1859490,-164664,3298,-167962,25688,51376,-219338,63816,1472033,399583,1072450,,2568845,20.0,57.64,0.1426,1456,146.93,119587.71,0.53,0.6598
636,Rodriguez-Miller,False,AU,Anthonyport,AI/ML,2008,https://rodriguez-miller.com,Must assume others series finally necessary.,20,rodriguez-miller,2023,USD,616041,138409,477632,30802,446830,11805,435025,6160,12320,422705,14468,379521,18976,360545,,616041,539.16,950.89,0.001,338,151.72,17594.79,0.82,0.7753
637,Hickman Allen and Miller,False,TN,New Valeriefort,Mobility,2009,https://hickmanallenandmiller.com,Answer behavior final wonder seem.,27,hickman-allen-and-miller,2023,USD,5352927,497973,4854954,1472589,3382365,812,3381553,53529,107058,3274495,1146527,4002661,200133,3802528,,5352927,825.97,421.66,0.0839,1617,275.85,104441.06,10.98,0.907
638,Porter-Edwards,False,BR,Swansonberg,Energy,2019,https://porter-edwards.com,Former to me maybe simple.,15,porter-edwards,2023,USD,3283611,1123275,2160336,2482971,-322635,0,-322635,32836,65672,-388307,221866,1971016,538409,1432607,,3283611,2468.78,9475.43,0.0807,13681,20.0,229669.79,0.97,0.6579
639,Matthews Group,False,IN,Williston,Cybersecurity,2008,https://matthewsgroup.com,Claim radio bad personal well discuss democratic.,21,matthews-group,2023,USD,115008,29643,85365,38555,46810,16634,30176,1150,2300,27876,12444,231181,73200,157981,,115008,2205.22,4304.67,0.1574,53,180.39,4783.18,2.6,0.7423
640,Pena Mack and Martin,False,CA,Sethberg,Fintech,2019,https://penamackandmartin.com,Fact perhaps vote always require raise dream young.,19,pena-mack-and-martin,2023,USD,932851,241853,690998,224728,466270,0,466270,9328,18657,447613,272770,813015,292554,520461,,932851,20.0,103.47,0.001,1011,76.85,1000.0,272.77,0.7407
641,Jones Hernandez and Burton,False,DE,Davistown,Cybersecurity,2011,https://joneshernandezandburton.com,Short finally test something time material.,22,jones-hernandez-and-burton,2023,EUR,575326,250175,325151,218195,106956,26055,80901,5753,11506,69395,47670,387377,274377,113000,,575326,2713.33,12448.47,0.0352,2397,20.0,13000.41,3.67,0.5652
642,Edwards-Villa,False,AU,North Joshua,IoT,2018,https://edwards-villa.com,Government author represent leave worry without shake kind.,21,edwards-villa,2023,USD,480395,142582,337813,67397,270416,28922,241494,4803,9607,231887,55557,332609,193193,139416,,480395,1069.1,1499.02,0.001,2001,20.0,16548.41,3.36,0.7032
643,Case PLC,False,GB,Williamsport,SaaS,2019,https://caseplc.com,Important people quite kid mention person finish base.,19,case-plc,2023,USD,243440,98493,144947,53363,91584,15732,75852,2434,4868,70984,38498,223521,93012,130509,20286.67,243440,333.7,1617.45,0.001,347,58.3,1000.0,38.5,0.5954
644,Hunter-Baker,False,NG,New Tiffanyton,E-commerce,2013,https://hunter-baker.com,Record night choice black heart now take.,21,hunter-baker,2023,USD,987011,448682,538329,524885,13444,0,13444,9870,19740,-6296,196190,737496,291625,445871,,987011,840.21,1913.19,0.0612,744,110.41,54865.26,3.58,0.5454
645,Price Group,False,AU,West Stevenside,Marketplaces,2022,https://pricegroup.com,Board Congress board where however item husband ask garden.,28,price-group,2023,USD,745602,274977,470625,37280,433345,0,433345,7456,14912,418433,11908,423717,166633,257084,,745602,20.0,10.0,0.0819,213,291.04,39886.22,0.3,0.6312
646,Tucker Park and Alvarez,False,ZA,Shawnside,Mobility,2013,https://tuckerparkandalvarez.com,We certainly degree nothing write similar.,28,tucker-park-and-alvarez,2023,USD,1817093,944490,872603,420566,452037,2763,449274,18170,36341,412933,57775,1017855,458511,559344,,1817093,606.05,3797.24,0.001,5992,25.27,78778.02,0.73,0.4802
647,Mayer LLC,False,AU,Irwinborough,HealthTech,2010,https://mayerllc.com,Deep age serve institution edge.,19,mayer-llc,2023,USD,377015,119628,257387,89644,167743,0,167743,3770,7540,160203,5753,251656,120495,131161,31417.92,377015,10.0,10.0,0.0372,574,54.72,2814.49,2.04,0.6827
648,Miller Inc,False,ZA,Richardport,Mobility,2009,https://millerinc.com,The modern prove else store begin top garden send.,9,miller-inc,2023,USD,1924367,113233,1811134,1261630,549504,0,549504,19243,38487,511017,64612,1076933,445649,631284,,1924367,20.0,10.0,0.1278,8018,20.0,101699.26,0.64,0.9412
649,Gonzalez Group,False,IN,Alvarezburgh,EdTech,2009,https://gonzalezgroup.com,Great realize home act situation others back property pattern.,23,gonzalez-group,2023,USD,329485,183246,146239,163533,-17294,0,-17294,3294,6589,-23883,18207,276834,125540,151294,27457.08,329485,176.93,408.26,0.001,458,59.82,9547.21,1.91,0.4438
650,Beck-Colon,False,AU,Alexismouth,EdTech,2009,https://beck-colon.com,Material first society purpose enjoy reveal.,27,beck-colon,2023,USD,421238,204583,216655,178602,38053,3062,34991,4212,8424,26567,37359,319957,216203,103754,35103.17,421238,680.17,2183.64,0.0141,611,57.39,1000.0,37.36,0.5143
651,Harding-Mathews,False,CA,Fowlershire,AgriTech,2024,https://harding-mathews.com,Already second could recent similar.,22,harding-mathews,2023,USD,603147,248338,354809,102985,251824,0,251824,6031,12062,239762,45680,358060,163215,194845,,603147,871.46,435.73,0.0323,619,81.09,1000.0,45.68,0.5883
652,Gray Bailey and Farley,False,TN,West Lisatown,AI/ML,2023,https://graybaileyandfarley.com,To maybe test record power lay improve.,24,gray-bailey-and-farley,2023,USD,3240928,1049381,2191547,1228729,962818,9219,953599,32409,64818,888781,78041,1758201,87910,1670291,,3240928,450.59,1103.19,0.001,5497,49.13,66081.1,1.18,0.6762
653,Clayton-Simmons,False,IN,Danielburgh,SaaS,2014,https://clayton-simmons.com,Into computer organization myself high suddenly read join exist.,25,clayton-simmons,2023,USD,3097445,1525570,1571875,762041,809834,0,809834,30974,61948,747886,254483,1937962,924446,1013516,258120.42,3097445,216.62,835.54,0.001,12067,21.39,67345.7,3.78,0.5075
654,Pace Bullock and Garcia,False,IN,Port Maryland,E-commerce,2009,https://pacebullockandgarcia.com,Pattern in market seem.,21,pace-bullock-and-garcia,2023,USD,979812,347497,632315,472817,159498,40272,119226,9798,19596,99630,116130,685275,269115,416160,,979812,591.55,2413.65,0.085,4082,20.0,49644.31,2.34,0.6453
655,Garcia Wallace and Perkins,False,BR,Lake Kellychester,E-commerce,2016,https://garciawallaceandperkins.com,Development lawyer high crime light buy.,18,garcia-wallace-and-perkins,2023,USD,311319,126308,185011,264882,-79871,14244,-94115,3113,6226,-100341,7768,348532,191329,157203,,311319,20.0,116.81,0.0796,752,34.48,7940.12,0.98,0.5943
656,Gutierrez-Hoover,False,FR,Smithstad,E-commerce,2021,https://gutierrez-hoover.com,Medical environment probably film total training pull.,14,gutierrez-hoover,2023,EUR,1719922,531024,1188898,826190,362708,0,362708,17199,34398,328310,167903,1187368,391784,795584,,1719922,263.84,972.68,0.0048,5542,25.86,65537.75,2.56,0.6913
657,Mccullough Group,False,TN,North Anthonystad,Cybersecurity,2022,https://mcculloughgroup.com,Star outside friend where year drop wind cover popular stock.,20,mccullough-group,2023,USD,476127,106800,369327,63658,305669,37542,268127,4761,9522,258605,65233,358108,32972,325136,,476127,777.61,7231.23,0.1053,1983,20.0,3206.84,20.34,0.7757
658,Patterson Ayers and Myers,False,TN,South Rebecca,E-commerce,2013,https://pattersonayersandmyers.com,Citizen discuss report call brother officer hot several true study.,17,patterson-ayers-and-myers,2023,USD,2320125,790559,1529566,1094972,434594,0,434594,23201,46402,388192,85384,1277232,421223,856009,,2320125,1253.44,626.72,0.0578,1411,136.93,109145.84,0.78,0.6593
659,Fry and Sons,False,EG,North Anthonytown,Cybersecurity,2023,https://fryandsons.com,Show check peace myself win occur agent safe work play sing.,18,fry-and-sons,2023,USD,748294,253639,494655,371537,123118,31051,92067,7482,14965,77102,11155,441932,85182,356750,,748294,20.0,94.53,0.0654,2677,23.29,62938.39,0.18,0.661
660,Allen and Sons,False,CA,Jamesbury,AI/ML,2016,https://allenandsons.com,Side process ever various physical point often billion.,24,allen-and-sons,2023,USD,1080364,450005,630359,382399,247960,0,247960,10803,21607,226353,49878,782471,362249,420222,,1080364,20.0,27.19,0.0388,494,182.14,37507.31,1.33,0.5835
661,Ho-Martinez,False,AU,West Jose,Fintech,2021,https://ho-martinez.com,Behavior management guess stuff hospital make.,30,ho-martinez,2023,USD,5865004,1695420,4169584,293250,3876334,21518,3854816,58650,117300,3737516,1578674,4672606,2002462,2670144,,5865004,20.0,39.7,0.0944,24437,20.0,1000.0,1578.67,0.7109
662,Gutierrez Group,False,FR,East Gracefurt,Energy,2013,https://gutierrezgroup.com,Plant late claim federal tough process piece talk.,14,gutierrez-group,2023,EUR,590558,267569,322989,461956,-138967,0,-138967,5905,11811,-150778,10365,362611,125704,236907,,590558,906.48,4186.14,0.0345,359,136.73,35657.63,0.29,0.5469
663,Daugherty LLC,False,NG,Cooleyside,AgriTech,2018,https://daughertyllc.com,Citizen score unit cover.,23,daugherty-llc,2023,USD,408890,98549,310341,235970,74371,12673,61698,4088,8177,53521,7581,248394,105945,142449,,408890,547.86,2008.19,0.078,447,76.11,24417.02,0.31,0.759
664,Herrera PLC,False,FR,East Michelle,Fintech,2018,https://herreraplc.com,Together ahead catch base reality.,17,herrera-plc,2023,EUR,403593,127588,276005,287638,-11633,0,-11633,4035,8071,-19704,14115,254716,133925,120791,,403593,20.0,59.31,0.1092,190,176.8,19676.6,0.72,0.6839
665,Adams Group,False,BR,North Michael,AgriTech,2017,https://adamsgroup.com,Present level speak job watch two economic cup suffer response.,21,adams-group,2023,USD,1397425,310116,1087309,574810,512499,3797,508702,13974,27948,480754,128102,893984,180835,713149,,1397425,1683.62,7530.54,0.0181,3587,32.46,64069.06,2.0,0.7781
666,Garcia-Mcguire,False,EG,Gabrielborough,IoT,2021,https://garcia-mcguire.com,Item land others even five blue him current good.,19,garcia-mcguire,2023,USD,533952,88280,445672,215349,230323,0,230323,5339,10679,219644,6968,280360,88419,191941,,533952,20.0,112.16,0.0932,469,94.85,1000.0,6.97,0.8347
667,Weiss Cole and Preston,False,GB,Brendaport,Cybersecurity,2022,https://weisscoleandpreston.com,Step population whole good air conference follow so group authority.,18,weiss-cole-and-preston,2023,USD,7022922,1747629,5275293,3824905,1450388,0,1450388,70229,140458,1309930,241059,3818607,190930,3627677,,7022922,20.0,51.9,0.099,7194,81.35,324845.1,0.74,0.7512
668,Watson Thomas and Edwards,False,CA,West Haleymouth,Mobility,2009,https://watsonthomasandedwards.com,Let somebody together no history own.,15,watson-thomas-and-edwards,2023,USD,2810273,140513,2669760,1369171,1300589,721,1299868,28102,56205,1243663,52897,1494408,681544,812864,,2810273,608.68,1111.21,0.1399,1078,217.07,144704.42,0.37,0.95
669,Robinson Hoffman and Moran,False,ZA,New Patriciachester,E-commerce,2021,https://robinsonhoffmanandmoran.com,Fish floor culture sort material wrong instead buy commercial.,17,robinson-hoffman-and-moran,2023,USD,443626,200441,243185,403161,-159976,0,-159976,4436,8872,-168848,26272,337873,67398,270475,,443626,310.77,1039.27,0.0523,1848,20.0,60199.89,0.44,0.5482
670,Garza-Young,False,IN,West Andrewshire,Marketplaces,2009,https://garza-young.com,Treatment expect success idea.,20,garza-young,2023,USD,612078,163502,448576,423671,24905,0,24905,6120,12241,12664,39108,379517,196771,182746,,612078,20.0,127.01,0.0208,146,348.21,63512.44,0.62,0.7329
671,Hull Williams and Newman,False,FR,South Codychester,Marketplaces,2020,https://hullwilliamsandnewman.com,Ever send hundred news finish partner hotel.,25,hull-williams-and-newman,2023,EUR,822830,111714,711116,764316,-53200,0,-53200,8228,16456,-69656,11558,513000,113943,399057,,822830,308.04,154.02,0.1076,879,77.98,61650.94,0.19,0.8642
672,Riggs Snyder and Davidson,False,CA,Port Nathanielville,AI/ML,2013,https://riggssnyderanddavidson.com,Difference stay catch year technology.,14,riggs-snyder-and-davidson,2023,USD,930937,376808,554129,333490,220639,0,220639,9309,18618,202021,82591,571463,89391,482072,,930937,20.0,38.22,0.0538,632,122.66,12458.99,6.63,0.5952
673,Graham Jackson and Lee,False,US,Lisaside,HealthTech,2022,https://grahamjacksonandlee.com,Various test employee size.,26,graham-jackson-and-lee,2023,USD,1204752,197940,1006812,565987,440825,8148,432677,12047,24095,408582,41155,814771,336225,478546,100396.0,1204752,220.58,220.58,0.0098,4193,23.94,53983.22,0.76,0.8357
674,Williams LLC,False,US,West Markfurt,HealthTech,2010,https://williamsllc.com,Recognize understand on build floor challenge once.,18,williams-llc,2023,USD,1562364,461159,1101205,325252,775953,0,775953,15623,31247,744706,69897,989320,308156,681164,130197.0,1562364,10.0,32.56,0.0662,1760,73.97,17421.07,4.01,0.7048
675,Walsh-Barnett,False,DE,New Timothy,Marketplaces,2019,https://walsh-barnett.com,With focus room difficult enough fast bar next their.,19,walsh-barnett,2023,EUR,2489836,881470,1608366,573703,1034663,33264,1001399,24898,49796,951603,37254,1448563,276393,1172170,,2489836,832.01,4263.5,0.0338,644,321.77,48094.33,0.77,0.646
676,Holland Foley and Neal,False,CA,South Briantown,Energy,2009,https://hollandfoleyandneal.com,Life his maintain future sport seven.,21,holland-foley-and-neal,2023,USD,3405238,1157846,2247392,2704895,-457503,0,-457503,34052,68104,-525607,41062,1887173,687541,1199632,,3405238,1066.62,4475.87,0.0979,1582,179.35,257520.14,0.16,0.66
677,Garrison Hodges and Collins,False,KE,Rioshaven,HealthTech,2022,https://garrisonhodgesandcollins.com,Trial despite hair window test.,21,garrison-hodges-and-collins,2023,USD,708715,257799,450916,270109,180807,27351,153456,7087,14174,139282,62791,494321,135337,358984,59059.58,708715,10.0,42.07,0.0275,646,91.37,24351.71,2.58,0.6362
678,Harris Ross and Jones,False,CA,Martinport,E-commerce,2022,https://harrisrossandjones.com,Possible challenge then seat drive thus cost agreement product laugh.,23,harris-ross-and-jones,2023,USD,3127805,434062,2693743,1916360,777383,34527,742856,31278,62556,680300,2713,1706992,704244,1002748,,3127805,1518.28,8171.91,0.0229,1543,168.85,157656.54,0.02,0.8612
679,Wilson-Pierce,False,AU,Ryanberg,Fintech,2012,https://wilson-pierce.com,Maybe meet apply evening best possible rule institution.,24,wilson-pierce,2023,USD,2793775,956406,1837369,381334,1456035,0,1456035,27937,55875,1400160,183469,1692885,708379,984506,,2793775,20.0,71.17,0.042,1494,155.73,24075.92,7.62,0.6577
680,Lopez-Thompson,False,NG,Alyssafort,E-commerce,2020,https://lopez-thompson.com,Item race position where detail apply along entire assume big.,26,lopez-thompson,2023,USD,443695,167622,276073,227247,48826,0,48826,4436,8873,39953,71791,360413,111485,248928,,443695,1677.94,2304.74,0.0939,239,154.22,7558.32,9.5,0.6222
681,Andrade Ltd,False,CA,Myersville,Marketplaces,2016,https://andradeltd.com,Safe they environmental day size girl explain.,12,andrade-ltd,2023,USD,2403173,1392593,1010580,120158,890422,0,890422,24031,48063,842359,11456,1272961,63648,1209313,,2403173,677.22,665.8,0.001,1149,174.17,40761.1,0.28,0.4205
682,Roberts Smith and Lopez,False,DE,Stevensonbury,Fintech,2008,https://robertssmithandlopez.com,Fire attorney cost tonight center actually.,20,roberts-smith-and-lopez,2023,EUR,4284573,2355242,1929331,1418126,511205,0,511205,42845,85691,425514,161464,2364012,1772111,591901,,4284573,20.0,25.99,0.0509,2635,135.49,70217.2,2.3,0.4503
683,Patterson-Smith,False,ZA,Nicoleburgh,HealthTech,2023,https://patterson-smith.com,Order wide on major.,30,patterson-smith,2023,USD,452560,152943,299617,184735,114882,0,114882,4525,9051,105831,14449,431863,253054,178809,37713.33,452560,395.67,2348.79,0.001,503,74.91,25575.51,0.56,0.662
684,Kennedy Inc,False,NG,New Erinport,Energy,2011,https://kennedyinc.com,Moment cold chair behind fight save laugh.,14,kennedy-inc,2023,USD,3375717,897382,2478335,648132,1830203,18315,1811888,33757,67514,1744374,1653308,3374534,1607050,1767484,,3375717,1083.92,1961.94,0.0662,14065,20.0,44364.82,37.27,0.7342
685,Bell Gardner and Alvarado,False,IN,Michaeltown,AgriTech,2022,https://bellgardnerandalvarado.com,Feeling free military professional tend such machine establish.,13,bell-gardner-and-alvarado,2023,USD,151403,62876,88527,94807,-6280,0,-6280,1514,3028,-9308,2175,212474,179381,33093,,151403,20.0,75.34,0.001,197,64.04,34496.47,0.06,0.5847
686,Chandler Smith and Irwin,False,DE,Lake Virginia,IoT,2017,https://chandlersmithandirwin.com,Marriage each scientist wind grow season create western.,26,chandler-smith-and-irwin,2023,EUR,132808,33629,99179,115450,-16271,0,-16271,1328,2656,-18927,2685,208919,75498,133421,,132808,20.0,79.45,0.0905,553,20.0,25353.69,0.11,0.7468
687,Rodriguez Hill and Sims,False,ZA,Archerhaven,Mobility,2014,https://rodriguezhillandsims.com,Enter quickly thousand hospital individual yes.,11,rodriguez-hill-and-sims,2023,USD,1246519,627029,619490,370664,248826,0,248826,12465,24930,223896,4654,771997,255831,516166,,1246519,20.0,94.67,0.1232,5193,20.0,57845.82,0.08,0.497
688,Lee-Riley,False,FR,Maryville,HealthTech,2010,https://lee-riley.com,Somebody note society get body across until chair race.,17,lee-riley,2023,EUR,1813333,240587,1572746,551617,1021129,6742,1014387,18133,36266,978121,33095,1042973,686181,356792,151111.08,1813333,403.67,1719.18,0.0185,4593,32.9,62783.29,0.53,0.8673
689,Levy Hanson and Beck,False,EG,Tommyland,HealthTech,2022,https://levyhansonandbeck.com,Administration American executive or apply figure involve.,20,levy-hanson-and-beck,2023,USD,1008513,379736,628777,258328,370449,46192,324257,10085,20170,304087,178171,788053,431918,356135,84042.75,1008513,10.0,42.6,0.001,4285,19.61,29952.28,5.95,0.6235
690,Flowers Williams and Taylor,False,FR,Kristenhaven,Marketplaces,2018,https://flowerswilliamsandtaylor.com,Choice beat establish you culture one ball despite list great.,17,flowers-williams-and-taylor,2023,EUR,1500023,704140,795883,1026528,-230645,21603,-252248,15000,30000,-282248,108890,968360,48418,919942,,1500023,1279.05,5087.69,0.0437,386,323.71,58799.15,1.85,0.5306
691,Walsh Henderson and Rasmussen,False,BR,West Samanthaport,E-commerce,2010,https://walshhendersonandrasmussen.com,Nor quickly follow official raise current.,26,walsh-henderson-and-rasmussen,2023,USD,333109,113800,219309,51336,167973,0,167973,3331,6662,161311,4306,199747,11674,188073,,333109,1127.13,598.25,0.055,228,121.48,24853.46,0.17,0.6584
692,Butler and Sons,False,NG,Kevinport,AI/ML,2017,https://butlerandsons.com,Until leave contain site street benefit money reason mean rate.,33,butler-and-sons,2023,USD,2330670,704680,1625990,1948655,-322665,31110,-353775,23306,46613,-400388,148325,1357384,82659,1274725,,2330670,20.0,102.98,0.0613,1354,143.43,174523.16,0.85,0.6976
693,Mcdonald-Patterson,False,IN,Alimouth,HealthTech,2013,https://mcdonald-patterson.com,Tree ago short because cell.,19,mcdonald-patterson,2023,USD,477027,216858,260169,275425,-15256,1253,-16509,4770,9540,-26049,95899,337077,103668,233409,39752.25,477027,314.95,1907.12,0.042,539,73.7,14088.35,6.81,0.5454
694,Buchanan-Carpenter,False,AU,Davidside,E-commerce,2024,https://buchanan-carpenter.com,There apply suddenly call prove leg several military stuff be.,21,buchanan-carpenter,2023,USD,710207,327893,382314,35510,346804,31662,315142,7102,14204,300938,8198,545415,171216,374199,,710207,888.73,2742.44,0.0552,348,169.8,7867.29,1.04,0.5383
695,Gallegos-Santos,False,DE,Brookeport,Fintech,2014,https://gallegos-santos.com,Loss former article science purpose school apply day century science.,19,gallegos-santos,2023,EUR,656293,297846,358447,477109,-118662,13544,-132206,6562,13125,-145331,27296,413970,299015,114955,,656293,647.24,3785.0,0.1207,1039,52.59,39175.63,0.7,0.5462
696,Taylor-Jacobson,False,AU,West Courtney,HealthTech,2015,https://taylor-jacobson.com,South perhaps customer attack.,18,taylor-jacobson,2023,USD,906870,282245,624625,710888,-86263,24504,-110767,9068,18137,-128904,65597,558129,79958,478171,75572.5,906870,178.95,914.33,0.0649,1611,46.89,92922.81,0.71,0.6888
697,Munoz Inc,False,AU,East Jamesfort,Mobility,2008,https://munozinc.com,Strategy kitchen argue business identify.,18,munoz-inc,2023,USD,804338,128184,676154,911833,-235679,0,-235679,8043,16086,-251765,70677,636664,341769,294895,,804338,20.0,90.97,0.0854,221,302.4,23170.37,3.05,0.8406
698,Wilkins PLC,False,CA,Lorrainemouth,AI/ML,2019,https://wilkinsplc.com,But chair against center seat drive memory record customer lose face.,21,wilkins-plc,2023,USD,425183,166050,259133,229378,29755,0,29755,4251,8503,21252,17322,420598,207374,213224,,425183,20.0,51.71,0.0812,671,52.8,55223.17,0.31,0.6095
699,Haley Group,False,EG,Elizabethfurt,AI/ML,2012,https://haleygroup.com,Recently blue indicate interesting agreement lead nor action.,12,haley-group,2023,USD,306198,91495,214703,107980,106723,32116,74607,3061,6123,68484,14784,244640,41230,203410,,306198,20.0,95.11,0.0083,1275,20.0,1000.0,14.78,0.7012
700,Johnson-Santos,False,KE,Williamsstad,Fintech,2010,https://johnson-santos.com,Life rich everybody word group task.,13,johnson-santos,2023,USD,808426,238911,569515,549109,20406,10130,10276,8084,16168,-5892,24136,532571,136926,395645,,808426,574.49,287.24,0.1018,333,201.71,43180.99,0.56,0.7045
701,Clark Orr and Warren,False,IN,East Dianastad,Energy,2023,https://clarkorrandwarren.com,Fund resource skill everything several field hour trouble population heavy.,13,clark-orr-and-warren,2023,USD,1075771,406164,669607,218494,451113,0,451113,10757,21515,429598,18552,594176,253323,340853,,1075771,337.07,1651.74,0.0802,1633,54.87,1000.0,18.55,0.6224
702,Obrien-White,False,NG,Davidmouth,Energy,2021,https://obrien-white.com,Western give pay identify and system city benefit blood various.,13,obrien-white,2023,USD,2216903,406009,1810894,110845,1700049,0,1700049,22169,44338,1655711,105017,1377026,376855,1000171,,2216903,261.16,1000.66,0.0187,978,188.82,13835.57,7.59,0.8169
703,Morris-Hall,False,KE,North Rachel,Fintech,2012,https://morris-hall.com,Rock himself wind two artist economy.,16,morris-hall,2023,USD,2424302,863741,1560561,1724563,-164002,971,-164973,24243,48486,-213459,177471,1520182,519717,1000465,,2424302,133.35,291.96,0.0743,1061,190.34,130605.46,1.36,0.6437
704,Bradford Inc,False,CA,Hinestown,Marketplaces,2010,https://bradfordinc.com,Fly recognize help writer off current.,25,bradford-inc,2023,USD,831016,274798,556218,230070,326148,27106,299042,8310,16620,282422,52797,471356,100416,370940,,831016,729.88,4490.47,0.001,780,88.69,9018.62,5.85,0.6693
705,Henry-Shelton,False,EG,East Judy,Mobility,2024,https://henry-shelton.com,Sport speak court old pick protect data special throw.,20,henry-shelton,2023,USD,1277002,690724,586278,613163,-26885,25880,-52765,12770,25540,-78305,114477,878001,230870,647131,,1277002,20.0,35.15,0.1557,3814,27.9,80639.84,1.42,0.4591
706,Schroeder-Carroll,False,CA,West Jacobhaven,HealthTech,2013,https://schroeder-carroll.com,Couple debate still may ground tonight table soon keep.,16,schroeder-carroll,2023,USD,1511636,594998,916638,1515086,-598448,10777,-609225,15116,30232,-639457,125717,1044140,653119,391021,125969.67,1511636,10.0,36.56,0.0478,2434,51.75,127951.77,0.98,0.6064
707,Bennett Jones and Miller,False,AU,Craigfort,HealthTech,2021,https://bennettjonesandmiller.com,Anything music against start face stock hospital.,24,bennett-jones-and-miller,2023,USD,1350749,504927,845822,67537,778285,0,778285,13507,27014,751271,45060,888240,44412,843828,112562.42,1350749,53.93,304.97,0.0286,22512,5.0,23672.49,1.9,0.6262
708,Jones-Savage,False,NG,Charlesshire,SaaS,2011,https://jones-savage.com,Table use matter human arm recently book.,19,jones-savage,2023,USD,3074166,1105944,1968222,1044629,923593,0,923593,30741,61483,862110,310022,2006360,621696,1384664,256180.5,3074166,508.88,4053.2,0.0586,7577,33.81,130488.47,2.38,0.6402
709,Giles-Mercer,False,NG,North Matthewview,HealthTech,2017,https://giles-mercer.com,Free share cause natural safe under.,17,giles-mercer,2023,USD,274393,110583,163810,135522,28288,1960,26328,2743,5487,20841,30817,184161,109845,74316,22866.08,274393,10.0,17.34,0.0602,530,43.14,7185.41,4.29,0.597
710,Gaines Brown and Snyder,False,GB,West Tinachester,HealthTech,2018,https://gainesbrownandsnyder.com,School upon thought long can rich bit market different go.,16,gaines-brown-and-snyder,2023,USD,2254777,665544,1589233,1878182,-288949,22779,-311728,22547,45095,-356823,65017,1314485,411777,902708,187898.08,2254777,884.08,2238.88,0.0018,2959,63.48,137586.78,0.47,0.7048
711,Turner-Horn,False,ZA,North Sarah,EdTech,2019,https://turner-horn.com,Similar specific move team radio.,14,turner-horn,2023,USD,1200803,318285,882518,285150,597368,9619,587749,12008,24016,563733,81714,854540,482134,372406,100066.92,1200803,121.29,429.08,0.001,907,110.26,38244.25,2.14,0.7349
712,Smith Olson and Hughes,False,NG,Dominguezchester,AgriTech,2010,https://smitholsonandhughes.com,Near break brother past tough goal gas truth draw.,23,smith-olson-and-hughes,2023,USD,646211,180644,465567,391806,73761,9472,64289,6462,12924,51365,4262,332533,44425,288108,,646211,1573.15,786.58,0.001,907,59.36,38036.62,0.11,0.7205
713,Chapman and Sons,False,IN,Burgessside,EdTech,2016,https://chapmanandsons.com,Animal soon their economic arm arm just executive fire own.,18,chapman-and-sons,2023,USD,577313,242309,335004,28865,306139,20970,285169,5773,11546,273623,69356,406515,116931,289584,48109.42,577313,219.02,720.6,0.1038,1105,43.53,1000.0,69.36,0.5803
714,Bolton and Sons,False,GB,Mendozaville,Marketplaces,2017,https://boltonandsons.com,Baby voice day relate spend.,26,bolton-and-sons,2023,USD,426421,112126,314295,176219,138076,24985,113091,4264,8528,104563,61221,402975,206146,196829,,426421,402.2,1610.34,0.0751,372,95.32,1000.0,61.22,0.7371
715,Wallace LLC,False,KE,Kimberlyport,AI/ML,2010,https://wallacellc.com,Money environment recently me approach too relationship.,23,wallace-llc,2023,USD,1304878,821652,483226,578708,-95482,27722,-123204,13048,26097,-149301,111861,894385,656736,237649,,1304878,20.0,56.95,0.1248,1184,91.82,36003.97,3.11,0.3703
716,Tucker Miller and Barr,False,NG,West Judy,Marketplaces,2013,https://tuckermillerandbarr.com,But right small along dog key.,21,tucker-miller-and-barr,2023,USD,563647,215165,348482,262617,85865,663,85202,5636,11272,73930,21029,350304,129014,221290,,563647,856.98,6513.43,0.0087,916,51.24,29721.35,0.71,0.6183
717,Benton-Smith,False,KE,West Joshuafurt,IoT,2012,https://benton-smith.com,Still be everything particular manager television his.,26,benton-smith,2023,USD,720272,189306,530966,114333,416633,17209,399424,7202,14405,385019,12183,432076,253519,178557,,720272,471.44,1057.17,0.001,629,95.29,2215.53,5.5,0.7372
718,Walker Group,False,GB,Lake Ryan,Marketplaces,2018,https://walkergroup.com,Produce all several visit travel.,12,walker-group,2023,USD,3069802,1292406,1777396,2272969,-495573,0,-495573,30698,61396,-556969,198213,1793422,785520,1007902,,3069802,527.71,2095.11,0.0852,1060,241.28,171905.17,1.15,0.579
719,Livingston-Solomon,False,KE,Port Anthony,SaaS,2008,https://livingston-solomon.com,Its into role save arm body hold return question teach visit.,16,livingston-solomon,2023,USD,552894,269524,283370,369199,-85829,0,-85829,5528,11057,-96886,152204,501450,44108,457342,46074.5,552894,137.73,544.7,0.0597,9214,5.0,14140.46,10.76,0.5125
720,Coleman-Ball,False,FR,Franciscofurt,SaaS,2016,https://coleman-ball.com,Second under car address son week beat economic myself.,21,coleman-ball,2023,EUR,1201432,528217,673215,609358,63857,5806,58051,12014,24028,34023,10115,660023,469827,190196,100119.33,1201432,10.0,10.0,0.0292,5865,17.07,48227.42,0.21,0.5603
721,Duncan-Johnson,False,BR,Michaelview,EdTech,2021,https://duncan-johnson.com,Activity fill produce structure summer kitchen admit across already grow.,19,duncan-johnson,2023,USD,235607,87910,147697,138835,8862,0,8862,2356,4712,4150,32243,155508,95055,60453,19633.92,235607,355.03,2605.14,0.0063,227,86.28,31070.27,1.04,0.6269
722,Richard Robinson and Brown,False,KE,West Pennyside,Marketplaces,2008,https://richardrobinsonandbrown.com,Well key election skill employee manager dinner company.,29,richard-robinson-and-brown,2023,USD,478422,178563,299859,148588,151271,2159,149112,4784,9568,139544,29557,282136,122916,159220,,478422,875.53,1661.77,0.0238,1993,20.0,20479.65,1.44,0.6268
723,Douglas Hall and Pena,False,EG,Lake William,Marketplaces,2017,https://douglashallandpena.com,Oil among response article research else either question tax.,19,douglas-hall-and-pena,2023,USD,2022774,358211,1664563,976364,688199,0,688199,20227,40455,647744,134088,1324779,385164,939615,,2022774,46.67,148.39,0.0798,608,276.87,100489.99,1.33,0.8229
724,Fernandez-Williams,False,BR,West Daniel,AgriTech,2023,https://fernandez-williams.com,Kitchen memory down for he state indeed politics then.,13,fernandez-williams,2023,USD,1136218,136721,999497,1091255,-91758,12219,-103977,11362,22724,-126701,120486,708268,163549,544719,,1136218,1441.04,720.52,0.0634,649,145.74,57330.33,2.1,0.8797
725,Johnson PLC,False,DE,Matthewchester,Marketplaces,2020,https://johnsonplc.com,Likely wind perform civil and us treatment agent.,20,johnson-plc,2023,EUR,991740,124161,867579,321201,546378,0,546378,9917,19834,526544,290087,951883,471981,479902,,991740,685.3,4011.76,0.0686,1218,67.8,30155.31,9.62,0.8748
726,Lewis Edwards and Baldwin,False,IN,Shelbyfurt,Mobility,2010,https://lewisedwardsandbaldwin.com,Allow risk high young bad back very different me off.,19,lewis-edwards-and-baldwin,2023,USD,958348,562423,395925,341358,54567,1879,52688,9583,19166,33522,168437,819099,474874,344225,,958348,20.0,81.25,0.0441,747,106.77,14795.74,11.38,0.4131
727,Gross Ryan and Martinez,False,ZA,New Thomashaven,SaaS,2013,https://grossryanandmartinez.com,Kid especially structure fall during during should gun lay security.,18,gross-ryan-and-martinez,2023,USD,577053,175171,401882,85037,316845,5769,311076,5770,11541,299535,9915,354980,149817,205163,48087.75,577053,200.54,365.25,0.0633,881,54.57,12990.32,0.76,0.6964
728,Steele Group,False,EG,Coxstad,Energy,2023,https://steelegroup.com,Measure trip president painting large industry notice step by Mrs.,17,steele-group,2023,USD,2140112,703805,1436307,142250,1294057,0,1294057,21401,42802,1251255,58682,1292560,764514,528046,,2140112,1969.24,984.62,0.001,1025,173.85,1000.0,58.68,0.6711
729,Craig-Wade,False,EG,Lauramouth,EdTech,2018,https://craig-wade.com,Brother impact measure chance management thing cup conference.,24,craig-wade,2023,USD,228202,63379,164823,126497,38326,21863,16463,2282,4564,11899,1218,249585,139254,110331,19016.83,228202,10.0,32.0,0.0451,3803,5.0,12165.93,0.1,0.7223
730,Smith-Martinez,False,KE,Kathyfort,HealthTech,2018,https://smith-martinez.com,Call alone issue real wrong.,16,smith-martinez,2023,USD,700218,294796,405422,414769,-9347,0,-9347,7002,14004,-23351,11640,456714,225928,230786,58351.5,700218,476.11,514.21,0.0315,998,58.41,61123.34,0.19,0.579
731,Robertson PLC,False,ZA,Strongstad,E-commerce,2019,https://robertsonplc.com,I news Republican budget today together.,23,robertson-plc,2023,USD,2355271,474721,1880550,1258820,621730,8176,613554,23552,47105,566449,98722,1384554,69227,1315327,,2355271,150.83,470.17,0.001,1348,145.56,98503.52,1.0,0.7984
732,Franklin Rodriguez and Bowen,False,TN,Lake Samanthamouth,HealthTech,2019,https://franklinrodriguezandbowen.com,Piece scientist job serious record safe rich operation.,19,franklin-rodriguez-and-bowen,2023,USD,2797165,606608,2190557,2456408,-265851,5919,-271770,27971,55943,-327713,109732,1609464,326385,1283079,233097.08,2797165,163.09,761.65,0.001,46619,5.0,231780.85,0.47,0.7831
733,Miller Huang and Watkins,False,NG,Emilymouth,AI/ML,2011,https://millerhuangandwatkins.com,Fly computer reveal evidence significant discussion manage answer.,19,miller-huang-and-watkins,2023,USD,2605913,951270,1654643,1886740,-232097,36073,-268170,26059,52118,-320288,30269,1523970,808327,715643,,2605913,20.0,103.89,0.119,1711,126.86,156372.24,0.19,0.635
734,Merritt Riley and Anthony,False,CA,Mitchellfurt,EdTech,2022,https://merrittrileyandanthony.com,Serious well among war think room issue everything.,14,merritt-riley-and-anthony,2023,USD,1114729,537336,577393,941908,-364515,44263,-408778,11147,22294,-431072,77733,638145,134673,503472,92894.08,1114729,10.32,69.7,0.0819,1050,88.43,60700.44,1.28,0.518
735,Edwards Reed and Martin,False,FR,Joshuamouth,AgriTech,2022,https://edwardsreedandmartin.com,Those eye truth writer send under project.,24,edwards-reed-and-martin,2023,EUR,230198,95699,134499,138119,-3620,45193,-48813,2301,4603,-53416,1603,157949,53515,104434,,230198,1237.56,3828.11,0.024,959,20.0,1000.0,1.6,0.5843
736,Davis PLC,False,DE,North Carmen,HealthTech,2011,https://davisplc.com,Whether music sometimes according strategy.,16,davis-plc,2023,EUR,647740,277768,369972,174509,195463,6198,189265,6477,12954,176311,36653,447229,42254,404975,53978.33,647740,10.0,37.35,0.0824,477,113.09,1000.0,36.65,0.5712
737,Wood LLC,False,US,Dennishaven,AgriTech,2020,https://woodllc.com,Store far body relationship suddenly know.,21,wood-llc,2023,USD,32236,3377,28859,23976,4883,0,4883,322,644,4239,89897,158847,22722,136125,,32236,144.99,514.84,0.0269,41,64.19,30992.17,2.9,0.8952
738,Snyder-Miller,False,KE,West Jessica,Energy,2015,https://snyder-miller.com,Why sound season develop avoid.,21,snyder-miller,2023,USD,1623171,737536,885635,1276425,-390790,38618,-429408,16231,32463,-461871,132601,1103709,149957,953752,,1623171,950.8,2406.46,0.1295,6763,20.0,116391.34,1.14,0.5456
739,Hunter LLC,False,GB,Mccoyhaven,E-commerce,2018,https://hunterllc.com,Religious fire under item usually.,20,hunter-llc,2023,USD,952833,250207,702626,211388,491238,19027,472211,9528,19056,453155,110939,725825,341686,384139,,952833,1762.72,8037.77,0.001,482,164.59,14214.93,7.8,0.7374
740,Stewart Skinner and Guerrero,False,DE,Lake Courtneybury,HealthTech,2023,https://stewartskinnerandguerrero.com,Only the detail cultural like machine.,25,stewart-skinner-and-guerrero,2023,EUR,623908,232281,391627,310158,81469,5200,76269,6239,12478,63791,70165,511893,110914,400979,51992.33,623908,692.68,4162.09,0.0091,622,83.51,65693.81,1.07,0.6277
741,Gross LLC,False,NG,East Cynthia,Mobility,2023,https://grossllc.com,Week tax see about attack.,18,gross-llc,2023,USD,497682,241139,256543,245577,10966,0,10966,4976,9953,1013,21458,381414,102432,278982,,497682,773.09,1640.39,0.0336,2073,20.0,39939.83,0.54,0.5155
742,Carr Mckinney and Williams,False,IN,Christinashire,Mobility,2008,https://carrmckinneyandwilliams.com,Point machine prevent conference feel discussion factor.,16,carr-mckinney-and-williams,2023,USD,873880,343681,530199,624709,-94510,0,-94510,8738,17477,-111987,87024,683310,486210,197100,,873880,133.87,265.3,0.0345,437,166.4,31692.33,2.75,0.6067
743,Henry-Mccoy,False,FR,Amyport,Energy,2024,https://henry-mccoy.com,Despite while to shake information.,17,henry-mccoy,2023,EUR,1947034,576341,1370693,1202681,168012,21134,146878,19470,38940,107938,51132,1155492,396594,758898,,1947034,28.15,111.54,0.001,8112,20.0,79578.95,0.64,0.704
744,Nguyen-Bates,False,EG,East Stevenmouth,EdTech,2014,https://nguyen-bates.com,Girl huge campaign think style.,14,nguyen-bates,2023,USD,452792,205604,247188,316714,-69526,6834,-76360,4527,9055,-85415,11560,325548,114464,211084,37732.67,452792,27.04,127.43,0.0095,1275,29.59,4309.21,2.68,0.5459
745,Burke-Mcdaniel,False,KE,West Josephborough,E-commerce,2009,https://burke-mcdaniel.com,Article sign energy fish hot kind human treatment.,16,burke-mcdaniel,2023,USD,4759746,2006643,2753103,4070586,-1317483,14708,-1332191,47597,95194,-1427385,1093140,3513893,1488108,2025785,,4759746,747.0,2563.21,0.0324,5934,66.84,330397.46,3.31,0.5784
746,Washington-Robinson,False,US,West Sethbury,AgriTech,2023,https://washington-robinson.com,Then movie single book why particularly can music wear again.,15,washington-robinson,2023,USD,109834,51461,58373,62034,-3661,23355,-27016,1098,2196,-29212,7331,185519,9275,176244,,109834,20.0,102.22,0.001,71,127.89,34554.01,0.21,0.5315
747,Davis-Bush,False,KE,Katieside,Marketplaces,2023,https://davis-bush.com,Pressure million gun cup church.,17,davis-bush,2023,USD,964591,294400,670191,863161,-192970,32260,-225230,9645,19291,-244521,28937,639708,357274,282434,,964591,150.86,467.12,0.0539,4019,20.0,112034.01,0.26,0.6948
748,Foster Robbins and Roberts,False,IN,West Martin,AI/ML,2008,https://fosterrobbinsandroberts.com,Need eat add suddenly sense money.,27,foster-robbins-and-roberts,2023,USD,746601,286228,460373,37330,423043,4377,418666,7466,14932,403734,52143,594014,258958,335056,,746601,670.65,490.4,0.001,608,102.28,4195.68,12.43,0.6166
749,Sanders Washington and Moore,False,FR,Andrewbury,Energy,2012,https://sanderswashingtonandmoore.com,Evening buy six pretty capital.,23,sanders-washington-and-moore,2023,EUR,388623,69880,318743,134399,184344,0,184344,3886,7772,176572,103843,329569,103292,226277,,388623,20.0,125.87,0.0411,236,137.01,1000.0,103.84,0.8202
750,Mcdowell Atkins and Jones,False,IN,Smithside,Cybersecurity,2019,https://mcdowellatkinsandjones.com,Try believe open hospital story teacher size interesting sea few.,19,mcdowell-atkins-and-jones,2023,USD,1356133,469610,886523,651126,235397,0,235397,13561,27122,208275,18087,878648,107282,771366,,1356133,917.18,3055.94,0.0804,944,119.64,40260.2,0.45,0.6537
751,Harris-Baker,False,AU,Bennettchester,Energy,2019,https://harris-baker.com,Develop image everything expect reflect.,13,harris-baker,2023,USD,1016967,220148,796819,50848,745971,0,745971,10169,20339,725632,95088,696516,276386,420130,,1016967,850.48,425.24,0.0571,902,93.89,9369.54,10.15,0.7835
752,Sanchez Smith and Crawford,False,US,Beanside,Energy,2009,https://sanchezsmithandcrawford.com,Laugh official agent side language.,31,sanchez-smith-and-crawford,2023,USD,5593297,3780050,1813247,345428,1467819,33343,1434476,55932,111865,1322611,269269,3138712,877648,2261064,,5593297,1021.14,510.57,0.0175,23305,20.0,21694.16,12.41,0.3242
753,Hart-Day,False,KE,Douglasland,AI/ML,2014,https://hart-day.com,Night debate walk order base.,22,hart-day,2023,USD,588034,231848,356186,220049,136137,26400,109737,5880,11760,97977,37233,515816,359672,156144,,588034,308.01,154.0,0.0608,2450,20.0,18948.42,1.96,0.6057
754,Jensen-Wells,False,CA,North Katrina,AI/ML,2017,https://jensen-wells.com,In scientist strong already ready out the.,21,jensen-wells,2023,USD,1446782,250063,1196719,988283,208436,5293,203143,14467,28935,174208,10884,867760,194511,673249,,1446782,20.0,16.67,0.0617,268,449.69,124692.98,0.09,0.8272
755,Vaughn-Fischer,False,FR,Gardnermouth,Energy,2024,https://vaughn-fischer.com,Focus remember method teach yeah bank bit.,18,vaughn-fischer,2023,EUR,3955193,1375839,2579354,1448981,1130373,16312,1114061,39551,79103,1034958,259711,2374322,1320331,1053991,,3955193,1492.91,843.35,0.1092,2254,146.22,86665.47,3.0,0.6521
756,Jones Martinez and Smith,False,EG,East Jamesville,AI/ML,2016,https://jonesmartinezandsmith.com,Those manager phone modern cause.,19,jones-martinez-and-smith,2023,USD,1557438,665565,891873,511192,380681,16707,363974,15574,31148,332826,8138,807982,459358,348624,,1557438,111.61,55.8,0.0445,1268,102.28,56044.89,0.15,0.5727
757,Barnes Smith and Wilson,False,KE,Jenniferview,Marketplaces,2011,https://barnessmithandwilson.com,Follow threat nor coach face rate sort weight he page.,18,barnes-smith-and-wilson,2023,USD,5420245,2115093,3305152,2138864,1166288,32819,1133469,54202,108404,1025065,312199,3196578,1970391,1226187,,5420245,88.98,509.2,0.001,5899,76.56,179262.49,1.74,0.6098
758,Ford-Mayer,False,GB,East Alice,Fintech,2020,https://ford-mayer.com,Act indicate change attack with find could really Mrs.,27,ford-mayer,2023,USD,617820,262765,355055,436526,-81471,0,-81471,6178,12356,-93827,25539,432803,22484,410319,,617820,1329.2,3496.12,0.001,437,117.57,53176.06,0.48,0.5747
759,Davis-Weber,False,CA,North Michael,E-commerce,2019,https://davis-weber.com,Third general add cover exist treatment international role happen short.,19,davis-weber,2023,USD,585049,240969,344080,500490,-156410,0,-156410,5850,11700,-168110,7717,453073,215791,237282,,585049,20.0,29.07,0.0751,349,139.52,31652.97,0.24,0.5881
760,Hoffman-May,False,AU,North Brittany,HealthTech,2014,https://hoffman-may.com,Room evidence enjoy bill someone.,15,hoffman-may,2023,USD,914820,446992,467828,369232,98596,688,97908,9148,18296,79612,24319,589689,164519,425170,76235.0,914820,269.69,1886.09,0.0297,3569,21.36,36404.14,0.67,0.5114
761,Newman Reyes and Johnston,False,KE,Tammyfort,AI/ML,2020,https://newmanreyesandjohnston.com,Collection situation writer before sound chair.,21,newman-reyes-and-johnston,2023,USD,1527465,634636,892829,457068,435761,0,435761,15274,30549,405212,87973,871633,334144,537489,,1527465,87.67,608.21,0.097,2274,55.96,22876.99,3.85,0.5845
762,Alvarez Inc,False,NG,Christianton,SaaS,2009,https://alvarezinc.com,Memory keep professor force matter bring.,31,alvarez-inc,2023,USD,1671709,612649,1059060,1249453,-190393,11912,-202305,16717,33434,-235739,78553,1039332,487365,551967,139309.08,1671709,808.29,4728.97,0.018,1739,80.07,73429.5,1.07,0.6335
763,Long Schroeder and Mccarthy,False,US,Larryhaven,HealthTech,2018,https://longschroederandmccarthy.com,Most third success western watch street represent style.,13,long-schroeder-and-mccarthy,2023,USD,684531,99942,584589,128998,455591,0,455591,6845,13690,441901,81923,590221,108923,481298,57044.25,684531,333.73,2608.09,0.001,610,93.46,48502.34,1.69,0.854
764,Alexander Neal and King,False,AU,New Rachelstad,Mobility,2024,https://alexandernealandking.com,Agent hand letter prove rock degree.,15,alexander-neal-and-king,2023,USD,419499,147564,271935,229273,42662,1906,40756,4194,8389,32367,42828,271899,48269,223630,,419499,1553.69,1845.66,0.001,687,50.88,6486.98,6.6,0.6482
765,Walter Knapp and Lee,False,EG,Haroldtown,HealthTech,2024,https://walterknappandlee.com,Kind moment accept financial behind hard.,21,walter-knapp-and-lee,2023,USD,620251,196760,423491,394251,29240,0,29240,6202,12405,16835,24989,486801,97170,389631,51687.58,620251,703.89,2466.93,0.0384,4000,12.92,45401.3,0.55,0.6828
766,Shaw-Smith,False,GB,Arthurview,E-commerce,2018,https://shaw-smith.com,Huge yet region ever arm occur air responsibility likely.,22,shaw-smith,2023,USD,951301,445814,505487,534475,-28988,4242,-33230,9513,19026,-52256,51227,717487,377216,340271,,951301,20.0,49.27,0.077,2344,33.82,73465.74,0.7,0.5314
767,Chen Henry and Wells,False,GB,North Mikeberg,Energy,2017,https://chenhenryandwells.com,That capital information suffer argue PM.,17,chen-henry-and-wells,2023,USD,1169718,441705,728013,301130,426883,18771,408112,11697,23394,384718,23371,802361,40118,762243,,1169718,20.0,95.51,0.1199,559,174.09,40717.67,0.57,0.6224
768,Edwards PLC,False,KE,Tonyaborough,E-commerce,2024,https://edwardsplc.com,Scene four public tonight today college worry reveal hand add professor.,33,edwards-plc,2023,USD,741403,272045,469358,50974,418384,2324,416060,7414,14828,401232,15679,404219,180553,223666,,741403,850.1,674.58,0.0728,207,298.3,8890.77,1.76,0.6331
769,Monroe-Caldwell,False,NG,East Mandyhaven,AI/ML,2023,https://monroe-caldwell.com,Rock base kitchen every cup measure.,14,monroe-caldwell,2023,USD,902723,411616,491107,164747,326360,0,326360,9027,18054,308306,33846,557026,306182,250844,,902723,20.0,76.9,0.001,435,172.86,49084.06,0.69,0.544
770,Reid Inc,False,ZA,Joshuastad,IoT,2017,https://reidinc.com,Game nothing recent not leg break.,17,reid-inc,2023,USD,241337,86953,154384,111243,43141,35264,7877,2413,4826,3051,26229,176321,41092,135229,,241337,2190.28,1095.14,0.0899,1005,20.0,1000.0,26.23,0.6397
771,White Inc,False,EG,West Brittany,SaaS,2019,https://whiteinc.com,Short small design hear.,23,white-inc,2023,USD,512600,219502,293098,407521,-114423,9013,-123436,5126,10252,-133688,62367,445580,163142,282438,42716.67,512600,373.72,373.72,0.0665,348,122.46,55752.67,1.12,0.5718
772,Wiley and Sons,False,CA,Maryborough,Marketplaces,2011,https://wileyandsons.com,Financial here expert everything north including.,16,wiley-and-sons,2023,USD,506600,148722,357878,417760,-59882,0,-59882,5066,10132,-70014,3905,314074,167964,146110,,506600,20.0,52.13,0.001,2110,20.0,7275.39,0.54,0.7064
773,Nelson and Sons,False,TN,West Jordan,IoT,2017,https://nelsonandsons.com,Enough majority official give politics last piece story already.,17,nelson-and-sons,2023,USD,1756195,534052,1222143,685174,536969,0,536969,17561,35123,501846,40609,1002274,611945,390329,,1756195,20.0,10.0,0.0503,2277,64.27,27284.54,1.49,0.6959
774,Cruz Medina and Clark,False,AU,Reedport,Cybersecurity,2008,https://cruzmedinaandclark.com,Garden why necessary sea especially message.,12,cruz-medina-and-clark,2023,USD,1344140,533981,810159,951394,-141235,4464,-145699,13441,26882,-172581,29422,880686,503129,377557,,1344140,62.0,313.44,0.0658,5600,20.0,78325.65,0.38,0.6027
775,Scott Group,False,KE,Anthonyville,Mobility,2016,https://scottgroup.com,Probably cost cause only head help open almost red picture.,19,scott-group,2023,USD,4283924,1160434,3123490,1586871,1536619,0,1536619,42839,85678,1450941,196345,2471968,576896,1895072,,4283924,1155.23,747.05,0.1125,1575,226.59,138141.51,1.42,0.7291
776,Moore Group,False,BR,Matthewville,IoT,2015,https://mooregroup.com,Tree fill level control against speak.,20,moore-group,2023,USD,202535,23653,178882,55379,123503,0,123503,2025,4050,119453,5121,142754,42315,100439,,202535,20.0,106.34,0.1112,843,20.0,23985.93,0.21,0.8832
777,Watkins-Neal,False,ZA,Wellsbury,SaaS,2023,https://watkins-neal.com,Rich over lot husband always upon doctor.,15,watkins-neal,2023,USD,1386380,289981,1096399,279382,817017,28058,788959,13863,27727,761232,463760,1217634,521949,695685,115531.67,1386380,10.0,68.6,0.0222,23106,5.0,35982.13,12.89,0.7908
778,Rodriguez Simmons and Adams,False,GB,Watkinsburgh,AI/ML,2020,https://rodriguezsimmonsandadams.com,Coach feel others recently model week nothing cause professional small.,23,rodriguez-simmons-and-adams,2023,USD,1975415,558929,1416486,976068,440418,18546,421872,19754,39508,382364,126914,1150835,289719,861116,,1975415,1926.88,9254.66,0.0874,796,206.69,88291.65,1.44,0.7171
779,Waller LLC,False,GB,Port Michael,Marketplaces,2015,https://wallerllc.com,Close a challenge third feeling ball door data.,16,waller-llc,2023,USD,317735,132358,185377,112044,73333,4420,68913,3177,6354,62559,24146,290745,52891,237854,,317735,20.0,21.51,0.05,166,159.04,7434.5,3.25,0.5834
780,Ramsey and Sons,False,US,Adamburgh,IoT,2011,https://ramseyandsons.com,Beyond near hour defense line heavy less drug.,26,ramsey-and-sons,2023,USD,168352,36128,132224,129314,2910,0,2910,1683,3367,-457,83088,215619,108618,107001,,168352,992.39,509.56,0.0423,701,20.0,35925.92,2.31,0.7854
781,Hughes LLC,False,DE,South Kerri,SaaS,2022,https://hughesllc.com,Star room interesting hour author major science.,22,hughes-llc,2023,EUR,383029,96402,286627,118470,168157,2071,166086,3830,7660,158426,23785,274530,166214,108316,31919.08,383029,10.0,27.62,0.0886,1102,28.96,1000.0,23.78,0.7483
782,Johnson Blackwell and Thompson,False,CA,West Michael,Energy,2012,https://johnsonblackwellandthompson.com,Statement particular seem trip population catch could deep itself.,24,johnson-blackwell-and-thompson,2023,USD,2886190,967534,1918656,172922,1745734,24850,1720884,28861,57723,1663161,112408,1724018,703791,1020227,,2886190,1381.22,9054.02,0.1236,1259,190.93,18241.13,6.16,0.6648
783,Cruz-White,False,TN,West Larry,Cybersecurity,2014,https://cruz-white.com,Alone when instead clear radio strong let bar rather.,21,cruz-white,2023,USD,2039337,567095,1472242,1153283,318959,0,318959,20393,40786,278173,85721,1277710,566084,711626,,2039337,20.0,10.0,0.001,1062,159.93,113864.89,0.75,0.7219
784,Rios Group,False,TN,East Luisshire,AI/ML,2023,https://riosgroup.com,Himself lawyer main whether I side field else plant.,15,rios-group,2023,USD,216537,46211,170326,58562,111764,8882,102882,2165,4330,98552,2984,286075,72252,213823,,216537,20.0,10.0,0.0913,902,20.0,11433.05,0.26,0.7866
785,Roman Odonnell and Shaw,False,ZA,Josephside,Cybersecurity,2009,https://romanodonnellandshaw.com,Born condition interest service that bag according way.,14,roman-odonnell-and-shaw,2023,USD,1022485,460363,562122,546026,16096,15002,1094,10224,20449,-19355,84252,631040,332487,298553,,1022485,20.0,45.93,0.0287,327,260.4,57451.22,1.47,0.5498
786,Lawrence Gonzalez and Hess,False,ZA,Grahammouth,HealthTech,2024,https://lawrencegonzalezandhess.com,Always test least anyone out hard international.,16,lawrence-gonzalez-and-hess,2023,USD,4206218,1182821,3023397,210310,2813087,0,2813087,42062,84124,2728963,59715,2199599,990914,1208685,350518.17,4206218,10.0,18.78,0.04,5331,65.75,21519.76,2.77,0.7188
787,Phillips Fuentes and Daniels,False,DE,West Michael,AI/ML,2018,https://phillipsfuentesanddaniels.com,Land fear along born.,24,phillips-fuentes-and-daniels,2023,EUR,714520,326026,388494,537680,-149186,10566,-159752,7145,14290,-174042,62266,558817,127582,431235,,714520,20.0,35.04,0.0585,626,94.99,52550.68,1.18,0.5437
788,Johnson Rodgers and Wright,False,BR,New Codyberg,Mobility,2024,https://johnsonrodgersandwright.com,Issue ever will ready each stay strong run model.,20,johnson-rodgers-and-wright,2023,USD,5163133,1573988,3589145,2420868,1168277,7054,1161223,51631,103262,1057961,213232,2805660,339846,2465814,,5163133,20.0,56.91,0.0628,15399,27.94,163950.37,1.3,0.6951
789,Williams-Nguyen,False,TN,East Chelseaville,E-commerce,2013,https://williams-nguyen.com,Mention rise front PM few husband contain section.,18,williams-nguyen,2023,USD,258984,91141,167843,129140,38703,25263,13440,2589,5179,8261,22555,282701,66024,216677,,258984,254.75,772.19,0.0623,187,115.07,1000.0,22.56,0.6481
790,Delgado Andrade and Copeland,False,EG,Sanfordborough,AI/ML,2018,https://delgadoandradeandcopeland.com,End field method take during sometimes hear list set join.,19,delgado-andrade-and-copeland,2023,USD,1788532,513729,1274803,473107,801696,40184,761512,17885,35770,725742,56891,1077709,668897,408812,,1788532,20.0,92.61,0.0242,3280,45.43,39550.83,1.44,0.7128
791,Barker Lopez and Mason,False,NG,New Raymondburgh,E-commerce,2016,https://barkerlopezandmason.com,Evening imagine affect increase candidate environment out.,22,barker-lopez-and-mason,2023,USD,1448545,542642,905903,245850,660053,28387,631666,14485,28970,602696,108986,902166,253122,649044,,1448545,20.0,17.29,0.0513,2523,47.83,23798.82,4.58,0.6254
792,Flores Walker and Smith,False,KE,Jeffreyport,Mobility,2014,https://floreswalkerandsmith.com,Step onto play forget home upon actually future get know.,23,flores-walker-and-smith,2023,USD,1470600,331130,1139470,581231,558239,11031,547208,14706,29412,517796,56768,974446,436106,538340,,1470600,159.48,79.74,0.0381,803,152.52,55008.44,1.03,0.7748
793,Dickerson-Porter,False,DE,Lake Peter,AgriTech,2017,https://dickerson-porter.com,Allow system whose place no generation debate world.,22,dickerson-porter,2023,EUR,820924,303555,517369,310875,206494,0,206494,8209,16418,190076,159231,623019,238814,384205,,820924,20.0,44.89,0.0548,508,134.59,55014.68,2.89,0.6302
794,Torres-Potter,False,DE,Craigtown,AgriTech,2017,https://torres-potter.com,Person coach goal it yet age.,23,torres-potter,2023,EUR,60319,30956,29363,26092,3271,35768,-32497,603,1206,-33703,4802,127623,45847,81776,,60319,1595.31,5428.5,0.0403,26,189.87,1000.0,4.8,0.4868
795,Hawkins-Henry,False,ZA,South Samantha,EdTech,2023,https://hawkins-henry.com,Her we but how deep book.,15,hawkins-henry,2023,USD,710895,188373,522522,242583,279939,0,279939,7108,14217,265722,3594,429515,55107,374408,59241.25,710895,568.86,2462.38,0.0144,11848,5.0,1000.0,3.59,0.735
796,White-Moore,False,CA,Piercestad,Mobility,2019,https://white-moore.com,Industry out floor guy black those.,27,white-moore,2023,USD,1170123,481915,688208,621900,66308,0,66308,11701,23402,42906,94253,870068,571601,298467,,1170123,137.91,615.62,0.0484,4875,20.0,29551.27,3.19,0.5882
797,Gill Stewart and Nichols,False,NG,Perezfurt,Cybersecurity,2016,https://gillstewartandnichols.com,Series experience under church them hundred about stop several.,23,gill-stewart-and-nichols,2023,USD,834299,287201,547098,371438,175660,0,175660,8342,16685,158975,94389,694023,176630,517393,,834299,699.75,3505.64,0.1299,515,134.83,60663.4,1.56,0.6558
798,Jackson Solomon and Reyes,False,IN,Mccannchester,Fintech,2020,https://jacksonsolomonandreyes.com,Player peace catch people your outside.,27,jackson-solomon-and-reyes,2023,USD,191110,105870,85240,116624,-31384,0,-31384,1911,3822,-35206,4833,150702,7535,143167,,191110,1035.81,7263.95,0.1119,55,289.47,41285.52,0.12,0.446
799,Ortiz Johnson and Bishop,False,TN,New Colleen,E-commerce,2012,https://ortizjohnsonandbishop.com,Weight age over smile hope.,23,ortiz-johnson-and-bishop,2023,USD,5415963,2036329,3379634,308397,3071237,0,3071237,54159,108319,2962918,399941,3228782,1178432,2050350,,5415963,1567.79,7390.79,0.028,22566,20.0,13562.69,29.49,0.624
800,Boyer Jefferson and Martin,False,IN,Jenniferbury,SaaS,2017,https://boyerjeffersonandmartin.com,Line require current car ask air.,20,boyer-jefferson-and-martin,2023,USD,619958,201900,418058,260936,157122,21948,135174,6199,12399,122775,69238,523799,26189,497610,51663.17,619958,164.49,980.99,0.0416,587,87.88,18493.47,3.74,0.6743
801,Murray Sanchez and Morrison,False,ZA,Port Gregory,Fintech,2019,https://murraysanchezandmorrison.com,Matter book page former turn city left while according.,20,murray-sanchez-and-morrison,2023,USD,1555303,308841,1246462,681594,564868,34086,530782,15553,31106,499676,119404,1033945,138339,895606,,1555303,385.42,299.79,0.001,486,266.37,54525.83,2.19,0.8014
802,Fleming Group,False,EG,Atkinsland,Marketplaces,2016,https://fleminggroup.com,Whatever third Mr respond parent writer resource just still.,26,fleming-group,2023,USD,744258,394196,350062,422863,-72801,15529,-88330,7442,14885,-103215,27142,562300,71384,490916,,744258,102.35,364.55,0.0224,931,66.6,23332.47,1.16,0.4704
803,Carter Group,False,ZA,West Reginaldhaven,Mobility,2014,https://cartergroup.com,Power investment buy certainly energy stay send born college include fund.,21,carter-group,2023,USD,603538,193071,410467,519850,-109383,296,-109679,6035,12070,-121749,15146,413270,88026,325244,,603538,671.38,2976.53,0.0044,2514,20.0,27593.31,0.55,0.6801
804,Pope and Sons,False,DE,Coltonland,AI/ML,2016,https://popeandsons.com,Tonight man each employee far know skin record nothing.,28,pope-and-sons,2023,EUR,1135121,291497,843624,323351,520273,586,519687,11351,22702,496985,19543,771625,214825,556800,,1135121,88.95,379.58,0.0617,666,141.87,14469.19,1.35,0.7432
805,Johnson Taylor and Boyd,False,NG,East Nicoleshire,Cybersecurity,2016,https://johnsontaylorandboyd.com,Research fill respond nothing fight require pull child.,22,johnson-taylor-and-boyd,2023,USD,3130779,1434383,1696396,670762,1025634,0,1025634,31307,62615,963019,78478,1666316,384398,1281918,,3130779,20.0,54.01,0.001,1189,219.38,55649.51,1.41,0.5418
806,Anderson Lawson and Villarreal,False,GB,Danatown,Fintech,2015,https://andersonlawsonandvillarreal.com,On chance activity hair meet thank.,24,anderson-lawson-and-villarreal,2023,USD,893001,331592,561409,224442,336967,0,336967,8930,17860,319107,80962,665202,361592,303610,,893001,20.0,28.11,0.0079,681,109.19,1000.0,80.96,0.6287
807,Sullivan Montgomery and Jackson,False,DE,Dawnshire,SaaS,2024,https://sullivanmontgomeryandjackson.com,Fire hear tend magazine college moment compare today add.,13,sullivan-montgomery-and-jackson,2023,EUR,532806,134441,398365,373440,24925,0,24925,5328,10656,14269,94771,372526,108949,263577,44400.5,532806,96.34,178.76,0.055,764,58.04,45255.41,2.09,0.7477
808,Peterson LLC,False,DE,East Edward,Marketplaces,2015,https://petersonllc.com,Sing smile practice ground least tree trade style suffer situation.,21,peterson-llc,2023,EUR,206643,107706,98937,86445,12492,0,12492,2066,4132,8360,3898,267527,149940,117587,,206643,763.68,1905.27,0.001,861,20.0,1000.0,3.9,0.4788
809,Villanueva Figueroa and Cox,False,US,South Conniemouth,Fintech,2021,https://villanuevafigueroaandcox.com,Attack network movement scientist their wife argue note easy.,25,villanueva-figueroa-and-cox,2023,USD,1023990,376597,647393,369627,277766,26758,251008,10239,20479,230529,86207,623438,238509,384929,,1023990,840.1,1175.65,0.0491,4266,20.0,30093.85,2.86,0.6322
810,Robles-White,False,CA,East Hannah,Cybersecurity,2023,https://robles-white.com,Concern without entire everyone sea safe true town car.,19,robles-white,2023,USD,684511,373085,311426,75009,236417,38846,197571,6845,13690,183881,26397,464199,136746,327453,,684511,1017.77,4132.52,0.0195,623,91.46,18107.43,1.46,0.455
811,Brown-Perez,False,FR,Marshallside,Marketplaces,2012,https://brown-perez.com,Five plant cultural bring bar.,19,brown-perez,2023,EUR,472238,136192,336046,221942,114104,0,114104,4722,9444,104660,92096,411867,148007,263860,,472238,20.0,73.71,0.0795,1967,20.0,39797.22,2.31,0.7116
812,Garcia PLC,False,US,New Tony,AI/ML,2013,https://garciaplc.com,Act involve toward result kind politics open play sense yeah.,16,garcia-plc,2023,USD,1551508,819239,732269,616818,115451,25659,89792,15515,31030,58762,19591,839414,41970,797444,,1551508,20.0,21.1,0.001,1087,118.9,46271.78,0.42,0.472
813,Webster-Guzman,False,TN,Welchmouth,Marketplaces,2023,https://webster-guzman.com,Low exist population enough mother game question me personal.,20,webster-guzman,2023,USD,1307119,604701,702418,540900,161518,0,161518,13071,26142,135376,13211,714831,194798,520033,,1307119,254.37,1694.48,0.0747,749,145.31,25708.28,0.51,0.5374
814,Rowland and Sons,False,EG,Smithhaven,Marketplaces,2014,https://rowlandandsons.com,Many condition set pull behind television garden reach state.,32,rowland-and-sons,2023,USD,875290,385388,489902,265189,224713,26785,197928,8752,17505,180423,64126,573028,279644,293384,,875290,850.67,1812.22,0.0619,961,75.85,1000.0,64.13,0.5597
815,Maxwell and Sons,False,AU,West Warren,AgriTech,2018,https://maxwellandsons.com,Short line range until decision public food court.,26,maxwell-and-sons,2023,USD,598373,254009,344364,312272,32092,8196,23896,5983,11967,11929,8426,395814,122220,273594,,598373,20.0,11.46,0.1408,200,248.68,26523.76,0.32,0.5755
816,Floyd-Phelps,False,IN,West Sue,Marketplaces,2009,https://floyd-phelps.com,President small sister especially usually line task field certain.,16,floyd-phelps,2023,USD,651765,286815,364950,230932,134018,27513,106505,6517,13035,93470,7030,499923,283404,216519,,651765,26.7,40.75,0.0472,728,74.57,17672.52,0.4,0.5599
817,Acosta-Calderon,False,AU,Shannonchester,Fintech,2015,https://acosta-calderon.com,Hour individual several identify why government south window short affect.,12,acosta-calderon,2023,USD,2800445,1005869,1794576,1138070,656506,0,656506,28004,56008,600498,36961,1469205,898555,570650,,2800445,20.0,62.67,0.0687,948,246.1,65165.5,0.57,0.6408
818,Harris Bates and Scott,False,NG,Andrewchester,Cybersecurity,2009,https://harrisbatesandscott.com,For nice current Democrat me task blood during.,22,harris-bates-and-scott,2023,USD,848222,267323,580899,533496,47403,21950,25453,8482,16964,8489,94057,699786,302937,396849,,848222,214.46,566.28,0.0258,3534,20.0,58180.43,1.62,0.6848
819,Sharp-David,False,GB,Craneton,Energy,2013,https://sharp-david.com,Reach training main exactly parent heart big policy.,18,sharp-david,2023,USD,847784,260103,587681,114414,473267,12566,460701,8477,16955,443746,108722,625989,173897,452092,,847784,45.7,74.5,0.0036,666,105.98,9656.42,11.26,0.6932
820,Medina-Kim,False,US,Danielberg,Energy,2023,https://medina-kim.com,Foot simple including charge character.,17,medina-kim,2023,USD,3336537,1512018,1824519,2038464,-213945,22745,-236690,33365,66730,-303420,493029,2295866,881708,1414158,,3336537,863.71,2759.96,0.1418,13902,20.0,158814.51,3.1,0.5468
821,Andrews-Hoffman,False,GB,Sanchezshire,Cybersecurity,2017,https://andrews-hoffman.com,Several end most fact against sign attention skill represent finish.,21,andrews-hoffman,2023,USD,2735497,1719960,1015537,3568874,-2553337,0,-2553337,27354,54709,-2608046,119473,1493328,151061,1342267,,2735497,20.0,61.31,0.0513,2900,78.6,306302.23,0.39,0.3712
822,Stein-Griffin,False,US,East Manuel,SaaS,2017,https://stein-griffin.com,Leave four question region effort section age.,24,stein-griffin,2023,USD,253180,108620,144560,12659,131901,12544,119357,2531,5063,114294,4508,173460,110446,63014,21098.33,253180,10.0,57.64,0.0469,222,94.76,1000.0,4.51,0.571
823,May Group,False,KE,Shafferton,IoT,2011,https://maygroup.com,Art writer health not yet where their force much executive.,16,may-group,2023,USD,176117,113158,62959,38409,24550,13230,11320,1761,3522,7798,8264,286398,110762,175636,,176117,20.0,47.6,0.0807,43,335.57,1000.0,8.26,0.3575
824,Walters-Navarro,False,CA,New Kimberlyside,AgriTech,2022,https://walters-navarro.com,Sometimes suffer because two particular year.,16,walters-navarro,2023,USD,92747,39920,52827,32153,20674,0,20674,927,1854,18820,28466,150239,41925,108314,,92747,20.0,70.58,0.0199,386,20.0,1000.0,28.47,0.5696
825,Wang Group,False,BR,Stevenberg,AI/ML,2024,https://wanggroup.com,Authority possible fund month realize star it again.,19,wang-group,2023,USD,1525960,543783,982177,169684,812493,0,812493,15259,30519,781974,124234,1005493,694616,310877,,1525960,651.41,3336.26,0.095,710,178.88,1000.0,124.23,0.6436
826,Carter Hanson and Price,False,EG,East Marcusberg,HealthTech,2024,https://carterhansonandprice.com,Talk once should mother president customer start.,24,carter-hanson-and-price,2023,USD,301040,48420,252620,165177,87443,12250,75193,3010,6020,69173,48142,284073,96063,188010,25086.67,301040,119.52,420.08,0.026,1321,18.98,1000.0,48.14,0.8392
827,Barry-Espinoza,False,EG,East Kendra,AgriTech,2014,https://barry-espinoza.com,Final beyond mouth war always camera.,20,barry-espinoza,2023,USD,79463,25770,53693,68248,-14555,4223,-18778,794,1589,-20367,1609,232716,89819,142897,,79463,162.52,128.5,0.001,20,322.27,9044.58,0.18,0.6757
828,Blevins-Murphy,False,AU,Sarahborough,Fintech,2018,https://blevins-murphy.com,Field interest even view describe green.,21,blevins-murphy,2023,USD,841099,328195,512904,765381,-252477,27815,-280292,8410,16821,-297113,1898,468222,44903,423319,,841099,313.61,869.97,0.0947,325,215.59,70469.24,0.03,0.6098
829,Rich Group,False,GB,Port Stacytown,Cybersecurity,2022,https://richgroup.com,Test take decade any just cup side opportunity by.,19,rich-group,2023,USD,1994409,820161,1174248,1028126,146122,23668,122454,19944,39888,82566,69453,1180401,455320,725081,,1994409,273.29,564.82,0.0316,1104,150.51,111439.71,0.62,0.5888
830,Hunter PLC,False,BR,East Katherineville,AgriTech,2013,https://hunterplc.com,Scientist group yet indeed decision before medical long meet.,18,hunter-plc,2023,USD,322701,142713,179988,198685,-18697,4770,-23467,3227,6454,-29921,5423,244120,123661,120459,,322701,20.0,159.93,0.0638,127,210.88,24604.12,0.22,0.5578
831,Smith-James,False,US,Rossville,Cybersecurity,2018,https://smith-james.com,Growth finally assume watch present director red practice.,22,smith-james,2023,USD,850986,395625,455361,281903,173458,0,173458,8509,17019,156439,285011,750947,246555,504392,,850986,670.8,4205.6,0.0925,346,204.81,46050.75,6.19,0.5351
832,Liu-Smith,False,AU,Jessicamouth,AgriTech,2014,https://liu-smith.com,Cell eat north campaign choose.,17,liu-smith,2023,USD,762455,113929,648526,505286,143240,29633,113607,7624,15249,98358,18833,491109,162628,328481,,762455,20.0,61.58,0.0582,521,121.78,44684.16,0.42,0.8506
833,Harrison Williams and Carlson,False,GB,Port Jodi,IoT,2020,https://harrisonwilliamsandcarlson.com,He increase church common view whole score.,25,harrison-williams-and-carlson,2023,USD,436436,164658,271778,337943,-66165,3412,-69577,4364,8728,-78305,27041,321410,106297,215113,,436436,20.0,55.83,0.1144,431,84.22,38882.1,0.7,0.6227
834,White Koch and Rodriguez,False,TN,North Tyler,AI/ML,2018,https://whitekochandrodriguez.com,Idea health success perform agreement ago agreement.,17,white-koch-and-rodriguez,2023,USD,1797211,365604,1431607,678893,752714,0,752714,17972,35944,716770,53191,1076586,968927,107659,,1797211,20.0,93.05,0.1303,926,161.64,66072.36,0.81,0.7966
835,Johnson-Wiggins,False,FR,Williamsfurt,Energy,2011,https://johnson-wiggins.com,Reveal college beyond give development information at why less indeed.,20,johnson-wiggins,2023,EUR,850934,162842,688092,422634,265458,0,265458,8509,17018,248440,118362,665993,330449,335544,,850934,20.0,145.41,0.0332,469,151.14,29055.18,4.07,0.8086
836,Alexander Vincent and Pacheco,False,GB,West Thomasview,HealthTech,2023,https://alexandervincentandpacheco.com,Follow music whatever protect benefit manage.,16,alexander-vincent-and-pacheco,2023,USD,585541,168141,417400,63561,353839,0,353839,5855,11710,342129,205565,644230,245791,398439,48795.08,585541,168.34,538.59,0.0615,776,62.81,1000.0,205.56,0.7128
837,Gonzalez Robinson and Anderson,False,CA,East Donna,EdTech,2008,https://gonzalezrobinsonandanderson.com,Response executive past economic economy.,26,gonzalez-robinson-and-anderson,2023,USD,265209,121413,143796,183996,-40200,51669,-91869,2652,5304,-97173,44900,281310,144988,136322,22100.75,265209,10.0,41.72,0.0452,1196,18.47,1000.0,44.9,0.5422
838,Hopkins Murphy and Dickson,False,IN,Kathleenberg,Energy,2015,https://hopkinsmurphyanddickson.com,Instead product often various alone town his answer.,15,hopkins-murphy-and-dickson,2023,USD,979040,191685,787355,363879,423476,0,423476,9790,19580,403896,35039,652629,297658,354971,,979040,89.46,260.2,0.0766,4079,20.0,78337.99,0.45,0.8042
839,Petty Inc,False,EG,Lake Austin,AgriTech,2018,https://pettyinc.com,Class follow occur low gas pick stage.,29,petty-inc,2023,USD,650084,164340,485744,214488,271256,32797,238459,6500,13001,225458,19243,360137,199422,160715,,650084,1130.89,3694.77,0.0838,349,155.16,1938.38,9.93,0.7472
840,Sullivan Haney and Chavez,False,IN,Amyville,IoT,2008,https://sullivanhaneyandchavez.com,Pretty method front you control game the.,25,sullivan-haney-and-chavez,2023,USD,397172,71095,326077,81971,244106,9591,234515,3971,7943,226572,9624,337342,171354,165988,,397172,20.0,55.57,0.0575,312,105.93,36139.52,0.27,0.821
841,Bryant Davis and Chase,False,IN,Bryanstad,Marketplaces,2019,https://bryantdavisandchase.com,Politics who call dinner leader book nearly fast their.,6,bryant-davis-and-chase,2023,USD,2111331,853354,1257977,1883935,-625958,0,-625958,21113,42226,-668184,167691,1347026,809738,537288,,2111331,330.93,441.7,0.0545,8797,20.0,165799.6,1.01,0.5958
842,Chavez-Tran,False,ZA,Port Teresaburgh,EdTech,2009,https://chavez-tran.com,Star those memory center quite simply cup seat.,21,chavez-tran,2023,USD,1070093,366577,703516,53504,650012,0,650012,10700,21401,628611,86031,690560,122720,567840,89174.42,1070093,132.0,699.37,0.0164,1654,53.9,39368.79,2.19,0.6574
843,Burke Hernandez and Heath,False,BR,Port Amandaside,Fintech,2022,https://burkehernandezandheath.com,Really young coach city quite play teacher.,22,burke-hernandez-and-heath,2023,USD,602876,81076,521800,307146,214654,0,214654,6028,12057,202597,9938,361375,18068,343307,,602876,221.4,1666.78,0.0528,705,71.24,30206.91,0.33,0.8655
844,Bridges Ltd,False,IN,New Sheri,HealthTech,2020,https://bridgesltd.com,Interest dark any wide husband hope miss instead live focus return.,20,bridges-ltd,2023,USD,661975,363598,298377,505701,-207324,0,-207324,6619,13239,-220563,27834,480194,44935,435259,55164.58,661975,253.21,1441.35,0.0392,8513,6.48,37664.0,0.74,0.4507
845,Smith-King,False,BR,Jasonland,AI/ML,2017,https://smith-king.com,Sense cell lose civil will.,26,smith-king,2023,USD,1949827,694103,1255724,742095,513629,5705,507924,19498,38996,468928,47113,1079476,345394,734082,,1949827,777.74,1929.05,0.0303,1250,129.9,51626.01,0.91,0.644
846,Myers and Sons,False,ZA,Myersborough,Fintech,2017,https://myersandsons.com,Strong audience white everybody throughout but science.,16,myers-and-sons,2023,USD,443252,73109,370143,309494,60649,12191,48458,4432,8865,39593,25549,284662,191769,92893,,443252,20.0,61.06,0.1006,596,61.88,24133.17,1.06,0.8351
847,Hernandez Ramos and Chambers,False,CA,Alexville,IoT,2015,https://hernandezramosandchambers.com,Find bill pick likely produce federal by sea lawyer audience.,18,hernandez-ramos-and-chambers,2023,USD,1028873,382361,646512,360622,285890,10161,275729,10288,20577,255152,29903,552516,41086,511430,,1028873,55.78,58.88,0.001,2381,36.0,1000.0,29.9,0.6284
848,Peterson Nelson and Travis,False,DE,Masseyview,HealthTech,2023,https://petersonnelsonandtravis.com,Phone international collection report tend.,20,peterson-nelson-and-travis,2023,EUR,309638,177641,131997,114705,17292,0,17292,3096,6192,11100,86160,271459,93950,177509,25803.17,309638,36.8,178.65,0.001,1202,21.45,21419.83,4.02,0.4263
849,Blake-Walker,False,GB,North Whitneystad,Mobility,2019,https://blake-walker.com,Thank professor student white instead point tend.,26,blake-walker,2023,USD,2374968,354416,2020552,723426,1297126,0,1297126,23749,47499,1249627,19380,1361076,195305,1165771,,2374968,1034.61,3621.6,0.001,842,234.85,27398.01,0.71,0.8508
850,Kirby-Oconnor,False,TN,Daniellemouth,Cybersecurity,2023,https://kirby-oconnor.com,Project economy ground actually require magazine one determine its.,21,kirby-oconnor,2023,USD,6815695,1593215,5222480,340784,4881696,13960,4867736,68156,136313,4731423,623352,4179015,559144,3619871,,6815695,1459.27,1105.94,0.0253,15476,36.7,1000.0,623.35,0.7662
851,Garcia-Norman,False,AU,Castroshire,AI/ML,2014,https://garcia-norman.com,Parent that property among blue study poor better.,18,garcia-norman,2023,USD,1234522,532224,702298,307631,394667,0,394667,12345,24690,369977,49562,707155,214150,493005,,1234522,219.84,555.09,0.0409,1343,76.56,47343.06,1.05,0.5689
852,Wilson and Sons,False,AU,Bettychester,EdTech,2010,https://wilsonandsons.com,Responsibility always positive key leave tell also human.,26,wilson-and-sons,2023,USD,324502,69173,255329,196924,58405,756,57649,3245,6490,51159,6206,218790,63149,155641,27041.83,324502,13.46,13.46,0.001,1068,25.31,17301.21,0.36,0.7868
853,Garner Reynolds and Odonnell,False,NG,New Henry,Mobility,2024,https://garnerreynoldsandodonnell.com,Watch better turn soon rock support effect stand general wind eat.,20,garner-reynolds-and-odonnell,2023,USD,3081629,1059007,2022622,899782,1122840,0,1122840,30816,61632,1061208,342051,1910543,95527,1815016,,3081629,20.0,43.67,0.042,3249,79.04,48609.85,7.04,0.6563
854,Bowers-Nguyen,False,ZA,Kaylaburgh,E-commerce,2010,https://bowers-nguyen.com,Next tell possible scientist send sit.,15,bowers-nguyen,2023,USD,2393797,326739,2067058,1506806,560252,0,560252,23937,47875,512377,130169,1486152,808866,677286,,2393797,1645.73,5552.72,0.0813,745,267.41,152964.53,0.85,0.8635
855,Kirk Inc,False,KE,Michaelside,Fintech,2009,https://kirkinc.com,First figure trial bed image perform police.,24,kirk-inc,2023,USD,1537531,706719,830812,763419,67393,30925,36468,15375,30750,5718,96132,941846,50110,891736,,1537531,172.75,523.42,0.0284,679,188.57,7286.08,13.19,0.5404
856,Harris-Chase,False,NG,Bellmouth,AI/ML,2014,https://harris-chase.com,Senior where follow born ok training record night.,17,harris-chase,2023,USD,446834,93182,353652,163094,190558,0,190558,4468,8936,181622,33144,441420,202030,239390,,446834,461.91,802.17,0.0315,1861,20.0,18998.14,1.74,0.7915
857,Medina Sanders and Dominguez,False,KE,North Christopher,AI/ML,2012,https://medinasandersanddominguez.com,Trip production system certainly future government card history suddenly save.,19,medina-sanders-and-dominguez,2023,USD,318484,153337,165147,201317,-36170,6999,-43169,3184,6369,-49538,12493,298938,98388,200550,,318484,769.06,1636.78,0.0732,314,84.33,27884.39,0.45,0.5185
858,Austin-Arellano,False,GB,Yvonnemouth,E-commerce,2024,https://austin-arellano.com,Early choice yeah ago difference.,15,austin-arellano,2023,USD,2385896,747001,1638895,496414,1142481,16289,1126192,23858,47717,1078475,37331,1275922,452724,823198,,2385896,1054.58,3470.67,0.2044,3035,65.5,49852.85,0.75,0.6869
859,Lucero Sanchez and Perez,False,EG,East Alexander,Fintech,2014,https://lucerosanchezandperez.com,Who tax low keep news your court.,20,lucero-sanchez-and-perez,2023,USD,1071112,296017,775095,501443,273652,0,273652,10711,21422,252230,74704,694529,34726,659803,,1071112,318.23,1102.62,0.0476,4462,20.0,17404.89,4.29,0.7236
860,Abbott PLC,False,ZA,Burtonfurt,IoT,2023,https://abbottplc.com,Religious word sound enjoy have tonight view.,21,abbott-plc,2023,USD,159436,40106,119330,90451,28879,6734,22145,1594,3188,18957,3772,138131,61539,76592,,159436,106.31,325.65,0.0325,664,20.0,25598.75,0.15,0.7485
861,Fernandez-Jones,False,FR,West Michelle,AI/ML,2022,https://fernandez-jones.com,Somebody often benefit true world remain movement.,26,fernandez-jones,2023,EUR,678168,345228,332940,276949,55991,0,55991,6781,13563,42428,299161,666468,33323,633145,,678168,20.0,10.0,0.1235,491,115.06,24984.95,11.97,0.4909
862,Aguirre PLC,False,AU,Lake Michael,SaaS,2022,https://aguirreplc.com,Start difference especially student least just opportunity ask yet against.,21,aguirre-plc,2023,USD,4055770,1448304,2607466,1421901,1185565,19371,1166194,40557,81115,1085079,172829,2222128,1999915,222213,337980.83,4055770,159.74,1227.76,0.0362,5031,67.17,88117.26,1.96,0.6429
863,Hansen-Brown,False,GB,Thomasberg,AI/ML,2021,https://hansen-brown.com,Radio assume rest now water.,29,hansen-brown,2023,USD,1391964,655087,736877,679875,57002,6662,50340,13919,27839,22501,17120,865365,567406,297959,,1391964,159.57,563.91,0.1339,415,278.94,14175.71,1.21,0.5294
864,Johnson Harper and Jordan,False,EG,South Jason,IoT,2009,https://johnsonharperandjordan.com,Finally recent fight discussion sometimes meet imagine short woman.,22,johnson-harper-and-jordan,2023,USD,322440,133068,189372,108936,80436,0,80436,3224,6448,73988,8926,289464,93714,195750,,322440,760.39,459.81,0.0673,217,123.51,38042.14,0.23,0.5873
865,Edwards Smith and Lynch,False,NG,Brianaland,Mobility,2017,https://edwardssmithandlynch.com,As including claim create woman similar writer structure ahead up rock.,16,edwards-smith-and-lynch,2023,USD,420820,162856,257964,325577,-67613,0,-67613,4208,8416,-76029,46727,285208,87158,198050,,420820,623.18,958.22,0.001,1753,20.0,27593.07,1.69,0.613
866,Davis-Shah,False,ZA,Ballardfurt,SaaS,2020,https://davis-shah.com,Catch gas benefit great religious these matter continue husband.,23,davis-shah,2023,USD,369597,119707,249890,293577,-43687,32511,-76198,3695,7391,-83589,20111,324459,219257,105202,30799.75,369597,431.3,1744.88,0.0433,1391,22.14,57000.98,0.35,0.6761
867,Bell Ltd,False,IN,West Shannonville,SaaS,2014,https://bellltd.com,Election these article news radio believe ability world actually force.,26,bell-ltd,2023,USD,320863,140549,180314,273536,-93222,0,-93222,3208,6417,-99639,11614,307407,149776,157631,26738.58,320863,664.95,3342.85,0.0525,5347,5.0,7621.36,1.52,0.562
868,Johnson-Stein,False,KE,Micheleburgh,Fintech,2009,https://johnson-stein.com,Pm marriage movement wish best raise.,20,johnson-stein,2023,USD,2101103,1240135,860968,968642,-107674,27815,-135489,21011,42022,-177511,140821,1255534,62776,1192758,,2101103,26.13,37.87,0.0071,8754,20.0,103212.45,1.36,0.4098
869,Greene PLC,False,TN,South Jasmine,E-commerce,2010,https://greeneplc.com,Medical sport knowledge performance very thousand.,24,greene-plc,2023,USD,203727,75591,128136,118114,10022,0,10022,2037,4074,5948,8118,177684,60748,116936,,203727,1243.16,2813.26,0.0406,848,20.0,9650.52,0.84,0.629
870,Aguirre LLC,False,NG,Danielburgh,SaaS,2010,https://aguirrellc.com,Million too marriage page young turn visit up nature home.,17,aguirre-llc,2023,USD,1887169,773866,1113303,94358,1018945,4316,1014629,18871,37743,976886,42494,1151280,274427,876853,157264.08,1887169,638.49,638.49,0.0244,17952,8.76,22657.66,1.88,0.5899
871,Raymond-Barnett,False,EG,West Johnberg,SaaS,2017,https://raymond-barnett.com,Whether make some among around word lose.,12,raymond-barnett,2023,USD,1619458,354250,1265208,80972,1184236,12063,1172173,16194,32389,1139784,29932,900411,338864,561547,134954.83,1619458,136.01,840.94,0.0098,2006,67.26,22364.47,1.34,0.7813
872,Zimmerman Combs and Garcia,False,TN,Lake Dianahaven,HealthTech,2012,https://zimmermancombsandgarcia.com,Offer mother hour national cut fly language cup want international.,18,zimmerman-combs-and-garcia,2023,USD,279767,127564,152203,246675,-94472,0,-94472,2797,5595,-100067,15813,300669,85935,214734,23313.92,279767,10.0,25.01,0.037,449,51.91,1000.0,15.81,0.544
873,Bennett-Henry,False,AU,Garciaside,Marketplaces,2021,https://bennett-henry.com,Participant fill yeah side side recognize month among water.,21,bennett-henry,2023,USD,1292429,424118,868311,798891,69420,9952,59468,12924,25848,33620,107315,868616,460663,407953,,1292429,1687.11,3994.74,0.0374,1207,89.17,48638.56,2.21,0.6718
874,Mcclain-Adkins,False,CA,Lake Lee,Energy,2022,https://mcclain-adkins.com,Move another field could who.,19,mcclain-adkins,2023,USD,1062284,451429,610855,53114,557741,13119,544622,10622,21245,523377,32199,761484,510783,250701,,1062284,20.0,120.21,0.1288,487,181.53,5375.81,5.99,0.575
875,Colon Ltd,False,TN,Rodgershaven,Energy,2010,https://colonltd.com,Meet race and Democrat lead control.,26,colon-ltd,2023,USD,4933746,1400192,3533554,246687,3286867,0,3286867,49337,98674,3188193,1390505,4053704,209917,3843787,,4933746,371.76,2357.59,0.1602,20557,20.0,33561.88,41.43,0.7162
876,Joseph Inc,False,BR,South Jamie,Marketplaces,2012,https://josephinc.com,Administration two deal ready under above drive sport story worker would.,23,joseph-inc,2023,USD,289443,147556,141887,83793,58094,33489,24605,2894,5788,18817,11503,333604,126812,206792,,289443,20.0,162.57,0.001,111,216.2,11472.71,1.0,0.4902
877,Watson Group,False,BR,East Donaldbury,E-commerce,2011,https://watsongroup.com,Protect think institution now tell phone daughter these say evening real.,21,watson-group,2023,USD,600402,302930,297472,513459,-215987,0,-215987,6004,12008,-227995,5794,343072,141870,201202,,600402,415.43,1227.75,0.0672,2501,20.0,80292.76,0.07,0.4955
878,Colon-Bennett,False,GB,Port Kimberly,AI/ML,2020,https://colon-bennett.com,Outside phone house receive last production development.,15,colon-bennett,2023,USD,988765,437184,551581,314825,236756,6428,230328,9887,19775,210553,44339,634726,31736,602990,,988765,1073.2,536.6,0.0579,538,153.03,24189.86,1.83,0.5578
879,Wilson Moore and Moody,False,NG,East Amandaburgh,HealthTech,2015,https://wilsonmooreandmoody.com,Western resource reason expect expert talk end.,19,wilson-moore-and-moody,2023,USD,1827955,890522,937433,733489,203944,10849,193095,18279,36559,156536,268453,1189511,154754,1034757,152329.58,1827955,465.95,850.19,0.0376,1460,104.3,20598.41,13.03,0.5128
880,Foster and Sons,False,US,New Meghanborough,SaaS,2017,https://fosterandsons.com,Million along long born also hold.,20,foster-and-sons,2023,USD,503042,171947,331095,232056,99039,3571,95468,5030,10060,85408,67520,433714,147380,286334,41920.17,503042,526.28,526.28,0.0463,1376,30.46,8315.35,8.12,0.6582
881,Farmer Inc,False,EG,South Christina,Marketplaces,2021,https://farmerinc.com,Scene kind shoulder production mean window shoulder right analysis.,24,farmer-inc,2023,USD,90230,29289,60941,41916,19025,0,19025,902,1804,17221,12557,83765,20471,63294,,90230,1008.94,2783.38,0.0325,71,104.86,1383.85,9.07,0.6754
882,Fry LLC,False,NG,Sandrastad,Energy,2015,https://fryllc.com,Customer popular hospital check factor as contain create price.,22,fry-llc,2023,USD,788413,189596,598817,299861,298956,0,298956,7884,15768,283188,30787,440528,141159,299369,,788413,1963.51,10967.47,0.0173,3285,20.0,20837.3,1.48,0.7595
883,Johnson-Alexander,False,DE,New Allison,Mobility,2019,https://johnson-alexander.com,Claim natural fish born assume million admit result right focus.,22,johnson-alexander,2023,EUR,1428690,426686,1002004,695302,306702,0,306702,14286,28573,278129,66360,935441,125181,810260,,1428690,20.0,76.57,0.0625,789,150.84,68135.16,0.97,0.7013
884,Thomas Inc,False,GB,North Patrick,AgriTech,2014,https://thomasinc.com,Around hold note tax several along nation after station live.,27,thomas-inc,2023,USD,723142,373701,349441,678257,-328816,5315,-334131,7231,14462,-348593,21021,482413,52026,430387,,723142,760.92,2499.25,0.0834,2589,23.27,38056.69,0.55,0.4832
885,Newman Campbell and Jensen,False,ZA,Kentbury,Fintech,2009,https://newmancampbellandjensen.com,Partner generation write lawyer try check movie growth certain.,23,newman-campbell-and-jensen,2023,USD,4221053,831731,3389322,835342,2553980,38949,2515031,42210,84421,2430610,331510,2457141,766269,1690872,,4221053,1727.1,8582.28,0.0895,15247,23.07,85357.36,3.88,0.803
886,Simon Mccarty and Price,False,AU,Nicolestad,Marketplaces,2021,https://simonmccartyandprice.com,It feel amount improve.,30,simon-mccarty-and-price,2023,USD,1058595,626829,431766,487988,-56222,16545,-72767,10585,21171,-93938,12404,586465,337648,248817,,1058595,20.0,45.37,0.1323,4410,20.0,37433.38,0.33,0.4079
887,Christian Archer and Martinez,False,KE,Jaredfurt,SaaS,2015,https://christianarcherandmartinez.com,Third leave laugh weight less full program card morning.,18,christian-archer-and-martinez,2023,USD,241130,49966,191164,108280,82884,7152,75732,2411,4822,70910,20745,307831,141178,166653,20094.17,241130,560.15,2472.97,0.001,1797,11.18,19456.83,1.07,0.7928
888,Robinson and Sons,False,DE,Port Jessica,Fintech,2011,https://robinsonandsons.com,Guy leg television society hear fill hotel like myself laugh toward.,20,robinson-and-sons,2023,EUR,689600,175742,513858,621163,-107305,0,-107305,6896,13792,-121097,36491,486185,24309,461876,,689600,807.94,3358.42,0.0576,325,176.7,70772.38,0.52,0.7452
889,Jenkins Gonzalez and Morgan,False,KE,Lake Patrick,SaaS,2022,https://jenkinsgonzalezandmorgan.com,It wall agency deal note common worker quite shoulder political.,18,jenkins-gonzalez-and-morgan,2023,USD,957095,305754,651341,293649,357692,0,357692,9570,19141,338551,57682,697584,63255,634329,79757.92,957095,466.78,4244.01,0.0814,1502,53.09,14020.33,4.11,0.6805
890,Casey Gonzalez and Jenkins,False,KE,Sanchezberg,Marketplaces,2009,https://caseygonzalezandjenkins.com,First usually partner same then put skin beat across.,14,casey-gonzalez-and-jenkins,2023,USD,189632,76641,112991,29336,83655,3543,80112,1896,3792,76320,23117,237952,149181,88771,,189632,601.46,2391.5,0.0151,310,50.95,2518.81,9.18,0.5958
891,Rivera Inc,False,DE,Sarahstad,Cybersecurity,2009,https://riverainc.com,Season when film at perhaps firm.,18,rivera-inc,2023,EUR,2344594,323808,2020786,1613727,407059,0,407059,23445,46891,360168,123543,1394577,528108,866469,,2344594,1326.02,6540.32,0.0746,1179,165.59,111925.43,1.1,0.8619
892,Alvarez-Padilla,False,TN,Kevinside,Mobility,2015,https://alvarez-padilla.com,Too charge indeed mother peace citizen.,22,alvarez-padilla,2023,USD,9058724,3639379,5419345,1417367,4001978,2513,3999465,90587,181174,3818291,418634,4968901,2253179,2715722,,9058724,311.31,1041.75,0.078,8800,85.78,143760.22,2.91,0.5982
893,Fuller Graves and Campbell,False,NG,North Elizabeth,EdTech,2009,https://fullergravesandcampbell.com,Training best always they list local.,15,fuller-graves-and-campbell,2023,USD,242491,59393,183098,16610,166488,33211,133277,2424,4849,128428,28497,170779,8538,162241,20207.58,242491,520.61,2421.55,0.0476,238,84.63,15321.1,1.86,0.7551
894,Willis LLC,False,GB,Richardsburgh,AI/ML,2017,https://willisllc.com,Thus wife water note those write though attention career.,23,willis-llc,2023,USD,1968352,738371,1229981,959243,270738,16332,254406,19683,39367,215039,27617,1204991,299541,905450,,1968352,20.0,85.64,0.001,776,211.21,64867.95,0.43,0.6249
895,Byrd-Rangel,False,DE,Port Susanborough,Cybersecurity,2018,https://byrd-rangel.com,Factor society skill great worker manager perform opportunity.,18,byrd-rangel,2023,EUR,1277803,236953,1040850,265441,775409,0,775409,12778,25556,749853,16673,667249,33362,633887,,1277803,1047.63,3758.93,0.001,576,184.57,1226.75,13.59,0.8146
896,Diaz LLC,False,KE,New Juan,IoT,2018,https://diazllc.com,Toward age five cold power red enjoy you front evening.,21,diaz-llc,2023,USD,903537,452731,450806,427978,22828,0,22828,9035,18070,4758,42636,645099,204603,440496,,903537,356.09,1030.3,0.0092,808,93.15,78093.59,0.55,0.4989
897,Ellis Miller and Arnold,False,DE,Port Tiffany,AgriTech,2012,https://ellismillerandarnold.com,Action off few current like home receive establish heart happen mention.,12,ellis-miller-and-arnold,2023,EUR,430896,106798,324098,196783,127315,13013,114302,4308,8617,105685,37377,268038,26411,241627,,430896,2524.61,11394.5,0.1414,1795,20.0,34503.89,1.08,0.7521
898,Russell-Peterson,False,BR,Jenniferside,AI/ML,2015,https://russell-peterson.com,Major entire tree try be program.,16,russell-peterson,2023,USD,384986,130672,254314,60184,194130,0,194130,3849,7699,186431,47202,334019,124336,209683,,384986,793.39,3591.51,0.0272,528,60.72,15066.83,3.13,0.6606
899,Hensley-Huang,False,TN,Port Davidville,AgriTech,2016,https://hensley-huang.com,Avoid health child soon single tell act.,26,hensley-huang,2023,USD,349500,142538,206962,90941,116021,0,116021,3495,6990,109031,44982,221812,74111,147701,,349500,596.57,1991.75,0.001,1456,20.0,1000.0,44.98,0.5922
900,Doyle LLC,False,US,East Brandimouth,AI/ML,2013,https://doylellc.com,Them skill black business region current second ball begin week about.,19,doyle-llc,2023,USD,449923,76277,373646,195218,178428,4945,173483,4499,8998,164485,8014,384856,41746,343110,,449923,1299.67,3378.17,0.0565,205,182.68,1000.0,8.01,0.8305
901,Hall Williams and Miller,False,BR,Colleenborough,Marketplaces,2021,https://hallwilliamsandmiller.com,Stage remain manager relationship light rule option team kind.,18,hall-williams-and-miller,2023,USD,750183,206773,543410,268044,275366,2523,272843,7501,15003,257840,13826,472996,140120,332876,,750183,20.0,88.01,0.0025,259,241.37,24458.45,0.57,0.7244
902,Smith Thompson and Gonzalez,False,NG,New Barbara,Mobility,2009,https://smiththompsonandgonzalez.com,Record reflect away cost focus yeah.,21,smith-thompson-and-gonzalez,2023,USD,1890823,567604,1323219,1184198,139021,9706,129315,18908,37816,91499,100037,1232798,61639,1171159,,1890823,865.47,2690.71,0.0465,7878,20.0,117542.88,0.85,0.6998
903,Foster PLC,False,CA,Carolynhaven,Marketplaces,2020,https://fosterplc.com,Design economy general drive according three raise.,23,foster-plc,2023,USD,1566381,647051,919330,683740,235590,2116,233474,15663,31327,202147,78065,927676,366057,561619,,1566381,20.0,60.04,0.05,6526,20.0,77058.81,1.01,0.5869
904,Webster-Brown,False,AU,South Maxton,AI/ML,2018,https://webster-brown.com,Sense involve purpose together knowledge with purpose five sign trial recently.,18,webster-brown,2023,USD,1780801,767850,1012951,1149193,-136242,3413,-139655,17808,35616,-175271,117717,1058485,520283,538202,,1780801,20.0,66.96,0.0076,923,160.78,96114.66,1.22,0.5688
905,Gregory Jones and Baker,False,ZA,Shannonfort,Energy,2021,https://gregoryjonesandbaker.com,Matter shake finish yourself couple onto amount good.,23,gregory-jones-and-baker,2023,USD,461490,188186,273304,378564,-105260,20176,-125436,4614,9229,-134665,53073,432434,202179,230255,,461490,20.0,63.17,0.0912,249,154.25,12595.82,4.21,0.5922
906,Hobbs-Nguyen,False,GB,Fordmouth,AgriTech,2020,https://hobbs-nguyen.com,Check scene history wear them small high that change.,24,hobbs-nguyen,2023,USD,1028405,190092,838313,416324,421989,23442,398547,10284,20568,377979,11498,658544,95688,562856,,1028405,543.56,2156.24,0.0728,316,270.61,46506.97,0.25,0.8152
907,Smith-Moody,False,GB,East Brittany,AI/ML,2023,https://smith-moody.com,Describe administration line even cup market.,18,smith-moody,2023,USD,529998,129030,400968,279648,121320,9384,111936,5299,10599,101337,20181,381601,267542,114059,,529998,594.12,1085.64,0.0939,2208,20.0,17095.12,1.18,0.7565
908,Torres PLC,False,DE,Jeremyfort,EdTech,2017,https://torresplc.com,Rich item water civil why art which at follow live.,27,torres-plc,2023,EUR,456659,130094,326565,49701,276864,616,276248,4566,9133,267115,97343,423081,108000,315081,38054.92,456659,444.64,1859.11,0.054,1115,34.12,37527.01,2.59,0.7151
909,Thomas-Stone,False,ZA,Larachester,HealthTech,2022,https://thomas-stone.com,Actually final city piece range investment business can example.,20,thomas-stone,2023,USD,1294503,429035,865468,910747,-45279,21393,-66672,12945,25890,-92562,33435,742522,183644,558878,107875.25,1294503,84.25,84.25,0.0219,996,108.23,92056.97,0.36,0.6686
910,Brooks Barker and Anderson,False,US,Brownmouth,AI/ML,2021,https://brooksbarkerandanderson.com,Indicate decide for do the fine trouble win.,16,brooks-barker-and-anderson,2023,USD,1613111,300133,1312978,716720,596258,8019,588239,16131,32262,555977,163882,1094088,577798,516290,,1613111,1970.27,3186.08,0.0178,644,208.58,59220.1,2.77,0.8139
911,Peters-Ray,False,TN,Hollyberg,AI/ML,2024,https://peters-ray.com,Sit occur treat remain participant spend eat none.,20,peters-ray,2023,USD,754790,335886,418904,521092,-102188,12145,-114333,7547,15095,-129428,37848,450412,190435,259977,,754790,208.2,654.34,0.0393,3144,20.0,74082.46,0.51,0.555
912,Edwards Inc,False,GB,Christensenmouth,Energy,2015,https://edwardsinc.com,More leg too water road.,22,edwards-inc,2023,USD,3112609,827707,2284902,1093207,1191695,14583,1177112,31126,62252,1114860,302818,1861903,579805,1282098,,3112609,1870.98,6808.25,0.0671,2195,118.16,72897.65,4.15,0.7341
913,Cole and Sons,False,IN,Jenniferstad,EdTech,2018,https://coleandsons.com,Listen development able green per.,23,cole-and-sons,2023,USD,411062,162719,248343,20553,227790,0,227790,4110,8221,219569,61326,372932,18646,354286,34255.17,411062,330.95,1142.52,0.0816,522,65.57,24741.51,2.48,0.6041
914,Thomas Nelson and Flores,False,BR,Cassandraside,Fintech,2022,https://thomasnelsonandflores.com,Station position whatever our build safe.,13,thomas-nelson-and-flores,2023,USD,284745,113806,170939,125958,44981,0,44981,2847,5694,39287,77504,290759,39870,250889,,284745,1091.16,2824.57,0.0739,157,150.96,1000.0,77.5,0.6003
915,Dyer Mills and Gordon,False,CA,Port Nicholas,Fintech,2014,https://dyermillsandgordon.com,Fear daughter fast agreement.,16,dyer-mills-and-gordon,2023,USD,9847492,4898686,4948806,8518374,-3569568,29288,-3598856,98474,196949,-3795805,253681,5289875,264493,5025382,,9847492,20.0,92.03,0.0046,4301,190.78,697629.03,0.36,0.5025
916,Farmer Miller and Marshall,False,US,South Connie,AgriTech,2020,https://farmermillerandmarshall.com,Church know finish view lay cup paper expect only follow.,18,farmer-miller-and-marshall,2023,USD,81386,28233,53153,16399,36754,34961,1793,813,1627,166,3935,167591,19656,147935,,81386,20.0,149.23,0.0421,63,106.68,17749.18,0.22,0.6531
917,Martinez LLC,False,BR,Woodmouth,IoT,2009,https://martinezllc.com,Nearly pick position how force structure alone executive.,19,martinez-llc,2023,USD,77105,31520,45585,47772,-2187,0,-2187,771,1542,-3729,3146,149543,61606,87937,,77105,935.91,3359.6,0.0402,34,188.85,15759.52,0.2,0.5912
918,Avila Williams and Hunt,False,FR,South Caleb,EdTech,2014,https://avilawilliamsandhunt.com,Cause bill clear research begin.,20,avila-williams-and-hunt,2023,EUR,169675,62912,106763,8483,98280,14102,84178,1696,3393,80785,21656,263028,13151,249877,14139.58,169675,131.06,271.99,0.001,291,48.5,1000.0,21.66,0.6292
919,Compton-Morgan,False,EG,Cooperland,EdTech,2018,https://compton-morgan.com,Hundred artist indicate smile reason nature become debate city.,21,compton-morgan,2023,USD,214547,108307,106240,63243,42997,35106,7891,2145,4290,3601,10410,169091,37135,131956,17878.92,214547,229.06,350.37,0.0189,673,26.53,1000.0,10.41,0.4952
920,Perez-Brown,False,IN,North Dawnbury,SaaS,2014,https://perez-brown.com,Amount despite discussion check that may follow series prove.,20,perez-brown,2023,USD,249006,71583,177423,117046,60377,0,60377,2490,4980,55397,7538,233126,92832,140294,20750.5,249006,653.62,2413.3,0.0138,279,74.16,13215.19,0.57,0.7125
921,Dixon LLC,False,DE,Johnsonchester,Cybersecurity,2011,https://dixonllc.com,Attack customer along director man glass ball think meeting stock.,13,dixon-llc,2023,EUR,3493773,1151475,2342298,738173,1604125,0,1604125,34937,69875,1534250,51506,1957674,1023625,934049,,3493773,937.42,4339.51,0.034,2073,140.39,86349.7,0.6,0.6704
922,Lewis-Herrera,False,ZA,Josephstad,Mobility,2015,https://lewis-herrera.com,Home strong senior eight cultural today hotel practice later knowledge.,27,lewis-herrera,2023,USD,2550988,1272413,1278575,1655014,-376439,0,-376439,25509,51019,-427458,116297,1462376,459212,1003164,,2550988,928.58,3220.43,0.0352,3118,68.17,139730.11,0.83,0.5012
923,Powers Carrillo and Harris,False,ZA,North Paulville,IoT,2014,https://powerscarrilloandharris.com,Customer now section strategy purpose though.,22,powers-carrillo-and-harris,2023,USD,2573686,530921,2042765,142033,1900732,0,1900732,25736,51473,1849259,37935,1472314,139511,1332803,,2573686,1222.36,4425.96,0.0423,1852,115.77,1000.0,37.94,0.7937
924,Ward-Brown,False,TN,New Pamela,EdTech,2018,https://ward-brown.com,Describe agency actually stop team deal water.,21,ward-brown,2023,USD,754656,168832,585824,492169,93655,29544,64111,7546,15093,49018,174783,736279,36813,699466,62888.0,754656,10.0,36.76,0.0377,457,137.37,35240.92,4.96,0.7763
925,Cortez-Ellis,False,AU,Guzmanburgh,AgriTech,2020,https://cortez-ellis.com,Lose others some project visit back blue a all.,26,cortez-ellis,2023,USD,1184856,523826,661030,971141,-310111,0,-310111,11848,23697,-333808,81370,846575,322586,523989,,1184856,710.81,987.74,0.0572,720,137.07,62131.07,1.31,0.5579
926,Vincent LLC,False,EG,West Seanshire,AI/ML,2019,https://vincentllc.com,Best happy position wife score health.,21,vincent-llc,2023,USD,348782,128923,219859,130541,89318,0,89318,3487,6975,82343,2797,358091,173508,184583,,348782,20.0,109.88,0.1324,209,138.88,8688.47,0.32,0.6304
927,Butler-Johnson,False,IN,North Kevinview,AgriTech,2019,https://butler-johnson.com,Us thought song daughter try season radio air use.,11,butler-johnson,2023,USD,2401265,601406,1799859,316907,1482952,0,1482952,24012,48025,1434927,153416,1508876,75443,1433433,,2401265,20.0,29.66,0.001,1240,161.29,23638.9,6.49,0.7495
928,Thompson-Rodriguez,False,NG,South Molly,Mobility,2022,https://thompson-rodriguez.com,Reason event against none as reality democratic huge help also.,21,thompson-rodriguez,2023,USD,2866733,734891,2131842,1374252,757590,0,757590,28667,57334,700256,331415,1865658,608795,1256863,,2866733,670.39,1549.1,0.0091,1049,227.53,79102.47,4.19,0.7436
929,Rivas-Gutierrez,False,FR,New Phyllisland,Cybersecurity,2023,https://rivas-gutierrez.com,Report rest dark environment provide white could.,22,rivas-gutierrez,2023,EUR,2395317,921363,1473954,782029,691925,29820,662105,23953,47906,614199,43572,1324443,198751,1125692,,2395317,20.0,66.84,0.001,1129,176.8,88633.67,0.49,0.6153
930,West Smith and Santos,False,AU,Hansenfort,E-commerce,2014,https://westsmithandsantos.com,Resource score expert because happen star name.,21,west-smith-and-santos,2023,USD,900709,491659,409050,196712,212338,795,211543,9007,18014,193529,26913,496228,88417,407811,,900709,141.05,347.96,0.0175,3752,20.0,1229.39,21.89,0.4541
931,Hopkins-Watson,False,CA,West Jill,E-commerce,2021,https://hopkins-watson.com,Imagine oil head work should challenge pull threat.,28,hopkins-watson,2023,USD,732518,271121,461397,271709,189688,28173,161515,7325,14650,146865,60876,596155,29807,566348,,732518,1576.78,8758.39,0.001,220,277.15,1647.03,36.96,0.6299
932,Daniels Ward and Reynolds,False,US,Nicolemouth,IoT,2015,https://danielswardandreynolds.com,Population late much quite threat gas truth work.,17,daniels-ward-and-reynolds,2023,USD,242053,116608,125445,12102,113343,25650,87693,2420,4841,82852,28912,210630,28639,181991,,242053,655.07,327.54,0.088,152,132.06,1000.0,28.91,0.5183
933,George PLC,False,ZA,Port Lauren,HealthTech,2008,https://georgeplc.com,With society station how statement thing.,20,george-plc,2023,USD,260566,55490,205076,139930,65146,0,65146,2605,5211,59935,11828,308218,207293,100925,21713.83,260566,10.0,47.01,0.0715,406,53.45,28903.06,0.41,0.787
934,Stephens Stone and Johnston,False,IN,Sarahburgh,AI/ML,2021,https://stephensstoneandjohnston.com,Range skin major for student health view.,18,stephens-stone-and-johnston,2023,USD,303551,19551,284000,117698,166302,17213,149089,3035,6071,143018,21499,278637,75149,203488,,303551,1002.22,2656.71,0.001,286,88.32,1000.0,21.5,0.9356
935,Sandoval Long and Ray,False,IN,Wattsville,HealthTech,2014,https://sandovallongandray.com,Policy law strong time could a soldier.,25,sandoval-long-and-ray,2023,USD,1183249,639460,543789,231266,312523,0,312523,11832,23664,288859,71091,795722,567954,227768,98604.08,1183249,667.16,2769.26,0.0447,19720,5.0,52790.54,1.35,0.4596
936,Marsh Simpson and Moon,False,CA,Johnfurt,EdTech,2020,https://marshsimpsonandmoon.com,Stay my benefit sport age all building.,20,marsh-simpson-and-moon,2023,USD,662585,175014,487571,290780,196791,0,196791,6625,13251,183540,50879,568251,381163,187088,55215.42,662585,88.59,88.59,0.001,613,90.02,14596.35,3.49,0.7359
937,Carey Ltd,False,KE,North Jonville,EdTech,2023,https://careyltd.com,War product action our gas heart field people try.,25,carey-ltd,2023,USD,328949,80044,248905,136452,112453,5407,107046,3289,6578,100468,60649,327304,196344,130960,27412.42,328949,10.0,37.64,0.0085,918,29.83,18266.53,3.32,0.7567
938,Mendez Williams and Henry,False,NG,South Luistown,Marketplaces,2018,https://mendezwilliamsandhenry.com,Red technology himself much better read per.,18,mendez-williams-and-henry,2023,USD,1073405,223035,850370,540643,309727,22446,287281,10734,21468,265813,18346,596530,388846,207684,,1073405,528.55,3292.64,0.1172,613,145.85,58080.2,0.32,0.7922
939,Avery-Cohen,False,IN,South Benjaminfort,Mobility,2023,https://avery-cohen.com,Little myself bar right resource.,25,avery-cohen,2023,USD,697640,239561,458079,156564,301515,0,301515,6976,13952,287563,24175,505151,112617,392534,,697640,1152.72,3324.93,0.0552,168,344.73,1000.0,24.18,0.6566
940,Gibson Ltd,False,EG,Johnfort,HealthTech,2019,https://gibsonltd.com,Follow need region later party.,16,gibson-ltd,2023,USD,1976203,904469,1071734,1029350,42384,19355,23029,19762,39524,-16495,13039,1189931,439894,750037,164683.58,1976203,10.0,23.91,0.0376,8181,20.13,109650.02,0.12,0.5423
941,Smith and Sons,False,GB,New Seanhaven,HealthTech,2023,https://smithandsons.com,Leg recent hold understand president any.,26,smith-and-sons,2023,USD,751356,275798,475558,648607,-173049,21574,-194623,7513,15027,-209650,95887,496479,147533,348946,62613.0,751356,50.3,210.85,0.001,12522,5.0,82495.05,1.16,0.6329
942,Wilson Black and Thompson,False,GB,Carterburgh,AI/ML,2009,https://wilsonblackandthompson.com,Face former body choice study.,14,wilson-black-and-thompson,2023,USD,5199491,2123240,3076251,1059473,2016778,27861,1988917,51994,103989,1884928,206263,2833793,206022,2627771,,5199491,252.81,1014.04,0.001,11666,37.14,72906.17,2.83,0.5916
943,Olson and Sons,False,NG,South Kimberlyburgh,SaaS,2010,https://olsonandsons.com,Analysis consumer future raise suffer director know red.,25,olson-and-sons,2023,USD,571532,108599,462933,726434,-263501,20666,-284167,5715,11430,-295597,21880,375210,196537,178673,47627.67,571532,72.38,99.29,0.0586,1577,30.19,59641.47,0.37,0.81
944,Garcia and Sons,False,BR,Lake Tiffany,SaaS,2008,https://garciaandsons.com,None just happen recognize after modern really play blood list.,13,garcia-and-sons,2023,USD,1482211,372731,1109480,499166,610314,14714,595600,14822,29644,565956,68361,930698,190895,739803,123517.58,1482211,237.91,372.57,0.0062,24703,5.0,50979.27,1.34,0.7485
945,Graham-Miles,False,TN,North Christopherstad,HealthTech,2015,https://graham-miles.com,Husband try trade then building class now professor land.,18,graham-miles,2023,USD,2958263,910421,2047842,2826114,-778272,19798,-798070,29582,59165,-857235,58279,1649579,420196,1229383,246521.92,2958263,530.85,1660.77,0.001,3585,68.76,239103.42,0.24,0.6922
946,Brooks Baker and Jones,False,FR,New Robert,Cybersecurity,2012,https://brooksbakerandjones.com,Always dark feel second hospital head member activity modern entire.,17,brooks-baker-and-jones,2023,EUR,3876865,1630081,2246784,1248150,998634,38321,960313,38768,77537,882776,372086,2366437,1840275,526162,,3876865,525.14,1417.41,0.0447,16153,20.0,121409.01,3.06,0.5795
947,Smith Beard and Taylor,False,US,Port Timothy,EdTech,2024,https://smithbeardandtaylor.com,Country listen long between hold plant.,17,smith-beard-and-taylor,2023,USD,142525,69076,73449,73617,-168,17744,-17912,1425,2850,-20762,22523,255549,191222,64327,11877.08,142525,283.27,470.23,0.034,206,57.61,26085.39,0.86,0.5153
948,Trevino Jones and Estrada,False,EG,Port Kathleen,E-commerce,2009,https://trevinojonesandestrada.com,Message would not east send style gun different energy.,26,trevino-jones-and-estrada,2023,USD,177631,65543,112088,34691,77397,12965,64432,1776,3552,60880,3111,232255,128128,104127,,177631,551.93,1583.23,0.0497,740,20.0,1000.0,3.11,0.631
949,Goodwin Inc,False,KE,Kimberlytown,Marketplaces,2023,https://goodwininc.com,Public us hospital paper term security.,19,goodwin-inc,2023,USD,312676,122689,189987,169588,20399,11251,9148,3126,6253,2895,3867,244172,30787,213385,,312676,20.0,88.79,0.0477,1302,20.0,1000.0,3.87,0.6076
950,Mendoza PLC,False,BR,Lucasburgh,Mobility,2008,https://mendozaplc.com,Out explain significant item all at be.,25,mendoza-plc,2023,USD,2572607,1058683,1513924,621845,892079,22378,869701,25726,51452,818249,176895,1509136,1283742,225394,,2572607,20.0,34.65,0.001,2082,102.94,83960.8,2.11,0.5885
951,Mejia Inc,False,US,Joshuaview,AI/ML,2021,https://mejiainc.com,Practice would game student painting try talk like maintain.,18,mejia-inc,2023,USD,733112,265000,468112,153888,314224,0,314224,7331,14662,299562,29701,422257,120674,301583,,733112,20.0,26.99,0.1054,3054,20.0,41529.76,0.72,0.6385
952,Lawrence Castro and Fleming,False,US,South Matthew,SaaS,2024,https://lawrencecastroandfleming.com,Window mouth pattern as pick various themselves organization direction.,22,lawrence-castro-and-fleming,2023,USD,2493158,335130,2158028,358461,1799567,0,1799567,24931,49863,1749704,138282,1498177,187488,1310689,207763.17,2493158,282.32,1214.27,0.067,41552,5.0,40840.71,3.39,0.8656
953,Solomon-Knight,False,ZA,Teresaborough,AgriTech,2017,https://solomon-knight.com,Military in enough interest probably shoulder three cause.,15,solomon-knight,2023,USD,92595,33845,58750,9156,49594,23199,26395,925,1851,24544,18024,246149,113595,132554,,92595,1333.97,5753.21,0.0967,24,315.68,9871.19,1.83,0.6345
954,Phillips Mcdaniel and Ward,False,US,Jamesmouth,AI/ML,2021,https://phillipsmcdanielandward.com,Minute bring reveal factor east our plant front thought special.,23,phillips-mcdaniel-and-ward,2023,USD,699552,269351,430201,280766,149435,0,149435,6995,13991,135444,23242,479620,52620,427000,,699552,20.0,121.51,0.0361,248,234.16,31094.56,0.75,0.615
955,Sanchez-Washington,False,AU,Sarahmouth,HealthTech,2011,https://sanchez-washington.com,Game effort author buy heavy nearly hotel at speech effort.,14,sanchez-washington,2023,USD,2796216,885401,1910815,1299393,611422,0,611422,27962,55924,555498,36741,1532154,881640,650514,233018.0,2796216,443.16,2606.9,0.037,17209,13.54,113143.68,0.32,0.6834
956,Gibson-Ewing,False,FR,Williamchester,AI/ML,2012,https://gibson-ewing.com,Enter word physical majority blue join.,16,gibson-ewing,2023,EUR,1042758,530541,512217,660910,-148693,9121,-157814,10427,20855,-178669,95007,693079,333507,359572,,1042758,20.0,112.08,0.001,1448,60.0,89457.35,1.06,0.4912
957,Wilson-White,False,DE,Kathleenton,EdTech,2024,https://wilson-white.com,Suggest everyone nature environmental six.,19,wilson-white,2023,EUR,1994490,485456,1509034,1393195,115839,5335,110504,19944,39889,70615,16379,1155605,258621,896984,166207.5,1994490,10.0,59.64,0.0171,3031,54.83,89486.6,0.18,0.7566
958,Mcdaniel Harris and Vance,False,IN,North Danielview,E-commerce,2016,https://mcdanielharrisandvance.com,Involve discover peace number environment need subject.,26,mcdaniel-harris-and-vance,2023,USD,449661,155100,294561,181421,113140,0,113140,4496,8993,104147,49315,453654,60103,393551,,449661,170.86,488.31,0.0609,1873,20.0,17887.51,2.76,0.6551
959,Johnson PLC,False,AU,Kathrynburgh,Energy,2010,https://johnsonplc.com,Data pattern west before science without especially main.,16,johnson-plc,2023,USD,1348007,303693,1044314,630380,413934,0,413934,13480,26960,386974,98480,950093,649466,300627,,1348007,1443.82,7038.18,0.001,5616,20.0,46126.04,2.14,0.7747
960,Sanchez Group,False,CA,East Stephen,Energy,2022,https://sanchezgroup.com,Throughout truth evidence about provide itself.,20,sanchez-group,2023,USD,506607,183722,322885,301471,21414,0,21414,5066,10132,11282,100095,531633,265569,266064,,506607,20.0,79.06,0.08,813,51.9,1000.0,100.1,0.6373
961,Atkinson Griffin and Hall,False,KE,South Jennifermouth,EdTech,2015,https://atkinsongriffinandhall.com,School his past herself must even.,15,atkinson-griffin-and-hall,2023,USD,829193,136068,693125,395267,297858,0,297858,8291,16583,281275,60596,500315,187631,312684,69099.42,829193,582.57,948.6,0.055,4486,15.4,49351.07,1.23,0.8359
962,Henry Clarke and Warren,False,IN,Andrewhaven,Marketplaces,2010,https://henryclarkeandwarren.com,Hold kind day certain back student raise collection identify design government.,20,henry-clarke-and-warren,2023,USD,291293,124809,166484,19871,146613,47354,99259,2912,5825,93434,4280,284183,64282,219901,,291293,1222.04,611.02,0.1045,124,194.65,25899.61,0.17,0.5715
963,Wright-Roberts,False,BR,South Caroline,Marketplaces,2009,https://wright-roberts.com,Whether rather none population ask require against occur growth.,22,wright-roberts,2023,USD,188652,51884,136768,107484,29284,0,29284,1886,3773,25511,13018,256354,102084,154270,,188652,164.8,225.67,0.0906,67,233.83,3317.71,3.92,0.725
964,Henry Ltd,False,FR,Blankenshipland,Energy,2020,https://henryltd.com,Effort direction hand young long collection table population out.,25,henry-ltd,2023,EUR,1652117,377230,1274887,1043424,231463,4344,227119,16521,33042,194077,38465,1017942,629947,387995,,1652117,20.0,118.57,0.0547,1223,112.51,84008.04,0.46,0.7717
965,Singleton Group,False,TN,Brandonbury,AI/ML,2023,https://singletongroup.com,Religious city past need economy.,15,singleton-group,2023,USD,1140573,557246,583327,502194,81133,24719,56414,11405,22811,33603,46293,765608,361222,404386,,1140573,20.0,121.72,0.001,1048,90.63,42084.23,1.1,0.5114
966,Frederick Chavez and Carter,False,US,Ramirezburgh,Marketplaces,2008,https://frederickchavezandcarter.com,Important coach at the per of situation.,19,frederick-chavez-and-carter,2023,USD,1125266,373834,751432,256936,494496,0,494496,11252,22505,471991,39653,755131,37756,717375,,1125266,1530.0,4172.71,0.014,1107,84.67,20118.41,1.97,0.6678
967,Thompson Kelley and Mcmahon,False,ZA,East Andre,HealthTech,2010,https://thompsonkelleyandmcmahon.com,Owner baby significant especially situation move.,27,thompson-kelley-and-mcmahon,2023,USD,899204,396947,502257,425335,76922,0,76922,8992,17984,58938,11066,549930,233355,316575,74933.67,899204,191.63,327.13,0.114,802,93.35,39337.54,0.28,0.5586
968,Tran-Wood,False,EG,East Amanda,Energy,2018,https://tran-wood.com,Early across talk short message again.,13,tran-wood,2023,USD,2104435,871532,1232903,1187404,45499,48041,-2542,21044,42088,-44630,627669,1834458,1637165,197293,,2104435,1324.39,5307.27,0.0638,742,236.06,122731.48,5.11,0.5859
969,Jacobson Long and Jackson,False,KE,Mooreberg,Fintech,2024,https://jacobsonlongandjackson.com,Technology strong off evidence early compare body.,20,jacobson-long-and-jackson,2023,USD,352704,43694,309010,90936,218074,0,218074,3527,7054,211020,58212,333466,122824,210642,,352704,384.26,866.08,0.001,1469,20.0,4516.33,12.89,0.8761
970,Martin PLC,False,US,North Tonyaberg,EdTech,2014,https://martinplc.com,Expert more majority senior.,22,martin-plc,2023,USD,582343,236277,346066,429497,-83431,6321,-89752,5823,11646,-101398,155926,558366,248874,309492,48528.58,582343,58.75,168.3,0.0157,2178,22.28,19188.52,8.13,0.5943
971,Weaver Powell and Warren,False,ZA,Kristinshire,IoT,2023,https://weaverpowellandwarren.com,Seem model imagine me matter source deal outside.,23,weaver-powell-and-warren,2023,USD,125023,46503,78520,72330,6190,0,6190,1250,2500,3690,9262,123429,20574,102855,,125023,1211.68,4727.82,0.057,72,143.31,54235.18,0.17,0.628
972,Wilkinson-Wilson,False,IN,Reyesport,SaaS,2010,https://wilkinson-wilson.com,Agency maintain seek democratic simple seek last opportunity.,23,wilkinson-wilson,2023,USD,1556220,424966,1131254,424755,706499,0,706499,15562,31124,675375,51566,910588,211074,699514,129685.0,1556220,498.67,1921.2,0.001,4610,28.13,17415.5,2.96,0.7269
973,Taylor Leon and Sanders,False,BR,North Rachel,AgriTech,2009,https://taylorleonandsanders.com,Education human require he daughter candidate where early certainly.,21,taylor-leon-and-sanders,2023,USD,103459,28689,74770,91828,-17058,17735,-34793,1034,2069,-36862,3120,253077,130337,122740,,103459,1423.72,4162.28,0.0962,137,62.49,1562.72,2.0,0.7227
974,Livingston Phillips and Brown,False,GB,Blankenshipchester,E-commerce,2008,https://livingstonphillipsandbrown.com,Our great mention local value.,23,livingston-phillips-and-brown,2023,USD,10633163,2836151,7797012,3596267,4200745,0,4200745,106331,212663,3988082,6304384,11743047,3867734,7875313,,10633163,38.41,143.3,0.0665,5312,166.8,305410.29,20.64,0.7333
975,Jones-Rivera,False,DE,Sandraburgh,IoT,2012,https://jones-rivera.com,Yeah certainly represent especially.,15,jones-rivera,2023,EUR,2035298,1126242,909056,733008,176048,14128,161920,20352,40705,121215,58853,1117414,230138,887276,,2035298,284.41,872.32,0.1045,979,173.19,58806.47,1.0,0.4466
976,Hicks Ltd,False,AU,Andrewfurt,Cybersecurity,2020,https://hicksltd.com,Sometimes least perform expect anything military but just.,16,hicks-ltd,2023,USD,1114984,310012,804972,621809,183163,11996,171167,11149,22299,148868,137227,698710,299254,399456,,1114984,631.04,2562.21,0.1012,4645,20.0,16303.97,8.42,0.722
977,Hamilton-Palmer,False,FR,East Sarahfurt,AgriTech,2013,https://hamilton-palmer.com,Produce key reveal environment central trip behavior himself.,23,hamilton-palmer,2023,EUR,1640408,332792,1307616,678328,629288,4018,625270,16404,32808,592462,161174,1064492,337522,726970,,1640408,20.0,109.72,0.0532,1776,76.93,40702.75,3.96,0.7971
978,Robinson-Williams,False,KE,East Jamesshire,EdTech,2020,https://robinson-williams.com,Individual stay charge natural effort trouble.,22,robinson-williams,2023,USD,1396334,431593,964741,460505,504236,0,504236,13963,27926,476310,39605,917348,134730,782618,116361.17,1396334,163.6,180.41,0.001,12772,9.11,39805.59,0.99,0.6909
979,Ritter and Sons,False,BR,West Jessicaland,AI/ML,2018,https://ritterandsons.com,Life wonder understand management bag least tonight.,21,ritter-and-sons,2023,USD,2704714,360789,2343925,264655,2079270,5213,2074057,27047,54094,2019963,312074,1721682,822290,899392,,2704714,227.71,113.86,0.0339,1385,162.63,55406.91,5.63,0.8666
980,Luna Watson and Harrison,False,TN,Barbaraside,Cybersecurity,2012,https://lunawatsonandharrison.com,Place force choose radio respond mind everything order.,25,luna-watson-and-harrison,2023,USD,537011,227888,309123,65797,243326,2827,240499,5370,10740,229759,109645,433953,166374,267579,,537011,20.0,64.27,0.0874,162,275.28,1000.0,109.64,0.5756
981,Perez Inc,False,AU,Webbmouth,Cybersecurity,2010,https://perezinc.com,Feel win yard anything option soon election station never such.,20,perez-inc,2023,USD,1249946,626004,623942,848386,-224444,5761,-230205,12499,24998,-255203,71182,712778,35638,677140,,1249946,611.05,998.62,0.001,828,125.74,69232.3,1.03,0.4992
982,Gilmore and Sons,False,NG,Steinville,Cybersecurity,2019,https://gilmoreandsons.com,Media include hundred note federal drug performance way production simple.,15,gilmore-and-sons,2023,USD,5020212,1653505,3366707,4478264,-1111557,20738,-1132295,50202,100404,-1232699,845356,3438090,2166377,1271713,,5020212,514.56,257.28,0.0894,3616,115.69,357471.02,2.36,0.6706
983,Graham Group,False,US,South Thomas,Fintech,2021,https://grahamgroup.com,Free have final main young.,21,graham-group,2023,USD,1559583,690435,869148,848128,21020,39369,-18349,15595,31191,-49540,371103,1255959,133823,1122136,,1559583,328.72,164.36,0.001,828,156.8,53006.36,7.0,0.5573
984,Chapman-Sullivan,False,DE,West John,Fintech,2018,https://chapman-sullivan.com,From our order table beyond bank.,18,chapman-sullivan,2023,EUR,1986210,424975,1561235,1063270,497965,27634,470331,19862,39724,430607,115862,1153586,281454,872132,,1986210,20.0,43.11,0.0391,1482,111.63,83927.67,1.38,0.786
985,Smith Fernandez and Vasquez,False,KE,Port Lindseyberg,IoT,2020,https://smithfernandezandvasquez.com,Able concern card worker happen.,20,smith-fernandez-and-vasquez,2023,USD,923794,383151,540643,557192,-16549,3342,-19891,9237,18475,-38366,33515,583150,223558,359592,,923794,454.96,1470.28,0.1312,304,253.13,24501.39,1.37,0.5852
986,Hull Graves and Wade,False,AU,North Frederickport,E-commerce,2008,https://hullgravesandwade.com,Beyond you bank always a two smile today.,20,hull-graves-and-wade,2023,USD,4284960,1139062,3145898,3673714,-527816,7677,-535493,42849,85699,-621192,177958,2486029,885244,1600785,,4284960,526.46,777.53,0.1599,17854,20.0,330182.17,0.54,0.7342
987,Rodriguez-Watkins,False,BR,Port Cheyenneberg,AgriTech,2022,https://rodriguez-watkins.com,Left system church simply method.,25,rodriguez-watkins,2023,USD,377232,86077,291155,149988,141167,6560,134607,3772,7544,127063,25214,347489,143399,204090,,377232,233.58,453.86,0.0698,1571,20.0,14092.84,1.79,0.7718
988,Obrien-Barker,False,EG,South Melissaburgh,EdTech,2019,https://obrien-barker.com,Special grow meeting family relationship husband southern dog world.,30,obrien-barker,2023,USD,996818,572084,424734,339208,85526,0,85526,9968,19936,65590,166055,825590,199147,626443,83068.17,996818,10.0,29.3,0.0155,1000,83.03,1000.0,166.06,0.4261
989,Wade-Clark,False,NG,Hernandezberg,Energy,2021,https://wade-clark.com,Bag onto brother blue large.,18,wade-clark,2023,USD,883343,405416,477927,540174,-62247,0,-62247,8833,17666,-79913,87397,595674,243009,352665,,883343,1473.62,3387.88,0.001,557,131.93,54355.17,1.61,0.541
990,Sharp LLC,False,GB,Gwendolynshire,Marketplaces,2020,https://sharpllc.com,Responsibility itself but popular wall need onto.,21,sharp-llc,2023,USD,822722,194799,627923,166858,461065,22196,438869,8227,16454,422415,58779,564162,260578,303584,,822722,207.93,628.42,0.0765,3428,20.0,31029.66,1.89,0.7632
991,Clark Kennedy and Johnson,False,FR,South James,IoT,2017,https://clarkkennedyandjohnson.com,Any subject sound hope speech.,22,clark-kennedy-and-johnson,2023,EUR,1005551,330008,675543,346547,328996,19251,309745,10055,20111,289634,42091,560787,62013,498774,,1005551,259.71,847.56,0.0681,2557,32.76,28580.41,1.47,0.6718
992,Barrett-Sanders,False,AU,Shannonmouth,EdTech,2010,https://barrett-sanders.com,Probably when seem test contain than clearly economy behavior.,19,barrett-sanders,2023,USD,237025,55299,181726,134278,47448,23185,24263,2370,4740,19523,30295,231888,172720,59168,19752.08,237025,56.58,112.81,0.0146,370,53.29,1000.0,30.3,0.7667
993,Hernandez-Henson,False,FR,New Cassandra,AgriTech,2012,https://hernandez-henson.com,Trade result individual side place represent song.,23,hernandez-henson,2023,EUR,80673,14788,65885,31570,34315,0,34315,806,1613,32702,3745,192454,80413,112041,,80673,118.29,59.14,0.0455,76,87.73,12167.73,0.31,0.8167
994,Rogers-Garcia,False,TN,East Dylan,Cybersecurity,2012,https://rogers-garcia.com,Event hospital more opportunity unit cultural show rule always.,12,rogers-garcia,2023,USD,989107,198447,790660,418835,371825,9412,362413,9891,19782,342631,41778,540101,396848,143253,,989107,20.0,146.96,0.0142,850,96.91,14107.36,2.96,0.7994
995,Garza Roberts and Shea,False,ZA,Williamsmouth,Energy,2018,https://garzarobertsandshea.com,Imagine phone social listen.,23,garza-roberts-and-shea,2023,USD,4823342,2707092,2116250,2188977,-72727,0,-72727,48233,96466,-169193,136393,2710444,966860,1743584,,4823342,340.2,1581.45,0.0293,20097,20.0,173283.34,0.79,0.4388
996,Hickman-Sloan,False,CA,West Mary,Fintech,2010,https://hickman-sloan.com,Last feel present although director toward effect.,16,hickman-sloan,2023,USD,831396,234966,596430,588832,7598,0,7598,8313,16627,-9029,24058,625082,536583,88499,,831396,214.29,312.26,0.0692,3464,20.0,10090.06,2.38,0.7174
997,Smith-Perez,False,US,Port Shannon,AgriTech,2022,https://smith-perez.com,Able answer away sort movement tonight vote administration.,22,smith-perez,2023,USD,381610,119352,262258,240062,22196,11574,10622,3816,7632,2990,49436,275028,89524,185504,,381610,20.0,66.55,0.0665,1590,20.0,1769.52,27.94,0.6872
998,Norton Bowman and Torres,False,CA,South Vanessaborough,AgriTech,2011,https://nortonbowmanandtorres.com,Product explain break dog writer night forget nation customer rate.,17,norton-bowman-and-torres,2023,USD,378895,179207,199688,256600,-56912,0,-56912,3788,7577,-64489,6581,285853,67877,217976,,378895,586.38,713.36,0.073,1578,20.0,46397.04,0.14,0.527
999,Murphy and Sons,False,GB,Smithberg,Fintech,2013,https://murphyandsons.com,College factor either class interview role guess.,15,murphy-and-sons,2023,USD,758779,344305,414474,431350,-16876,16077,-32953,7587,15175,-48128,222503,762368,320052,442316,,758779,2493.82,1246.91,0.0561,468,134.96,27036.42,8.23,0.5462
1000,Collins-Daniels,False,TN,North Tonyaville,Mobility,2024,https://collins-daniels.com,Well at show serve.,21,collins-daniels,2023,USD,1235127,440366,794761,821826,-27065,9311,-36376,12351,24702,-61078,21071,720457,265780,454677,,1235127,20.0,44.34,0.0311,542,189.79,69538.19,0.3,0.6435
1001,Sanford-Wilson,False,TN,Morganhaven,Fintech,2008,https://sanford-wilson.com,Let business property everything bar smile good hold country war.,19,sanford-wilson,2023,USD,1889855,680747,1209108,479463,729645,0,729645,18898,37797,691848,157341,1200391,601970,598421,,1889855,20.0,73.99,0.0601,2727,57.75,82162.1,1.92,0.6398
1002,Smith Sloan and Brock,False,FR,North Francismouth,E-commerce,2010,https://smithsloanandbrock.com,Miss ready create yard serious goal.,21,smith-sloan-and-brock,2023,EUR,512891,138827,374064,333282,40782,16314,24468,5128,10257,14211,26580,433043,143624,289419,,512891,621.63,310.82,0.0441,257,166.17,56051.44,0.47,0.7293
1003,Castaneda-Sparks,False,KE,Garciahaven,IoT,2018,https://castaneda-sparks.com,Defense couple point similar security at year dinner.,22,castaneda-sparks,2023,USD,252647,98993,153654,51455,102199,0,102199,2526,5052,97147,5419,152656,120893,31763,,252647,322.05,2074.32,0.0716,1052,20.0,1000.0,5.42,0.6082
1004,Peck Norman and Grant,False,TN,Hughesstad,SaaS,2017,https://pecknormanandgrant.com,Tonight already could number admit professor.,17,peck-norman-and-grant,2023,USD,650451,253973,396478,209648,186830,14371,172459,6504,13009,159450,18971,461814,121439,340375,54204.25,650451,583.36,1898.52,0.0083,3611,15.01,31609.77,0.6,0.6095
1005,Wong-Perry,False,TN,West Michelleland,Energy,2010,https://wong-perry.com,Successful organization no bring career manager.,22,wong-perry,2023,USD,7453806,3115638,4338168,4542905,-204737,22401,-227138,74538,149076,-376214,2059988,5896794,3490776,2406018,,7453806,20.0,10.0,0.0825,13401,46.35,407847.11,5.05,0.582
1006,Swanson Peterson and Weber,False,ZA,Port Marymouth,AI/ML,2015,https://swansonpetersonandweber.com,Fine state fall teach area feel who.,18,swanson-peterson-and-weber,2023,USD,427748,164624,263124,138451,124673,0,124673,4277,8554,116119,19685,372008,131042,240966,,427748,20.0,10.0,0.0219,343,103.81,44725.97,0.44,0.6151
1007,Dominguez Group,False,KE,West Matthew,AI/ML,2013,https://dominguezgroup.com,Wonder window hair marriage school imagine ago expect.,17,dominguez-group,2023,USD,534775,324185,210590,104260,106330,0,106330,5347,10695,95635,17401,396905,31116,365789,,534775,20.0,29.32,0.0477,2228,20.0,6684.02,2.6,0.3938
1008,Joseph and Sons,False,BR,West Danielview,Energy,2013,https://josephandsons.com,Five buy office old bad any find set.,17,joseph-and-sons,2023,USD,1234466,197180,1037286,339790,697496,564,696932,12344,24689,672243,82848,830786,41539,789247,,1234466,444.17,506.49,0.001,5143,20.0,55306.76,1.5,0.8403
1009,Durham Miller and Marquez,False,GB,Rebeccaport,AgriTech,2017,https://durhammillerandmarquez.com,Time sell American try information.,23,durham-miller-and-marquez,2023,USD,173676,69699,103977,47571,56406,9097,47309,1736,3473,43836,3982,100353,65556,34797,,173676,1385.83,4265.35,0.0255,723,20.0,8340.06,0.48,0.5987
1010,Cook Figueroa and Taylor,False,IN,New Adamfort,Mobility,2012,https://cookfigueroaandtaylor.com,Light guess my enough opportunity.,34,cook-figueroa-and-taylor,2023,USD,1934817,994514,940303,1022136,-81833,0,-81833,19348,38696,-120529,102275,1070802,453812,616990,,1934817,20.0,70.98,0.0676,1160,138.9,73226.21,1.4,0.486
1011,Jacobson Wright and Cook,False,FR,Lake Samantha,HealthTech,2021,https://jacobsonwrightandcook.com,Piece admit despite remain college.,21,jacobson-wright-and-cook,2023,EUR,442833,130005,312828,150006,162822,0,162822,4428,8856,153966,9218,250384,130561,119823,36902.75,442833,359.09,383.41,0.0867,497,74.22,27522.92,0.33,0.7064
1012,Hicks Mayo and Smith,False,IN,Barbaraborough,Energy,2017,https://hicksmayoandsmith.com,Natural arrive decision project court month general identify opportunity.,24,hicks-mayo-and-smith,2023,USD,273687,122683,151004,177200,-26196,33300,-59496,2736,5473,-64969,7332,302048,132436,169612,,273687,20.0,10.0,0.1082,1140,20.0,14271.96,0.51,0.5517
1013,Roberts Wright and Chase,False,EG,Lake Robertfort,Fintech,2019,https://robertswrightandchase.com,Within if course education.,20,roberts-wright-and-chase,2023,USD,739984,127235,612749,643409,-30660,7145,-37805,7399,14799,-52604,27590,463478,125192,338286,,739984,274.33,324.57,0.0059,3083,20.0,1000.0,27.59,0.8281
1014,Ray Ltd,False,IN,Lake Johnton,EdTech,2023,https://rayltd.com,Your seat rule range card design where.,19,ray-ltd,2023,USD,160592,29770,130822,96638,34184,0,34184,1605,3211,30973,8545,199356,107815,91541,13382.67,160592,316.33,2032.47,0.0177,218,61.11,39165.47,0.22,0.8146
1015,Smith Clark and Rodriguez,False,KE,South Danielborough,IoT,2014,https://smithclarkandrodriguez.com,Certain right size than foot in process quite kitchen.,21,smith-clark-and-rodriguez,2023,USD,1057001,163315,893686,840804,52882,14518,38364,10570,21140,17224,1434297,2090858,1601886,488972,,1057001,1339.1,5221.03,0.01,234,375.02,52393.63,27.38,0.8455
1016,Hodge and Sons,False,EG,South Michael,Fintech,2012,https://hodgeandsons.com,Majority we join edge item city sit.,29,hodge-and-sons,2023,USD,1554835,136398,1418437,596238,822199,0,822199,15548,31096,791103,74653,998012,530449,467563,,1554835,20.0,92.16,0.1484,561,230.83,35913.5,2.08,0.9123
1017,Goodman PLC,False,IN,Jamesville,SaaS,2020,https://goodmanplc.com,Cell evidence international add size morning only.,19,goodman-plc,2023,USD,464509,179088,285421,292165,-6744,23235,-29979,4645,9290,-39269,8877,334327,146070,188257,38709.08,464509,10.0,53.38,0.0121,7741,5.0,42981.68,0.21,0.6145
1018,Turner-Walker,False,CA,Lake Michelle,IoT,2020,https://turner-walker.com,White especially lose just card sit population his worry.,16,turner-walker,2023,USD,3524123,748984,2775139,2378595,396544,0,396544,35241,70482,326062,535414,2456658,729044,1727614,,3524123,58.09,97.39,0.0562,14207,20.67,186487.4,2.87,0.7875
1019,Hicks Villa and Rodriguez,False,AU,Alexaville,E-commerce,2022,https://hicksvillaandrodriguez.com,Television might financial identify as whatever blue.,16,hicks-villa-and-rodriguez,2023,USD,1552400,385257,1167143,1042189,124954,0,124954,15524,31048,93906,77167,880233,208236,671997,,1552400,358.47,2158.91,0.001,975,132.63,107278.25,0.72,0.7518
1020,King-Sanchez,False,CA,Lake Tyler,Energy,2012,https://king-sanchez.com,About when force ready network nothing ability cover board fill.,24,king-sanchez,2023,USD,3144243,1065546,2078697,157212,1921485,3554,1917931,31442,62884,1855047,58346,1780746,265834,1514912,,3144243,447.93,2084.87,0.0896,5678,46.14,1000.0,58.35,0.6611
1021,King-Ballard,False,IN,Lake Richard,E-commerce,2014,https://king-ballard.com,North ground here person three foot tax ground serve mouth.,15,king-ballard,2023,USD,850827,321333,529494,463250,66244,1054,65190,8508,17016,48174,3408,588455,147666,440789,,850827,274.29,777.38,0.1156,205,345.4,1000.0,3.41,0.6223
1022,Perez-Bernard,False,EG,Lake Charlesshire,E-commerce,2013,https://perez-bernard.com,Discuss term day include you authority.,24,perez-bernard,2023,USD,748611,63540,685071,86414,598657,0,598657,7486,14972,583685,89606,533728,218847,314881,,748611,290.23,1197.73,0.0419,3119,20.0,1000.0,89.61,0.9151
1023,Fritz Dunn and Higgins,False,TN,Lake Jason,E-commerce,2017,https://fritzdunnandhiggins.com,Best either truth important yard poor threat throw.,14,fritz-dunn-and-higgins,2023,USD,507419,188180,319239,521079,-201840,0,-201840,5074,10148,-211988,18457,468536,159143,309393,,507419,20.0,62.3,0.1007,669,63.12,37171.51,0.5,0.6291
1024,Peterson and Sons,False,ZA,North Lindaside,Cybersecurity,2023,https://petersonandsons.com,Voice drop live everyone cold serious rock unit majority yeah somebody.,17,peterson-and-sons,2023,USD,779398,383944,395454,193611,201843,23891,177952,7793,15587,162365,52281,640849,169533,471316,,779398,1347.26,4279.75,0.001,3247,20.0,57539.31,0.91,0.5074
1025,Garcia-Gordon,False,KE,New Joshua,EdTech,2018,https://garcia-gordon.com,Recent various send news clearly school wonder occur project.,21,garcia-gordon,2023,USD,561769,182956,378813,278580,100233,0,100233,5617,11235,88998,29864,388103,291901,96202,46814.08,561769,187.63,235.37,0.0526,3188,14.68,38234.21,0.78,0.6743
1026,Jackson and Sons,False,TN,Lake Brandon,AgriTech,2020,https://jacksonandsons.com,Cultural decide car leave product difficult.,19,jackson-and-sons,2023,USD,77490,41724,35766,18622,17144,2315,14829,774,1549,13280,6930,61105,24193,36912,,77490,799.13,2836.05,0.0512,322,20.0,25543.9,0.27,0.4616
1027,Johnson Ltd,False,CA,West Courtney,Fintech,2014,https://johnsonltd.com,Strong it reach street city her commercial.,22,johnson-ltd,2023,USD,2701777,922721,1779056,1115341,663715,14612,649103,27017,54035,595068,618182,1992205,737756,1254449,,2701777,532.07,4125.18,0.0407,11257,20.0,69744.41,8.86,0.6585
1028,Patel Ltd,False,KE,Rodriguezburgh,AI/ML,2013,https://patelltd.com,Available indeed itself record coach require.,22,patel-ltd,2023,USD,243321,58836,184485,12166,172319,39149,133170,2433,4866,128304,150641,319973,36750,283223,,243321,871.35,4363.09,0.0569,172,117.52,1000.0,150.64,0.7582
1029,Peters Byrd and Dodson,False,BR,Oliviaburgh,AI/ML,2008,https://petersbyrdanddodson.com,Mouth note well interesting particularly some evidence employee degree safe.,14,peters-byrd-and-dodson,2023,USD,397933,133710,264223,29745,234478,12887,221591,3979,7958,213633,23756,377023,144953,232070,,397933,643.89,2711.23,0.0289,152,216.87,56538.4,0.42,0.664
1030,Gonzalez LLC,False,ZA,Bartonmouth,Mobility,2014,https://gonzalezllc.com,Themselves break reason too discover.,25,gonzalez-llc,2023,USD,943932,457374,486558,309902,176656,12495,164161,9439,18878,145283,66138,651674,119601,532073,,943932,87.84,264.52,0.015,553,142.04,22253.04,2.97,0.5155
1031,Ferguson Vincent and Castro,False,EG,Blankenshipshire,AgriTech,2010,https://fergusonvincentandcastro.com,Apply conference then sometimes drive anything.,20,ferguson-vincent-and-castro,2023,USD,176784,60349,116435,136706,-20271,0,-20271,1767,3535,-23806,41123,270893,48142,222751,,176784,913.75,3692.93,0.001,381,38.62,1000.0,41.12,0.6586
1032,Stephens Jones and Ryan,False,AU,West Alicialand,Energy,2023,https://stephensjonesandryan.com,End nature stock analysis make study cause.,28,stephens-jones-and-ryan,2023,USD,2873988,783629,2090359,706256,1384103,8924,1375179,28739,57479,1317700,156783,1781991,945409,836582,,2873988,382.93,2437.47,0.1574,1725,138.84,47117.81,3.33,0.7273
1033,Hale Inc,False,GB,New Scott,Marketplaces,2017,https://haleinc.com,Return national scene focus clearly everybody suggest air she.,19,hale-inc,2023,USD,2300250,792097,1508153,1140488,367665,0,367665,23002,46005,321660,54155,1404121,408464,995657,,2300250,20.0,43.05,0.0215,879,217.92,99378.35,0.54,0.6556
1034,Rowe Ltd,False,DE,Port Lisatown,AgriTech,2012,https://roweltd.com,Follow serious space one bar.,12,rowe-ltd,2023,EUR,308849,98264,210585,161670,48915,7357,41558,3088,6176,35382,47412,342908,220653,122255,,308849,135.72,420.11,0.1008,56,455.47,33661.89,1.41,0.6818
1035,Castillo Inc,False,ZA,Bowersside,Energy,2020,https://castilloinc.com,Arm piece why ago change government here boy.,14,castillo-inc,2023,USD,7704526,3326414,4378112,3891842,486270,0,486270,77045,154090,332180,408211,4295364,214768,4080596,,7704526,20.0,64.08,0.0615,32102,20.0,297372.74,1.37,0.5683
1036,Brewer Goodwin and Green,False,FR,New Lisashire,Mobility,2023,https://brewergoodwinandgreen.com,Live make travel baby compare shake may small fire light.,14,brewer-goodwin-and-green,2023,EUR,1037376,399173,638203,809491,-171288,0,-171288,10373,20747,-192035,417856,979783,281143,698640,,1037376,1452.04,2701.87,0.0701,676,127.78,66048.38,6.33,0.6152
1037,Hamilton Johnson and Greene,False,KE,Lake Josebury,Energy,2024,https://hamiltonjohnsonandgreene.com,Generation game guess middle morning if none dog.,23,hamilton-johnson-and-greene,2023,USD,2202846,597967,1604879,1052043,552836,27156,525680,22028,44056,481624,43153,1239428,104259,1135169,,2202846,20.0,93.34,0.0613,9178,20.0,68807.32,0.63,0.7285
1038,Salinas PLC,False,ZA,West Mike,Energy,2009,https://salinasplc.com,Hand start size heart among.,25,salinas-plc,2023,USD,889405,325554,563851,145086,418765,0,418765,8894,17788,400977,480973,1048729,387005,661724,,889405,20.0,17.63,0.1433,914,81.03,13716.69,35.06,0.634
1039,Williams Harrison and Russell,False,AU,South Carrie,E-commerce,2010,https://williamsharrisonandrussell.com,Next peace skill admit person player voice under continue ask environmental.,21,williams-harrison-and-russell,2023,USD,2740284,1141848,1598436,584825,1013611,17136,996475,27402,54805,941670,52842,1518643,813801,704842,,2740284,1222.31,611.16,0.1309,11417,20.0,41875.53,1.26,0.5833
1040,Hebert Group,False,FR,Maryville,EdTech,2019,https://hebertgroup.com,Trip school energy safe while popular natural list they eat.,23,hebert-group,2023,EUR,199578,96618,102960,114849,-11889,26737,-38626,1995,3991,-42617,1796,293320,72301,221019,16631.5,199578,374.13,2155.41,0.0139,156,106.1,26061.05,0.07,0.5159
1041,Gray and Sons,False,GB,South Josephberg,Marketplaces,2009,https://grayandsons.com,Center hundred question rise miss.,23,gray-and-sons,2023,USD,132110,74124,57986,39503,18483,0,18483,1321,2642,15841,2677,204504,99098,105406,,132110,366.23,994.85,0.0419,45,241.77,11128.14,0.24,0.4389
1042,Caldwell Cross and Russell,False,KE,North John,Marketplaces,2020,https://caldwellcrossandrussell.com,Series candidate reveal suddenly issue bit whether edge left.,28,caldwell-cross-and-russell,2023,USD,240834,47326,193508,120972,72536,0,72536,2408,4816,67720,16458,303468,103030,200438,,240834,935.89,1040.74,0.001,118,169.6,1000.0,16.46,0.8035
1043,Short LLC,False,AU,Moorestad,E-commerce,2021,https://shortllc.com,Term amount idea director put future raise.,26,short-llc,2023,USD,814175,264428,549747,172976,376771,10392,366379,8141,16283,350096,391119,983489,244944,738545,,814175,1035.73,7483.01,0.0589,2285,29.69,1000.0,391.12,0.6752
1044,Lee-Grimes,False,FR,Lake Christopherfurt,SaaS,2011,https://lee-grimes.com,In evidence fact office spring measure truth.,24,lee-grimes,2023,EUR,1420975,265553,1155422,115173,1040249,0,1040249,14209,28419,1011830,370782,1277505,63875,1213630,118414.58,1420975,620.87,2055.87,0.0515,12386,9.56,18147.74,20.43,0.8131
1045,Cross LLC,False,IN,New Heidi,EdTech,2024,https://crossllc.com,Condition word former win letter story article read also rather.,16,cross-llc,2023,USD,121289,22908,98381,69196,29185,18391,10794,1212,2425,8369,4152,238427,79693,158734,10107.42,121289,242.43,537.47,0.0298,2021,5.0,9084.16,0.46,0.8111
1046,Kaiser LLC,False,ZA,East Sabrina,AI/ML,2015,https://kaiserllc.com,Wide station create moment onto third.,15,kaiser-llc,2023,USD,1451141,540569,910572,999869,-89297,0,-89297,14511,29022,-118319,415497,1214870,557298,657572,,1451141,20.0,25.19,0.001,413,292.23,77451.08,5.36,0.6275
1047,Foster and Sons,False,EG,Port Curtis,E-commerce,2020,https://fosterandsons.com,Represent lawyer letter these buy.,17,foster-and-sons,2023,USD,6194983,1977491,4217492,3015396,1202096,0,1202096,61949,123899,1078197,412808,3523524,176176,3347348,,6194983,192.63,96.32,0.0839,19070,27.07,265177.66,1.56,0.6808
1048,Obrien and Sons,False,EG,New Christopher,Marketplaces,2024,https://obrienandsons.com,Manage care popular yourself always image.,18,obrien-and-sons,2023,USD,731552,273757,457795,494410,-36615,34842,-71457,7315,14631,-86088,80802,565481,195483,369998,,731552,269.08,1168.32,0.1418,1190,51.19,7630.81,10.59,0.6258
1049,Cummings Inc,False,GB,Changmouth,E-commerce,2008,https://cummingsinc.com,Believe whether teach single result modern across treatment.,19,cummings-inc,2023,USD,941123,304812,636311,293329,342982,0,342982,9411,18822,324160,25548,647991,332709,315282,,941123,824.02,1040.59,0.001,523,149.67,45474.93,0.56,0.6761
1050,Hoover Inc,False,EG,West Kimberlyville,Fintech,2017,https://hooverinc.com,Campaign others under each help line reflect enough exist without.,11,hoover-inc,2023,USD,356140,134093,222047,137732,84315,15679,68636,3561,7122,61514,1765,268872,117658,151214,,356140,39.37,282.38,0.001,182,162.4,40655.37,0.04,0.6235
1051,Horne Group,False,TN,New Erinfurt,Fintech,2011,https://hornegroup.com,Particular generation though baby page speak that police.,22,horne-group,2023,USD,287341,70611,216730,236477,-19747,0,-19747,2873,5746,-25493,2881,309850,78187,231663,,287341,717.99,3429.71,0.1452,96,247.65,1000.0,2.88,0.7543
1052,Mitchell Ryan and Perez,False,ZA,Morenomouth,HealthTech,2019,https://mitchellryanandperez.com,Only series imagine color reveal.,28,mitchell-ryan-and-perez,2023,USD,2295720,561308,1734412,623603,1110809,4764,1106045,22957,45914,1060131,60161,1242840,552848,689992,191310.0,2295720,10.0,10.0,0.0131,2879,66.44,55626.38,1.08,0.7555
1053,Obrien PLC,False,IN,North John,E-commerce,2022,https://obrienplc.com,Friend industry begin value receive tax family.,23,obrien-plc,2023,USD,1061536,193349,868187,411087,457100,0,457100,10615,21230,435870,44373,651068,411333,239735,,1061536,704.27,413.23,0.0489,4423,20.0,22064.21,2.01,0.8179
1054,Herrera Shepard and Williams,False,AU,Crystalmouth,EdTech,2024,https://herrerashepardandwilliams.com,Manage how itself so another really bring.,18,herrera-shepard-and-williams,2023,USD,314756,163890,150866,69342,81524,22381,59143,3147,6295,52848,45758,233270,118904,114366,26229.67,314756,476.91,2433.44,0.001,301,86.88,39797.93,1.15,0.4793
1055,Simmons Inc,False,EG,East Nancyton,E-commerce,2023,https://simmonsinc.com,Those guess huge parent stand several hit rate authority wait.,20,simmons-inc,2023,USD,644688,273018,371670,378885,-7215,961,-8176,6446,12893,-21069,9235,369541,151933,217608,,644688,935.59,2942.78,0.103,2686,20.0,25108.31,0.37,0.5765
1056,Garcia and Sons,False,FR,West Priscilla,Mobility,2022,https://garciaandsons.com,Appear involve nearly job board phone magazine several.,11,garcia-and-sons,2023,EUR,1945603,897661,1047942,392738,655204,6483,648721,19456,38912,609809,116173,1226720,867193,359527,,1945603,1598.55,8392.07,0.0199,827,195.97,1934.45,60.05,0.5386
1057,Barrera Howell and Riggs,False,CA,Kellyton,Fintech,2017,https://barrerahowellandriggs.com,Drug to above month language.,21,barrera-howell-and-riggs,2023,USD,3360972,1154317,2206655,4004905,-1798250,0,-1798250,33609,67219,-1865469,303478,2040359,469857,1570502,,3360972,273.8,428.16,0.1829,1860,150.51,339339.85,0.89,0.6566
1058,Cooper and Sons,False,US,Royside,Cybersecurity,2011,https://cooperandsons.com,Carry animal do hear rich apply project later really paper.,22,cooper-and-sons,2023,USD,306465,80415,226050,91402,134648,24718,109930,3064,6129,103801,37591,215141,107033,108108,,306465,20.0,116.97,0.0579,191,133.03,1000.0,37.59,0.7376
1059,Romero PLC,False,US,Port Keithshire,E-commerce,2011,https://romeroplc.com,Various research laugh effort southern idea.,18,romero-plc,2023,USD,1535171,585549,949622,616340,333282,30569,302713,15351,30703,272010,19236,952601,219713,732888,,1535171,563.69,2434.83,0.001,6396,20.0,40718.44,0.47,0.6186
1060,Mccarthy Hanson and Garrett,False,BR,Kaneport,HealthTech,2015,https://mccarthyhansonandgarrett.com,Politics service second put seven take bed mission certain situation.,30,mccarthy-hanson-and-garrett,2023,USD,827592,183715,643877,421282,222595,2643,219952,8275,16551,203401,26422,523949,190349,333600,68966.0,827592,10.0,52.21,0.0276,13793,5.0,52243.39,0.51,0.778
1061,Cruz Crane and Wright,False,NG,Annetteport,HealthTech,2013,https://cruzcraneandwright.com,Sign thought notice society.,24,cruz-crane-and-wright,2023,USD,998284,381920,616364,486652,129712,0,129712,9982,19965,109747,47139,585868,239474,346394,83190.33,998284,122.81,122.81,0.0239,690,120.53,43253.12,1.09,0.6174
1062,Ashley and Sons,False,CA,East Marybury,AI/ML,2021,https://ashleyandsons.com,Sister simply involve nor whether area performance.,18,ashley-and-sons,2023,USD,85369,33245,52124,33593,18531,0,18531,853,1707,16824,3428,90979,31586,59393,,85369,984.46,7323.84,0.001,28,252.3,28279.36,0.12,0.6106
1063,Branch Group,False,EG,South Danielle,EdTech,2020,https://branchgroup.com,Shake win air kind see finally wall right mind.,14,branch-group,2023,USD,879439,295502,583937,184469,399468,0,399468,8794,17588,381880,22646,568177,393254,174923,73286.58,879439,379.78,2035.75,0.0617,891,82.25,21726.85,1.04,0.664
1064,Nguyen Ltd,False,BR,Debrahaven,HealthTech,2013,https://nguyenltd.com,Price night admit standard expect able.,21,nguyen-ltd,2023,USD,771960,365446,406514,134953,271561,418,271143,7719,15439,255704,59061,562816,159606,403210,64330.0,771960,158.21,435.33,0.0307,1123,57.28,13508.85,4.37,0.5266
1065,Choi-Clay,False,BR,East Rachelshire,Marketplaces,2021,https://choi-clay.com,Its air source six image several name chair produce behavior nearly.,20,choi-clay,2023,USD,140093,81315,58778,59449,-671,0,-671,1400,2801,-3472,16706,153550,30811,122739,,140093,1994.71,8982.43,0.0892,39,294.17,1000.0,16.71,0.4196
1066,Gray Russell and Jones,False,TN,North Anna,SaaS,2014,https://grayrussellandjones.com,Better store think short southern finish front under build.,26,gray-russell-and-jones,2023,USD,5769558,1946285,3823273,2209693,1613580,38260,1575320,57695,115391,1459929,494893,3566635,373757,3192878,480796.5,5769558,820.07,3672.03,0.0115,17926,26.82,197731.8,2.5,0.6627
1067,Waters Group,False,EG,East Briana,IoT,2021,https://watersgroup.com,Sure evening together take strategy clearly sell.,15,waters-group,2023,USD,259794,78282,181512,12989,168523,30481,138042,2597,5195,132847,10616,219899,40955,178944,,259794,1540.96,3379.52,0.0027,1082,20.0,18488.99,0.57,0.6987
1068,Smith PLC,False,TN,Burkefurt,SaaS,2014,https://smithplc.com,Your bring woman hit dark.,23,smith-plc,2023,USD,567998,176774,391224,375023,16201,4698,11503,5679,11359,144,32316,474041,257938,216103,47333.17,567998,240.89,528.88,0.0222,9466,5.0,24356.59,1.33,0.6888
1069,Barnett PLC,False,DE,Madisontown,AgriTech,2010,https://barnettplc.com,War heart argue possible bag.,15,barnett-plc,2023,EUR,204124,120505,83619,69385,14234,0,14234,2041,4082,10152,4760,246284,137612,108672,,204124,476.7,1322.22,0.001,173,98.25,12820.61,0.37,0.4096
1070,Obrien Hodge and Morris,False,KE,Russellburgh,Fintech,2013,https://obrienhodgeandmorris.com,Miss the we politics phone anyone happy point establish time key.,26,obrien-hodge-and-morris,2023,USD,305168,108614,196554,38267,158287,0,158287,3051,6103,152184,30382,289221,209871,79350,,305168,1052.44,1327.08,0.0153,165,153.56,5345.28,5.68,0.6441
1071,Campbell Martin and Klein,False,CA,Mcclurefurt,E-commerce,2014,https://campbellmartinandklein.com,Provide others general new begin their right step.,16,campbell-martin-and-klein,2023,USD,2681582,821758,1859824,247072,1612752,12959,1599793,26815,53631,1546162,142937,1678088,402402,1275686,,2681582,20.0,78.83,0.0994,11173,20.0,29516.82,4.84,0.6936
1072,Leblanc-Hendrix,False,EG,Port Kimberlytown,Fintech,2016,https://leblanc-hendrix.com,View push enjoy wife cup law become car.,22,leblanc-hendrix,2023,USD,674431,247500,426931,282284,144647,41449,103198,6744,13488,89710,13083,533603,190826,342777,,674431,20.0,101.9,0.001,255,220.4,12148.36,1.08,0.633
1073,Howard-Arias,False,BR,West Ruth,Mobility,2024,https://howard-arias.com,Board name bad action support tonight clearly big.,13,howard-arias,2023,USD,606935,314111,292824,461260,-168436,19400,-187836,6069,12138,-199974,85961,396440,89566,306874,,606935,20.0,85.67,0.0094,2528,20.0,32950.25,2.61,0.4825
1074,Martin James and Robinson,False,BR,Younghaven,E-commerce,2020,https://martinjamesandrobinson.com,Car many of general building design avoid property.,12,martin-james-and-robinson,2023,USD,1283948,263379,1020569,1042992,-22423,37722,-60145,12839,25678,-85823,89237,865499,381698,483801,,1283948,20.0,86.08,0.092,1233,86.75,42750.44,2.09,0.7949
1075,Parker-Watkins,False,KE,Port Beth,Energy,2011,https://parker-watkins.com,Cell how member win behind.,21,parker-watkins,2023,USD,2535851,1093287,1442564,1884704,-442140,5341,-447481,25358,50717,-498198,281247,1724895,851429,873466,,2535851,1899.42,3799.16,0.001,10566,20.0,178308.57,1.58,0.5689
1076,Mitchell-Brown,False,CA,Harrisview,E-commerce,2022,https://mitchell-brown.com,Huge move until toward scientist.,30,mitchell-brown,2023,USD,3064276,985808,2078468,153213,1925255,3895,1921360,30642,61285,1860075,1216989,2914519,838669,2075850,,3064276,20.0,10.32,0.0718,12767,20.0,32843.79,37.05,0.6783
1077,Contreras-Jackson,False,KE,North Alexis,HealthTech,2017,https://contreras-jackson.com,Police there thus open still bill.,23,contreras-jackson,2023,USD,3858269,1793906,2064363,1251147,813216,8389,804827,38582,77165,727662,20191,2011778,960656,1051122,321522.42,3858269,10.0,39.89,0.001,4276,75.18,114595.86,0.18,0.535
1078,Green Group,False,KE,New Amy,IoT,2010,https://greengroup.com,Six rather just serious term discuss state drug boy.,20,green-group,2023,USD,487618,119935,367683,86102,281581,18233,263348,4876,9752,253596,146970,420194,174496,245698,,487618,431.12,1475.62,0.1091,154,263.32,1000.0,146.97,0.754
1079,Thompson Maldonado and Flores,False,BR,West Jeremymouth,HealthTech,2018,https://thompsonmaldonadoandflores.com,Manage reflect name PM.,16,thompson-maldonado-and-flores,2023,USD,383165,140568,242597,330402,-87805,22218,-110023,3831,7663,-117686,11531,294466,24088,270378,31930.42,383165,58.05,359.83,0.0118,527,60.57,30447.46,0.38,0.6331
1080,Becker-Vang,False,FR,Mendozaton,EdTech,2017,https://becker-vang.com,Team market too million space team administration share.,20,becker-vang,2023,EUR,131032,34913,96119,51457,44662,29265,15397,1310,2620,12777,8827,83494,10042,73452,10919.33,131032,10.0,48.82,0.0106,272,40.11,1000.0,8.83,0.7336
1081,Fernandez-Miller,False,FR,East Jeffrey,HealthTech,2019,https://fernandez-miller.com,Foreign city yeah quickly process address friend writer.,15,fernandez-miller,2023,EUR,961504,199554,761950,315370,446580,8651,437929,9615,19230,418699,38873,608223,243341,364882,80125.33,961504,229.59,1478.0,0.001,1364,58.73,19653.31,1.98,0.7925
1082,Mcdaniel Group,False,ZA,Lake Charles,HealthTech,2024,https://mcdanielgroup.com,Authority number force huge lead order.,32,mcdaniel-group,2023,USD,1963824,813598,1150226,768331,381895,12811,369084,19638,39276,329808,56752,1205319,369150,836169,163652.0,1963824,462.45,1716.74,0.0798,1685,97.12,102225.08,0.56,0.5857
1083,Grant PLC,False,TN,Joeside,Energy,2012,https://grantplc.com,Situation test well camera truth surface sometimes.,17,grant-plc,2023,USD,276248,142549,133699,141212,-7513,37711,-45224,2762,5524,-50748,3621,194909,61934,132975,,276248,1076.76,3500.47,0.001,1151,20.0,8732.26,0.41,0.484
1084,Holt Hall and Wilkinson,False,KE,Proctorview,Energy,2021,https://holthallandwilkinson.com,Why possible fear paper suffer particular network at base.,19,holt-hall-and-wilkinson,2023,USD,831342,348304,483038,529337,-46299,0,-46299,8313,16626,-62925,65698,540838,239470,301368,,831342,400.78,200.39,0.0473,3463,20.0,72611.94,0.9,0.581
1085,Hayes-Gardner,False,GB,Riverston,Mobility,2013,https://hayes-gardner.com,Begin type dog name language local much will cost.,24,hayes-gardner,2023,USD,760918,167275,593643,468990,124653,14278,110375,7609,15218,95157,386758,945169,145689,799480,,760918,167.18,279.15,0.0208,361,175.32,79981.28,4.84,0.7802
1086,Hayes James and Miller,False,NG,Lake Courtneymouth,HealthTech,2023,https://hayesjamesandmiller.com,Particular manage my tax off job market suddenly student.,9,hayes-james-and-miller,2023,USD,979718,109677,870041,313458,556583,6937,549646,9797,19594,530052,310111,884781,138814,745967,81643.17,979718,138.02,638.48,0.084,16328,5.0,34443.1,9.0,0.8881
1087,Flores PLC,False,IN,South Virginia,HealthTech,2013,https://floresplc.com,So mother race a poor.,17,flores-plc,2023,USD,579971,212090,367881,221003,146878,0,146878,5799,11599,135279,65892,386050,65051,320999,48330.92,579971,151.93,1124.71,0.0553,9666,5.0,1662.64,39.63,0.6343
1088,Garrett Young and Williams,False,CA,Nicolestad,Mobility,2009,https://garrettyoungandwilliams.com,Herself people rate notice air by evidence my.,18,garrett-young-and-williams,2023,USD,1327141,517665,809476,766365,43111,19588,23523,13271,26542,-3019,227884,996644,569260,427384,,1327141,1421.06,9177.82,0.1821,1015,108.94,65108.5,3.5,0.6099
1089,Cooper Brooks and King,False,CA,Murrayfurt,SaaS,2023,https://cooperbrooksandking.com,Cell step particularly control east weight.,22,cooper-brooks-and-king,2023,USD,2344953,940166,1404787,1612802,-208015,0,-208015,23449,46899,-254914,113914,1404909,308101,1096808,195412.75,2344953,566.14,1418.5,0.0479,2232,87.54,125078.0,0.91,0.5991
1090,Patel Johnston and Adams,False,GB,Greerbury,EdTech,2020,https://pateljohnstonandadams.com,National top occur billion if end.,18,patel-johnston-and-adams,2023,USD,231915,88912,143003,113382,29621,0,29621,2319,4638,24983,30469,290254,152724,137530,19326.25,231915,10.0,70.62,0.001,3865,5.0,6901.1,4.42,0.6166
1091,Becker Murphy and Patel,False,NG,Jenniferfort,AI/ML,2023,https://beckermurphyandpatel.com,Trial gas cold offer idea operation.,21,becker-murphy-and-patel,2023,USD,1847917,906626,941291,393323,547968,0,547968,18479,36958,511010,512984,1506801,447869,1058932,,1847917,991.52,3994.9,0.001,2092,73.6,12782.06,40.13,0.5094
1092,Walker Moreno and Harrington,False,TN,Curtishaven,Marketplaces,2023,https://walkermorenoandharrington.com,Nice hospital hand weight majority.,23,walker-moreno-and-harrington,2023,USD,4373767,1748709,2625058,2215883,409175,26379,382796,43737,87475,295321,91908,2336564,262020,2074544,,4373767,1076.24,5046.28,0.1565,18224,20.0,189463.45,0.49,0.6002
1093,Huber-Herring,False,TN,Alexismouth,Cybersecurity,2022,https://huber-herring.com,Significant expert energy account fill perhaps there throw station.,20,huber-herring,2023,USD,944599,259003,685596,500619,184977,8867,176110,9445,18891,157219,43486,634138,184624,449514,,944599,20.0,11.33,0.0083,519,151.61,52568.33,0.83,0.7258
1094,House Inc,False,EG,Georgeburgh,HealthTech,2010,https://houseinc.com,Current strategy four door soldier.,25,house-inc,2023,USD,2483680,1010275,1473405,1180572,292833,18938,273895,24836,49673,224222,11056,1400608,1123086,277522,206973.33,2483680,174.2,788.97,0.0294,2506,82.59,103015.01,0.11,0.5932
1095,Roberson and Sons,False,KE,Parkermouth,SaaS,2015,https://robersonandsons.com,Law force foreign blue rock hand though.,25,roberson-and-sons,2023,USD,1611682,565372,1046310,781689,264621,11815,252806,16116,32233,220573,47563,1024761,458123,566638,134306.83,1611682,356.53,2095.71,0.0036,3462,38.79,73579.68,0.65,0.6492
1096,Alvarez-Singleton,False,IN,East Laurenmouth,SaaS,2016,https://alvarez-singleton.com,Animal where entire suggest recent poor board wear.,18,alvarez-singleton,2023,USD,1651140,271286,1379854,876367,503487,0,503487,16511,33022,470465,417244,1298907,769378,529529,137595.0,1651140,163.01,492.24,0.0617,15833,8.69,62574.96,6.67,0.8357
1097,Johnson LLC,False,DE,South Patrick,AI/ML,2017,https://johnsonllc.com,Way business option list art run capital long even candidate.,25,johnson-llc,2023,EUR,1088338,326294,762044,394604,367440,5513,361927,10883,21766,340161,69844,768571,246377,522194,,1088338,164.96,654.78,0.127,328,276.2,24271.83,2.88,0.7002
1098,Rose Gates and Bailey,False,GB,East Savannah,Mobility,2023,https://rosegatesandbailey.com,Speak speak into around foot significant media society last kind.,15,rose-gates-and-bailey,2023,USD,1529073,575957,953116,972791,-19675,39018,-58693,15290,30581,-89274,50490,895509,292679,602830,,1529073,737.06,1878.91,0.0537,585,217.74,32179.27,1.57,0.6233
1099,Huffman-Taylor,False,NG,Williamview,AI/ML,2011,https://huffman-taylor.com,Place run instead hair term skin success explain maybe fight.,18,huffman-taylor,2023,USD,343844,102272,241572,17192,224380,14352,210028,3438,6876,203152,24667,237842,60100,177742,,343844,503.55,3056.2,0.0792,100,286.12,16701.62,1.48,0.7026
1100,Lozano Ponce and Burnett,False,KE,Duketown,Fintech,2016,https://lozanoponceandburnett.com,Usually according always choose fill police.,9,lozano-ponce-and-burnett,2023,USD,539062,260245,278817,160857,117960,1272,116688,5390,10781,105907,94944,542127,244407,297720,,539062,20.0,55.13,0.0633,285,157.19,4678.95,20.29,0.5172
1101,Holland Hall and Mullen,False,AU,Lake Natalie,AI/ML,2019,https://hollandhallandmullen.com,Son than attorney accept future.,26,holland-hall-and-mullen,2023,USD,875557,330042,545515,696817,-151302,14463,-165765,8755,17511,-183276,53514,649748,102909,546839,,875557,20.0,40.48,0.058,3648,20.0,64458.02,0.83,0.623
1102,Boyd Ltd,False,NG,Petersburgh,SaaS,2022,https://boydltd.com,Exist expect mind pay history.,23,boyd-ltd,2023,USD,2297665,1554402,743263,792725,-49462,0,-49462,22976,45953,-95415,20132,1174553,469351,705202,191472.08,2297665,10.0,46.78,0.0451,4317,44.35,45809.46,0.44,0.3235
1103,Carney Henry and Porter,False,NG,South Shane,EdTech,2021,https://carneyhenryandporter.com,Rest fall including section can suffer world region try.,19,carney-henry-and-porter,2023,USD,333062,112154,220908,16653,204255,9064,195191,3330,6661,188530,46594,276377,149619,126758,27755.17,333062,227.44,861.48,0.0157,323,85.83,8320.38,5.6,0.6633
1104,Clark-Benjamin,False,FR,Port Lisa,Cybersecurity,2015,https://clark-benjamin.com,Space black card student call paper these population phone perhaps.,22,clark-benjamin,2023,EUR,2696963,1138003,1558960,2071063,-512103,2000,-514103,26969,53939,-568042,44200,1478579,366340,1112239,,2696963,745.96,2104.27,0.0039,2140,105.02,193863.35,0.23,0.578
1105,Bennett Inc,False,IN,New Johnview,SaaS,2022,https://bennettinc.com,Civil response leg agency close likely million beautiful lay.,21,bennett-inc,2023,USD,141699,69250,72449,84247,-11798,0,-11798,1416,2833,-14631,1405,114784,37565,77219,11808.25,141699,519.23,920.08,0.0503,103,113.66,23668.64,0.06,0.5113
1106,Yoder Group,False,IN,Floresstad,E-commerce,2010,https://yodergroup.com,Physical low her television walk foot peace memory simply prove.,18,yoder-group,2023,USD,1073386,294799,778587,624954,153633,0,153633,10733,21467,132166,41183,652557,141091,511466,,1073386,431.99,2235.16,0.001,1071,83.49,76464.77,0.54,0.7254
1107,Reyes-Sandoval,False,EG,Lake Curtis,Fintech,2015,https://reyes-sandoval.com,Near consider keep building light.,22,reyes-sandoval,2023,USD,2199431,914260,1285171,932550,352621,46260,306361,21994,43988,262373,106656,1222459,797458,425001,,2199431,20.0,43.08,0.001,1072,170.93,58149.2,1.83,0.5843
1108,Bryant and Sons,False,DE,South Kristin,Cybersecurity,2019,https://bryantandsons.com,Understand pretty whom what unit for.,23,bryant-and-sons,2023,EUR,1640791,1022400,618391,1348797,-730406,1959,-732365,16407,32815,-765180,32185,953681,331045,622636,,1640791,557.59,1153.0,0.1149,1140,119.91,96554.39,0.33,0.3769
1109,Moore PLC,False,ZA,Lake Robert,IoT,2021,https://mooreplc.com,Western run son price one policy.,20,moore-plc,2023,USD,179950,101104,78846,80939,-2093,21492,-23585,1799,3599,-27184,3838,200259,98596,101663,,179950,620.07,1790.13,0.0249,93,160.37,1000.0,3.84,0.4382
1110,Tran and Sons,False,GB,East Mark,IoT,2012,https://tranandsons.com,Reflect each officer thus data new final individual.,19,tran-and-sons,2023,USD,773593,297424,476169,340784,135385,6970,128415,7735,15471,112944,31654,515463,131053,384410,,773593,20.0,53.4,0.0263,2541,25.37,80545.2,0.39,0.6155
1111,Hardy-Ford,False,AU,Robinsonfurt,EdTech,2014,https://hardy-ford.com,East affect forward tend officer well marriage.,20,hardy-ford,2023,USD,224278,79159,145119,82231,62888,21229,41659,2242,4485,37174,17417,259857,131387,128470,18689.83,224278,104.3,118.54,0.1147,3737,5.0,1000.0,17.42,0.647
1112,Hardy White and Griffin,False,AU,Smithshire,SaaS,2019,https://hardywhiteandgriffin.com,Key class former project other service.,22,hardy-white-and-griffin,2023,USD,1008871,456172,552699,373981,178718,32021,146697,10088,20177,126520,125743,790407,254911,535496,84072.58,1008871,647.09,1083.36,0.0574,1536,54.7,38873.29,3.23,0.5478
1113,Higgins-Lewis,False,NG,Devonside,AgriTech,2013,https://higgins-lewis.com,Drug chance speech sell better soldier however so television nature.,14,higgins-lewis,2023,USD,245156,61729,183427,183061,366,6835,-6469,2451,4903,-11372,6228,171440,10711,160729,,245156,20.0,56.65,0.0528,91,224.25,12897.4,0.48,0.7482
1114,Johnson Inc,False,CA,Kathleenfort,Cybersecurity,2017,https://johnsoninc.com,Specific rather letter me tell just raise really reveal these.,26,johnson-inc,2023,USD,1228987,351160,877827,486143,391684,33880,357804,12289,24579,333225,226479,942233,143235,798998,,1228987,947.28,3096.82,0.1156,1370,74.74,17683.6,12.81,0.7143
1115,Robertson Lopez and Walsh,False,IN,Glasston,IoT,2016,https://robertsonlopezandwalsh.com,Admit within door hold bank of.,16,robertson-lopez-and-walsh,2023,USD,653072,286594,366478,258860,107618,16022,91596,6530,13061,78535,12506,393739,19686,374053,,653072,20.0,74.44,0.1063,2721,20.0,40268.38,0.31,0.5612
1116,Flores Stevens and Reed,False,NG,East Monica,Marketplaces,2011,https://floresstevensandreed.com,Together test age chance officer single role only give agency.,38,flores-stevens-and-reed,2023,USD,274564,149724,124840,155407,-30567,0,-30567,2745,5491,-36058,6581,327570,182785,144785,,274564,302.95,1471.17,0.002,155,147.3,8452.19,0.78,0.4547
1117,Gonzalez-Ramirez,False,GB,North Cheryl,Energy,2009,https://gonzalez-ramirez.com,Treatment office yeah bar rather matter.,15,gonzalez-ramirez,2023,USD,1027962,103829,924133,953994,-29861,0,-29861,10279,20559,-50420,251065,888911,317889,571022,,1027962,20.0,62.31,0.0915,4283,20.0,95535.73,2.63,0.899
1118,Ponce Thomas and Williams,False,IN,Lake Edward,Marketplaces,2012,https://poncethomasandwilliams.com,Church term under whether improve sell.,16,ponce-thomas-and-williams,2023,USD,1073299,294584,778715,219743,558972,0,558972,10732,21465,537507,18030,689278,120299,568979,,1073299,878.33,3021.51,0.0663,693,129.04,1000.0,18.03,0.7255
1119,Brown PLC,False,ZA,North Danielfurt,HealthTech,2015,https://brownplc.com,Can Congress building return land.,18,brown-plc,2023,USD,349920,66136,283784,158629,125155,52122,73033,3499,6998,66035,37415,384521,19226,365295,29160.0,349920,347.13,1987.36,0.0556,5832,5.0,1000.0,37.42,0.811
1120,Cooper Newton and Rice,False,GB,Randolphborough,Cybersecurity,2018,https://coopernewtonandrice.com,Section degree family court herself decade add condition practice professor feeling.,25,cooper-newton-and-rice,2023,USD,1100226,451367,648859,708442,-59583,0,-59583,11002,22004,-81587,5570,600074,262424,337650,,1100226,908.73,2497.11,0.1861,712,128.63,99581.98,0.06,0.5898
1121,Garcia Duran and Campbell,False,DE,North Justinside,Marketplaces,2020,https://garciaduranandcampbell.com,Personal cell front across professor word change expert.,21,garcia-duran-and-campbell,2023,EUR,1674011,159529,1514482,823146,691336,15338,675998,16740,33480,642518,83231,1000106,427240,572866,,1674011,1051.11,1902.19,0.0665,1325,105.26,50440.5,1.65,0.9047
1122,Smith PLC,False,EG,Lake Melanie,HealthTech,2016,https://smithplc.com,Return style at score pretty south Democrat project.,15,smith-plc,2023,USD,312840,134563,178277,42896,135381,48172,87209,3128,6256,80953,2605,191995,89950,102045,26070.0,312840,182.42,641.86,0.0435,346,75.2,10330.43,0.25,0.5699
1123,Reed Maxwell and Silva,False,BR,Port Coltonmouth,Energy,2020,https://reedmaxwellandsilva.com,Center course very near much hold.,16,reed-maxwell-and-silva,2023,USD,984455,209112,775343,278807,496536,5664,490872,9844,19689,471183,70463,736876,520301,216575,,984455,1077.26,6815.72,0.001,1166,70.33,39799.26,1.77,0.7876
1124,Lewis Inc,False,EG,Shellyberg,Fintech,2010,https://lewisinc.com,Cell loss approach but pass.,19,lewis-inc,2023,USD,2680905,1471333,1209572,1501911,-292339,14172,-306511,26809,53618,-360129,378863,1733943,771390,962553,,2680905,1089.88,2430.96,0.0457,11170,20.0,114051.88,3.32,0.4512
1125,Hall-Simpson,False,TN,East Carolton,AI/ML,2016,https://hall-simpson.com,Responsibility who issue technology against direction call example practice.,30,hall-simpson,2023,USD,1774505,897793,876712,820064,56648,0,56648,17745,35490,21158,327402,1317071,73234,1243837,,1774505,319.7,1598.45,0.0306,3590,41.19,53188.3,6.16,0.4941
1126,Peterson LLC,False,ZA,Port Natalie,E-commerce,2022,https://petersonllc.com,Politics develop report experience economic by pattern traditional if many trial.,19,peterson-llc,2023,USD,1702661,619280,1083381,991382,91999,21452,70547,17026,34053,36494,226527,1215900,599895,616005,,1702661,286.73,1875.58,0.001,7094,20.0,84222.87,2.69,0.6363
1127,Hayes Henderson and Buchanan,False,EG,West Scottstad,E-commerce,2008,https://hayeshendersonandbuchanan.com,Expect such watch economy success carry special left.,27,hayes-henderson-and-buchanan,2023,USD,6537915,2784224,3753691,3147881,605810,15132,590678,65379,130758,459920,218935,3609684,2201641,1408043,,6537915,20.0,98.23,0.0416,3592,151.65,258507.3,0.85,0.5741
1128,Rodriguez PLC,False,AU,Port Davidhaven,Cybersecurity,2010,https://rodriguezplc.com,Although ago treatment society network beyond.,22,rodriguez-plc,2023,USD,1025039,590398,434641,602332,-167691,43618,-211309,10250,20500,-231809,65030,712736,74724,638012,,1025039,225.3,527.63,0.002,2583,33.06,34957.43,1.86,0.424
1129,Hill-Harding,False,ZA,Martinhaven,Mobility,2019,https://hill-harding.com,Name might speech prove language.,25,hill-harding,2023,USD,260273,26063,234210,13013,221197,0,221197,2602,5205,215992,24605,263055,73323,189732,,260273,1386.18,6818.64,0.0879,71,302.29,1000.0,24.6,0.8999
1130,Watkins Ltd,False,FR,West Janetmouth,AI/ML,2020,https://watkinsltd.com,Crime amount laugh east left.,26,watkins-ltd,2023,EUR,1634494,668692,965802,920531,45271,59017,-13746,16344,32689,-46435,75729,900264,401279,498985,,1634494,1103.79,1326.7,0.001,781,174.29,87028.02,0.87,0.5909
1131,Cook Inc,False,DE,Michaelhaven,Energy,2014,https://cookinc.com,Man current hundred box cultural admit itself.,15,cook-inc,2023,EUR,4408051,1728939,2679112,345642,2333470,9813,2323657,44080,88161,2235496,71572,2423460,121173,2302287,,4408051,1314.12,3170.61,0.0019,2916,125.93,33447.78,2.14,0.6078
1132,Schmidt-Rice,False,EG,Seanchester,AgriTech,2018,https://schmidt-rice.com,Effect ahead building accept current provide the customer I state.,17,schmidt-rice,2023,USD,160157,54430,105727,8007,97720,2505,95215,1601,3203,92012,7845,128538,67011,61527,,160157,2205.4,7325.04,0.0225,108,123.28,58413.51,0.13,0.6601
1133,Weeks-Massey,False,IN,Kimberg,E-commerce,2012,https://weeks-massey.com,Good ask drive catch table.,25,weeks-massey,2023,USD,1533468,651357,882111,895412,-13301,0,-13301,15334,30669,-43970,110728,901015,76611,824404,,1533468,20.0,82.27,0.0167,840,151.96,59503.6,1.86,0.5752
1134,Johnson LLC,False,KE,Perryville,Mobility,2018,https://johnsonllc.com,Whole phone agent attack bring land magazine.,15,johnson-llc,2023,USD,415690,178495,237195,20784,216411,0,216411,4156,8313,208098,11496,375660,124417,251243,,415690,20.0,107.57,0.0982,363,95.34,25606.57,0.45,0.5706
1135,Martinez-King,False,BR,Lake Dianashire,SaaS,2009,https://martinez-king.com,Name walk attack resource serious teach piece.,20,martinez-king,2023,USD,225336,95872,129464,134729,-5265,36076,-41341,2253,4506,-45847,33246,345221,130078,215143,18778.0,225336,261.84,438.29,0.001,349,53.71,12515.95,2.66,0.5745
1136,Andrews-Edwards,False,FR,West Kristenton,Marketplaces,2022,https://andrews-edwards.com,Particular maybe space father store start upon.,25,andrews-edwards,2023,EUR,753418,162725,590693,657340,-66647,0,-66647,7534,15068,-81715,54698,444776,306872,137904,,753418,20.0,95.47,0.0274,374,167.61,39428.19,1.39,0.784
1137,Logan-Rice,False,US,Fowlerland,Fintech,2013,https://logan-rice.com,Leg keep build increase owner seek.,20,logan-rice,2023,USD,680750,246139,434611,34037,400574,8396,392178,6807,13615,378563,2993,541618,307415,234203,,680750,862.34,703.77,0.0544,574,98.77,12464.38,0.24,0.6384
1138,Jenkins Group,False,EG,East Javierport,Mobility,2008,https://jenkinsgroup.com,Machine number eat store several.,25,jenkins-group,2023,USD,639564,184105,455459,411787,43672,0,43672,6395,12791,30881,4709,514099,153920,360179,,639564,20.0,10.0,0.0347,1965,27.11,64094.48,0.07,0.7121
1139,White-Mclaughlin,False,TN,Brandiville,EdTech,2012,https://white-mclaughlin.com,Land address represent treat close issue write produce ago level middle.,26,white-mclaughlin,2023,USD,138718,53264,85454,38019,47435,0,47435,1387,2774,44661,21055,176344,57472,118872,11559.83,138718,167.55,863.89,0.0608,2311,5.0,2684.74,7.84,0.616
1140,Richard Garcia and Jenkins,False,BR,Lake Elizabeth,AgriTech,2013,https://richardgarciaandjenkins.com,Piece produce else support top.,22,richard-garcia-and-jenkins,2023,USD,217739,78652,139087,88053,51034,30137,20897,2177,4354,16543,3517,271656,152073,119583,,217739,886.93,2049.72,0.001,129,139.61,1000.0,3.52,0.6388
1141,Acevedo Lloyd and Young,False,IN,Lesterville,Fintech,2019,https://acevedolloydandyoung.com,Wish while room Mr personal.,19,acevedo-lloyd-and-young,2023,USD,378131,81077,297054,134388,162666,22282,140384,3781,7562,132822,26412,296596,52584,244012,,378131,125.49,449.75,0.001,486,64.82,18768.55,1.41,0.7856
1142,Reilly-Romero,False,IN,New Sarahview,Fintech,2019,https://reilly-romero.com,Movement claim build water third miss scene.,24,reilly-romero,2023,USD,541199,244112,297087,260293,36794,0,36794,5411,10823,25971,37729,355137,38555,316582,,541199,20.0,118.92,0.0757,400,112.53,17676.28,2.13,0.5489
1143,Duncan Group,False,BR,Samueltown,Marketplaces,2013,https://duncangroup.com,Common speech else another listen list behavior successful success herself.,26,duncan-group,2023,USD,2339961,556746,1783215,624090,1159125,0,1159125,23399,46799,1112326,62649,1405650,70282,1335368,,2339961,1075.92,5119.87,0.0732,640,304.64,66509.49,0.94,0.7621
1144,Evans Group,False,US,Port Deborahland,Energy,2017,https://evansgroup.com,Memory matter stage establish close prove.,22,evans-group,2023,USD,1971603,1006013,965590,504242,461348,17969,443379,19716,39432,403947,425009,1514536,761846,752690,,1971603,1475.05,7091.4,0.0374,873,187.99,18424.21,23.07,0.4897
1145,Mckee Hernandez and Barber,False,ZA,Lanefort,Cybersecurity,2015,https://mckeehernandezandbarber.com,Environment open director brother toward.,13,mckee-hernandez-and-barber,2023,USD,853524,209497,644027,300894,343133,0,343133,8535,17070,326063,21334,635046,273769,361277,,853524,1214.24,3623.47,0.0884,865,82.21,16397.55,1.3,0.7546
1146,Tyler Group,False,TN,West Ronaldfort,Marketplaces,2010,https://tylergroup.com,Politics computer exist throw real next four help blood use.,23,tyler-group,2023,USD,834770,208651,626119,307825,318294,0,318294,8347,16695,301599,29296,533169,119792,413377,,834770,1834.96,5149.82,0.083,1376,50.53,7914.32,3.7,0.75
1147,Yates Ballard and Santiago,False,ZA,Whiteton,Fintech,2008,https://yatesballardandsantiago.com,Unit reduce executive particular himself eat enter partner agent laugh.,17,yates-ballard-and-santiago,2023,USD,398472,182140,216332,143308,73024,152,72872,3984,7969,64903,30646,298980,87297,211683,,398472,20.0,14.35,0.001,191,173.4,1000.0,30.65,0.5429
1148,Hernandez-Wallace,False,DE,New Matthew,Mobility,2010,https://hernandez-wallace.com,Central wonder green set stay image my by.,27,hernandez-wallace,2023,EUR,2141059,312589,1828470,1109813,718657,10211,708446,21410,42821,665625,355541,1624919,518055,1106864,,2141059,463.5,3348.66,0.0903,8921,20.0,69248.38,5.13,0.854
1149,Ponce Choi and Osborne,False,GB,Amandaside,IoT,2015,https://poncechoiandosborne.com,Direction American job world house character would money own.,15,ponce-choi-and-osborne,2023,USD,934595,143600,790995,393154,397841,10220,387621,9345,18691,368930,38777,610323,30516,579807,,934595,20.0,84.75,0.0835,370,210.01,1000.0,38.78,0.8464
1150,Coleman PLC,False,NG,North Kevinborough,Marketplaces,2022,https://colemanplc.com,Only series right group sense.,25,coleman-plc,2023,USD,845116,207148,637968,257457,380511,28969,351542,8451,16902,334640,129647,741931,379867,362064,,845116,398.76,1210.38,0.001,267,263.71,1199.17,108.11,0.7549
1151,Bowman Martin and Hoover,False,US,Lake Richard,SaaS,2018,https://bowmanmartinandhoover.com,Degree rest thus game wonder analysis effort.,18,bowman-martin-and-hoover,2023,USD,354628,77981,276647,256154,20493,0,20493,3546,7092,13401,14541,382178,199814,182364,29552.33,354628,278.21,1021.47,0.001,4860,6.08,1000.0,14.54,0.7801
1152,Dixon Morales and Chan,False,FR,East Michaelview,Energy,2012,https://dixonmoralesandchan.com,Many energy pattern investment practice their recent.,20,dixon-morales-and-chan,2023,EUR,3067609,1479722,1587887,1260974,326913,3269,323644,30676,61352,262292,456642,2099193,165837,1933356,,3067609,353.98,2141.4,0.0611,12781,20.0,123958.8,3.68,0.5176
1153,Johnson-Bradley,False,EG,Brucefort,Fintech,2015,https://johnson-bradley.com,To use assume middle record organization of national among.,16,johnson-bradley,2023,USD,2061723,439799,1621924,712953,908971,0,908971,20617,41234,867737,92940,1146892,344383,802509,,2061723,20.0,10.0,0.0608,937,183.32,82730.31,1.12,0.7867
1154,Huber Blair and Cline,False,TN,Whitakerberg,Fintech,2011,https://huberblairandcline.com,Even kitchen including summer bit.,18,huber-blair-and-cline,2023,USD,906248,490919,415329,257247,158082,16405,141677,9062,18124,123553,14296,534920,54515,480405,,906248,572.85,535.52,0.1035,373,202.32,1000.0,14.3,0.4583
1155,Franco PLC,False,FR,South Courtney,E-commerce,2019,https://francoplc.com,National pattern Mrs source eat window how.,20,franco-plc,2023,EUR,1273121,260579,1012542,686006,326536,28397,298139,12731,25462,272677,82654,758655,635532,123123,,1273121,381.74,813.51,0.1281,806,131.52,56626.52,1.46,0.7953
1156,Dunn Collins and Hunter,False,IN,Haleyland,HealthTech,2020,https://dunncollinsandhunter.com,Future end finish process book party reveal quickly.,22,dunn-collins-and-hunter,2023,USD,47530,10264,37266,35855,1411,25849,-24438,475,950,-25388,7742,96614,29474,67140,3960.83,47530,395.94,2247.99,0.0141,792,5.0,1000.0,7.74,0.7841
1157,Kirk Group,False,AU,Johnfurt,HealthTech,2012,https://kirkgroup.com,Goal audience bad radio artist.,21,kirk-group,2023,USD,527693,26384,501309,41544,459765,16244,443521,5276,10553,432968,18743,440444,54134,386310,43974.42,527693,229.2,280.72,0.001,442,99.4,8492.09,2.21,0.95
1158,Medina Wise and Aguirre,False,FR,South Leonard,AI/ML,2008,https://medinawiseandaguirre.com,Wish positive beyond often foreign outside her account.,21,medina-wise-and-aguirre,2023,EUR,425418,97554,327864,37628,290236,0,290236,4254,8508,281728,3518,288599,32137,256462,,425418,20.0,10.0,0.0499,158,223.06,1461.44,2.41,0.7707
1159,Wheeler Ltd,False,KE,Lindsayport,Marketplaces,2013,https://wheelerltd.com,Will economic another turn your radio ever total technology party.,16,wheeler-ltd,2023,USD,552186,233685,318501,418542,-100041,0,-100041,5521,11043,-111084,36011,317438,95058,222380,,552186,1051.6,3608.78,0.0906,151,303.82,79420.76,0.45,0.5768
1160,Jimenez-Williams,False,EG,Bakertown,E-commerce,2014,https://jimenez-williams.com,Fire tend majority kitchen Mr ahead late.,16,jimenez-williams,2023,USD,245985,93229,152756,29390,123366,20117,103249,2459,4919,98330,16272,318118,73774,244344,,245985,470.2,266.53,0.1354,129,158.68,29876.44,0.54,0.621
1161,Tate-Oconnell,False,BR,Port William,Cybersecurity,2012,https://tate-oconnell.com,Ahead capital tax hard sometimes then situation take contain industry.,23,tate-oconnell,2023,USD,381204,154597,226607,176070,50537,38567,11970,3812,7624,4346,26562,232583,11629,220954,,381204,1396.29,4783.27,0.0269,282,112.47,1000.0,26.56,0.5945
1162,Roberts Rodriguez and Chen,False,TN,Jeremyton,IoT,2022,https://robertsrodriguezandchen.com,Reason push civil cost.,22,roberts-rodriguez-and-chen,2023,USD,420674,125978,294696,252921,41775,32076,9699,4206,8413,1286,5114,357849,194507,163342,,420674,20.0,122.87,0.0752,381,91.97,24787.27,0.21,0.7005
1163,Hernandez and Sons,False,DE,Pattersonfort,Fintech,2011,https://hernandezandsons.com,Financial care firm attack agree bad exactly work begin.,15,hernandez-and-sons,2023,EUR,1985241,595046,1390195,1325471,64724,17784,46940,19852,39704,7236,93380,1216682,393762,822920,,1985241,550.78,2207.88,0.0693,1603,103.16,108248.25,0.86,0.7003
1164,Ochoa King and Robles,False,GB,Holdertown,Fintech,2020,https://ochoakingandrobles.com,Address listen might how represent yard campaign themselves common other.,15,ochoa-king-and-robles,2023,USD,1253729,227529,1026200,381221,644979,6009,638970,12537,25074,613896,30032,673618,179498,494120,,1253729,1873.15,10942.8,0.002,5223,20.0,36174.86,0.83,0.8185
1165,Wallace-Floyd,False,CA,Port Joshuaberg,Energy,2018,https://wallace-floyd.com,Society table police interesting challenge book clearly data.,21,wallace-floyd,2023,USD,2973062,1398644,1574418,1150914,423504,28493,395011,29730,59461,335550,482493,2106607,667942,1438665,,2973062,44.19,111.64,0.0393,12387,20.0,93657.87,5.15,0.5296
1166,Perez-Wolf,False,AU,Petersonchester,HealthTech,2015,https://perez-wolf.com,Recent role term mother leave go standard collection.,24,perez-wolf,2023,USD,101522,40052,61470,16006,45464,12339,33125,1015,2030,31095,10228,135079,38169,96910,8460.17,101522,349.71,1717.53,0.0303,154,54.74,1000.0,10.23,0.6055
1167,Gould-Thompson,False,IN,North Emily,Marketplaces,2010,https://gould-thompson.com,Me these gun sell wear another put.,17,gould-thompson,2023,USD,244753,86990,157763,158872,-1109,17546,-18655,2447,4895,-23550,11069,251188,110258,140930,,244753,716.61,2378.7,0.1242,110,185.12,19329.93,0.57,0.6446
1168,Scott-Delgado,False,DE,Denisemouth,AI/ML,2017,https://scott-delgado.com,Thank suddenly baby cause cover various.,18,scott-delgado,2023,EUR,535368,158456,376912,368464,8448,13428,-4980,5353,10707,-15687,19444,434267,189684,244583,,535368,20.0,54.15,0.0415,2230,20.0,45762.28,0.42,0.704
1169,Mitchell-Medina,False,AU,Flemingland,Cybersecurity,2008,https://mitchell-medina.com,Just similar shake drug fall political score majority air.,21,mitchell-medina,2023,USD,3266720,998692,2268028,2156197,111831,0,111831,32667,65334,46497,219603,1975328,945835,1029493,,3266720,42.62,141.23,0.0075,13611,20.0,207102.34,1.06,0.6943
1170,Ryan Cohen and Weiss,False,BR,Gomeztown,AgriTech,2014,https://ryancohenandweiss.com,Article suggest parent hit east among forget play almost participant.,17,ryan-cohen-and-weiss,2023,USD,34536,1726,32810,3486,29324,17505,11819,345,690,11129,10307,85399,34580,50819,,34536,732.41,4101.56,0.1124,143,20.0,5846.12,1.76,0.95
1171,Nguyen PLC,False,NG,West Claudia,IoT,2024,https://nguyenplc.com,Former director figure along TV record plant.,23,nguyen-plc,2023,USD,628244,254650,373594,183057,190537,0,190537,6282,12564,177973,25251,425630,205703,219927,,628244,1231.94,2991.9,0.001,383,136.4,12325.74,2.05,0.5947
1172,Robertson Ltd,False,DE,Alexanderhaven,Cybersecurity,2020,https://robertsonltd.com,Method attack interesting writer everything effort prove.,15,robertson-ltd,2023,EUR,861078,214875,646203,607825,38378,20225,18153,8610,17221,932,137901,618949,388551,230398,,861078,1607.64,6218.76,0.0492,1251,57.33,32896.06,4.19,0.7505
1173,Green-Simmons,False,IN,Port Amanda,Marketplaces,2009,https://green-simmons.com,Read little people late six blue politics prepare.,10,green-simmons,2023,USD,225566,73057,152509,56177,96332,16719,79613,2255,4511,75102,41644,299088,31289,267799,,225566,468.96,2678.06,0.1212,65,286.64,1000.0,41.64,0.6761
1174,Caldwell Allen and Larson,False,AU,New Stephen,EdTech,2023,https://caldwellallenandlarson.com,Mention eight much history performance often write month simply.,22,caldwell-allen-and-larson,2023,USD,775434,288947,486487,376088,110399,0,110399,7754,15508,94891,21134,471157,177824,293333,64619.5,775434,10.0,33.59,0.0159,1020,63.35,31321.95,0.67,0.6274
1175,George Torres and Galloway,False,TN,Rileyberg,Fintech,2015,https://georgetorresandgalloway.com,Bit style race effect discussion special technology worry music.,14,george-torres-and-galloway,2023,USD,1342920,807910,535010,800235,-265225,0,-265225,13429,26858,-292083,95408,941811,232645,709166,,1342920,20.0,31.19,0.0503,700,159.72,66987.84,1.42,0.3984
1176,Page-Thompson,False,EG,East Marie,Marketplaces,2010,https://page-thompson.com,Or clear dog nothing billion wish world.,25,page-thompson,2023,USD,299873,123082,176791,111818,64973,25593,39380,2998,5997,33383,3979,229377,98914,130463,,299873,1654.88,3378.91,0.0152,89,278.76,47275.53,0.08,0.5896
1177,Dunn Johnson and Mora,False,NG,New Jason,SaaS,2019,https://dunnjohnsonandmora.com,Military method any official under cold.,21,dunn-johnson-and-mora,2023,USD,214172,59377,154795,37824,116971,41247,75724,2141,4283,71441,2329,288424,204991,83433,17847.67,214172,10.0,53.38,0.001,194,91.67,19618.71,0.12,0.7228
1178,Williams Inc,False,CA,East Jerrytown,HealthTech,2020,https://williamsinc.com,As miss leave here.,18,williams-inc,2023,USD,194582,47445,147137,18261,128876,18023,110853,1945,3891,106962,10989,267737,60338,207399,16215.17,194582,529.82,4113.12,0.085,143,112.78,1000.0,10.99,0.7562
1179,Kent PLC,False,KE,Espinozaville,Energy,2019,https://kentplc.com,Natural stand country himself.,30,kent-plc,2023,USD,552451,126812,425639,118232,307407,11469,295938,5524,11049,284889,15671,436562,333760,102802,,552451,113.37,300.32,0.001,2301,20.0,9823.17,1.6,0.7705
1180,Roberts Ltd,False,NG,New Keith,Marketplaces,2013,https://robertsltd.com,Practice political be member another lot inside seem.,19,roberts-ltd,2023,USD,1265538,616373,649165,63276,585889,51507,534382,12655,25310,509072,111583,940519,97378,843141,,1265538,76.51,202.67,0.0437,456,231.25,1000.0,111.58,0.513
1181,May Lee and Parker,False,AU,Marilynville,Mobility,2010,https://mayleeandparker.com,About safe yes lead seem.,15,may-lee-and-parker,2023,USD,2500490,696352,1804138,1107387,696751,0,696751,25004,50009,646742,365100,1687994,1038393,649601,,2500490,194.91,696.02,0.0902,3572,58.33,79993.71,4.56,0.7215
1182,Smith LLC,False,US,Stephanieshire,IoT,2010,https://smithllc.com,Join avoid affect ready job win protect instead.,18,smith-llc,2023,USD,171459,70094,101365,88009,13356,0,13356,1714,3429,9927,18357,283714,66181,217533,,171459,124.2,62.1,0.0403,57,248.77,34693.47,0.53,0.5912
1183,Jones Ltd,False,US,Hendricksport,AgriTech,2014,https://jonesltd.com,Remember region through wall would.,12,jones-ltd,2023,USD,219834,49325,170509,133450,37059,10168,26891,2198,4396,22495,10959,142981,63687,79294,,219834,20.0,70.27,0.0359,132,138.1,15481.96,0.71,0.7756
1184,Morton PLC,False,US,Craigshire,SaaS,2020,https://mortonplc.com,Significant light mission address significant set involve.,16,morton-plc,2023,USD,4659459,1856839,2802620,2719295,83325,6308,77017,46594,93189,-16172,584542,3035588,1221170,1814418,388288.25,4659459,691.59,3100.12,0.0438,4804,80.82,220148.57,2.66,0.6015
1185,Harris Spencer and Gray,False,NG,Mooremouth,AgriTech,2024,https://harrisspencerandgray.com,Month music newspaper mind.,20,harris-spencer-and-gray,2023,USD,235860,66267,169593,11793,157800,0,157800,2358,4717,153083,5705,301412,161455,139957,,235860,155.41,568.88,0.0991,72,272.59,15230.06,0.37,0.719
1186,Knight Kennedy and Cooley,False,AU,Harringtonland,Energy,2021,https://knightkennedyandcooley.com,Air sort investment guy such notice to age.,19,knight-kennedy-and-cooley,2023,USD,3931649,1405912,2525737,1016804,1508933,24415,1484518,39316,78632,1405886,117781,2092499,120185,1972314,,3931649,738.73,2668.32,0.0828,16381,20.0,88537.7,1.33,0.6424
1187,Young Johnson and Miller,False,ZA,Ibarrastad,Energy,2010,https://youngjohnsonandmiller.com,Support piece officer store cost address within network accept.,18,young-johnson-and-miller,2023,USD,2419075,555900,1863175,407596,1455579,0,1455579,24190,48381,1407198,158675,1567250,78362,1488888,,2419075,1374.93,3044.52,0.1054,4351,46.33,23682.14,6.7,0.7702
1188,Richardson Taylor and Jones,False,BR,Wardhaven,AI/ML,2012,https://richardsontaylorandjones.com,Will brother main fact bed security major his.,19,richardson-taylor-and-jones,2023,USD,2213624,852343,1361281,2517323,-1156042,6331,-1162373,22136,44272,-1206645,117735,1411819,553333,858486,,2213624,579.98,2876.03,0.0692,1010,182.59,169329.47,0.7,0.615
1189,Bowers Inc,False,IN,West Christopher,Fintech,2017,https://bowersinc.com,Idea case entire class owner local mention avoid apply religious.,13,bowers-inc,2023,USD,2281258,1120603,1160655,896722,263933,0,263933,22812,45625,218308,154928,1318631,256882,1061749,,2281258,994.51,1575.15,0.0156,1453,130.81,64599.12,2.4,0.5088
1190,Le-Richardson,False,FR,North Madeline,AI/ML,2014,https://le-richardson.com,Race health street animal itself media able official.,25,le-richardson,2023,EUR,222336,70849,151487,134379,17108,14716,2392,2223,4446,-2054,4999,255954,105078,150876,,222336,112.85,867.61,0.0488,182,101.51,15819.23,0.32,0.6813
1191,Richard LLC,False,AU,Rivasshire,HealthTech,2018,https://richardllc.com,Visit anyone place detail.,27,richard-llc,2023,USD,827629,82858,744771,167552,577219,0,577219,8276,16552,560667,93275,555073,161052,394021,68969.08,827629,317.22,1291.0,0.0347,3304,20.87,1000.0,93.28,0.8999
1192,Roach Ortiz and Sampson,False,TN,Jacksonberg,IoT,2010,https://roachortizandsampson.com,Summer like concern clear nice foreign return.,27,roach-ortiz-and-sampson,2023,USD,608655,165276,443379,217450,225929,15662,210267,6086,12173,198094,129183,594052,283133,310919,,608655,20.0,110.23,0.0218,2536,20.0,40563.67,3.18,0.7285
1193,Smith-Davis,False,IN,East Haley,Cybersecurity,2021,https://smith-davis.com,Drive carry information hope value under some health loss.,24,smith-davis,2023,USD,1686159,600620,1085539,462499,623040,3115,619925,16861,33723,586202,101913,1073336,597319,476017,,1686159,173.67,86.84,0.0761,2245,62.57,50381.25,2.02,0.6438
1194,Hartman PLC,False,ZA,North Darrenstad,EdTech,2009,https://hartmanplc.com,Particular such though body.,14,hartman-plc,2023,USD,285843,57088,228755,100049,128706,18820,109886,2858,5716,104170,13253,189720,61761,127959,23820.25,285843,10.0,32.71,0.0691,399,59.6,1000.0,13.25,0.8003
1195,Miller Lopez and Miller,False,DE,Lake Michaelmouth,Fintech,2021,https://millerlopezandmiller.com,Start carry analysis left special.,17,miller-lopez-and-miller,2023,EUR,710961,77743,633218,644002,-10784,18163,-28947,7109,14219,-43166,33829,410946,84813,326133,,710961,867.59,970.01,0.001,2962,20.0,27298.81,1.24,0.8907
1196,Edwards Smith and Krueger,False,FR,Rebeccaland,Mobility,2009,https://edwardssmithandkrueger.com,Off fine represent recognize dinner position something miss including.,28,edwards-smith-and-krueger,2023,EUR,1717418,738986,978432,592108,386324,3590,382734,17174,34348,348386,51491,967607,322418,645189,,1717418,334.2,2051.98,0.0127,1685,84.91,62771.58,0.82,0.5697
1197,Berry Grimes and Jenkins,False,IN,New Jonathan,Marketplaces,2013,https://berrygrimesandjenkins.com,She including run where soldier method center listen source.,30,berry-grimes-and-jenkins,2023,USD,887691,165159,722532,333191,389341,0,389341,8876,17753,371588,12424,542661,319780,222881,,887691,1606.05,12402.89,0.0513,395,187.25,40090.79,0.31,0.8139
1198,Miller Winters and Swanson,False,FR,North Jonathanton,SaaS,2012,https://millerwintersandswanson.com,Goal no particularly develop consumer life.,17,miller-winters-and-swanson,2023,EUR,576706,228836,347870,441830,-93960,20517,-114477,5767,11534,-126011,31460,380874,270218,110656,48058.83,576706,167.02,1057.17,0.001,9611,5.0,60891.25,0.52,0.6032
1199,Lewis-Keith,False,ZA,Samuelhaven,SaaS,2013,https://lewis-keith.com,Front truth inside art television without itself.,18,lewis-keith,2023,USD,119974,36228,83746,82124,1622,0,1622,1199,2399,-777,1302,82608,29976,52632,9997.83,119974,10.0,53.54,0.001,113,87.97,23314.59,0.06,0.698
1200,Patterson Lee and Kelley,False,EG,Patriciaside,E-commerce,2024,https://pattersonleeandkelley.com,Crime field computer son him wonder traditional why fear.,22,patterson-lee-and-kelley,2023,USD,914056,477327,436729,745142,-308413,7872,-316285,9140,18281,-334566,14344,559705,233251,326454,,914056,134.42,67.21,0.1125,386,197.27,79208.2,0.18,0.4778
1201,Fernandez LLC,False,NG,Brianmouth,Cybersecurity,2016,https://fernandezllc.com,Relate hour large friend bag which city.,23,fernandez-llc,2023,USD,1888140,557767,1330373,1263170,67203,40935,26268,18881,37762,-11494,57973,1103653,558545,545108,,1888140,52.84,290.85,0.047,731,215.17,82744.61,0.7,0.7046
1202,White Summers and Wheeler,False,GB,Rachelmouth,E-commerce,2012,https://whitesummersandwheeler.com,Amount pick finally agree wrong.,12,white-summers-and-wheeler,2023,USD,286572,154094,132478,177009,-44531,3010,-47541,2865,5731,-53272,23209,264667,141505,123162,,286572,592.22,1899.97,0.1287,274,86.85,1000.0,23.21,0.4623
1203,Preston Inc,False,ZA,North Stevenhaven,AgriTech,2011,https://prestoninc.com,Believe worry affect forget far wall radio approach.,26,preston-inc,2023,USD,305974,89294,216680,15298,201382,0,201382,3059,6119,195263,21981,274288,125816,148472,,305974,188.63,564.58,0.0753,150,169.54,24466.75,0.9,0.7082
1204,Thompson Schultz and Sullivan,False,AU,Samanthamouth,SaaS,2018,https://thompsonschultzandsullivan.com,Recognize bar computer a bar career just.,14,thompson-schultz-and-sullivan,2023,USD,506425,165764,340661,248235,92426,4866,87560,5064,10128,77432,52836,483996,76092,407904,42202.08,506425,10.0,51.25,0.0226,8440,5.0,3537.66,14.94,0.6727
1205,Glover-Mccullough,False,AU,Monicaton,Energy,2016,https://glover-mccullough.com,Citizen individual speech try.,19,glover-mccullough,2023,USD,2631574,1026199,1605375,1347484,257891,0,257891,26315,52631,205260,468603,1790848,741224,1049624,,2631574,1047.7,1864.38,0.0488,1919,114.25,71630.86,6.54,0.61
1206,Flores LLC,False,NG,Port Jennifer,Fintech,2016,https://floresllc.com,Trade get something rather open key.,24,flores-llc,2023,USD,4192104,1137138,3054966,2203185,851781,6094,845687,41921,83842,761845,114804,2307121,1062081,1245040,,4192104,20.0,40.04,0.001,5252,66.51,188714.3,0.61,0.7287
1207,Morgan Kim and Williams,False,ZA,Garciamouth,IoT,2010,https://morgankimandwilliams.com,Suddenly less nearly us remain operation.,21,morgan-kim-and-williams,2023,USD,1092870,692131,400739,1032735,-631996,9464,-641460,10928,21857,-663317,51843,632219,146030,486189,,1092870,382.91,749.67,0.0807,286,318.4,63176.15,0.82,0.3667
1208,Schneider-Mcintyre,False,EG,North Alecfurt,Mobility,2024,https://schneider-mcintyre.com,Whatever performance wide significant activity real often.,19,schneider-mcintyre,2023,USD,542898,111303,431595,42101,389494,5974,383520,5428,10857,372663,85036,452646,103629,349017,,542898,282.25,1647.14,0.0776,284,159.06,9886.53,8.6,0.795
1209,Ramirez and Sons,False,CA,East Rosshaven,SaaS,2023,https://ramirezandsons.com,Recognize set ask myself phone travel western wrong front past throughout.,19,ramirez-and-sons,2023,USD,955752,340770,614982,588558,26424,9120,17304,9557,19115,-1811,17005,500216,234312,265904,79646.0,955752,514.06,2067.76,0.001,1162,68.49,53992.3,0.31,0.6435
1210,Howard Wolf and Sanchez,False,KE,Ginamouth,HealthTech,2019,https://howardwolfandsanchez.com,Animal hold almost imagine main wait.,19,howard-wolf-and-sanchez,2023,USD,1587473,335497,1251976,79373,1172603,25540,1147063,15874,31749,1115314,79076,1072324,503156,569168,132289.42,1587473,420.68,1502.37,0.0688,5005,26.43,1000.0,79.08,0.7887
1211,Schneider Group,False,GB,Hahnside,AgriTech,2011,https://schneidergroup.com,Available hit keep enjoy sing.,13,schneider-group,2023,USD,1298758,457816,840942,257365,583577,0,583577,12987,25975,557602,108579,877593,43879,833714,,1298758,20.0,41.95,0.0425,1605,67.4,17724.89,6.13,0.6475
1212,Ferrell PLC,False,KE,Heatherberg,Marketplaces,2011,https://ferrellplc.com,Production now eye ok white heart.,25,ferrell-plc,2023,USD,568582,262054,306528,469463,-162935,0,-162935,5685,11371,-174306,124820,477258,147325,329933,,568582,1092.41,5079.53,0.0561,171,276.03,12181.95,10.25,0.5391
1213,Smith Group,False,DE,Ellisburgh,Cybersecurity,2024,https://smithgroup.com,Foreign design plan stock authority defense here effort.,20,smith-group,2023,EUR,429056,174228,254828,327962,-73134,39171,-112305,4290,8581,-120886,19277,282983,87748,195235,,429056,319.53,530.71,0.001,859,41.61,81900.16,0.24,0.5939
1214,White-Rodriguez,False,US,Isaiahton,SaaS,2008,https://white-rodriguez.com,Cost water reflect change smile film task attorney say allow always.,17,white-rodriguez,2023,USD,293152,32350,260802,139087,121715,8487,113228,2931,5863,107365,51751,296591,17645,278946,24429.33,293152,465.81,2137.33,0.0021,1379,17.71,1000.0,51.75,0.8896
1215,Combs-Williams,False,DE,North Dana,SaaS,2023,https://combs-williams.com,New including education add though bring himself know some pattern.,27,combs-williams,2023,EUR,3870855,197202,3673653,1856285,1817368,23335,1794033,38708,77417,1716616,127135,2146726,107336,2039390,322571.25,3870855,275.01,1002.95,0.001,7035,45.85,152788.03,0.83,0.9491
1216,Campbell Ltd,False,CA,Susanmouth,Energy,2012,https://campbellltd.com,Senior you news word later tax team because.,17,campbell-ltd,2023,USD,1503949,786438,717511,75197,642314,0,642314,15039,30078,612236,89680,882988,310309,572679,,1503949,20.0,10.0,0.0709,708,177.0,1000.0,89.68,0.4771
1217,Mclaughlin Wise and Collins,False,GB,Williamsbury,SaaS,2021,https://mclaughlinwiseandcollins.com,Provide think something those center have minute back left.,19,mclaughlin-wise-and-collins,2023,USD,474579,126718,347861,245782,102079,25185,76894,4745,9491,67403,9099,373436,87753,285683,39548.25,474579,178.71,178.71,0.0452,447,88.44,21298.97,0.43,0.733
1218,Wu-Neal,False,DE,North Rebecca,E-commerce,2015,https://wu-neal.com,Before general class require nearly.,15,wu-neal,2023,EUR,4155684,561772,3593912,3183559,410353,3727,406626,41556,83113,323513,87417,2183490,365440,1818050,,4155684,20.0,166.4,0.001,5283,65.55,288348.33,0.3,0.8648
1219,Lopez Ltd,False,TN,North Deborah,Cybersecurity,2018,https://lopezltd.com,Rise color good travel size mission travel reveal rather not.,10,lopez-ltd,2023,USD,878817,309068,569749,445234,124515,0,124515,8788,17576,106939,76873,695983,204715,491268,,878817,20.0,28.82,0.0701,451,162.13,67483.22,1.14,0.6483
1220,Rodriguez-Rodriguez,False,IN,Lewisstad,Fintech,2019,https://rodriguez-rodriguez.com,Nearly bank open fine see real like region.,16,rodriguez-rodriguez,2023,USD,1212122,199714,1012408,838615,173793,23168,150625,12121,24242,126383,123367,729637,331246,398391,,1212122,20.0,46.77,0.0945,301,334.96,81662.77,1.51,0.8352
1221,James PLC,False,FR,Lake Brentmouth,AI/ML,2009,https://jamesplc.com,Long she record teach attack without participant.,14,james-plc,2023,EUR,126715,41006,85709,51407,34302,7560,26742,1267,2534,24208,2356,158772,27649,131123,,126715,238.58,119.29,0.0419,527,20.0,5695.38,0.41,0.6764
1222,Romero PLC,False,GB,Nolanhaven,EdTech,2024,https://romeroplc.com,Forward think term price yet catch reveal.,22,romero-plc,2023,USD,1094608,395995,698613,774120,-75507,0,-75507,10946,21892,-97399,14442,650576,75513,575063,91217.33,1094608,830.76,4095.02,0.0663,18243,5.0,94355.1,0.15,0.6382
1223,Martin-Brown,False,US,New Kelly,Energy,2010,https://martin-brown.com,Personal stuff director production choice edge.,14,martin-brown,2023,USD,650581,363760,286821,117459,169362,19584,149778,6505,13011,136767,28966,522603,258530,264073,,650581,1161.86,580.93,0.001,2710,20.0,52371.37,0.55,0.4409
1224,Ramirez-Archer,False,EG,Lake David,AgriTech,2017,https://ramirez-archer.com,Security at wind what officer report red pull save same.,21,ramirez-archer,2023,USD,342221,112320,229901,157060,72841,14782,58059,3422,6844,51215,14037,310367,174442,135925,,342221,20.0,43.63,0.102,1425,20.0,9173.66,1.53,0.6718
1225,Johnson and Sons,False,CA,West Sharonberg,Fintech,2022,https://johnsonandsons.com,System candidate keep grow us receive billion.,12,johnson-and-sons,2023,USD,939838,424514,515324,442959,72365,962,71403,9398,18796,52607,90077,689784,251301,438483,,939838,722.17,3069.55,0.1082,249,314.16,17620.1,5.11,0.5483
1226,Robbins-Williams,False,US,New Clayton,E-commerce,2014,https://robbins-williams.com,Though imagine how able worker arm resource organization.,23,robbins-williams,2023,USD,775742,497289,278453,333739,-55286,27328,-82614,7757,15514,-98128,101679,502296,164031,338265,,775742,330.21,363.01,0.001,414,155.93,1000.0,101.68,0.359
1227,Bryant-Kelly,False,IN,New Amandaberg,IoT,2017,https://bryant-kelly.com,Raise prepare wrong bed radio.,19,bryant-kelly,2023,USD,878800,324364,554436,450580,103856,17636,86220,8788,17576,68644,162560,791317,281335,509982,,878800,651.05,2051.69,0.077,1202,60.91,1000.0,162.56,0.6309
1228,Good Jones and Evans,False,ZA,Port Shirleyshire,IoT,2015,https://goodjonesandevans.com,Design want ahead easy whole must every per hot character.,21,good-jones-and-evans,2023,USD,844279,295063,549216,426707,122509,12926,109583,8442,16885,92698,64538,628032,251400,376632,,844279,1050.75,538.16,0.0347,3196,22.01,14474.41,4.46,0.6505
1229,Solis and Sons,False,EG,South Tommyhaven,E-commerce,2023,https://solisandsons.com,Happen newspaper happy subject success.,13,solis-and-sons,2023,USD,1911438,618790,1292648,1573026,-280378,181,-280559,19114,38228,-318787,32366,1097948,330986,766962,,1911438,840.49,3038.95,0.0412,2463,64.67,123686.62,0.26,0.6763
1230,Stevens-Mullins,False,AU,South Jesusfurt,EdTech,2015,https://stevens-mullins.com,Base mention hour gun field expert.,21,stevens-mullins,2023,USD,531064,308486,222578,229750,-7172,4031,-11203,5310,10621,-21824,16018,389156,19457,369699,44255.33,531064,521.73,2375.81,0.0737,8851,5.0,1837.11,8.72,0.4191
1231,Turner-Johnson,False,GB,Myersborough,SaaS,2021,https://turner-johnson.com,Painting country different indicate across positive heavy.,25,turner-johnson,2023,USD,2588244,398089,2190155,1009105,1181050,12986,1168064,25882,51764,1116300,283153,1752506,957113,795393,215687.0,2588244,10.0,69.55,0.0603,8576,25.15,109573.28,2.58,0.8462
1232,Lopez-Bradford,False,US,Taylorville,EdTech,2019,https://lopez-bradford.com,Far chair describe in case.,20,lopez-bradford,2023,USD,170106,66377,103729,92052,11677,34563,-22886,1701,3402,-26288,1766,143501,39166,104335,14175.5,170106,386.33,2059.52,0.0683,558,25.38,1000.0,1.77,0.6098
1233,Cooper Pena and Dominguez,False,BR,Emilyville,Cybersecurity,2008,https://cooperpenaanddominguez.com,Sure player western move manage worry wear pay science us.,20,cooper-pena-and-dominguez,2023,USD,1053153,389257,663896,234119,429777,0,429777,10531,21063,408714,226878,926954,598105,328849,,1053153,448.89,2406.43,0.0589,528,166.21,6744.06,33.64,0.6304
1234,Fowler Ltd,False,CA,Rebeccaland,SaaS,2020,https://fowlerltd.com,Number herself determine nice source thought result while example leave.,20,fowler-ltd,2023,USD,187837,96631,91206,9391,81815,41987,39828,1878,3756,36072,29651,172013,93287,78726,15653.08,187837,544.12,2917.57,0.0068,1686,9.28,10033.19,2.96,0.4856
1235,Small Ltd,False,ZA,West Amandabury,Cybersecurity,2017,https://smallltd.com,End dark spring speak drive bad strong.,22,small-ltd,2023,USD,1256042,533433,722609,787111,-64502,0,-64502,12560,25120,-89622,73460,703109,365429,337680,,1256042,866.75,2351.45,0.001,5233,20.0,110222.51,0.67,0.5753
1236,Rice Sullivan and Brooks,False,FR,Mitchellmouth,EdTech,2024,https://ricesullivanandbrooks.com,Trouble nor environmental former law only thus something.,23,rice-sullivan-and-brooks,2023,EUR,291264,162412,128852,14563,114289,10519,103770,2912,5825,97945,117421,368124,187871,180253,24272.0,291264,10.0,53.91,0.001,1628,14.9,11407.31,10.29,0.4424
1237,Griffith-Bender,False,DE,Staceystad,Energy,2023,https://griffith-bender.com,Job nor yard establish hit rock since.,17,griffith-bender,2023,EUR,2687303,1229456,1457847,965224,492623,1866,490757,26873,53746,437011,22486,1422394,466642,955752,,2687303,905.59,2653.78,0.0358,8740,25.62,107295.23,0.21,0.5425
1238,Rivers-Brown,False,US,West David,HealthTech,2016,https://rivers-brown.com,Gas have movement traditional of understand.,21,rivers-brown,2023,USD,1938758,1119078,819680,1535925,-716245,0,-716245,19387,38775,-755020,478210,1593296,556586,1036710,161563.17,1938758,541.42,586.16,0.0691,6794,23.78,121907.78,3.92,0.4228
1239,Stark Torres and Miller,False,FR,Jacobfurt,SaaS,2015,https://starktorresandmiller.com,Central skill he high few land both two add thank.,22,stark-torres-and-miller,2023,EUR,618673,169930,448743,558143,-109400,0,-109400,6186,12373,-121773,18119,413591,37986,375605,51556.08,618673,516.61,546.35,0.0234,10311,5.0,51401.01,0.35,0.7253
1240,Taylor-Richardson,False,NG,West Hunterville,Energy,2019,https://taylor-richardson.com,Apply property enter name crime society church.,29,taylor-richardson,2023,USD,3820651,1324313,2496338,1688550,807788,6709,801079,38206,76413,724666,158125,2079774,871586,1208188,,3820651,534.16,3588.66,0.0255,1777,179.14,154287.92,1.02,0.6534
1241,Velasquez-Turner,False,EG,Oliviaborough,Cybersecurity,2010,https://velasquez-turner.com,Laugh include price leader bit.,27,velasquez-turner,2023,USD,1485078,512222,972856,808708,164148,15067,149081,14850,29701,119380,139926,1081315,694914,386401,,1485078,214.35,990.68,0.0969,927,133.43,88151.75,1.59,0.6551
1242,Mckee Johnson and Brewer,False,KE,South Shelbystad,Fintech,2024,https://mckeejohnsonandbrewer.com,Center build happy near begin usually.,21,mckee-johnson-and-brewer,2023,USD,1528324,583960,944364,478117,466247,0,466247,15283,30566,435681,131529,956306,637652,318654,,1528324,1124.1,4724.77,0.0057,6368,20.0,44874.84,2.93,0.6179
1243,Flores-Clark,False,GB,Jocelynburgh,Marketplaces,2020,https://flores-clark.com,Threat measure leave environment quite three marriage both create.,17,flores-clark,2023,USD,1042509,473885,568624,189992,378632,2154,376478,10425,20850,355628,70430,705693,134627,571066,,1042509,370.36,1432.14,0.0651,948,91.63,13027.04,5.41,0.5454
1244,Kane Ltd,False,FR,Lake Allisonmouth,IoT,2009,https://kaneltd.com,Development know laugh officer hundred food.,20,kane-ltd,2023,EUR,1970044,785772,1184272,683411,500861,17328,483533,19700,39400,444133,191170,1354152,469594,884558,,1970044,28.76,59.23,0.0725,8208,20.0,46450.99,4.12,0.6011
1245,Lee Inc,False,TN,West Rhondaton,Marketplaces,2012,https://leeinc.com,Record spring sport usually as until happen power probably animal agent.,20,lee-inc,2023,USD,558745,146711,412034,263661,148373,0,148373,5587,11174,137199,51957,511674,160378,351296,,558745,2192.67,8419.49,0.0201,425,109.37,2475.9,20.99,0.7374
1246,Webb Ltd,False,DE,Lake David,AgriTech,2016,https://webbltd.com,Control leg suggest crime international page dinner.,23,webb-ltd,2023,EUR,362110,88840,273270,172299,100971,0,100971,3621,7242,93729,15615,271522,139941,131581,,362110,1434.03,5722.6,0.0848,1325,22.77,28145.0,0.55,0.7547
1247,Schwartz Martinez and Sellers,False,CA,Riceland,Energy,2018,https://schwartzmartinezandsellers.com,Year training cup cup performance go child simply compare.,18,schwartz-martinez-and-sellers,2023,USD,622012,182163,439849,423956,15893,0,15893,6220,12440,3453,4210,493320,194818,298502,,622012,1181.98,747.64,0.001,2591,20.0,42711.04,0.1,0.7071
1248,Johnson Newman and Johnston,False,CA,Bowersstad,Mobility,2016,https://johnsonnewmanandjohnston.com,Rest whom good throw process degree.,10,johnson-newman-and-johnston,2023,USD,614037,223705,390332,225576,164756,4442,160314,6140,12280,148034,73606,541273,340904,200369,,614037,20.0,40.11,0.0136,293,174.5,43148.96,1.71,0.6357
1249,Hernandez and Sons,False,DE,Perezborough,Fintech,2014,https://hernandezandsons.com,Owner company expert table reality stock site develop government can.,14,hernandez-and-sons,2023,EUR,1600189,541407,1058782,837926,220856,42796,178060,16001,32003,146057,199380,1032904,367096,665808,,1600189,775.95,2849.57,0.0397,6667,20.0,70425.48,2.83,0.6617
1250,Simmons-Hunter,False,GB,South Randyton,IoT,2011,https://simmons-hunter.com,Wish animal could parent small building media citizen table high.,15,simmons-hunter,2023,USD,458636,104340,354296,125906,228390,0,228390,4586,9172,219218,68150,409151,20457,388694,,458636,1251.5,4885.21,0.001,203,187.72,15557.34,4.38,0.7725
1251,Smith Inc,False,GB,South Cory,Fintech,2013,https://smithinc.com,Develop while question place consumer bed teacher program success itself.,16,smith-inc,2023,USD,1809175,486371,1322804,518531,804273,2207,802066,18091,36183,765883,106129,1180816,658596,522220,,1809175,2253.56,10043.39,0.0334,1086,138.82,34716.37,3.06,0.7312
1252,Gill Ferguson and Scott,False,EG,Mendozamouth,Mobility,2018,https://gillfergusonandscott.com,Send capital decide wide describe real check weight try.,19,gill-ferguson-and-scott,2023,USD,550201,222563,327638,215025,112613,47360,65253,5502,11004,54249,16124,305903,145450,160453,,550201,815.86,1330.53,0.0564,363,126.01,1581.52,10.2,0.5955
1253,Smith Rodriguez and Lawson,False,TN,Wendystad,Fintech,2019,https://smithrodriguezandlawson.com,Wrong teach not response professor rate team condition when if.,21,smith-rodriguez-and-lawson,2023,USD,310420,112639,197781,165531,32250,11531,20719,3104,6208,14511,11694,319034,128967,190067,,310420,1202.4,6094.49,0.0406,1293,20.0,16375.35,0.71,0.6371
1254,White-Beasley,False,AU,Jasonton,EdTech,2022,https://white-beasley.com,Drug today so long sometimes at positive mother.,30,white-beasley,2023,USD,527071,159982,367089,137021,230068,13563,216505,5270,10541,205964,5730,286526,182991,103535,43922.58,527071,178.51,202.86,0.001,750,58.51,18435.21,0.31,0.6965
1255,Sanders-Mcguire,False,IN,Danbury,Mobility,2016,https://sanders-mcguire.com,Magazine firm task wear.,24,sanders-mcguire,2023,USD,1295235,231844,1063391,829302,234089,1751,232338,12952,25904,206434,61865,756071,422581,333490,,1295235,541.13,3397.62,0.083,562,191.75,85198.51,0.73,0.821
1256,Delgado LLC,False,FR,North Pamela,Fintech,2013,https://delgadollc.com,Detail history husband arm six.,25,delgado-llc,2023,EUR,1036217,475360,560857,511487,49370,0,49370,10362,20724,28646,14353,583995,140382,443613,,1036217,20.0,66.66,0.022,4317,20.0,35349.15,0.41,0.5413
1257,Ross Duncan and Cortez,False,AU,Paulmouth,Marketplaces,2017,https://rossduncanandcortez.com,So and five notice son view process.,23,ross-duncan-and-cortez,2023,USD,725581,121329,604252,443338,160914,0,160914,7255,14511,146403,119689,581682,202644,379038,,725581,163.68,716.26,0.0099,437,138.14,61741.57,1.94,0.8328
1258,Miller-Madden,False,ZA,Charlesshire,Cybersecurity,2009,https://miller-madden.com,Form even now provide office heavy world opportunity.,18,miller-madden,2023,USD,546935,197405,349530,168980,180550,8624,171926,5469,10938,160988,9078,442465,107100,335365,,546935,20.0,72.41,0.1057,389,117.09,27622.28,0.33,0.6391
1259,Payne-Howard,False,DE,North Thomas,E-commerce,2012,https://payne-howard.com,Specific adult collection with.,23,payne-howard,2023,EUR,1160887,384210,776677,298274,478403,0,478403,11608,23217,455186,34381,686502,340734,345768,,1160887,77.26,432.53,0.0169,688,140.6,13013.08,2.64,0.669
1260,Smith Dean and Pearson,False,FR,East Jessicaland,Cybersecurity,2015,https://smithdeanandpearson.com,Film wait number sell involve water.,13,smith-dean-and-pearson,2023,EUR,452877,117329,335548,235157,100391,21162,79229,4528,9057,70172,195352,596620,359487,237133,,452877,653.91,2291.2,0.001,132,285.3,74142.97,2.63,0.7409
1261,Ford-Knight,False,CA,Sullivanshire,Energy,2024,https://ford-knight.com,Listen avoid international throw discuss something world continue just hope.,22,ford-knight,2023,USD,1600414,131711,1468703,793127,675576,5635,669941,16004,32008,637933,19551,983821,432519,551302,,1600414,859.27,5942.94,0.0745,650,205.14,26363.37,0.74,0.9177
1262,Stevens LLC,False,US,Wongchester,Marketplaces,2017,https://stevensllc.com,Down PM debate piece occur trouble realize data.,21,stevens-llc,2023,USD,1481009,213784,1267225,493599,773626,0,773626,14810,29620,744006,34282,870909,547663,323246,,1481009,169.22,88.09,0.1222,6170,20.0,72699.98,0.47,0.8556
1263,Davis Carrillo and Murphy,False,IN,North Stephanie,HealthTech,2008,https://daviscarrilloandmurphy.com,Pm consider by animal building attorney success simple main her.,16,davis-carrillo-and-murphy,2023,USD,663310,250637,412673,193211,219462,52017,167445,6633,13266,154179,205789,551411,27570,523841,55275.83,663310,390.85,1764.75,0.001,962,57.44,45041.01,4.57,0.6221
1264,Hart-Bryant,False,TN,Timothyton,Mobility,2015,https://hart-bryant.com,Cell why less fill.,21,hart-bryant,2023,USD,3141581,875084,2266497,1522774,743723,26066,717657,31415,62831,654826,1321937,3074950,286237,2788713,,3141581,503.91,2588.04,0.1029,1239,211.25,78227.05,16.9,0.7215
1265,Ortega Graham and Morales,False,FR,Watkinsport,Mobility,2011,https://ortegagrahamandmorales.com,Information cut three interview wrong.,23,ortega-graham-and-morales,2023,EUR,322232,52386,269846,207414,62432,7272,55160,3222,6444,48716,8474,194572,124089,70483,,322232,455.79,501.42,0.0165,116,230.99,1000.0,8.47,0.8374
1266,Hodge-Johnson,False,AU,Sanchezmouth,HealthTech,2011,https://hodge-johnson.com,Like also school window north pattern while.,24,hodge-johnson,2023,USD,856187,231035,625152,309557,315595,15023,300572,8561,17123,283449,110981,732542,384122,348420,71348.92,856187,344.07,1868.9,0.0149,1372,51.97,31780.09,3.49,0.7302
1267,Miller-Andrade,False,US,Derrickfurt,SaaS,2015,https://miller-andrade.com,Fly anyone he letter account happy body.,17,miller-andrade,2023,USD,748371,304234,444137,352042,92095,12890,79205,7483,14967,64238,36768,581229,29061,552168,62364.25,748371,10.0,47.11,0.001,5343,11.67,4232.19,8.69,0.5935
1268,Martin Gutierrez and Clark,False,GB,Jimmyland,EdTech,2020,https://martingutierrezandclark.com,Pass trouble per nice now friend hour two.,20,martin-gutierrez-and-clark,2023,USD,2639363,346257,2293106,1986686,306420,11722,294698,26393,52787,241911,285025,1703625,373362,1330263,219946.92,2639363,10.0,30.91,0.001,3173,69.3,178723.11,1.59,0.8688
1269,Sandoval-Wright,False,CA,Karenport,Marketplaces,2010,https://sandoval-wright.com,Film either authority to partner how up.,18,sandoval-wright,2023,USD,3045307,1436182,1609125,152265,1456860,19696,1437164,30453,60906,1376258,698071,2309243,722118,1587125,,3045307,1031.04,2281.39,0.1668,6845,37.07,14503.64,48.13,0.5284
1270,Sanchez Lawson and Bass,False,KE,Joshuamouth,IoT,2016,https://sanchezlawsonandbass.com,Difficult thing theory enough moment put price.,15,sanchez-lawson-and-bass,2023,USD,113307,44280,69027,34962,34065,0,34065,1133,2266,31799,28155,200790,104519,96271,,113307,1498.0,2572.05,0.0089,472,20.0,1000.0,28.16,0.6092
1271,Jackson Walker and Watkins,False,FR,Andersonfort,SaaS,2010,https://jacksonwalkerandwatkins.com,Write protect mouth side mission teach.,21,jackson-walker-and-watkins,2023,EUR,1436676,598395,838281,615713,222568,0,222568,14366,28733,193835,402540,1205247,332811,872436,119723.0,1436676,99.49,265.23,0.0026,1280,93.49,1000.0,402.54,0.5835
1272,Garcia-Moore,False,DE,Port Ashleyberg,Marketplaces,2022,https://garcia-moore.com,Reality boy long analysis force.,20,garcia-moore,2023,EUR,486304,112305,373999,156263,217736,0,217736,4863,9726,208010,98458,524262,281977,242285,,486304,106.55,53.28,0.0994,2026,20.0,1000.0,98.46,0.7691
1273,Bailey Mitchell and Mckinney,False,AU,Woodfort,HealthTech,2010,https://baileymitchellandmckinney.com,Car sing also act few note summer high ask rich.,10,bailey-mitchell-and-mckinney,2023,USD,1300120,717317,582803,1210975,-628172,0,-628172,13001,26002,-654174,45998,777143,260479,516664,108343.33,1300120,181.33,1210.53,0.0527,2933,36.93,96682.3,0.48,0.4483
1274,Knight Inc,False,AU,Lake Nancy,E-commerce,2011,https://knightinc.com,Carry boy safe left teach.,18,knight-inc,2023,USD,167863,48810,119053,53503,65550,3882,61668,1678,3357,58311,10953,159450,52017,107433,,167863,20.0,75.76,0.0655,87,160.14,6243.02,1.75,0.7092
1275,Rice-Larson,False,US,West Brandi,Mobility,2009,https://rice-larson.com,Quality likely able vote wife bad off despite attention relationship need.,19,rice-larson,2023,USD,673095,380118,292977,305063,-12086,0,-12086,6730,13461,-25547,34228,550255,231632,318623,,673095,216.9,835.03,0.1338,313,179.06,45546.93,0.75,0.4353
1276,Green LLC,False,GB,Hughesland,IoT,2021,https://greenllc.com,Development my he those father.,23,green-llc,2023,USD,4930520,1257870,3672650,2654550,1018100,19649,998451,49305,98610,899841,147922,2619088,1400416,1218672,,4930520,20.0,87.74,0.0826,1325,309.96,210920.53,0.7,0.7449
1277,Lee Group,False,ZA,Lake Joyce,Energy,2023,https://leegroup.com,Teach crime leader consumer image.,24,lee-group,2023,USD,3947430,1595467,2351963,1263207,1088756,26789,1061967,39474,78948,983019,85498,2112137,1339363,772774,,3947430,1776.81,11641.79,0.055,16447,20.0,98681.46,0.87,0.5958
1278,Rodriguez Turner and Alvarado,False,US,Gordonfurt,Energy,2021,https://rodriguezturnerandalvarado.com,Story allow social write prepare represent today notice exactly send.,25,rodriguez-turner-and-alvarado,2023,USD,1478483,465178,1013305,73924,939381,0,939381,14784,29569,909812,15611,916535,104788,811747,,1478483,20.0,126.18,0.0374,6160,20.0,1000.0,15.61,0.6854
1279,Hernandez Ltd,False,GB,Lake Elainefort,E-commerce,2014,https://hernandezltd.com,Threat ask enjoy year few success around direction soldier.,19,hernandez-ltd,2023,USD,170362,53152,117210,98852,18358,13080,5278,1703,3407,1871,60400,264458,47456,217002,,170362,997.98,2328.27,0.0192,145,97.41,3623.24,16.67,0.688
1280,Valentine-Martin,False,GB,Robertmouth,AgriTech,2016,https://valentine-martin.com,Large front the two city cut.,22,valentine-martin,2023,USD,632409,260196,372213,70106,302107,294,301813,6324,12648,289165,59732,416996,139422,277574,,632409,699.17,387.32,0.0344,2635,20.0,44076.15,1.36,0.5886
1281,Mcknight Hanson and Hall,False,EG,North Dennis,HealthTech,2009,https://mcknighthansonandhall.com,Of blue daughter act against culture impact kid.,13,mcknight-hanson-and-hall,2023,USD,993673,281776,711897,474133,237764,0,237764,9936,19873,217891,108348,683947,256430,427517,82806.08,993673,210.63,935.96,0.0273,3063,27.03,13675.16,7.92,0.7164
1282,Schwartz Santiago and Patterson,False,KE,Diaztown,IoT,2015,https://schwartzsantiagoandpatterson.com,Task center long particular seem firm together arm everyone.,20,schwartz-santiago-and-patterson,2023,USD,456111,298451,157660,254299,-96639,30244,-126883,4561,9122,-136005,11506,380989,21861,359128,,456111,265.89,1389.54,0.1016,294,129.23,47563.74,0.24,0.3457
1283,Clark-Miller,False,BR,East Jessica,AgriTech,2023,https://clark-miller.com,Show staff color ahead establish truth society another music learn.,17,clark-miller,2023,USD,817668,228131,589537,56943,532594,15651,516943,8176,16353,500590,23653,553538,391881,161657,,817668,535.46,2276.73,0.0833,280,243.01,1000.0,23.65,0.721
1284,Pacheco Robles and Lowery,False,TN,North Shawnburgh,AI/ML,2023,https://pachecoroblesandlowery.com,Product car appear health keep these.,27,pacheco-robles-and-lowery,2023,USD,344990,111110,233880,206213,27667,4455,23212,3449,6899,16313,3649,364747,18237,346510,,344990,20.0,24.27,0.001,1437,20.0,46431.73,0.08,0.6779
1285,Hendricks-Green,False,US,Blairville,Fintech,2016,https://hendricks-green.com,Politics real fly employee black skill over television understand.,12,hendricks-green,2023,USD,2182602,711574,1471028,661727,809301,1766,807535,21826,43652,763883,647627,1864525,330006,1534519,,2182602,642.2,2255.87,0.0792,9094,20.0,52583.98,12.32,0.674
1286,Hughes Ltd,False,TN,New Monique,HealthTech,2021,https://hughesltd.com,Child quality pick fund the ask choose out sort.,16,hughes-ltd,2023,USD,403147,211675,191472,158092,33380,9910,23470,4031,8062,15408,35238,379077,160839,218238,33595.58,403147,146.33,652.94,0.0218,629,53.41,6696.69,5.26,0.4749
1287,Casey Cooper and Long,False,DE,Jenniferhaven,Marketplaces,2024,https://caseycooperandlong.com,Water magazine physical later show baby.,19,casey-cooper-and-long,2023,EUR,171007,75889,95118,24807,70311,0,70311,1710,3420,66891,27573,258387,155552,102835,,171007,1134.54,4848.21,0.0257,712,20.0,12941.38,2.13,0.5562
1288,Garcia Inc,False,DE,North Davidmouth,Marketplaces,2008,https://garciainc.com,Among recent work need southern sea anyone trouble wish available.,19,garcia-inc,2023,EUR,238111,109780,128331,100889,27442,5084,22358,2381,4762,17596,552,276746,111707,165039,,238111,293.47,852.42,0.1456,992,20.0,1000.0,0.55,0.539
1289,Roy Group,False,TN,Heatherbury,Cybersecurity,2019,https://roygroup.com,Character billion will pay reason condition five though share management.,23,roy-group,2023,USD,1065060,554721,510339,628415,-118076,5503,-123579,10650,21301,-144880,139403,707042,135367,571675,,1065060,1145.26,3542.1,0.0038,3594,24.69,80957.21,1.72,0.4792
1290,Thompson Group,False,EG,Goodmanbury,AI/ML,2023,https://thompsongroup.com,Newspaper consider again tax change both computer.,33,thompson-group,2023,USD,1019486,564030,455456,677114,-221658,8764,-230422,10194,20389,-250811,319362,936047,272961,663086,,1019486,503.58,772.94,0.0666,389,217.84,47279.67,6.75,0.4468
1291,Flores Cochran and Garza,False,CA,Hornborough,IoT,2024,https://florescochranandgarza.com,Science ability much crime wish family.,24,flores-cochran-and-garza,2023,USD,519829,315095,204734,329475,-124741,0,-124741,5198,10396,-135137,11283,339747,34602,305145,,519829,722.54,2777.46,0.0392,2165,20.0,64800.88,0.17,0.3938
1292,Wiley-Bass,False,CA,Waynehaven,Energy,2016,https://wiley-bass.com,Meet oil former even again coach team pass help.,19,wiley-bass,2023,USD,367118,159788,207330,68298,139032,0,139032,3671,7342,131690,47511,271348,73111,198237,,367118,915.74,3149.08,0.0838,243,125.6,1000.0,47.51,0.5648
1293,Cohen Jones and Miranda,False,GB,Jakemouth,SaaS,2018,https://cohenjonesandmiranda.com,Either reduce consider interview price civil there scientist increase.,29,cohen-jones-and-miranda,2023,USD,861544,239751,621793,487027,134766,7458,127308,8615,17230,110078,40870,574533,163352,411181,71795.33,861544,10.0,57.24,0.0267,942,76.15,102012.32,0.4,0.7217
1294,Lopez-Morse,False,KE,Floresburgh,EdTech,2008,https://lopez-morse.com,Treatment note adult ball human my.,19,lopez-morse,2023,USD,56370,8790,47580,17940,29640,10549,19091,563,1127,17964,28220,135949,60168,75781,4697.5,56370,12.93,70.0,0.001,72,64.82,26234.77,1.08,0.8441
1295,Pacheco and Sons,False,AU,Lake Miguelburgh,AgriTech,2009,https://pachecoandsons.com,Or bring follow ten up improve.,19,pacheco-and-sons,2023,USD,632612,188997,443615,321710,121905,21903,100002,6326,12652,87350,200807,635485,220507,414978,,632612,996.29,3261.27,0.0473,598,88.02,35320.49,5.69,0.7012
1296,Hernandez LLC,False,AU,Katherineshire,Mobility,2024,https://hernandezllc.com,Discussion each property speech position common performance father.,12,hernandez-llc,2023,USD,1425981,499233,926748,841425,85323,27423,57900,14259,28519,29381,50907,791654,39582,752072,,1425981,20.0,18.3,0.0226,5941,20.0,60388.9,0.84,0.6499
1297,Williams Group,False,CA,West Elizabethhaven,IoT,2015,https://williamsgroup.com,Position necessary best daughter blood.,20,williams-group,2023,USD,798998,248146,550852,347387,203465,8806,194659,7989,15979,178680,85817,489749,24487,465262,,798998,20.0,120.34,0.0136,186,357.95,18925.45,4.53,0.6894
1298,Medina York and Williams,False,GB,Lake Melissa,Fintech,2015,https://medinayorkandwilliams.com,Standard base sure behind stock.,23,medina-york-and-williams,2023,USD,13907126,4814105,9093021,2513924,6579097,0,6579097,139071,278142,6300955,772481,7775222,2322829,5452393,,13907126,509.8,2378.44,0.1196,57946,20.0,211422.06,3.65,0.6538
1299,Watson LLC,False,BR,Lake Nathanberg,EdTech,2016,https://watsonllc.com,Myself movie yard fear across shake body force news.,20,watson-llc,2023,USD,129070,44307,84763,51444,33319,15323,17996,1290,2581,15415,13107,137055,53431,83624,10755.83,129070,10.0,33.81,0.057,108,99.32,1000.0,13.11,0.6567
1300,Price LLC,False,NG,Port Mary,Cybersecurity,2009,https://pricellc.com,Amount home now maybe.,28,price-llc,2023,USD,186683,49158,137525,57001,80524,0,80524,1866,3733,76791,4202,183088,37912,145176,,186683,20.0,10.0,0.1034,777,20.0,1659.97,2.53,0.7367
1301,Ramos-Warren,False,AU,Port Lee,EdTech,2020,https://ramos-warren.com,Simply where point example thank see simple budget.,21,ramos-warren,2023,USD,1685468,613436,1072032,711587,360445,0,360445,16854,33709,326736,153396,1154977,389373,765604,140455.67,1685468,977.11,2329.67,0.0176,28091,5.0,70175.23,2.19,0.636
1302,Ramsey-Robinson,False,CA,North Cheryl,HealthTech,2013,https://ramsey-robinson.com,Speak condition cover admit real animal clear education describe.,29,ramsey-robinson,2023,USD,1093246,498770,594476,748225,-153749,0,-153749,10932,21864,-175613,194504,833603,233096,600507,91103.83,1093246,10.0,41.38,0.001,1037,87.83,40593.41,4.79,0.5438
1303,Campbell Group,False,DE,North Thomasmouth,IoT,2018,https://campbellgroup.com,Stay image participant with everyone real.,14,campbell-group,2023,EUR,367533,150383,217150,112172,104978,21456,83522,3675,7350,76172,22799,243417,106406,137011,,367533,20.0,70.92,0.0621,256,119.18,11734.35,1.94,0.5908
1304,Pearson PLC,False,AU,North Jill,Cybersecurity,2019,https://pearsonplc.com,Arm themselves institution again.,23,pearson-plc,2023,USD,716794,177103,539691,277440,262251,16737,245514,7167,14335,231179,55731,606878,373758,233120,,716794,1026.12,1397.02,0.0674,501,119.18,39291.58,1.42,0.7529
1305,Mcgee Mccarthy and Brown,False,KE,Sharonburgh,SaaS,2019,https://mcgeemccarthyandbrown.com,From name country benefit focus another special establish though tonight.,18,mcgee-mccarthy-and-brown,2023,USD,1370814,582225,788589,1028586,-239997,0,-239997,13708,27416,-267413,22434,840796,154485,686311,114234.5,1370814,710.7,4013.26,0.0169,3192,35.78,111788.64,0.2,0.5753
1306,Mckinney Mcconnell and Tran,False,KE,South Megan,IoT,2012,https://mckinneymcconnellandtran.com,Color sing should artist later move it state series value tax.,20,mckinney-mcconnell-and-tran,2023,USD,773264,243561,529703,538997,-9294,10039,-19333,7732,15465,-34798,67518,609205,272232,336973,,773264,20.0,86.19,0.0263,3055,21.09,59980.3,1.13,0.685
1307,Anthony and Sons,False,KE,Nunezborough,EdTech,2023,https://anthonyandsons.com,Sport imagine section measure play third.,24,anthony-and-sons,2023,USD,206056,107695,98361,143388,-45027,0,-45027,2060,4121,-49148,4280,119216,87687,31529,17171.33,206056,10.0,28.06,0.0584,3434,5.0,1407.32,3.04,0.4774
1308,Gentry Brady and Tate,False,NG,South Spencer,AgriTech,2013,https://gentrybradyandtate.com,Its fight since a avoid choice media.,17,gentry-brady-and-tate,2023,USD,248981,66763,182218,125709,56509,0,56509,2489,4979,51530,5178,320314,86547,233767,,248981,1545.51,3217.74,0.001,140,148.05,1000.0,5.18,0.7319
1309,Harris and Sons,False,EG,North Emily,SaaS,2010,https://harrisandsons.com,Room difference today leave outside task more foot visit save.,19,harris-and-sons,2023,USD,846061,183145,662916,581315,81601,0,81601,8460,16921,64680,25883,565822,231932,333890,70505.08,846061,10.0,52.34,0.1031,4872,14.47,59764.04,0.43,0.7835
1310,Smith Cisneros and Olson,False,US,Daviston,EdTech,2015,https://smithcisnerosandolson.com,Sense rich stay cold play various mission task spend.,15,smith-cisneros-and-olson,2023,USD,383287,115905,267382,191546,75836,0,75836,3832,7665,68171,1481,312416,74343,238073,31940.58,383287,193.62,1097.68,0.0457,612,52.13,8924.52,0.17,0.6976
1311,Townsend PLC,False,US,South Catherine,AI/ML,2023,https://townsendplc.com,Bring truth reason good order often mouth east.,27,townsend-plc,2023,USD,287959,92710,195249,169515,25734,0,25734,2879,5759,19975,417,290167,185508,104659,,287959,700.82,2065.43,0.0487,392,61.19,1038.32,0.4,0.678
1312,Evans Guerrero and Thompson,False,US,Lake Lynnberg,E-commerce,2014,https://evansguerreroandthompson.com,Heavy receive state move shake particularly government stop.,19,evans-guerrero-and-thompson,2023,USD,397590,174187,223403,93579,129824,5815,124009,3975,7951,116058,20189,319270,123791,195479,,397590,896.8,7610.45,0.0142,155,212.68,12842.88,1.57,0.5619
1313,Morris and Sons,False,AU,Christinashire,HealthTech,2018,https://morrisandsons.com,Through class for own provide pick across know fear carry.,21,morris-and-sons,2023,USD,138316,48354,89962,113575,-23613,62812,-86425,1383,2766,-89191,20214,204997,56666,148331,11526.33,138316,658.12,3946.0,0.011,136,84.27,12832.6,1.58,0.6504
1314,Johnson Adams and Alvarez,False,ZA,Hendersonport,HealthTech,2018,https://johnsonadamsandalvarez.com,Share off how again about.,17,johnson-adams-and-alvarez,2023,USD,339763,146861,192902,92579,100323,12264,88059,3397,6795,81264,13184,370638,160756,209882,28313.58,339763,10.0,52.53,0.0354,394,71.73,18028.17,0.73,0.5678
1315,Ellis Parks and Jimenez,False,US,Ginashire,SaaS,2012,https://ellisparksandjimenez.com,If away meeting sort soon suggest both.,18,ellis-parks-and-jimenez,2023,USD,930830,351499,579331,610953,-31622,44294,-75916,9308,18616,-94532,78949,618324,263085,355239,77569.17,930830,138.0,641.05,0.0686,585,132.59,49946.87,1.58,0.6224
1316,Sanchez-Combs,False,KE,Jamieshire,Cybersecurity,2012,https://sanchez-combs.com,Space blood herself simply move enter firm society coach policy.,14,sanchez-combs,2023,USD,577175,285078,292097,333999,-41902,0,-41902,5771,11543,-53445,8291,434593,48351,386242,,577175,703.87,2910.23,0.1344,219,219.49,15713.99,0.53,0.5061
1317,Liu-Murphy,False,AU,North Mary,Fintech,2024,https://liu-murphy.com,Clearly cause learn however face.,30,liu-murphy,2023,USD,517073,169335,347738,296405,51333,0,51333,5170,10341,40992,95721,401625,20081,381544,,517073,1575.41,3507.01,0.0102,2118,20.34,34245.21,2.8,0.6725
1318,Winters Smith and Stephens,False,CA,Amandaview,Fintech,2019,https://winterssmithandstephens.com,Minute show a theory of couple program American.,18,winters-smith-and-stephens,2023,USD,407657,104266,303391,259830,43561,0,43561,4076,8153,35408,29473,301575,86653,214922,,407657,1577.19,2912.0,0.0606,973,34.91,10259.84,2.87,0.7442
1319,Torres-Briggs,False,ZA,New Brooke,Marketplaces,2020,https://torres-briggs.com,Energy take yes network indeed tend address understand language.,23,torres-briggs,2023,USD,381459,158519,222940,232609,-9669,7524,-17193,3814,7629,-24822,87694,401797,262616,139181,,381459,20.0,46.94,0.0715,127,248.85,42603.14,2.06,0.5844
1320,Herman-Williams,False,KE,North Erin,Fintech,2018,https://herman-williams.com,Service idea or thank others population admit why.,29,herman-williams,2023,USD,1052971,226278,826693,896974,-70281,0,-70281,10529,21059,-91340,7729,680845,424425,256420,,1052971,2509.69,14786.17,0.0349,718,122.13,39237.79,0.2,0.7851
1321,Hughes-Davis,False,IN,Katrinaborough,E-commerce,2012,https://hughes-davis.com,Without professor today family large appear seven trial treatment.,20,hughes-davis,2023,USD,2076273,560457,1515816,1764127,-248311,21955,-270266,20762,41525,-311791,35005,1247024,62351,1184673,,2076273,20.0,49.97,0.1448,8651,20.0,197843.4,0.18,0.7301
1322,Wilson Kennedy and Perry,False,GB,North Danielborough,Cybersecurity,2021,https://wilsonkennedyandperry.com,Head reach answer even fast wear edge own visit.,24,wilson-kennedy-and-perry,2023,USD,1707414,666214,1041200,1394273,-353073,0,-353073,17074,34148,-387221,281876,1238876,696084,542792,,1707414,20.0,68.45,0.1264,775,183.56,107989.54,2.61,0.6098
1323,Webb-Ortega,False,AU,Hansenfurt,Marketplaces,2023,https://webb-ortega.com,Close vote help skin call food general our.,22,webb-ortega,2023,USD,576967,98363,478604,227641,250963,0,250963,5769,11539,239424,25229,344305,17215,327090,,576967,140.89,852.2,0.0654,620,77.46,31984.65,0.79,0.8295
1324,Taylor-Randolph,False,BR,East Sheila,E-commerce,2013,https://taylor-randolph.com,By account door use positive far.,19,taylor-randolph,2023,USD,4591528,586059,4005469,1639954,2365515,34109,2331406,45915,91830,2239576,611602,3047997,2434775,613222,,4591528,1366.61,1102.08,0.0409,3517,108.77,147692.8,4.14,0.8724
1325,Green LLC,False,ZA,Lesterport,AI/ML,2019,https://greenllc.com,Eye size head development join color summer stand move fine.,19,green-llc,2023,USD,626482,159731,466751,263026,203725,0,203725,6264,12529,191196,7445,408134,163962,244172,,626482,535.3,2371.32,0.1281,2610,20.0,29377.2,0.25,0.745
1326,Rivas-Montes,False,DE,Masonstad,Marketplaces,2013,https://rivas-montes.com,Big reduce technology other about eat.,26,rivas-montes,2023,EUR,704039,143685,560354,197434,362920,0,362920,7040,14080,348840,20840,390474,137500,252974,,704039,1082.45,5689.19,0.0297,411,142.53,26441.13,0.79,0.7959
1327,Barrett Inc,False,TN,Lake Kimberlybury,AgriTech,2017,https://barrettinc.com,Plan leg church significant movie nation.,15,barrett-inc,2023,USD,471342,68427,402915,180542,222373,0,222373,4713,9426,212947,6193,325154,56763,268391,,471342,20.0,10.0,0.005,183,214.43,23557.1,0.26,0.8548
1328,Williamson PLC,False,GB,Jennifermouth,HealthTech,2008,https://williamsonplc.com,Foot Congress protect color success cause teacher big break maybe.,18,williamson-plc,2023,USD,1368786,635690,733096,817026,-83930,13555,-97485,13687,27375,-124860,469940,1326678,557777,768901,114065.5,1368786,150.75,808.4,0.0597,1596,71.43,86156.93,5.45,0.5356
1329,Richardson-Miller,False,ZA,North Matthewton,IoT,2020,https://richardson-miller.com,Surface another final behavior large film likely share police ground.,18,richardson-miller,2023,USD,208972,60238,148734,52454,96280,0,96280,2089,4179,92101,25432,159573,59262,100311,,208972,20.0,33.07,0.1012,161,107.84,1000.0,25.43,0.7117
1330,Evans PLC,False,AU,Danielmouth,IoT,2009,https://evansplc.com,Ground feel south number current eye.,23,evans-plc,2023,USD,653769,297814,355955,405876,-49921,8159,-58080,6537,13075,-71155,14240,520189,52166,468023,,653769,20.0,71.62,0.1041,436,124.82,65611.94,0.22,0.5445
1331,Harris Cook and Freeman,False,GB,East Jameshaven,IoT,2018,https://harriscookandfreeman.com,Instead them attention cut stay miss.,20,harris-cook-and-freeman,2023,USD,456757,185095,271662,22837,248825,0,248825,4567,9135,239690,26017,320097,117468,202629,,456757,1061.97,6059.18,0.0879,168,226.45,1000.0,26.02,0.5948
1332,Baird Simmons and Johnson,False,AU,Hunterburgh,IoT,2015,https://bairdsimmonsandjohnson.com,Attention some lose little act still itself firm artist consider.,19,baird-simmons-and-johnson,2023,USD,608651,268451,340200,246363,93837,24200,69637,6086,12173,57464,20821,465871,269130,196741,,608651,343.03,1543.6,0.0622,2536,20.0,17542.04,1.19,0.5589
1333,Holt-Ortiz,False,BR,West Jessica,IoT,2011,https://holt-ortiz.com,Speech six anyone mention tell green rate could evidence.,20,holt-ortiz,2023,USD,248998,31531,217467,67888,149579,42174,107405,2489,4979,102426,39619,290963,53235,237728,,248998,1102.57,551.28,0.0073,112,184.52,1029.81,38.47,0.8734
1334,Crawford-Moss,False,EG,Newtonburgh,HealthTech,2018,https://crawford-moss.com,Speak open assume financial decide how onto offer thousand pick.,24,crawford-moss,2023,USD,783837,460577,323260,389206,-65946,6686,-72632,7838,15676,-88308,91645,570514,217840,352674,65319.75,783837,150.0,443.39,0.0202,13063,5.0,25042.51,3.66,0.4124
1335,Green-Escobar,False,ZA,New Brianashire,Fintech,2015,https://green-escobar.com,Ready born mother never look.,29,green-escobar,2023,USD,1060297,492598,567699,367008,200691,6733,193958,10602,21205,172753,661124,1246375,136754,1109621,,1060297,763.52,2529.93,0.0786,3782,23.36,21404.85,30.89,0.5354
1336,Smith Bullock and Wall,False,CA,Frankland,E-commerce,2013,https://smithbullockandwall.com,Organization professional fact explain practice hope save method might people.,23,smith-bullock-and-wall,2023,USD,1584719,246137,1338582,145055,1193527,0,1193527,15847,31694,1161833,103535,1018078,340066,678012,,1584719,34.57,75.21,0.0482,6602,20.0,1000.0,103.54,0.8447
1337,Gilbert Ellis and Wood,False,BR,New Renee,Fintech,2018,https://gilbertellisandwood.com,Statement three forget report give mind watch score.,16,gilbert-ellis-and-wood,2023,USD,1417111,733815,683296,601794,81502,0,81502,14171,28342,53160,80859,934691,194642,740049,,1417111,20.0,109.13,0.0181,603,195.67,25796.07,3.13,0.4822
1338,Williams Thomas and Alexander,False,EG,Simonland,SaaS,2016,https://williamsthomasandalexander.com,Federal music police trade later bank.,14,williams-thomas-and-alexander,2023,USD,1869633,373253,1496380,753704,742676,0,742676,18696,37392,705284,32339,1133420,78425,1054995,155802.75,1869633,436.03,3355.02,0.041,1495,104.19,83743.13,0.39,0.8004
1339,Howe PLC,False,DE,Ruthview,EdTech,2010,https://howeplc.com,Specific so some deal many them mission hospital.,22,howe-plc,2023,EUR,79755,18615,61140,85867,-24727,0,-24727,797,1595,-26322,9810,235334,115405,119929,6646.25,79755,88.5,525.55,0.052,114,58.01,14084.87,0.7,0.7666
1340,Garcia White and Robinson,False,CA,East Allisonmouth,AgriTech,2011,https://garciawhiteandrobinson.com,Support box bank early worry man much every trouble.,17,garcia-white-and-robinson,2023,USD,140086,62097,77989,24620,53369,0,53369,1400,2801,50568,13392,191324,93418,97906,,140086,999.64,2450.89,0.001,400,29.16,1000.0,13.39,0.5567
1341,Smith Nicholson and Rojas,False,ZA,Port Daniel,SaaS,2009,https://smithnicholsonandrojas.com,Officer have challenge technology under one determine smile become.,24,smith-nicholson-and-rojas,2023,USD,2250222,1226063,1024159,1942861,-918702,0,-918702,22502,45004,-963706,93182,1388435,371745,1016690,187518.5,2250222,1117.91,6212.79,0.0137,2105,89.05,151900.43,0.61,0.4551
1342,Edwards Wagner and Potter,False,TN,Woodwardtown,Mobility,2021,https://edwardswagnerandpotter.com,Crime pull after season business drop once action.,21,edwards-wagner-and-potter,2023,USD,363795,48337,315458,31520,283938,0,283938,3637,7275,276663,38989,245655,71681,173974,,363795,20.0,24.44,0.001,238,127.27,19504.8,2.0,0.8671
1343,Martinez Berry and Wells,False,GB,Lake Michelle,Energy,2023,https://martinezberryandwells.com,Building rich amount arrive most step something talk.,22,martinez-berry-and-wells,2023,USD,2066559,961216,1105343,595863,509480,0,509480,20665,41331,468149,72979,1245696,701123,544573,,2066559,20.0,82.97,0.0302,8610,20.0,43681.49,1.67,0.5349
1344,Martinez Campbell and Brown,False,TN,West Jason,E-commerce,2020,https://martinezcampbellandbrown.com,Deal attorney gas recent skin many here I trip.,17,martinez-campbell-and-brown,2023,USD,765515,326949,438566,211315,227251,0,227251,7655,15310,211941,72618,605539,358112,247427,,765515,511.48,886.57,0.0192,548,116.3,34544.03,2.1,0.5729
1345,Robinson LLC,False,FR,Carrollborough,Mobility,2015,https://robinsonllc.com,Drop peace region phone name wish with success.,23,robinson-llc,2023,EUR,2041460,853909,1187551,985781,201770,1492,200278,20414,40829,159449,342411,1531238,421482,1109756,,2041460,785.15,949.51,0.015,953,178.34,84926.3,4.03,0.5817
1346,Davis-Chen,False,GB,Shannonbury,Mobility,2010,https://davis-chen.com,Practice team star dream maintain.,14,davis-chen,2023,USD,1217035,246529,970506,1110623,-140117,17767,-157884,12170,24340,-182224,61211,705861,207490,498371,,1217035,300.12,1351.46,0.001,3077,32.95,97155.22,0.63,0.7974
1347,Kelly Inc,False,AU,South Kellyfurt,SaaS,2017,https://kellyinc.com,Amount care meet drive main lead talk name instead she her.,24,kelly-inc,2023,USD,2052772,547140,1505632,221082,1284550,0,1284550,20527,41055,1243495,371772,1441971,745688,696283,171064.33,2052772,321.42,446.08,0.0095,34212,5.0,27539.31,13.5,0.7335
1348,Cooper and Sons,False,US,Gregoryland,E-commerce,2016,https://cooperandsons.com,Southern eight stage raise baby throw perhaps recent.,21,cooper-and-sons,2023,USD,774066,340713,433353,513580,-80227,173,-80400,7740,15481,-95881,22739,414339,24621,389718,,774066,949.74,4362.66,0.0049,3225,20.0,48670.14,0.47,0.5598
1349,Walters-Harris,False,FR,Robertview,Fintech,2018,https://walters-harris.com,Wish white also protect natural.,12,walters-harris,2023,EUR,3353760,1112679,2241081,885929,1355152,0,1355152,33537,67075,1288077,701333,2420879,813637,1607242,,3353760,671.97,2084.63,0.001,13974,20.0,34154.73,20.53,0.6682
1350,Henry and Sons,False,GB,West Douglaschester,Energy,2013,https://henryandsons.com,Instead value meeting bill plant put.,22,henry-and-sons,2023,USD,2508265,922908,1585357,409519,1175838,13357,1162481,25082,50165,1112316,53081,1432314,708994,723320,,2508265,886.34,3013.61,0.001,1419,147.21,55406.53,0.96,0.6321
1351,Wilson-Fischer,False,ZA,New Logan,Fintech,2010,https://wilson-fischer.com,Unit offer offer and manager employee.,19,wilson-fischer,2023,USD,2586348,470332,2116016,1567673,548343,0,548343,25863,51726,496617,234395,1535756,906915,628841,,2586348,334.47,2172.04,0.0215,1020,211.1,92282.76,2.54,0.8181
1352,Dalton Sims and Holt,False,CA,New Glennhaven,IoT,2023,https://daltonsimsandholt.com,Shake everything party lawyer especially floor which born religious story.,22,dalton-sims-and-holt,2023,USD,84186,23052,61134,47585,13549,37925,-24376,841,1683,-26059,3328,236200,114578,121622,,84186,20.0,47.02,0.0723,33,206.59,1000.0,3.33,0.7262
1353,Medina-Orozco,False,ZA,Port Travis,SaaS,2021,https://medina-orozco.com,Entire cultural politics interesting need nice build black himself.,12,medina-orozco,2023,USD,3309369,1530992,1778377,2512702,-734325,18182,-752507,33093,66187,-818694,55418,1726839,438780,1288059,275780.75,3309369,13.38,75.52,0.038,7049,39.12,199567.35,0.28,0.5374
1354,Rowe-Cannon,False,BR,East Kevinborough,HealthTech,2021,https://rowe-cannon.com,Mean mission assume management nature kitchen section which develop doctor.,14,rowe-cannon,2023,USD,1468014,522381,945633,830697,114936,12796,102140,14680,29360,72780,51043,919872,343109,576763,122334.5,1468014,10.0,47.67,0.0401,24466,5.0,67851.35,0.75,0.6442
1355,Campbell-Wells,False,GB,Port Johnbury,SaaS,2011,https://campbell-wells.com,Painting performance both week.,21,campbell-wells,2023,USD,4109354,225356,3883998,3630766,253232,0,253232,41093,82187,171045,210640,2404880,1412516,992364,342446.17,4109354,673.12,2504.41,0.0475,7442,46.01,294879.85,0.71,0.9452
1356,Hunt Ltd,False,CA,Costaburgh,EdTech,2014,https://huntltd.com,Campaign card enough cold always energy pretty color thank thus.,28,hunt-ltd,2023,USD,472829,101228,371601,221662,149939,8073,141866,4728,9456,132410,35125,420516,33994,386522,39402.42,472829,380.3,1692.97,0.082,1272,30.96,7884.67,4.45,0.7859
1357,Johnson Pearson and Cole,False,TN,North Joseph,Cybersecurity,2016,https://johnsonpearsonandcole.com,At argue real ready stuff evening north.,19,johnson-pearson-and-cole,2023,USD,100211,43517,56694,45015,11679,12966,-1287,1002,2004,-3291,17464,123315,68808,54507,,100211,20.0,31.96,0.0743,91,91.32,1000.0,17.46,0.5657
1358,Nelson and Sons,False,BR,North Christineport,AgriTech,2017,https://nelsonandsons.com,Western type certain everyone weight.,19,nelson-and-sons,2023,USD,150266,76243,74023,35840,38183,0,38183,1502,3005,35178,12140,200619,80421,120198,,150266,20.0,80.12,0.0602,626,20.0,1000.0,12.14,0.4926
1359,Matthews Ltd,False,DE,Hernandezfurt,Fintech,2009,https://matthewsltd.com,Tend off daughter concern back many fear.,14,matthews-ltd,2023,EUR,887617,257003,630614,318564,312050,10914,301136,8876,17752,283384,58419,510551,44629,465922,,887617,335.21,167.6,0.0679,2172,34.05,1000.0,58.42,0.7105
1360,Lopez Inc,False,TN,Marisaborough,IoT,2023,https://lopezinc.com,Information blue stock appear court him.,24,lopez-inc,2023,USD,586244,328670,257574,215290,42284,32814,9470,5862,11724,-2254,21367,324036,89843,234193,,586244,432.91,3458.86,0.0834,1064,45.9,10918.38,1.96,0.4394
1361,Garcia-James,False,GB,South Alexanderside,SaaS,2019,https://garcia-james.com,Large present argue upon single all friend society.,27,garcia-james,2023,USD,845740,277474,568266,146063,422203,4058,418145,8457,16914,401231,3385,494873,24743,470130,70478.33,845740,60.82,272.14,0.001,1886,37.36,12814.08,0.26,0.6719
1362,Barry-Gutierrez,False,US,North Ashley,Energy,2010,https://barry-gutierrez.com,Important myself all fund little fine.,11,barry-gutierrez,2023,USD,3966405,1214203,2752202,2078146,674056,16205,657851,39664,79328,578523,892315,2902467,1377689,1524778,,3966405,20.0,39.59,0.1521,16526,20.0,201753.02,4.42,0.6939
1363,Davis and Sons,False,IN,West Stephanie,Marketplaces,2023,https://davisandsons.com,Whole ago left past become sell alone later civil board.,22,davis-and-sons,2023,USD,309052,116928,192124,281076,-88952,13950,-102902,3090,6181,-109083,43290,266867,13343,253524,,309052,915.55,4664.83,0.0436,116,221.23,1000.0,43.29,0.6217
1364,Hess Knight and Paul,False,DE,Wilkersonfurt,Fintech,2008,https://hessknightandpaul.com,Central build sound effect thank report evidence imagine born.,20,hess-knight-and-paul,2023,EUR,3088083,1333535,1754548,751646,1002902,0,1002902,30880,61761,941141,171901,1867750,918193,949557,,3088083,1091.03,545.52,0.001,761,337.97,57144.23,3.01,0.5682
1365,Rodriguez-Jackson,False,DE,South Marymouth,HealthTech,2017,https://rodriguez-jackson.com,Fill imagine work certain difficult feeling task.,23,rodriguez-jackson,2023,EUR,1250807,365208,885599,934876,-49277,34084,-83361,12508,25016,-108377,10216,704452,45243,659209,104233.92,1250807,364.57,751.22,0.0262,1477,70.54,28726.57,0.36,0.708
1366,White and Sons,False,FR,Lake Rayberg,Mobility,2011,https://whiteandsons.com,Congress treat establish bank west trial professor admit.,20,white-and-sons,2023,EUR,1403813,769847,633966,806745,-172779,18061,-190840,14038,28076,-218916,234179,1052213,104295,947918,,1403813,1006.6,503.3,0.0952,5808,20.14,26989.12,8.68,0.4516
1367,Torres-Morrow,False,IN,Warefurt,Energy,2023,https://torres-morrow.com,Against purpose inside personal firm different candidate important prepare owner feel.,19,torres-morrow,2023,USD,1941852,988464,953388,901807,51581,68,51513,19418,38837,12676,173338,1274920,224156,1050764,,1941852,425.58,2297.6,0.0298,732,221.0,98213.6,1.76,0.491
1368,Johnson Arellano and Anderson,False,EG,Margaretstad,Marketplaces,2016,https://johnsonarellanoandanderson.com,Music born already black offer book western Mr two before.,19,johnson-arellano-and-anderson,2023,USD,209265,107265,102000,72594,29406,0,29406,2092,4185,25221,17366,306656,134498,172158,,209265,20.0,10.0,0.0853,130,133.26,34457.39,0.5,0.4874
1369,Fernandez-Sullivan,False,FR,Jessicaside,Marketplaces,2020,https://fernandez-sullivan.com,Effort new social traditional message instead degree here.,28,fernandez-sullivan,2023,EUR,772262,273665,498597,319875,178722,6614,172108,7722,15445,156663,56939,519104,139979,379125,,772262,25.91,40.18,0.0429,145,441.64,54223.39,1.05,0.6456
1370,Velez PLC,False,GB,Larryview,E-commerce,2020,https://velezplc.com,Memory discuss start newspaper become.,13,velez-plc,2023,USD,647349,225984,421365,444003,-22638,40212,-62850,6473,12946,-75796,13967,529461,174307,355154,,647349,20.0,10.0,0.0813,206,260.64,62847.14,0.22,0.6509
1371,Rodriguez Johnson and Carter,False,CA,North Samuel,HealthTech,2022,https://rodriguezjohnsonandcarter.com,Anyone number risk more statement.,13,rodriguez-johnson-and-carter,2023,USD,173367,54472,118895,14217,104678,0,104678,1733,3467,101211,37090,240154,21880,218274,14447.25,173367,412.06,2205.24,0.048,528,27.35,1000.0,37.09,0.6858
1372,Long Ltd,False,US,Port James,AgriTech,2022,https://longltd.com,Woman everything especially join last week mean bring.,18,long-ltd,2023,USD,177448,55573,121875,8872,113003,22506,90497,1774,3548,86949,13804,205334,99594,105740,,177448,2788.51,15169.57,0.0297,233,63.31,20184.85,0.68,0.6868
1373,Sheppard Ortiz and Hill,False,EG,East Jennifer,AgriTech,2015,https://sheppardortizandhill.com,Collection young current risk.,15,sheppard-ortiz-and-hill,2023,USD,202802,111347,91455,101604,-10149,0,-10149,2028,4056,-14205,8813,151831,36919,114912,,202802,1948.28,10387.89,0.0742,43,386.28,23976.31,0.37,0.451
1374,Mcmillan Hernandez and Smith,False,IN,Aaronborough,IoT,2009,https://mcmillanhernandezandsmith.com,Ability again nature heavy soldier season.,19,mcmillan-hernandez-and-smith,2023,USD,1208694,313154,895540,539321,356219,16910,339309,12086,24173,315136,46839,841846,46591,795255,,1208694,1097.36,3709.7,0.1075,635,158.39,43215.72,1.08,0.7409
1375,Chavez-Wheeler,False,GB,North Zacharyshire,Cybersecurity,2011,https://chavez-wheeler.com,Yourself building budget sometimes age western sure his send physical.,28,chavez-wheeler,2023,USD,1047487,251351,796136,62785,733351,42093,691258,10474,20949,670309,162343,713218,50993,662225,,1047487,1007.74,5342.26,0.001,1823,47.87,56428.94,2.88,0.76
1376,Taylor Group,False,FR,South Judy,Marketplaces,2019,https://taylorgroup.com,Pull war officer least respond and across somebody front myself.,24,taylor-group,2023,EUR,3020381,1041482,1978899,1610497,368402,2281,366121,30203,60407,305714,254821,1941389,1414510,526879,,3020381,1342.12,3569.72,0.0029,12584,20.0,105104.18,2.42,0.6552
1377,Bender PLC,False,AU,Castilloview,AI/ML,2021,https://benderplc.com,Each anything TV staff win middle range eat.,15,bender-plc,2023,USD,1027762,624391,403371,331987,71384,0,71384,10277,20555,50829,36937,710519,396754,313765,,1027762,867.13,433.56,0.0857,506,169.08,1000.0,36.94,0.3925
1378,Zamora Ltd,False,AU,South Christopher,IoT,2015,https://zamoraltd.com,Model be begin page position.,17,zamora-ltd,2023,USD,283290,131944,151346,158224,-6878,0,-6878,2832,5665,-12543,5415,291780,118372,173408,,283290,90.41,554.98,0.0124,64,365.35,17496.25,0.31,0.5342
1379,Green Mason and Malone,False,NG,Edwardtown,SaaS,2020,https://greenmasonandmalone.com,Player source professor attention data several.,20,green-mason-and-malone,2023,USD,764936,334380,430556,705931,-275375,11011,-286386,7649,15298,-301684,22828,446205,139238,306967,63744.67,764936,617.48,2344.98,0.001,1090,58.47,46549.57,0.49,0.5629
1380,Gutierrez-Johnson,False,NG,Nicholasshire,Energy,2023,https://gutierrez-johnson.com,Others exist three event identify kid respond believe nearly environment.,19,gutierrez-johnson,2023,USD,915902,198843,717059,617645,99414,0,99414,9159,18318,81096,6206,660618,95093,565525,,915902,698.7,1736.79,0.0657,2592,29.44,46586.92,0.13,0.7829
1381,Le Patrick and Mccarthy,False,KE,Lake Williamberg,EdTech,2023,https://lepatrickandmccarthy.com,Message others short why chance three cell.,19,le-patrick-and-mccarthy,2023,USD,133847,41275,92572,134228,-41656,29724,-71380,1338,2676,-74056,3129,144591,102034,42557,11153.92,133847,239.69,2017.4,0.001,2230,5.0,8365.35,0.37,0.6916
1382,Reed Eaton and Crawford,False,IN,Rebeccamouth,Fintech,2020,https://reedeatonandcrawford.com,Smile grow wife in civil us general.,16,reed-eaton-and-crawford,2023,USD,1842199,611958,1230241,308619,921622,4106,917516,18421,36843,880673,62441,989459,411724,577735,,1842199,20.0,105.67,0.0785,7675,20.0,44069.47,1.42,0.6678
1383,Smith-Phillips,False,ZA,New Cody,SaaS,2024,https://smith-phillips.com,Wear necessary forward near rather voice pick skill window generation.,28,smith-phillips,2023,USD,877063,304159,572904,303292,269612,31674,237938,8770,17541,220397,21521,625258,257298,367960,73088.58,877063,293.4,1205.81,0.0648,1374,53.17,23323.87,0.92,0.6532
1384,Mitchell Group,False,KE,North Bruceburgh,AI/ML,2012,https://mitchellgroup.com,Area interview age be no mission leader.,24,mitchell-group,2023,USD,6349877,2227462,4122415,3350902,771513,0,771513,63498,126997,644516,178301,3505434,175271,3330163,,6349877,20.0,23.7,0.0482,2438,217.01,266357.77,0.67,0.6492
1385,Davis Ltd,False,FR,East Tonya,Mobility,2013,https://davisltd.com,Nothing wrong phone attention become ahead.,11,davis-ltd,2023,EUR,339596,98026,241570,190407,51163,5838,45325,3395,6791,38534,15643,328394,242182,86212,,339596,645.39,2474.97,0.0328,176,160.72,22482.51,0.7,0.7113
1386,Potts-Espinoza,False,GB,South Jillchester,EdTech,2014,https://potts-espinoza.com,Difference spring through tree senior fine rise wife.,17,potts-espinoza,2023,USD,349726,110231,239495,29548,209947,4895,205052,3497,6994,198058,21890,316908,109445,207463,29143.83,349726,91.54,290.06,0.033,516,56.38,1000.0,21.89,0.6848
1387,Rios-English,False,GB,Barnesbury,SaaS,2021,https://rios-english.com,Him whom blood because door hand rest.,14,rios-english,2023,USD,473907,147940,325967,54459,271508,0,271508,4739,9478,262030,29862,363436,203554,159882,39492.25,473907,427.92,1358.18,0.0696,507,77.82,5716.62,5.22,0.6878
1388,Bird Maynard and Parker,False,FR,West Jimmy,Marketplaces,2021,https://birdmaynardandparker.com,Which bar yourself movement clear fish big quickly step property.,17,bird-maynard-and-parker,2023,EUR,2312963,666970,1645993,809788,836205,28021,808184,23129,46259,761925,155072,1476443,195308,1281135,,2312963,580.61,1214.31,0.1889,9637,20.0,70133.9,2.21,0.7116
1389,Long Inc,False,DE,Boonefurt,Marketplaces,2012,https://longinc.com,Use situation well task everybody baby unit these.,20,long-inc,2023,EUR,1465621,537811,927810,1187402,-259592,0,-259592,14656,29312,-288904,64956,866731,351756,514975,,1465621,1062.99,1932.42,0.001,2117,57.68,67053.65,0.97,0.633
1390,Phelps-Ramos,False,KE,Kristyport,AgriTech,2018,https://phelps-ramos.com,Level ball civil art debate address include usually south.,22,phelps-ramos,2023,USD,977730,224884,752846,761989,-9143,49135,-58278,9777,19554,-77832,9051,526859,135733,391126,,977730,878.34,3434.8,0.0749,353,230.7,84748.93,0.11,0.77
1391,Mason-Webb,False,ZA,Teresaberg,Fintech,2010,https://mason-webb.com,Finish even decide approach risk these senior.,23,mason-webb,2023,USD,877128,484284,392844,288373,104471,0,104471,8771,17542,86929,24956,516052,57671,458381,,877128,1186.88,7122.94,0.0346,2016,36.24,1000.0,24.96,0.4479
1392,Hernandez Rodriguez and Miller,False,TN,Bridgesstad,AI/ML,2020,https://hernandezrodriguezandmiller.com,Ground offer common wide process everybody.,18,hernandez-rodriguez-and-miller,2023,USD,2146312,313087,1833225,1482653,350572,16441,334131,21463,42926,291205,541346,1681898,370413,1311485,,2146312,2366.95,10050.55,0.0077,2266,78.93,148343.06,3.65,0.8541
1393,Day-Miller,False,NG,North Ellenfort,E-commerce,2016,https://day-miller.com,National bag chair eat tax investment.,21,day-miller,2023,USD,445249,211029,234220,136100,98120,32016,66104,4452,8904,57200,17496,399892,117607,282285,,445249,1301.82,2037.96,0.0443,202,183.43,1000.0,17.5,0.526
1394,Perez-Byrd,False,NG,Vincenthaven,Mobility,2008,https://perez-byrd.com,Right month everyone soon Mr year.,17,perez-byrd,2023,USD,953752,460781,492971,157564,335407,0,335407,9537,19075,316332,165440,707449,174870,532579,,953752,20.0,16.26,0.0724,371,213.87,21545.6,7.68,0.5169
1395,Green-Schroeder,False,AU,Melanieville,Cybersecurity,2024,https://green-schroeder.com,Consider claim there financial prevent.,18,green-schroeder,2023,USD,1007369,215935,791434,668715,122719,31674,91045,10073,20147,70898,83417,592152,141187,450965,,1007369,20.0,43.73,0.1036,712,117.88,92713.98,0.9,0.7856
1396,Miller-Barber,False,AU,Port Anthony,Energy,2011,https://miller-barber.com,Anything particularly week interest statement dream central require.,12,miller-barber,2023,USD,1032502,307997,724505,139903,584602,13583,571019,10325,20650,550369,14525,720632,473140,247492,,1032502,1174.02,2811.4,0.0081,393,218.57,4614.24,3.15,0.7017
1397,Brennan Cruz and Archer,False,TN,East Bryan,HealthTech,2012,https://brennancruzandarcher.com,Bit land stock performance treatment anyone.,21,brennan-cruz-and-archer,2023,USD,619955,313052,306903,88111,218792,26652,192140,6199,12399,179741,18897,437763,40767,396996,51662.92,619955,559.61,2229.85,0.0255,550,93.77,1000.0,18.9,0.495
1398,Aguirre Inc,False,KE,East Kennethfort,IoT,2011,https://aguirreinc.com,Drive seek many between state.,37,aguirre-inc,2023,USD,235263,59743,175520,137895,37625,5014,32611,2352,4705,27906,9214,218999,61856,157143,,235263,20.0,37.87,0.1576,980,20.0,47616.9,0.19,0.7461
1399,Peters Williams and Curry,False,FR,Hensonberg,IoT,2011,https://peterswilliamsandcurry.com,Raise pattern seem anything medical better possible suddenly.,16,peters-williams-and-curry,2023,EUR,1340341,430739,909602,67017,842585,10742,831843,13403,26806,805037,28876,856183,161295,694888,,1340341,899.97,2388.39,0.0187,2846,39.24,39966.06,0.72,0.6786
1400,Owens Warren and Dillon,False,AU,Lake Davidborough,AgriTech,2019,https://owenswarrenanddillon.com,Future front close budget line coach more test kitchen.,20,owens-warren-and-dillon,2023,USD,538173,154811,383362,213836,169526,15319,154207,5381,10763,143444,36084,430740,177990,252750,,538173,955.72,4773.75,0.0437,155,287.75,47289.74,0.76,0.7123
1401,Smith Taylor and Mcdonald,False,TN,Lake Jeremyville,AgriTech,2020,https://smithtaylorandmcdonald.com,Black agree real book past wish choice throw quality.,17,smith-taylor-and-mcdonald,2023,USD,2741691,974786,1766905,1596879,170026,0,170026,27416,54833,115193,1233631,2784151,532745,2251406,,2741691,510.21,255.1,0.001,2120,107.75,128221.76,9.62,0.6445
1402,Schultz Cruz and Castillo,False,BR,New Jamesmouth,Mobility,2023,https://schultzcruzandcastillo.com,American there nice black total consider expert.,20,schultz-cruz-and-castillo,2023,USD,3214064,1156396,2057668,2443514,-385846,25329,-411175,32140,64281,-475456,184904,1989836,1019032,970804,,3214064,1276.7,4684.36,0.0395,8441,31.73,191825.65,0.96,0.6402
1403,Nunez Ltd,False,US,Kristenmouth,HealthTech,2016,https://nunezltd.com,All college either test create should degree house control.,23,nunez-ltd,2023,USD,495241,106000,389241,308808,80433,0,80433,4952,9904,70529,6711,432826,59496,373330,41270.08,495241,95.08,245.82,0.0288,463,89.11,26303.03,0.26,0.786
1404,Myers Inc,False,TN,Morrisonfurt,HealthTech,2020,https://myersinc.com,Good lay huge line home kind radio at people brother.,14,myers-inc,2023,USD,774963,159741,615222,483313,131909,6213,125696,7749,15499,110197,58316,521502,387792,133710,64580.25,774963,10.0,29.28,0.0275,12916,5.0,24232.17,2.41,0.7939
1405,Atkinson Rocha and Diaz,False,US,North Marc,Energy,2018,https://atkinsonrochaanddiaz.com,Stuff thus statement home above.,25,atkinson-rocha-and-diaz,2023,USD,3613526,1356079,2257447,1080057,1177390,0,1177390,36135,72270,1105120,85657,2015687,1039987,975700,,3613526,20.0,106.97,0.0027,5358,56.2,69009.7,1.24,0.6247
1406,Robinson LLC,False,ZA,Port Deborahview,EdTech,2009,https://robinsonllc.com,Example deep security both Mrs develop.,19,robinson-llc,2023,USD,1176986,271516,905470,1011245,-105775,27875,-133650,11769,23539,-157189,25875,767609,161290,606319,98082.17,1176986,10.0,26.98,0.0208,3278,29.92,91337.56,0.28,0.7693
1407,Roberts LLC,False,ZA,East Andrewport,Mobility,2016,https://robertsllc.com,School over special sport first.,24,roberts-llc,2023,USD,2430192,1010440,1419752,121509,1298243,7141,1291102,24301,48603,1242499,61838,1475888,234220,1241668,,2430192,84.92,261.75,0.0462,1675,120.9,25296.46,2.44,0.5842
1408,Williams Inc,False,CA,Rhondafurt,SaaS,2018,https://williamsinc.com,Rest shake research writer recognize identify some discuss test.,23,williams-inc,2023,USD,3094137,835076,2259061,1714699,544362,14202,530160,30941,61882,468278,130939,1707334,667612,1039722,257844.75,3094137,602.16,1841.45,0.0598,7502,34.37,179340.48,0.73,0.7301
1409,Huffman Hall and Pierce,False,AU,North Markville,AgriTech,2017,https://huffmanhallandpierce.com,Treatment inside shoulder choice measure space skin.,27,huffman-hall-and-pierce,2023,USD,421463,94526,326937,209492,117445,0,117445,4214,8429,109016,51732,407947,159690,248257,,421463,20.0,69.45,0.0666,1756,20.0,1000.0,51.73,0.7757
1410,Flores and Sons,False,IN,Manuelville,Mobility,2011,https://floresandsons.com,National baby last manage southern care.,18,flores-and-sons,2023,USD,1379264,719350,659914,1178044,-518130,7435,-525565,13792,27585,-553150,159883,969928,245292,724636,,1379264,20.0,114.79,0.0878,994,115.58,110320.0,1.45,0.4785
1411,Watson Hart and Hunter,False,DE,Michaelberg,HealthTech,2017,https://watsonhartandhunter.com,Take police several speech left dinner himself child.,21,watson-hart-and-hunter,2023,EUR,2624402,1146311,1478091,1030149,447942,0,447942,26244,52488,395454,66397,1481577,325283,1156294,218700.17,2624402,80.36,356.9,0.0745,2249,97.23,50387.11,1.32,0.5632
1412,Graham-Rojas,False,ZA,Kelseychester,Mobility,2018,https://graham-rojas.com,Life already ask big leave article matter business his.,12,graham-rojas,2023,USD,1026441,339070,687371,542007,145364,0,145364,10264,20528,124836,54245,615348,156358,458990,,1026441,356.07,1618.1,0.0977,654,130.78,41623.24,1.3,0.6697
1413,Fischer-Castillo,False,IN,South Elizabeth,Cybersecurity,2021,https://fischer-castillo.com,Describe main fill direction administration.,18,fischer-castillo,2023,USD,1459994,695484,764510,324939,439571,20110,419461,14599,29199,390262,46454,805044,188913,616131,,1459994,94.0,374.56,0.1703,1168,104.16,1000.0,46.45,0.5236
1414,Oneal LLC,False,KE,Port Kevinmouth,Marketplaces,2010,https://onealllc.com,Public himself class common employee seem rate idea challenge.,20,oneal-llc,2023,USD,1002833,369023,633810,620896,12914,0,12914,10028,20056,-7142,65433,754432,140836,613596,,1002833,478.75,1219.87,0.0717,956,87.33,71663.43,0.91,0.632
1415,Lopez-Black,False,DE,Wendymouth,Mobility,2014,https://lopez-black.com,Investment carry knowledge throughout raise century watch teacher relationship.,21,lopez-black,2023,EUR,464357,154312,310045,200213,109832,15292,94540,4643,9287,85253,34229,295521,224619,70902,,464357,1767.24,2248.2,0.0622,508,76.04,1374.69,24.9,0.6677
1416,Clark-Kelley,False,TN,Alvarezberg,Cybersecurity,2023,https://clark-kelley.com,Page design more reveal structure parent image public.,21,clark-kelley,2023,USD,1212799,479568,733231,736705,-3474,14429,-17903,12127,24255,-42158,44743,653220,52815,600405,,1212799,20.0,74.62,0.0193,1352,74.7,80638.77,0.55,0.6046
1417,Salinas PLC,False,AU,Garzabury,AI/ML,2019,https://salinasplc.com,Arm free have dog accept small.,17,salinas-plc,2023,USD,2166910,797224,1369686,108345,1261341,0,1261341,21669,43338,1218003,52518,1247523,439188,808335,,2166910,25.22,98.18,0.0447,3741,48.26,1000.0,52.52,0.6321
1418,Warren Flowers and Ingram,False,US,Gonzalezchester,AI/ML,2013,https://warrenflowersandingram.com,Whatever force table investment either.,30,warren-flowers-and-ingram,2023,USD,2431421,347697,2083724,121571,1962153,0,1962153,24314,48628,1913525,75185,1443438,72171,1371267,,2431421,20.0,10.0,0.001,10130,20.0,1000.0,75.18,0.857
1419,Edwards Ltd,False,FR,Robertton,AgriTech,2024,https://edwardsltd.com,Matter think matter fund effort job baby relate agree.,15,edwards-ltd,2023,EUR,563203,217224,345979,220816,125163,48241,76922,5632,11264,65658,22138,488263,248839,239424,,563203,379.87,270.96,0.0656,348,134.71,30506.35,0.73,0.6143
1420,Green Bruce and Woods,False,TN,Bradyberg,HealthTech,2024,https://greenbruceandwoods.com,Rock Congress relationship compare poor lot blood avoid let.,10,green-bruce-and-woods,2023,USD,366227,118706,247521,60848,186673,0,186673,3662,7324,179349,93214,419257,158907,260350,30518.92,366227,151.06,253.92,0.0113,305,99.9,4426.7,21.06,0.6759
1421,Curtis-Henry,False,KE,South Danielburgh,SaaS,2013,https://curtis-henry.com,Single citizen third head eye.,17,curtis-henry,2023,USD,164951,77802,87149,90118,-2969,10513,-13482,1649,3299,-16781,11833,236272,56826,179446,13745.92,164951,116.43,678.12,0.0395,103,132.53,7555.26,1.57,0.5283
1422,Powell Tran and Johnson,False,DE,North Mary,EdTech,2009,https://powelltranandjohnson.com,Account once southern cost together section yet worker some add.,16,powell-tran-and-johnson,2023,EUR,386733,212236,174497,194775,-20278,39837,-60115,3867,7734,-67849,7874,348113,189973,158140,32227.75,386733,25.38,141.09,0.0459,524,61.47,33588.2,0.23,0.4512
1423,Lopez-Sanders,False,DE,Pooleton,SaaS,2022,https://lopez-sanders.com,National than late third service TV south ball under.,20,lopez-sanders,2023,EUR,5692435,2967520,2724915,3676518,-951603,0,-951603,56924,113848,-1065451,317650,3243952,1295196,1948756,474369.58,5692435,642.41,3503.86,0.0236,6444,73.61,302259.16,1.05,0.4787
1424,Eaton-Williams,False,US,Ginaton,E-commerce,2014,https://eaton-williams.com,On decade including learn effect evidence officer.,16,eaton-williams,2023,USD,2286129,860602,1425527,174840,1250687,11974,1238713,22861,45722,1192991,182832,1494559,883847,610712,,2286129,1010.26,4096.3,0.0791,1666,114.34,1000.0,182.83,0.6236
1425,Roy Group,False,IN,New Joshua,E-commerce,2022,https://roygroup.com,Item drop new music when allow huge upon employee.,9,roy-group,2023,USD,2567310,982637,1584673,850425,734248,2494,731754,25673,51346,680408,184383,1503709,580500,923209,,2567310,1033.31,2617.29,0.0782,1299,164.66,67606.97,2.73,0.6173
1426,Ibarra PLC,False,NG,Danielbury,Energy,2011,https://ibarraplc.com,Different left citizen serve conference technology civil occur state develop.,24,ibarra-plc,2023,USD,652534,317052,335482,131778,203704,0,203704,6525,13050,190654,12947,462995,213040,249955,,652534,20.0,71.97,0.0408,266,204.18,1000.0,12.95,0.5141
1427,Williams Proctor and Hart,False,BR,Brownchester,SaaS,2015,https://williamsproctorandhart.com,Laugh position station law coach popular green day majority.,24,williams-proctor-and-hart,2023,USD,1906850,538259,1368591,144034,1224557,0,1224557,19068,38137,1186420,42887,1012954,562894,450060,158904.17,1906850,10.0,44.58,0.0115,2144,74.09,36572.18,1.17,0.7177
1428,Curry Willis and Johnson,False,CA,New Michelechester,Mobility,2022,https://currywillisandjohnson.com,Staff industry manager guy include that college.,14,curry-willis-and-johnson,2023,USD,525458,152500,372958,169535,203423,1945,201478,5254,10509,190969,10685,421297,46131,375166,,525458,20.0,70.44,0.0463,562,77.83,1000.0,10.68,0.7098
1429,Smith Espinoza and Garcia,False,GB,New Brandon,Mobility,2019,https://smithespinozaandgarcia.com,Sign tough since war think draw.,21,smith-espinoza-and-garcia,2023,USD,260755,72383,188372,100169,88203,0,88203,2607,5215,82988,9942,277292,172423,104869,,260755,20.0,38.45,0.1092,339,64.07,1952.61,5.09,0.7224
1430,Ramirez PLC,False,CA,New Jeffreyburgh,HealthTech,2016,https://ramirezplc.com,Whatever easy community whatever each attack child hear.,21,ramirez-plc,2023,USD,288269,54669,233600,246900,-13300,22351,-35651,2882,5765,-41416,60239,252763,136305,116458,24022.42,288269,10.0,53.49,0.0449,325,73.84,1000.0,60.24,0.8104
1431,Trujillo Cooper and Mcpherson,False,ZA,New Nicolebury,Cybersecurity,2010,https://trujillocooperandmcpherson.com,Exist someone raise almost talk ok spend speak.,19,trujillo-cooper-and-mcpherson,2023,USD,2694792,834523,1860269,853432,1006837,3421,1003416,26947,53895,949521,1124471,2604980,1960478,644502,,2694792,20.0,98.13,0.0316,11228,20.0,62986.95,17.85,0.6903
1432,Neal-Clark,False,IN,Port Kimberly,SaaS,2020,https://neal-clark.com,Themselves far east try option car.,14,neal-clark,2023,USD,1734489,454205,1280284,1087944,192340,6701,185639,17344,34689,150950,116267,1037730,141913,895817,144540.75,1734489,446.18,813.53,0.1056,1430,101.03,86322.82,1.35,0.7381
1433,Johnson Elliott and Yang,False,US,North David,HealthTech,2014,https://johnsonelliottandyang.com,Sell bed they arm sister seem hotel.,22,johnson-elliott-and-yang,2023,USD,379664,174665,204999,148841,56158,6266,49892,3796,7593,42299,30743,373563,141002,232561,31638.67,379664,302.89,1910.77,0.0263,568,55.62,53607.7,0.57,0.5399
1434,Burke Anderson and Brown,False,DE,East Tammy,Marketplaces,2015,https://burkeandersonandbrown.com,Cup loss finally he civil trade himself other.,19,burke-anderson-and-brown,2023,EUR,467802,192780,275022,135366,139656,27391,112265,4678,9356,102909,14499,281307,147251,134056,,467802,1146.72,573.36,0.1361,215,180.99,1000.0,14.5,0.5879
1435,Davidson-Knight,False,BR,Petersonville,EdTech,2016,https://davidson-knight.com,Car how away director loss discussion husband want talk ever.,17,davidson-knight,2023,USD,290143,153789,136354,170011,-33657,0,-33657,2901,5802,-39459,8563,243307,206536,36771,24178.58,290143,423.33,2338.12,0.0427,695,34.77,2969.07,2.88,0.47
1436,Hernandez-Farrell,False,BR,Kingville,Energy,2024,https://hernandez-farrell.com,Red three international large short ago.,16,hernandez-farrell,2023,USD,527973,141892,386081,37399,348682,46268,302414,5279,10559,291855,9475,392276,174035,218241,,527973,37.21,22.42,0.0419,173,254.0,1000.0,9.48,0.7313
1437,Watkins Keller and Suarez,False,US,Leslieberg,Marketplaces,2008,https://watkinskellerandsuarez.com,Article coach black government discover forward act.,18,watkins-keller-and-suarez,2023,USD,819866,289069,530797,541741,-10944,16061,-27005,8198,16397,-43402,34400,560019,298249,261770,,819866,20.0,127.38,0.0506,391,174.41,23403.73,1.47,0.6474
1438,Nelson Ltd,False,EG,North Bonnie,HealthTech,2013,https://nelsonltd.com,Federal program any surface magazine.,21,nelson-ltd,2023,USD,788544,375341,413203,364634,48569,2761,45808,7885,15770,30038,102055,683459,46680,636779,65712.0,788544,123.42,123.42,0.0069,1798,36.53,14325.86,7.12,0.524
1439,Murray Taylor and Owens,False,KE,West Heather,SaaS,2015,https://murraytaylorandowens.com,Team check behavior nation remain effect something.,25,murray-taylor-and-owens,2023,USD,1043408,510383,533025,411501,121524,12424,109100,10434,20868,88232,55774,674334,561239,113095,86950.67,1043408,176.55,963.1,0.0255,17390,5.0,18555.2,3.01,0.5109
1440,Graves-Fernandez,False,IN,New Henrytown,IoT,2017,https://graves-fernandez.com,Sign low among manage him off which.,17,graves-fernandez,2023,USD,490670,163327,327343,55894,271449,18180,253269,4906,9813,243456,5150,391554,235234,156320,,490670,295.28,980.06,0.0292,2044,20.0,1000.0,5.15,0.6671
1441,Todd PLC,False,ZA,Gomezstad,Cybersecurity,2016,https://toddplc.com,Wall coach level myself face item arm mind PM size grow.,15,todd-plc,2023,USD,2321680,638943,1682737,1188247,494490,44591,449899,23216,46433,403466,272160,1485749,620811,864938,,2321680,901.62,2705.45,0.001,2134,90.64,79810.51,3.41,0.7248
1442,Moreno Gallegos and Weaver,False,TN,Hollyfort,Energy,2019,https://morenogallegosandweaver.com,Identify commercial science entire lot probably.,26,moreno-gallegos-and-weaver,2023,USD,5444640,2245553,3199087,272232,2926855,0,2926855,54446,108892,2817963,560301,3425830,2551375,874455,,5444640,995.38,4690.23,0.0269,5642,80.41,36135.06,15.51,0.5876
1443,Cox and Sons,False,EG,Jillianland,AgriTech,2014,https://coxandsons.com,Hot new common thank across blood contain role professional player.,15,cox-and-sons,2023,USD,855598,283217,572381,495928,76453,13218,63235,8555,17111,46124,80963,706073,35303,670770,,855598,523.4,502.15,0.1475,391,182.27,66020.17,1.23,0.669
1444,Sherman LLC,False,EG,Jacksonchester,AgriTech,2024,https://shermanllc.com,Open edge Congress actually surface college.,18,sherman-llc,2023,USD,375959,158401,217558,165012,52546,11158,41388,3759,7519,33869,29129,348423,233923,114500,,375959,1054.83,6108.39,0.0378,906,34.57,41859.57,0.7,0.5787
1445,Sanchez LLC,False,KE,West Ashleyburgh,Energy,2011,https://sanchezllc.com,Activity add reduce individual color really always improve a truth.,14,sanchez-llc,2023,USD,791754,139974,651780,348588,303192,1796,301396,7917,15835,285561,47794,593582,369410,224172,,791754,342.48,171.24,0.1277,3298,20.0,61117.28,0.78,0.8232
1446,Clayton-Williams,False,US,Russellburgh,AI/ML,2019,https://clayton-williams.com,Local expect always response pass.,16,clayton-williams,2023,USD,961384,261060,700324,789030,-88706,5162,-93868,9613,19227,-113095,28756,704601,634140,70461,,961384,442.1,1467.9,0.001,249,321.5,49716.72,0.58,0.7285
1447,Mclaughlin Inc,False,NG,East Nathan,Marketplaces,2017,https://mclaughlininc.com,Much concern civil student behavior wear.,14,mclaughlin-inc,2023,USD,1579423,850301,729122,842077,-112955,7034,-119989,15794,31588,-151577,14706,897680,448410,449270,,1579423,20.0,23.03,0.0821,790,166.59,67224.11,0.22,0.4616
1448,Reyes Inc,False,IN,South Tammyhaven,Marketplaces,2011,https://reyesinc.com,Left probably fly exactly book rate.,18,reyes-inc,2023,USD,859107,468792,390315,245273,145042,934,144108,8591,17182,126926,54463,531172,274286,256886,,859107,39.42,231.32,0.0829,3579,20.0,6905.65,7.89,0.4543
1449,Guerra-Brown,False,EG,Bergfurt,Fintech,2018,https://guerra-brown.com,Despite moment vote action occur direction community.,22,guerra-brown,2023,USD,831684,338574,493110,295627,197483,12738,184745,8316,16633,168112,60454,634598,286004,348594,,831684,874.54,1868.43,0.001,3465,20.0,54555.65,1.11,0.5929
1450,Henderson-Wallace,False,IN,Hopkinsbury,Marketplaces,2018,https://henderson-wallace.com,Day test cup improve actually.,18,henderson-wallace,2023,USD,537407,136744,400663,148633,252030,567,251463,5374,10748,240715,151689,474225,213475,260750,,537407,1197.96,4521.39,0.063,679,65.87,3368.18,45.04,0.7455
1451,Green Marquez and Hanna,False,IN,Derrickborough,AgriTech,2017,https://greenmarquezandhanna.com,Home everybody stage break see.,23,green-marquez-and-hanna,2023,USD,48737,16181,32556,38321,-5765,0,-5765,487,974,-6739,11428,231950,49482,182468,,48737,1403.97,6743.52,0.0367,203,20.0,10975.11,1.04,0.668
1452,White-Harrison,False,DE,Millsfort,HealthTech,2024,https://white-harrison.com,Thus sell instead realize so page conference window standard.,17,white-harrison,2023,EUR,2094584,293919,1800665,369345,1431320,7044,1424276,20945,41891,1382385,40843,1141622,385808,755814,174548.67,2094584,763.74,2493.28,0.0621,5898,29.59,20925.32,1.95,0.8597
1453,Lamb-Kennedy,False,AU,Craigside,EdTech,2009,https://lamb-kennedy.com,After beautiful suffer people north common recently American collection.,18,lamb-kennedy,2023,USD,754846,167824,587022,300034,286988,0,286988,7548,15096,271892,15673,432593,85924,346669,62903.83,754846,10.0,46.4,0.0583,5012,12.55,80721.07,0.19,0.7777
1454,Robinson Parker and Ingram,False,AU,Port Tylerbury,IoT,2020,https://robinsonparkerandingram.com,Generation sit someone may home eight now.,18,robinson-parker-and-ingram,2023,USD,1451814,905092,546722,575503,-28781,5950,-34731,14518,29036,-63767,27782,782225,208991,573234,,1451814,20.0,50.41,0.0725,6049,20.0,63625.65,0.44,0.3766
1455,Martin LLC,False,BR,Juliefurt,E-commerce,2012,https://martinllc.com,Individual nothing exactly life cup its.,24,martin-llc,2023,USD,1000543,134607,865936,161472,704464,19000,685464,10005,20010,665454,36133,584140,158449,425691,,1000543,187.37,996.79,0.0151,1367,60.98,8566.27,4.22,0.8655
1456,Adams Delgado and Krause,False,ZA,New Matthewhaven,SaaS,2023,https://adamsdelgadoandkrause.com,Personal fine score environmental before risk doctor sister.,21,adams-delgado-and-krause,2023,USD,725857,172722,553135,398758,154377,0,154377,7258,14517,139860,47096,446146,307560,138586,60488.08,725857,395.09,2258.7,0.0375,467,129.5,40550.95,1.16,0.762
1457,Smith Yates and Perkins,False,IN,South Amanda,AgriTech,2021,https://smithyatesandperkins.com,Public anyone major positive improve behind develop.,20,smith-yates-and-perkins,2023,USD,135740,52091,83649,59060,24589,43936,-19347,1357,2714,-22061,25008,234957,95604,139353,,135740,20.0,44.8,0.0513,565,20.0,17802.82,1.4,0.6162
1458,Blanchard Mills and Hill,False,TN,Williamsfurt,Energy,2009,https://blanchardmillsandhill.com,My later prepare task there.,13,blanchard-mills-and-hill,2023,USD,486522,163975,322547,366003,-43456,14857,-58313,4865,9730,-68043,43278,425832,139752,286080,,486522,496.3,264.66,0.0463,353,114.72,35338.13,1.22,0.663
1459,Kemp-Sweeney,False,KE,Lake Natalie,Cybersecurity,2014,https://kemp-sweeney.com,Identify under top site happy father really.,31,kemp-sweeney,2023,USD,1015870,120820,895050,847145,47905,0,47905,10158,20317,27588,54592,674813,279614,395199,,1015870,20.0,99.89,0.044,664,127.33,102094.1,0.53,0.8811
1460,Watson Holmes and Lynch,False,CA,North Edwardfort,Cybersecurity,2015,https://watsonholmesandlynch.com,Officer body since final American lawyer.,16,watson-holmes-and-lynch,2023,USD,454904,78309,376595,98140,278455,7064,271391,4549,9098,262293,11157,240259,105706,134553,,454904,20.0,168.8,0.0399,213,177.9,1000.0,11.16,0.8279
1461,Cruz Roberts and Young,False,BR,Mullinschester,AI/ML,2023,https://cruzrobertsandyoung.com,Front already relationship know trip.,21,cruz-roberts-and-young,2023,USD,1300326,387189,913137,600042,313095,0,313095,13003,26006,287089,49579,813565,684498,129067,,1300326,20.0,42.0,0.0381,1356,79.88,58283.24,0.85,0.7022
1462,Hicks Lewis and Sanders,False,BR,Wadetown,E-commerce,2024,https://hickslewisandsanders.com,Likely social toward nature career same inside thousand.,15,hicks-lewis-and-sanders,2023,USD,293222,134068,159154,140500,18654,7336,11318,2932,5864,5454,15933,306123,63405,242718,,293222,131.08,361.93,0.0518,1221,20.0,30035.91,0.53,0.5428
1463,Pruitt-Day,False,IN,New Allenhaven,HealthTech,2013,https://pruitt-day.com,Meet medical forget maybe forget our step hit seem.,22,pruitt-day,2023,USD,889657,246403,643254,416746,226508,25054,201454,8896,17793,183661,53603,679488,268613,410875,74138.08,889657,10.0,10.0,0.0157,1008,73.48,6212.96,8.63,0.723
1464,Perry Torres and Li,False,IN,Archertown,Fintech,2023,https://perrytorresandli.com,Sometimes point summer such PM number catch brother.,27,perry-torres-and-li,2023,USD,178536,68952,109584,8926,100658,23989,76669,1785,3570,73099,42257,179639,72575,107064,,178536,199.32,99.66,0.0934,55,267.83,14934.03,2.83,0.6138
1465,Brown-Wong,False,GB,Hubbardland,Cybersecurity,2016,https://brown-wong.com,Ten radio kind imagine day stuff several I clear us.,31,brown-wong,2023,USD,787919,277728,510191,328621,181570,0,181570,7879,15758,165812,129390,611726,41321,570405,,787919,1159.15,3684.26,0.124,3282,20.0,1000.0,129.39,0.6475
1466,Kemp Smith and Lee,False,ZA,Port Mary,AI/ML,2013,https://kempsmithandlee.com,Bag yet staff us make no industry follow third daughter sound.,25,kemp-smith-and-lee,2023,USD,558034,167051,390983,491406,-100423,1318,-101741,5580,11160,-112901,11282,353864,17693,336171,,558034,853.42,1627.03,0.001,416,111.76,15428.39,0.73,0.7006
1467,Davis-Mclaughlin,False,BR,New Rodneyport,E-commerce,2010,https://davis-mclaughlin.com,Energy if factor air responsibility option reach professor win beautiful side.,24,davis-mclaughlin,2023,USD,1510520,602823,907697,1574232,-666535,0,-666535,15105,30210,-696745,819055,1717170,1090019,627151,,1510520,669.65,4132.9,0.0491,1029,122.29,123310.22,6.64,0.6009
1468,Turner-Mayo,False,DE,North Justinshire,E-commerce,2015,https://turner-mayo.com,Without last yes out as future Mrs couple happy you most.,23,turner-mayo,2023,EUR,451528,104118,347410,200682,146728,53949,92779,4515,9030,83749,5212,291137,173428,117709,,451528,20.0,63.05,0.0947,1881,20.0,6324.66,0.82,0.7694
1469,Hall-Gaines,False,ZA,Donnabury,AgriTech,2021,https://hall-gaines.com,Recently situation really state away.,20,hall-gaines,2023,USD,259051,114172,144879,82127,62752,0,62752,2590,5181,57571,25316,243289,83623,159666,,259051,1324.95,7900.77,0.0091,71,301.18,1000.0,25.32,0.5593
1470,Ryan Perry and Shaw,False,AU,South Cynthiaview,E-commerce,2019,https://ryanperryandshaw.com,Question gas population oil sense total appear.,17,ryan-perry-and-shaw,2023,USD,1369859,534951,834908,1317568,-482660,42941,-525601,13698,27397,-552998,34022,720922,195793,525129,,1369859,1945.93,3748.39,0.0351,910,125.38,106538.48,0.32,0.6095
1471,Santos-King,False,IN,Port Destiny,IoT,2017,https://santos-king.com,Forget current large another live.,15,santos-king,2023,USD,1124244,572019,552225,542413,9812,19797,-9985,11242,22484,-32469,47292,793293,246240,547053,,1124244,1501.77,6747.61,0.0743,1126,83.2,74770.84,0.63,0.4912
1472,Madden Gutierrez and Evans,False,EG,Hobbsborough,Fintech,2023,https://maddengutierrezandevans.com,Message much military together which.,20,madden-gutierrez-and-evans,2023,USD,1020583,603583,417000,535417,-118417,0,-118417,10205,20411,-138828,193741,838000,289703,548297,,1020583,345.21,172.6,0.0465,4252,20.0,47579.04,4.07,0.4086
1473,Gibson Group,False,US,New Gabriel,Marketplaces,2010,https://gibsongroup.com,Nearly prepare side strategy successful for water produce affect.,16,gibson-group,2023,USD,1078932,462950,615982,227070,388912,24707,364205,10789,21578,342627,65149,770762,260484,510278,,1078932,1527.56,6778.89,0.001,384,233.82,44110.54,1.48,0.5709
1474,Black Ltd,False,EG,Stephanieburgh,EdTech,2024,https://blackltd.com,Place become industry able view rate rest this his.,17,black-ltd,2023,USD,767444,356425,411019,231736,179283,11923,167360,7674,15348,152012,41088,482678,225492,257186,63953.67,767444,10.0,16.23,0.0196,5419,11.8,1000.0,41.09,0.5356
1475,Jackson Group,False,FR,Myerstown,Marketplaces,2020,https://jacksongroup.com,Almost card admit person lead player source yes instead pull.,24,jackson-group,2023,EUR,1677094,404318,1272776,1037337,235439,27224,208215,16770,33541,174674,189285,1212548,640000,572548,,1677094,585.94,2595.76,0.0149,6987,20.0,85034.38,2.23,0.7589
1476,Ramirez-Robinson,False,NG,Mccoyburgh,AgriTech,2021,https://ramirez-robinson.com,Free miss start machine accept condition save.,23,ramirez-robinson,2023,USD,354336,133027,221309,205911,15398,18599,-3201,3543,7086,-10287,200392,498491,132151,366340,,354336,708.02,1479.04,0.0807,1476,20.0,22982.94,8.72,0.6246
1477,Cochran-Arias,False,US,West Francis,HealthTech,2012,https://cochran-arias.com,Democrat others one voice choose development hair across.,16,cochran-arias,2023,USD,228345,108730,119615,132694,-13079,0,-13079,2283,4566,-17645,20934,306055,39519,266536,19028.75,228345,461.27,1384.8,0.022,2142,8.88,14963.97,1.4,0.5238
1478,Blankenship Hudson and Sullivan,False,DE,East Chelseamouth,E-commerce,2021,https://blankenshiphudsonandsullivan.com,Car senior drug five.,16,blankenship-hudson-and-sullivan,2023,EUR,5313929,1621026,3692903,3933572,-240669,7984,-248653,53139,106278,-354931,386930,3210505,1841981,1368524,,5313929,588.69,301.58,0.0327,2282,194.05,317549.36,1.22,0.6949
1479,Parker Bell and Walker,False,KE,Scottland,Mobility,2012,https://parkerbellandwalker.com,Spring smile single everything administration during hundred reduce subject together.,17,parker-bell-and-walker,2023,USD,267669,122076,145593,49591,96002,21265,74737,2676,5353,69384,50438,255230,50221,205009,,267669,20.0,61.3,0.0019,404,55.1,1000.0,50.44,0.5439
1480,Thomas Bell and Love,False,CA,Boltonbury,Cybersecurity,2013,https://thomasbellandlove.com,Hard voice hundred charge culture camera into high southern page.,21,thomas-bell-and-love,2023,USD,104495,35109,69386,29592,39794,0,39794,1044,2089,37705,4826,147745,48724,99021,,104495,20.0,93.61,0.0802,48,179.16,48236.36,0.1,0.664
1481,Cordova Russell and Richards,False,AU,West Bonnie,Fintech,2023,https://cordovarussellandrichards.com,Staff whose talk project company security week control modern continue.,21,cordova-russell-and-richards,2023,USD,738913,180124,558789,198582,360207,15189,345018,7389,14778,330240,134785,628431,67756,560675,,738913,981.18,3275.94,0.1137,442,139.08,1000.0,134.78,0.7562
1482,Elliott-Anderson,False,CA,Butlerland,Marketplaces,2013,https://elliott-anderson.com,We notice impact country general particular operation threat over.,16,elliott-anderson,2023,USD,1209792,266478,943314,1017768,-74454,17644,-92098,12097,24195,-116293,134879,777797,420413,357384,,1209792,1501.89,5642.16,0.1357,687,146.54,52415.6,2.57,0.7797
1483,Chapman Ltd,False,CA,East Malik,Marketplaces,2009,https://chapmanltd.com,Same tend hundred method report late cost trouble its feeling.,23,chapman-ltd,2023,USD,183095,49709,133386,9154,124232,36172,88060,1830,3661,84399,7933,222074,173967,48107,,183095,1042.71,1324.28,0.0591,68,221.36,16523.9,0.48,0.7285
1484,Scott and Sons,False,US,New Staceyview,Mobility,2016,https://scottandsons.com,Spend believe customer month couple share be yard I ahead.,18,scott-and-sons,2023,USD,1086286,445920,640366,323464,316902,0,316902,10862,21725,295177,17022,743267,238778,504489,,1086286,199.04,630.06,0.1125,457,197.67,20182.15,0.84,0.5895
1485,Roberts Inc,False,DE,Spearsberg,HealthTech,2013,https://robertsinc.com,Right want what figure present dinner almost expect very audience feel.,18,roberts-inc,2023,EUR,561794,104596,457198,269197,188001,20019,167982,5617,11235,156747,23907,371405,94750,276655,46816.17,561794,385.89,1598.58,0.0188,698,67.02,37835.24,0.63,0.8138
1486,Harris PLC,False,EG,Morrisside,Fintech,2012,https://harrisplc.com,Car option music popular strategy himself civil skill vote.,29,harris-plc,2023,USD,1797654,819077,978577,715197,263380,2588,260792,17976,35953,224839,111051,1013647,471028,542619,,1797654,1031.09,5379.77,0.1121,730,205.12,17027.95,6.52,0.5444
1487,Phillips Inc,False,KE,Christineberg,Energy,2021,https://phillipsinc.com,Million do story all usually.,16,phillips-inc,2023,USD,2249787,644444,1605343,592017,1013326,16208,997118,22497,44995,952123,19936,1211541,60577,1150964,,2249787,20.0,145.79,0.023,1446,129.61,13176.92,1.51,0.7136
1488,Patterson-Dunlap,False,TN,New Sherryside,Energy,2023,https://patterson-dunlap.com,Husband trip nothing with since TV without almost write have move.,21,patterson-dunlap,2023,USD,2624969,1104364,1520605,506675,1013930,18411,995519,26249,52499,943020,93999,1605710,481818,1123892,,2624969,619.91,1139.31,0.001,2713,80.6,66078.3,1.42,0.5793
1489,Miller Ltd,False,TN,Johntown,SaaS,2009,https://millerltd.com,Past important view issue four lose serious prepare run.,19,miller-ltd,2023,USD,382897,127714,255183,154354,100829,24910,75919,3828,7657,68262,20220,245996,47102,198894,31908.08,382897,304.88,959.29,0.0041,6381,5.0,1000.0,20.22,0.6665
1490,Atkinson-Smith,False,NG,Port Sheila,EdTech,2019,https://atkinson-smith.com,Election represent fish who prevent lot peace sure best.,24,atkinson-smith,2023,USD,251912,68085,183827,201697,-17870,0,-17870,2519,5038,-22908,14572,319687,211698,107989,20992.67,251912,36.13,107.03,0.033,252,83.25,27090.9,0.54,0.7297
1491,Crawford Group,False,US,Lake Gavin,E-commerce,2024,https://crawfordgroup.com,Wrong glass difficult beat offer professional whole chair four.,18,crawford-group,2023,USD,210985,77818,133167,70815,62352,0,62352,2109,4219,58133,14206,250570,77019,173551,,210985,20.0,96.58,0.0934,875,20.09,15756.76,0.9,0.6312
1492,Garner Silva and Bowen,False,DE,New Todd,SaaS,2008,https://garnersilvaandbowen.com,Least couple rule special system financial.,18,garner-silva-and-bowen,2023,EUR,368716,50871,317845,297630,20215,0,20215,3687,7374,12841,8454,263449,32408,231041,30726.33,368716,10.0,23.54,0.0336,499,61.47,28737.33,0.29,0.862
1493,Mitchell-Lynch,False,BR,Trevortown,Cybersecurity,2015,https://mitchell-lynch.com,Seek movement tend simple firm assume why above student.,21,mitchell-lynch,2023,USD,877618,454386,423232,650032,-226800,0,-226800,8776,17552,-244352,163074,736215,336590,399625,,877618,20.0,61.21,0.001,3656,20.0,45269.93,3.6,0.4823
1494,Morris-Waters,False,DE,Port Thomaston,Cybersecurity,2019,https://morris-waters.com,Table window bed reason which coach Mrs girl environmental himself.,18,morris-waters,2023,EUR,230586,126439,104147,167954,-63807,0,-63807,2305,4611,-68418,3946,150461,43342,107119,,230586,523.73,885.26,0.0458,504,38.06,15414.89,0.26,0.4517
1495,Johnson-Cervantes,False,IN,Williamstad,HealthTech,2011,https://johnson-cervantes.com,Name bad say believe time later even song.,22,johnson-cervantes,2023,USD,466809,148261,318548,303917,14631,1380,13251,4668,9336,3915,47680,313230,166149,147081,38900.75,466809,249.32,774.37,0.0346,1206,32.24,20228.57,2.36,0.6824
1496,Caldwell-Wright,False,TN,South Brandonfort,AI/ML,2017,https://caldwell-wright.com,Able expect onto throughout song response five find much.,30,caldwell-wright,2023,USD,554658,189000,365658,316329,49329,0,49329,5546,11093,38236,55507,508655,237441,271214,,554658,160.23,416.34,0.1181,1781,25.94,24519.87,2.26,0.6592
1497,Vang and Sons,False,GB,East Christopher,Fintech,2009,https://vangandsons.com,Agency decade him shoulder short school always message trip name.,18,vang-and-sons,2023,USD,6611406,2758347,3853059,1966155,1886904,34963,1851941,66114,132228,1719713,395987,3783640,671307,3112333,,6611406,20.0,43.84,0.001,2162,254.79,164108.82,2.41,0.5828
1498,Cohen-Ramirez,False,IN,Lake Seanside,AgriTech,2022,https://cohen-ramirez.com,Charge focus part full.,15,cohen-ramirez,2023,USD,2259617,112980,2146637,391974,1754663,2339,1752324,22596,45192,1707132,124011,1389543,708445,681098,,2259617,405.95,1383.68,0.0156,1310,143.67,26542.51,4.67,0.95
1499,Campbell-Kim,False,ZA,Port James,AI/ML,2024,https://campbell-kim.com,Garden individual customer usually painting life enough.,25,campbell-kim,2023,USD,826098,160489,665609,222336,443273,0,443273,8260,16521,426752,25191,531985,190200,341785,,826098,752.97,1083.87,0.0908,1459,47.16,34337.67,0.73,0.8057
1500,Gordon PLC,False,CA,Port Kaylachester,Energy,2012,https://gordonplc.com,Amount rest painting lot why others American quickly brother.,15,gordon-plc,2023,USD,997604,223782,773822,352833,420989,6376,414613,9976,19952,394661,20615,520305,26015,494290,,997604,884.58,964.22,0.1661,803,103.47,45646.56,0.45,0.7757
1501,Gilbert Fernandez and Sharp,False,CA,Michelleland,Mobility,2019,https://gilbertfernandezandsharp.com,Current task certainly hope beyond.,24,gilbert-fernandez-and-sharp,2023,USD,122378,53183,69195,124705,-55510,20188,-75698,1223,2447,-78145,7688,132961,16877,116084,,122378,1911.49,2970.92,0.044,342,29.75,17670.62,0.44,0.5654
1502,Medina-Spencer,False,AU,West Frankfurt,EdTech,2013,https://medina-spencer.com,Cost budget order idea far lawyer raise.,24,medina-spencer,2023,USD,630562,273123,357439,215498,141941,0,141941,6305,12611,129330,32756,543893,218477,325416,52546.83,630562,893.48,3440.2,0.0485,1422,36.94,1000.0,32.76,0.5669
1503,Thomas LLC,False,AU,New Rebecca,Energy,2008,https://thomasllc.com,Live weight guy everything.,17,thomas-llc,2023,USD,635415,254079,381336,450440,-69104,11892,-80996,6354,12708,-93704,25327,496309,111088,385221,,635415,214.68,286.19,0.0915,849,62.35,12984.26,1.95,0.6001
1504,Barber-Benjamin,False,DE,Port Amandaberg,EdTech,2012,https://barber-benjamin.com,Bag seek eye second statement occur.,28,barber-benjamin,2023,EUR,180203,75757,104446,79215,25231,0,25231,1802,3604,21627,20606,167588,8379,159209,15016.92,180203,579.31,2065.28,0.0102,151,98.93,1415.32,14.56,0.5796
1505,Sanchez Nelson and Walter,False,DE,Larachester,Cybersecurity,2008,https://sancheznelsonandwalter.com,Their conference force serve heavy able.,27,sanchez-nelson-and-walter,2023,EUR,395041,110598,284443,159629,124814,10167,114647,3950,7900,106747,46975,250975,103450,147525,,395041,319.65,1877.29,0.0074,76,431.62,29607.06,1.59,0.72
1506,Cherry and Sons,False,KE,Jonesside,AI/ML,2013,https://cherryandsons.com,Administration hear spend trade accept trade might.,26,cherry-and-sons,2023,USD,4480511,1542929,2937582,224025,2713557,16340,2697217,44805,89610,2607607,180341,2435862,653965,1781897,,4480511,414.89,2248.05,0.001,1932,193.24,31079.57,5.8,0.6556
1507,Rivera Inc,False,FR,Youngfurt,E-commerce,2009,https://riverainc.com,Draw stop he can most political positive investment.,23,rivera-inc,2023,EUR,2737214,494805,2242409,707860,1534549,0,1534549,27372,54744,1479805,483738,1902348,439792,1462556,,2737214,20.0,73.68,0.0852,1697,134.36,52154.43,9.28,0.8192
1508,Hanson PLC,False,TN,North Micheleshire,Marketplaces,2016,https://hansonplc.com,Or write around scientist police.,17,hanson-plc,2023,USD,1432006,767847,664159,363880,300279,13746,286533,14320,28640,257893,39212,894577,283567,611010,,1432006,20.0,100.36,0.0211,1179,101.18,19120.05,2.05,0.4638
1509,Diaz Inc,False,AU,Matthewborough,AI/ML,2009,https://diazinc.com,Serious nothing receive happen tax off station wide among.,22,diaz-inc,2023,USD,575455,115330,460125,422937,37188,8900,28288,5754,11509,16779,47549,510986,182353,328633,,575455,467.84,1108.72,0.0533,165,289.91,33349.34,1.43,0.7996
1510,Moran Jordan and Anderson,False,KE,Baileyfort,SaaS,2011,https://moranjordanandanderson.com,Product election event picture weight analysis experience.,20,moran-jordan-and-anderson,2023,USD,225086,47364,177722,11254,166468,0,166468,2250,4501,161967,24318,162011,36647,125364,18757.17,225086,346.45,1028.23,0.0464,589,31.8,6905.28,3.52,0.7896
1511,Estes Campbell and Mitchell,False,BR,Jeffreyland,SaaS,2009,https://estescampbellandmitchell.com,Newspaper piece building nature hope picture.,16,estes-campbell-and-mitchell,2023,USD,478184,201939,276245,133649,142596,29107,113489,4781,9563,103926,249801,571490,275045,296445,39848.67,478184,573.78,2210.01,0.0075,465,85.58,1000.0,249.8,0.5777
1512,Lewis Mercado and Bruce,False,ZA,Raymondfurt,Fintech,2021,https://lewismercadoandbruce.com,Term others rate change management manager.,17,lewis-mercado-and-bruce,2023,USD,2973219,1120596,1852623,1310097,542526,10295,532231,29732,59464,472767,24374,1563186,399876,1163310,,2973219,502.59,2480.46,0.0344,2696,91.9,97519.62,0.25,0.6231
1513,Lyons-James,False,EG,Port Ricky,Energy,2011,https://lyons-james.com,Style finally institution language fast tell child instead TV.,17,lyons-james,2023,USD,965176,431329,533847,415311,118536,29877,88659,9651,19303,69356,79768,718215,175543,542672,,965176,20.0,98.72,0.1669,510,157.49,51305.96,1.55,0.5531
1514,Anderson LLC,False,NG,West Williamtown,AgriTech,2023,https://andersonllc.com,Hear current above kid quickly.,16,anderson-llc,2023,USD,259104,67033,192071,132946,59125,0,59125,2591,5182,53943,1957,198069,31559,166510,,259104,1598.0,7056.18,0.001,351,61.35,8768.64,0.22,0.7413
1515,Tapia Henderson and Lamb,False,ZA,Rodneystad,HealthTech,2014,https://tapiahendersonandlamb.com,Key artist can eight avoid early for kind enter report.,22,tapia-henderson-and-lamb,2023,USD,589242,122484,466758,312647,154111,4134,149977,5892,11784,138193,46824,530932,259145,271787,49103.5,589242,169.08,1317.21,0.001,8569,5.73,61884.66,0.76,0.7921
1516,Dennis-Diaz,False,ZA,Lake Lisamouth,Marketplaces,2008,https://dennis-diaz.com,Approach reveal but value bag poor modern offer huge who.,16,dennis-diaz,2023,USD,3373261,1092970,2280291,2186350,93941,0,93941,33732,67465,26476,331668,2027784,101389,1926395,,3373261,463.74,1258.15,0.076,14055,20.0,179373.1,1.85,0.676
1517,Abbott-Sullivan,False,IN,South Mark,Energy,2011,https://abbott-sullivan.com,Network crime focus parent enough provide.,19,abbott-sullivan,2023,USD,619238,137710,481528,392514,89014,5592,83422,6192,12384,71038,58350,459571,217204,242367,,619238,41.37,53.84,0.1015,2580,20.0,12137.22,4.81,0.7776
1518,Foster-Blevins,False,BR,Gloriaton,AI/ML,2016,https://foster-blevins.com,Wife year really suggest soon become.,25,foster-blevins,2023,USD,172961,69489,103472,71814,31658,25806,5852,1729,3459,2393,22531,111498,5574,105924,,172961,1507.28,3201.12,0.107,176,81.69,1000.0,22.53,0.5982
1519,Sanchez-Smith,False,KE,New Jacobtown,IoT,2012,https://sanchez-smith.com,Growth major describe sure century relationship recognize defense radio decision.,14,sanchez-smith,2023,USD,223096,97506,125590,149575,-23985,5528,-29513,2230,4461,-33974,3268,143510,51485,92025,,223096,464.65,232.32,0.0972,54,341.02,1000.0,3.27,0.5629
1520,Roberts-Williams,False,TN,West John,Fintech,2024,https://roberts-williams.com,Spring various time least pay order.,16,roberts-williams,2023,USD,382805,106470,276335,306482,-30147,15271,-45418,3828,7656,-53074,34771,415332,123097,292235,,382805,20.0,24.27,0.0301,1393,22.9,13914.04,2.5,0.7219
1521,Green Group,False,ZA,Sellersburgh,IoT,2011,https://greengroup.com,Return test prepare another draw consumer offer.,22,green-group,2023,USD,1029975,631432,398543,51498,347045,11262,335783,10299,20599,315184,33346,729098,258050,471048,,1029975,20.0,81.64,0.0767,2215,38.75,1000.0,33.35,0.3869
1522,Barker-Smith,False,IN,Jensenbury,Fintech,2011,https://barker-smith.com,Might fall defense father process painting.,14,barker-smith,2023,USD,6050881,2160870,3890011,1693764,2196247,0,2196247,60508,121017,2075230,208241,3294468,1335999,1958469,,6050881,710.71,2061.97,0.1205,2472,203.92,126964.2,1.64,0.6429
1523,Hernandez Franklin and Marsh,False,EG,Riveramouth,EdTech,2014,https://hernandezfranklinandmarsh.com,Foreign environmental garden to arm.,29,hernandez-franklin-and-marsh,2023,USD,532467,222142,310325,310632,-307,15497,-15804,5324,10649,-26453,18485,465439,97974,367465,44372.25,532467,209.96,1688.58,0.0235,600,73.87,39789.29,0.46,0.5828
1524,Morris-Carroll,False,AU,East Andreabury,AgriTech,2024,https://morris-carroll.com,Ahead respond hotel expect early pull.,19,morris-carroll,2023,USD,304174,138598,165576,103974,61602,0,61602,3041,6083,55519,14738,207759,154696,53063,,304174,1259.03,5781.87,0.0607,103,243.77,32240.57,0.46,0.5443
1525,Ayala Group,False,DE,East Trevor,E-commerce,2021,https://ayalagroup.com,Level data away though media whether western I federal.,26,ayala-group,2023,EUR,2439131,1002535,1436596,933396,503200,14762,488438,24391,48782,439656,84294,1406465,339289,1067176,,2439131,20.0,36.0,0.1054,1716,118.43,101556.8,0.83,0.589
1526,Johnson-Lang,False,IN,East Angelicaton,HealthTech,2009,https://johnson-lang.com,Her alone pass college me fight picture.,16,johnson-lang,2023,USD,546020,336418,209602,248024,-38422,36420,-74842,5460,10920,-85762,56766,473373,23668,449705,45501.67,546020,353.13,1663.14,0.0148,1361,33.42,15183.8,3.74,0.3839
1527,Luna Inc,False,NG,Moodyport,Mobility,2014,https://lunainc.com,Car many adult possible its.,16,luna-inc,2023,USD,1463617,166699,1296918,631422,665496,11999,653497,14636,29272,624225,41365,795075,202055,593020,,1463617,20.0,69.24,0.0667,1744,69.9,61097.51,0.68,0.8861
1528,Hunter-Patterson,False,ZA,Taylorshire,Mobility,2018,https://hunter-patterson.com,Success involve civil successful.,11,hunter-patterson,2023,USD,759570,280316,479254,494060,-14806,10264,-25070,7595,15191,-40261,36345,614184,116905,497279,,759570,966.76,4748.74,0.0636,211,298.58,14469.71,2.51,0.631
1529,Mann and Sons,False,DE,Cynthiafurt,SaaS,2008,https://mannandsons.com,Watch rock executive language fire magazine only.,23,mann-and-sons,2023,EUR,3836855,1630036,2206819,1727532,479287,4962,474325,38368,76737,397588,322292,2247002,112350,2134652,319737.92,3836855,572.89,3634.7,0.0471,6781,47.15,149929.56,2.15,0.5752
1530,Mills and Sons,False,BR,Goodmanside,Fintech,2011,https://millsandsons.com,Success our back out relationship interview operation.,22,mills-and-sons,2023,USD,1896202,631436,1264766,965942,298824,6633,292191,18962,37924,254267,18919,1003829,458916,544913,,1896202,69.58,75.56,0.0111,818,193.09,82897.65,0.23,0.667
1531,Oneal Cervantes and Smith,False,KE,Carlaborough,Marketplaces,2023,https://onealcervantesandsmith.com,Statement simple job describe capital develop.,23,oneal-cervantes-and-smith,2023,USD,273878,44668,229210,133882,95328,0,95328,2738,5477,89851,21936,356276,89135,267141,,273878,916.36,3268.45,0.001,90,250.98,34306.66,0.64,0.8369
1532,Scott James and Anderson,False,GB,Lake Amy,Fintech,2024,https://scottjamesandanderson.com,South avoid term bit pattern none fund edge about available.,14,scott-james-and-anderson,2023,USD,3752126,1652997,2099129,187606,1911523,12967,1898556,37521,75042,1823514,838097,2738450,1371670,1366780,,3752126,229.1,261.73,0.0784,15633,20.0,34096.9,24.58,0.5595
1533,Cole Figueroa and Huerta,False,FR,East Renee,Cybersecurity,2011,https://colefigueroaandhuerta.com,Will reflect fight marriage common threat PM game resource second.,16,cole-figueroa-and-huerta,2023,EUR,173806,87261,86545,99780,-13235,12250,-25485,1738,3476,-28961,35437,278951,27590,251361,,173806,476.31,995.03,0.0687,56,254.13,25137.11,1.41,0.4979
1534,Vasquez Boone and Schroeder,False,IN,East Jamie,Marketplaces,2015,https://vasquezbooneandschroeder.com,Poor power around price win face hold anyone recently would.,22,vasquez-boone-and-schroeder,2023,USD,2081675,717506,1364169,1552518,-188349,11734,-200083,20816,41633,-241716,73030,1146256,270253,876003,,2081675,20.0,36.48,0.0347,8673,20.0,143764.12,0.51,0.6553
1535,Wolfe LLC,False,EG,Richardmouth,AgriTech,2016,https://wolfellc.com,Outside win why hot send foot into kitchen especially simple.,21,wolfe-llc,2023,USD,526131,226885,299246,372982,-73736,0,-73736,5261,10522,-84258,45197,361707,254291,107416,,526131,20.0,104.15,0.0029,2192,20.0,23156.03,1.95,0.5688
1536,Lee-Gregory,False,EG,North Melissa,SaaS,2011,https://lee-gregory.com,Child house budget style arrive they individual his car.,16,lee-gregory,2023,USD,993880,405998,587882,389854,198028,0,198028,9938,19877,178151,137881,748792,104581,644211,82823.33,993880,213.86,213.86,0.0235,1135,72.94,44335.09,3.11,0.5915
1537,Barnes LLC,False,GB,Jessicahaven,SaaS,2017,https://barnesllc.com,Week form program mission human foreign serve thousand.,19,barnes-llc,2023,USD,3921712,1649934,2271778,3320377,-1048599,0,-1048599,39217,78434,-1127033,578383,2727169,391854,2335315,326809.33,3921712,71.8,71.8,0.0034,4164,78.47,249795.7,2.32,0.5793
1538,Garcia-Church,False,CA,Thomasview,Marketplaces,2018,https://garcia-church.com,According hit land minute.,16,garcia-church,2023,USD,1094074,167878,926196,294071,632125,5625,626500,10940,21881,604619,27940,660242,146770,513472,,1094074,274.1,1612.67,0.0728,2248,40.55,49187.47,0.57,0.8466
1539,Stokes-Foley,False,TN,Feliciastad,Cybersecurity,2011,https://stokes-foley.com,Increase good foot child through.,25,stokes-foley,2023,USD,1349343,344472,1004871,963431,41440,34678,6762,13493,26986,-20224,127734,867960,448020,419940,,1349343,20.0,10.0,0.001,386,291.06,82973.67,1.54,0.7447
1540,Green-Carrillo,False,FR,Fitzpatricktown,SaaS,2008,https://green-carrillo.com,Soon street cut image move international.,24,green-carrillo,2023,EUR,79830,37351,42479,25763,16716,0,16716,798,1596,15120,17633,210436,85928,124508,6652.5,79830,236.23,425.08,0.0059,384,17.3,15353.91,1.15,0.5321
1541,Rowe Copeland and Hoover,False,GB,Lake Bryantown,Marketplaces,2013,https://rowecopelandandhoover.com,Impact animal performance special environmental trouble mention.,23,rowe-copeland-and-hoover,2023,USD,772651,491279,281372,222755,58617,0,58617,7726,15453,43164,18870,594010,377757,216253,,772651,20.0,38.42,0.001,3219,20.0,13332.94,1.42,0.3642
1542,Brown-Williams,False,CA,Jessicaside,E-commerce,2022,https://brown-williams.com,Save development work since everyone attorney especially official on item at.,23,brown-williams,2023,USD,2564316,702478,1861838,430047,1431791,50121,1381670,25643,51286,1330384,158933,1619421,80971,1538450,,2564316,20.0,56.99,0.0995,10684,20.0,37947.26,4.19,0.7261
1543,Alvarez Washington and Kirk,False,KE,Taylorview,AgriTech,2010,https://alvarezwashingtonandkirk.com,Wrong new body guy participant money federal trial.,22,alvarez-washington-and-kirk,2023,USD,1388133,679109,709024,484825,224199,6334,217865,13881,27762,190103,29116,743023,225781,517242,,1388133,20.0,10.0,0.0229,471,245.1,18090.53,1.61,0.5108
1544,Harris-Molina,False,CA,Waltonfort,E-commerce,2013,https://harris-molina.com,Write wind add focus policy well of.,17,harris-molina,2023,USD,464442,79448,384994,160901,224093,33453,190640,4644,9288,181352,18060,289503,14475,275028,,464442,181.26,371.93,0.1103,704,54.94,21669.5,0.83,0.8289
1545,Smith Rogers and Clayton,False,FR,East Dianechester,Energy,2020,https://smithrogersandclayton.com,Collection pay establish practice.,20,smith-rogers-and-clayton,2023,EUR,2466341,943718,1522623,943983,578640,0,578640,24663,49326,529314,97492,1454190,453975,1000215,,2466341,1357.0,813.95,0.0894,10276,20.0,102010.37,0.96,0.6174
1546,Solis Inc,False,EG,Rhondaberg,AgriTech,2020,https://solisinc.com,Minute particular that light such child dinner nor.,20,solis-inc,2023,USD,123736,44025,79711,24802,54909,0,54909,1237,2474,52435,1114,156670,37426,119244,,123736,1199.85,2989.1,0.001,225,45.76,33618.28,0.03,0.6442
1547,Ortega-Ruiz,False,ZA,Stevensstad,Mobility,2021,https://ortega-ruiz.com,Prevent at tonight scene year.,16,ortega-ruiz,2023,USD,993826,445780,548046,288142,259904,11133,248771,9938,19876,228895,85571,767686,44532,723154,,993826,330.22,441.7,0.001,4140,20.0,27992.75,3.06,0.5515
1548,Mills Moore and Smith,False,BR,Port Catherine,HealthTech,2011,https://millsmooreandsmith.com,Them recent south everybody number city position detail wife investment.,26,mills-moore-and-smith,2023,USD,1750794,748084,1002710,413668,589042,45990,543052,17507,35015,508037,120691,1014783,368705,646078,145899.5,1750794,10.0,43.15,0.0668,29179,5.0,7231.74,16.69,0.5727
1549,Day Sharp and Bennett,False,GB,Gabrielchester,Cybersecurity,2009,https://daysharpandbennett.com,Fall might better word court able idea successful degree.,17,day-sharp-and-bennett,2023,USD,1619925,439902,1180023,819292,360731,6378,354353,16199,32398,321955,62967,1018353,453739,564614,,1619925,20.0,45.47,0.0535,6749,20.0,53050.1,1.19,0.7284
1550,Melendez Miller and Davis,False,GB,South Amberberg,Fintech,2021,https://melendezmilleranddavis.com,Single though statement start none increase nature.,23,melendez-miller-and-davis,2023,USD,403320,121093,282227,271429,10798,5042,5756,4033,8066,-2310,38142,332056,100724,231332,,403320,1306.55,1757.29,0.0702,1680,20.0,27195.67,1.4,0.6998
1551,Mahoney and Sons,False,KE,East Steve,Mobility,2022,https://mahoneyandsons.com,Detail listen late me often wonder.,18,mahoney-and-sons,2023,USD,2018632,692109,1326523,1219396,107127,15015,92112,20186,40372,51740,138431,1316789,356275,960514,,2018632,1579.57,5990.59,0.0811,8410,20.0,95032.24,1.46,0.6571
1552,Perez Ltd,False,GB,North Jeanettechester,IoT,2020,https://perezltd.com,Station their research physical large provide need special.,19,perez-ltd,2023,USD,184847,55397,129450,147327,-17877,43237,-61114,1848,3696,-64810,10093,190609,70247,120362,,184847,20.0,87.3,0.001,770,20.0,58449.89,0.17,0.7003
1553,Carpenter-Warner,False,AU,Lake Kyliechester,E-commerce,2008,https://carpenter-warner.com,Finish dark modern writer these name person always laugh.,20,carpenter-warner,2023,USD,147494,56859,90635,134017,-43382,26233,-69615,1474,2949,-72564,30803,254491,167633,86858,,147494,20.0,106.84,0.0888,333,36.86,1000.0,30.8,0.6145
1554,Ford Inc,False,BR,Brandymouth,Cybersecurity,2012,https://fordinc.com,Owner newspaper few member part Republican hospital if near.,23,ford-inc,2023,USD,461830,160781,301049,177379,123670,0,123670,4618,9236,114434,7491,390502,52431,338071,,461830,1120.16,560.08,0.1757,293,131.21,38599.3,0.19,0.6519
1555,Baker Hunt and Jenkins,False,EG,Port Erictown,Mobility,2011,https://bakerhuntandjenkins.com,Human character order race Congress very skill owner place.,12,baker-hunt-and-jenkins,2023,USD,854211,307564,546647,478499,68148,35013,33135,8542,17084,16051,26531,546971,252997,293974,,854211,1093.25,2909.26,0.001,3559,20.0,29349.09,0.9,0.6399
1556,Rojas-Payne,False,TN,East Sarahside,Mobility,2009,https://rojas-payne.com,Poor suggest six better short spring ago still according I.,13,rojas-payne,2023,USD,1510704,489561,1021143,872202,148941,14330,134611,15107,30214,104397,25312,818541,247592,570949,,1510704,774.76,2487.15,0.0871,226,556.81,62258.31,0.41,0.6759
1557,Hodges Sheppard and Johnson,False,FR,North Shawnberg,AgriTech,2018,https://hodgessheppardandjohnson.com,Loss chair never hold parent discuss ever.,25,hodges-sheppard-and-johnson,2023,EUR,667815,329239,338576,62579,275997,2472,273525,6678,13356,260169,46428,458521,226538,231983,,667815,1099.67,2729.82,0.0681,248,223.72,38648.11,1.2,0.507
1558,Dixon Spears and Kim,False,US,Catherinemouth,Cybersecurity,2024,https://dixonspearsandkim.com,Drug first inside foreign memory.,19,dixon-spears-and-kim,2023,USD,2883786,1112024,1771762,1873428,-101666,0,-101666,28837,57675,-159341,142927,1642393,622778,1019615,,2883786,344.72,230.18,0.1398,2795,85.97,138621.75,1.03,0.6144
1559,Atkins-Logan,False,AU,East Matthew,Cybersecurity,2015,https://atkins-logan.com,Actually main door big color south together design follow.,18,atkins-logan,2023,USD,829836,398704,431132,306326,124806,33219,91587,8298,16596,74991,12086,624784,187512,437272,,829836,20.0,92.3,0.0036,553,124.93,54418.18,0.22,0.5195
1560,Chen-Maldonado,False,BR,Scottton,E-commerce,2024,https://chen-maldonado.com,Camera behavior long page theory development event state.,23,chen-maldonado,2023,USD,1585827,582826,1003001,1025043,-22042,16988,-39030,15858,31716,-70746,113569,986224,833124,153100,,1585827,677.29,2567.74,0.0916,425,310.45,117096.3,0.97,0.6325
1561,Williams-Richardson,False,NG,North Teresa,Cybersecurity,2011,https://williams-richardson.com,Ask thousand week prepare reduce sell view.,22,williams-richardson,2023,USD,1539120,738218,800902,415839,385063,0,385063,15391,30782,354281,108049,974194,531163,443031,,1539120,20.0,10.0,0.1049,661,193.95,49836.17,2.17,0.5204
1562,Mcguire Rosales and Gonzalez,False,TN,Wilsonfurt,Marketplaces,2015,https://mcguirerosalesandgonzalez.com,Own season old just their pay Mrs them central police.,19,mcguire-rosales-and-gonzalez,2023,USD,2872568,1158691,1713877,2167165,-453288,9251,-462539,28725,57451,-519990,153474,1745355,1236304,509051,,2872568,1183.02,8218.68,0.1094,6187,38.69,162548.72,0.94,0.5966
1563,Brock-Burton,False,EG,Ronaldport,E-commerce,2020,https://brock-burton.com,Include list special agent seven discussion sign.,22,brock-burton,2023,USD,951507,391884,559623,712498,-152875,6747,-159622,9515,19030,-178652,25368,581504,227658,353846,,951507,1195.04,4402.01,0.001,428,184.99,30395.7,0.83,0.5881
1564,Chase Mckay and Olsen,False,GB,South Jefferyberg,AI/ML,2009,https://chasemckayandolsen.com,Floor despite material product than great war hand relationship civil travel.,25,chase-mckay-and-olsen,2023,USD,1795358,732367,1062991,756556,306435,0,306435,17953,35907,270528,78803,994110,590289,403821,,1795358,116.65,554.57,0.1427,395,378.15,34072.46,2.31,0.5921
1565,Thomas Gonzales and Garcia,False,US,Nixonborough,Marketplaces,2013,https://thomasgonzalesandgarcia.com,Carry stop former happy relate.,20,thomas-gonzales-and-garcia,2023,USD,748789,213399,535390,268834,266556,0,266556,7487,14975,251581,14435,405774,178509,227265,,748789,347.05,1074.57,0.0306,289,215.4,1000.0,14.44,0.715
1566,Day-Ferrell,False,NG,East Gregory,Mobility,2023,https://day-ferrell.com,Heavy yeah health nearly phone.,17,day-ferrell,2023,USD,2630133,876982,1753151,292803,1460348,16807,1443541,26301,52602,1390939,206863,1648830,574375,1074455,,2630133,334.76,167.38,0.058,2051,106.85,12727.74,16.25,0.6666
1567,Medina-Aguilar,False,GB,Johnsonmouth,Fintech,2023,https://medina-aguilar.com,Feel some suggest remember home road.,21,medina-aguilar,2023,USD,691954,261095,430859,458010,-27151,0,-27151,6919,13839,-40990,37936,496015,24800,471215,,691954,20.0,44.45,0.0036,2883,20.0,31938.04,1.19,0.6227
1568,Paul-Armstrong,False,CA,Debrafort,EdTech,2018,https://paul-armstrong.com,Scientist type particular interesting kind from way.,21,paul-armstrong,2023,USD,1046562,402291,644271,654107,-9836,32150,-41986,10465,20931,-62917,17723,615373,79360,536013,87213.5,1046562,561.73,1561.13,0.001,1160,75.14,77265.66,0.23,0.6156
1569,Jones Ltd,False,IN,South Anneland,SaaS,2024,https://jonesltd.com,Through between skin feel event look recognize.,22,jones-ltd,2023,USD,270945,111579,159366,159287,79,23011,-22932,2709,5418,-28350,15755,309234,61835,247399,22578.75,270945,10.0,61.87,0.0552,368,61.35,18835.76,0.84,0.5882
1570,Thornton LLC,False,DE,Lake Tommy,AI/ML,2020,https://thorntonllc.com,Explain save campaign special teacher movie eye PM drop.,13,thornton-llc,2023,EUR,686193,118767,567426,257348,310078,0,310078,6861,13723,296355,20651,389435,124124,265311,,686193,1544.82,8236.63,0.0769,546,104.63,1000.0,20.65,0.8269
1571,Townsend Inc,False,TN,South Suzanne,EdTech,2010,https://townsendinc.com,Wide see offer position his standard bring three.,20,townsend-inc,2023,USD,883332,300732,582600,820373,-237773,0,-237773,8833,17666,-255439,13192,498294,108201,390093,73611.0,883332,798.43,1444.06,0.0532,3208,22.94,92594.27,0.14,0.6595
1572,Bennett-Stevens,False,EG,Fritzchester,Mobility,2022,https://bennett-stevens.com,Weight ability young second trip everyone specific TV care.,17,bennett-stevens,2023,USD,6868517,3211570,3656947,2966924,690023,28311,661712,68685,137370,524342,443664,3897627,849093,3048534,,6868517,92.98,507.7,0.001,2489,229.93,251858.38,1.76,0.5324
1573,Anderson Ltd,False,FR,West Christina,Mobility,2022,https://andersonltd.com,Always tonight decade just interest determine inside group science behind.,28,anderson-ltd,2023,EUR,728856,292855,436001,291854,144147,0,144147,7288,14577,129570,149880,605939,221535,384404,,728856,457.31,1597.74,0.025,1538,39.48,40058.37,3.74,0.5982
1574,Mendez-Murphy,False,CA,Joshuafurt,Fintech,2023,https://mendez-murphy.com,Ever agree clearly early teach artist.,20,mendez-murphy,2023,USD,2041589,588920,1452669,570301,882368,11140,871228,20415,40831,830397,70007,1251531,558321,693210,,2041589,180.73,1074.36,0.0205,817,208.04,26851.88,2.61,0.7115
1575,York-Velez,False,ZA,Keithberg,Marketplaces,2008,https://york-velez.com,Spend body himself majority campaign design nothing site.,20,york-velez,2023,USD,1568317,694966,873351,850456,22895,0,22895,15683,31366,-8471,286783,1213515,456500,757015,,1568317,616.16,3377.46,0.015,1756,74.39,79284.21,3.62,0.5569
1576,Moss-Day,False,FR,Michaelburgh,Energy,2021,https://moss-day.com,Magazine just surface enjoy begin part.,23,moss-day,2023,EUR,449449,213264,236185,318666,-82481,3172,-85653,4494,8988,-94641,29636,329586,154592,174994,,449449,797.25,2415.32,0.1198,460,81.36,32632.31,0.91,0.5255
1577,Robinson PLC,False,US,Aaronburgh,AI/ML,2008,https://robinsonplc.com,Gas rock without story site even eye raise.,23,robinson-plc,2023,USD,1883479,695915,1187564,183525,1004039,15805,988234,18834,37669,950565,263802,1242329,62116,1180213,,1883479,861.34,2725.63,0.001,2946,53.26,19596.88,13.46,0.6305
1578,Ross Taylor and Ferguson,False,FR,New Aaron,IoT,2017,https://rosstaylorandferguson.com,Sense what at understand every rule receive health lot.,22,ross-taylor-and-ferguson,2023,EUR,672490,224571,447919,33624,414295,18901,395394,6724,13449,381945,40047,549531,27476,522055,,672490,987.34,493.67,0.0778,2802,20.0,10549.93,3.8,0.6661
1579,Gallegos Hernandez and Davis,False,NG,Heathershire,AI/ML,2014,https://gallegoshernandezanddavis.com,Moment level station degree care read face on experience.,19,gallegos-hernandez-and-davis,2023,USD,1079224,444017,635207,335609,299598,0,299598,10792,21584,278014,72356,631952,37630,594322,,1079224,20.0,140.24,0.0712,4496,20.0,46596.81,1.55,0.5886
1580,Simpson-Graham,False,BR,New Jameshaven,Marketplaces,2022,https://simpson-graham.com,Maybe art rich movie whole beat deal base.,21,simpson-graham,2023,USD,1470376,390003,1080373,598642,481731,0,481731,14703,29407,452324,20669,763952,101874,662078,,1470376,406.95,587.5,0.001,552,221.9,46150.56,0.45,0.7348
1581,Mays LLC,False,CA,South Timothy,E-commerce,2009,https://maysllc.com,Color billion son magazine nature nature best past.,23,mays-llc,2023,USD,1857941,839319,1018622,588283,430339,20625,409714,18579,37158,372556,782562,1740070,949154,790916,,1857941,215.34,171.78,0.0596,4352,35.57,79119.4,9.89,0.5483
1582,Mccoy-Flores,False,DE,Davidmouth,Mobility,2018,https://mccoy-flores.com,Image nature study central into.,23,mccoy-flores,2023,EUR,1338252,410866,927386,540131,387255,34414,352841,13382,26765,326076,139202,880227,284381,595846,,1338252,319.52,832.94,0.0693,445,250.47,39610.68,3.51,0.693
1583,Douglas Sanchez and Stokes,False,NG,West Sheriburgh,IoT,2023,https://douglassanchezandstokes.com,Activity almost continue approach where it.,22,douglas-sanchez-and-stokes,2023,USD,4309756,1558601,2751155,2302371,448784,36577,412207,43097,86195,326012,185479,2487604,1208573,1279031,,4309756,1115.27,3289.79,0.0568,1829,196.33,171862.88,1.08,0.6384
1584,Davila-Vazquez,False,ZA,Reneetown,Marketplaces,2019,https://davila-vazquez.com,Trip catch explain believe eye check identify lose.,19,davila-vazquez,2023,USD,1195567,437251,758316,510545,247771,0,247771,11955,23911,223860,161135,792023,455918,336105,,1195567,1352.15,4846.47,0.0083,564,176.37,28945.12,5.57,0.6343
1585,Edwards LLC,False,ZA,Joannashire,Mobility,2011,https://edwardsllc.com,Affect work I throughout day science.,28,edwards-llc,2023,USD,707661,418798,288863,484963,-196100,0,-196100,7076,14153,-210253,31291,580270,83591,496679,,707661,1392.66,1989.83,0.0509,261,225.5,35852.14,0.87,0.4082
1586,Anderson and Sons,False,FR,Benjaminmouth,Marketplaces,2015,https://andersonandsons.com,Than onto contain compare head cause agree.,15,anderson-and-sons,2023,EUR,659960,185876,474084,480808,-6724,1278,-8002,6599,13199,-21201,23625,387057,261928,125129,,659960,20.0,23.77,0.0567,2749,20.0,70896.7,0.33,0.7184
1587,Stevenson Todd and Jefferson,False,US,Port Jaredside,E-commerce,2019,https://stevensontoddandjefferson.com,Decide office court politics hair military western.,19,stevenson-todd-and-jefferson,2023,USD,1126793,56339,1070454,731015,339439,27363,312076,11267,22535,289541,54117,805159,295329,509830,,1126793,20.0,18.82,0.0405,261,358.55,47094.78,1.15,0.95
1588,Hogan and Sons,False,BR,Lake Carla,AgriTech,2024,https://hoganandsons.com,Strategy in exist call fight may fear sound.,14,hogan-and-sons,2023,USD,801828,311360,490468,399691,90777,0,90777,8018,16036,74741,62628,590020,364817,225203,,801828,257.35,230.16,0.0116,1935,34.53,66178.35,0.95,0.6117
1589,Ramos Mcguire and Thompson,False,CA,Jordanview,Cybersecurity,2011,https://ramosmcguireandthompson.com,Seat role on ground join law.,11,ramos-mcguire-and-thompson,2023,USD,837939,293477,544462,528416,16046,8876,7170,8379,16758,-9588,51956,604856,100022,504834,,837939,916.86,5513.89,0.001,3491,20.0,29895.85,1.74,0.6498
1590,Wells Stein and Nicholson,False,US,Dorothyside,HealthTech,2023,https://wellssteinandnicholson.com,Guess perform store green strong begin read young word identify sport.,25,wells-stein-and-nicholson,2023,USD,906214,315075,591139,454092,137047,13616,123431,9062,18124,105307,22935,493300,128198,365102,75517.83,906214,547.13,2226.36,0.0595,920,82.03,70847.56,0.32,0.6523
1591,Boone Adams and Gallagher,False,GB,Hornestad,Cybersecurity,2021,https://booneadamsandgallagher.com,Their memory people indicate feel entire situation.,19,boone-adams-and-gallagher,2023,USD,1639431,712178,927253,729992,197261,29872,167389,16394,32788,134601,86680,995345,317946,677399,,1639431,20.0,39.1,0.0618,1876,72.82,48562.44,1.78,0.5656
1592,Robinson-Powell,False,FR,Erikmouth,AgriTech,2014,https://robinson-powell.com,Under hour rest project full night recognize.,27,robinson-powell,2023,EUR,195545,70706,124839,63233,61606,0,61606,1955,3910,57696,1787,289351,94526,194825,,195545,118.06,231.9,0.0673,814,20.0,20451.93,0.09,0.6384
1593,Howe Martinez and Schultz,False,DE,Julieberg,Fintech,2020,https://howemartinezandschultz.com,Dark treat sense hold type character billion.,28,howe-martinez-and-schultz,2023,EUR,1424865,701660,723205,1305228,-582023,0,-582023,14248,28497,-610520,221252,1015870,93541,922329,,1424865,1483.43,4625.85,0.1187,3065,38.74,112349.42,1.97,0.5076
1594,Miller-Davidson,False,DE,Tapiaside,Mobility,2014,https://miller-davidson.com,Food defense process improve foreign see east.,26,miller-davidson,2023,EUR,502461,252895,249566,252778,-3212,24236,-27448,5024,10049,-37497,8631,333992,170551,163441,,502461,381.75,1379.95,0.0742,1290,32.44,17062.45,0.51,0.4967
1595,Johnson Glover and Long,False,ZA,West Ariana,E-commerce,2011,https://johnsongloverandlong.com,Police pattern sell serve skin baby benefit team purpose matter.,20,johnson-glover-and-long,2023,USD,272036,82627,189409,210701,-21292,29394,-50686,2720,5440,-56126,2436,251786,73136,178650,,272036,1277.05,3683.49,0.1229,1133,20.0,42967.74,0.06,0.6963
1596,Long PLC,False,AU,Lake Steven,Energy,2009,https://longplc.com,Each market decade capital arrive.,17,long-plc,2023,USD,593207,180139,413068,319699,93369,21939,71430,5932,11864,59566,31786,393570,262377,131193,,593207,20.0,31.71,0.001,200,246.14,6446.8,4.93,0.6963
1597,Martin Greer and Smith,False,BR,West Amandachester,Marketplaces,2011,https://martingreerandsmith.com,Where tough affect to hit every debate capital business.,17,martin-greer-and-smith,2023,USD,608894,191079,417815,158642,259173,0,259173,6088,12177,246996,4579,360959,32968,327991,,608894,20.0,93.93,0.0968,166,305.17,34587.52,0.13,0.6862
1598,Sanders-Gonzalez,False,AU,Kristamouth,Mobility,2022,https://sanders-gonzalez.com,Contain politics stuff security yard plan home reflect.,17,sanders-gonzalez,2023,USD,1247424,372544,874880,924279,-49399,30588,-79987,12474,24948,-104935,140843,921052,443705,477347,,1247424,171.87,149.74,0.0408,5197,20.0,63157.73,2.23,0.7013
1599,Christensen-Harris,False,BR,New Daniel,IoT,2024,https://christensen-harris.com,Security one southern piece feel Democrat.,25,christensen-harris,2023,USD,920258,433306,486952,46012,440940,6159,434781,9202,18405,416376,120980,587478,382600,204878,,920258,20.0,47.96,0.0223,634,120.77,9523.23,12.7,0.5291
1600,Baker Mathis and Miller,False,GB,East Dawnfurt,Mobility,2008,https://bakermathisandmiller.com,Note because improve writer agent radio nearly.,26,baker-mathis-and-miller,2023,USD,304067,130493,173574,156964,16610,16512,98,3040,6081,-5983,22507,218576,189708,28868,,304067,395.63,197.82,0.0557,112,224.91,29358.05,0.77,0.5708
1601,Murphy PLC,False,NG,North Danielfurt,Cybersecurity,2009,https://murphyplc.com,College size number box simply.,16,murphy-plc,2023,USD,2304135,294193,2009942,1103312,906630,0,906630,23041,46082,860548,514875,1746572,654503,1092069,,2304135,1349.2,963.68,0.0787,1671,114.88,106271.67,4.84,0.8723
1602,Bradley LLC,False,NG,Port Karenborough,Energy,2023,https://bradleyllc.com,Discuss will democratic truth information lot son.,21,bradley-llc,2023,USD,2355098,751906,1603192,117754,1485438,0,1485438,23550,47101,1438337,376103,1639792,496349,1143443,,2355098,1187.49,593.74,0.0702,1653,118.69,1000.0,376.1,0.6807
1603,Hill Norton and Campbell,False,NG,Christopherton,HealthTech,2013,https://hillnortonandcampbell.com,Ten management describe available economy.,11,hill-norton-and-campbell,2023,USD,1183739,492478,691261,796383,-105122,11963,-117085,11837,23674,-140759,70270,843400,607926,235474,98644.92,1183739,10.0,42.92,0.0469,1396,70.62,54499.68,1.29,0.584
1604,Davis Morales and Hester,False,ZA,Port Angelport,HealthTech,2011,https://davismoralesandhester.com,Throw although morning store individual indicate.,24,davis-morales-and-hester,2023,USD,1030119,541582,488537,442712,45825,19908,25917,10301,20602,5315,143549,732830,242173,490657,85843.25,1030119,581.17,3671.65,0.0609,1831,46.86,28838.05,4.98,0.4743
1605,Powell PLC,False,TN,Lake Tammieton,Marketplaces,2018,https://powellplc.com,Factor business suffer customer maybe sea forget.,21,powell-plc,2023,USD,387013,211462,175551,233147,-57596,0,-57596,3870,7740,-65336,17398,387748,142301,245447,,387013,256.59,688.95,0.0336,335,96.24,1000.0,17.4,0.4536
1606,Green Moore and Brown,False,NG,Jameschester,Energy,2021,https://greenmooreandbrown.com,Receive not provide magazine voice.,16,green-moore-and-brown,2023,USD,3537707,1271762,2265945,605343,1660602,0,1660602,35377,70754,1589848,1202303,3000822,1159286,1841536,,3537707,20.0,18.97,0.0341,3950,74.62,64990.84,18.5,0.6405
1607,Garcia Mccall and Reyes,False,KE,West Kristinville,Cybersecurity,2015,https://garciamccallandreyes.com,So break theory site best.,20,garcia-mccall-and-reyes,2023,USD,3605646,1329289,2276357,263830,2012527,0,2012527,36056,72112,1940415,324833,2166888,661197,1505691,,3605646,90.06,45.03,0.001,15023,20.0,17389.85,18.68,0.6313
1608,Parker Abbott and Smith,False,IN,West Rebecca,Energy,2018,https://parkerabbottandsmith.com,Claim usually new pretty.,22,parker-abbott-and-smith,2023,USD,1989343,722689,1266654,1163841,102813,0,102813,19893,39786,63027,723269,1892480,843150,1049330,,1989343,294.72,1135.63,0.0408,8288,20.0,107763.52,6.71,0.6367
1609,Davis-Anderson,False,IN,Rosalesport,Mobility,2012,https://davis-anderson.com,Carry machine recent significant parent wide live member.,18,davis-anderson,2023,USD,2420329,1130530,1289799,2604054,-1314255,0,-1314255,24203,48406,-1362661,256405,1514638,75731,1438907,,2420329,330.08,165.04,0.0921,1592,126.65,215636.84,1.19,0.5329
1610,James-Dalton,False,GB,New Charles,Energy,2024,https://james-dalton.com,Small bag truth material pass book worry business officer experience.,24,james-dalton,2023,USD,984895,505997,478898,778532,-299634,0,-299634,9848,19697,-319331,238995,773189,214902,558287,,984895,505.55,252.78,0.001,362,226.26,102023.35,2.34,0.4862
1611,May Inc,False,IN,Justinton,Cybersecurity,2018,https://mayinc.com,Report bar friend former in.,26,may-inc,2023,USD,5753537,1696932,4056605,3095476,961129,0,961129,57535,115070,846059,156769,3072860,1429340,1643520,,5753537,20.0,77.09,0.1635,3917,122.39,278476.06,0.56,0.7051
1612,Hamilton Stanley and Price,False,ZA,Kelleystad,Cybersecurity,2014,https://hamiltonstanleyandprice.com,Cold follow serious market find avoid catch guy.,27,hamilton-stanley-and-price,2023,USD,3404439,1725885,1678554,1247513,431041,0,431041,34044,68088,362953,268219,2127736,702527,1425209,,3404439,1024.32,972.14,0.1417,1795,158.02,113949.43,2.35,0.493
1613,Le-Brown,False,DE,Silvaview,EdTech,2017,https://le-brown.com,Moment travel international page media word our wonder air black.,17,le-brown,2023,EUR,817748,335905,481843,700031,-218188,0,-218188,8177,16354,-234542,15228,489218,104473,384745,68145.67,817748,598.31,2158.95,0.0182,670,101.61,22026.28,0.69,0.5892
1614,Haynes Peterson and Hayes,False,BR,Clarkstad,E-commerce,2012,https://haynespetersonandhayes.com,Fast certainly wrong large right lay hope card president.,19,haynes-peterson-and-hayes,2023,USD,1683718,565705,1118013,940479,177534,39488,138046,16837,33674,104372,102801,1044143,391637,652506,,1683718,1610.65,1053.89,0.0151,1518,92.37,64630.52,1.59,0.664
1615,Richardson-Green,False,ZA,South Andrewton,Marketplaces,2013,https://richardson-green.com,Family your TV born development.,15,richardson-green,2023,USD,544797,191901,352896,251802,101094,30467,70627,5447,10895,59732,26442,404358,137194,267164,,544797,502.95,1342.41,0.0219,674,67.33,1000.0,26.44,0.6478
1616,Hicks-Sosa,False,NG,Callahanview,AI/ML,2018,https://hicks-sosa.com,Skin mention sing bill above.,23,hicks-sosa,2023,USD,1591919,486694,1105225,510799,594426,0,594426,15919,31838,562588,92494,1081713,61455,1020258,,1591919,1779.97,7683.6,0.1058,3804,34.87,19800.23,4.67,0.6943
1617,Hooper Jenkins and Weaver,False,ZA,Lake Josephville,Fintech,2019,https://hooperjenkinsandweaver.com,Career cell line collection may born go society claim.,18,hooper-jenkins-and-weaver,2023,USD,342745,154308,188437,40179,148258,35351,112907,3427,6854,106053,4898,189876,29542,160334,,342745,413.53,835.06,0.0442,146,194.51,1000.0,4.9,0.5498
1618,Thomas and Sons,False,NG,East Angela,Mobility,2021,https://thomasandsons.com,Actually everyone force choose cover yourself opportunity.,16,thomas-and-sons,2023,USD,2516492,1127755,1388737,1493641,-104904,0,-104904,25164,50329,-155233,295861,1708744,518952,1189792,,2516492,20.0,138.85,0.0769,1939,108.11,108383.84,2.73,0.5519
1619,Johnson-Nelson,False,BR,Lake Karenview,Cybersecurity,2017,https://johnson-nelson.com,Painting break health site relate very get ahead table.,20,johnson-nelson,2023,USD,1632748,932061,700687,765683,-64996,142,-65138,16327,32654,-97792,30744,943772,400231,543541,,1632748,795.31,4854.32,0.0018,664,204.65,88923.59,0.35,0.4291
1620,Lee-Coffey,False,TN,Penningtonburgh,SaaS,2024,https://lee-coffey.com,Option type account upon eye policy very grow majority wonder.,19,lee-coffey,2023,USD,1377196,712146,665050,68859,596191,0,596191,13771,27543,568648,90438,930910,116246,814664,114766.33,1377196,435.19,1248.29,0.0439,4045,28.37,1000.0,90.44,0.4829
1621,Malone Warren and Johnson,False,FR,Port Charlesport,SaaS,2020,https://malonewarrenandjohnson.com,Performance travel Republican forget feeling.,22,malone-warren-and-johnson,2023,EUR,146999,82936,64063,102823,-38760,8654,-47414,1469,2939,-50353,6402,208830,57723,151107,12249.92,146999,10.0,11.47,0.0293,117,104.1,1000.0,6.4,0.4358
1622,Cook Blake and Buchanan,False,GB,Lake Josefort,SaaS,2009,https://cookblakeandbuchanan.com,Improve law run pick nearly compare political purpose unit development.,16,cook-blake-and-buchanan,2023,USD,690737,61151,629586,77417,552169,29458,522711,6907,13814,508897,51762,445269,161313,283956,57561.42,690737,275.16,1104.71,0.0521,11512,5.0,1000.0,51.76,0.9115
1623,Walker-Cooper,False,DE,Lake Wandamouth,AgriTech,2013,https://walker-cooper.com,One break certainly develop produce rise responsibility economy truth dream.,21,walker-cooper,2023,EUR,338940,156799,182141,250779,-68638,26240,-94878,3389,6778,-101656,1623,304201,19927,284274,,338940,695.11,5682.22,0.0455,98,287.58,26769.57,0.06,0.5374
1624,Powell Johnston and Flores,False,IN,Angelastad,Marketplaces,2016,https://powelljohnstonandflores.com,Six or fill should name everything office say street.,22,powell-johnston-and-flores,2023,USD,401134,115017,286117,206223,79894,0,79894,4011,8022,71872,34745,394554,154096,240458,,401134,426.84,1854.16,0.0142,1671,20.0,34535.66,1.01,0.7133
1625,Oconnell Knight and Williams,False,GB,Michaelberg,SaaS,2017,https://oconnellknightandwilliams.com,Part myself address at any former least do series he.,15,oconnell-knight-and-williams,2023,USD,1628587,497971,1130616,845561,285055,0,285055,16285,32571,252484,140997,959379,594205,365174,135715.58,1628587,603.23,2985.49,0.067,1421,95.46,74016.64,1.9,0.6942
1626,Miller LLC,False,DE,South Robert,AI/ML,2009,https://millerllc.com,Industry nice federal together around group play.,22,miller-llc,2023,EUR,770509,201670,568839,538859,29980,830,29150,7705,15410,13740,27674,461433,139783,321650,,770509,20.0,62.47,0.0504,977,65.67,55673.81,0.5,0.7383
1627,Ramirez Mendoza and Ross,False,CA,Lake Chloe,Mobility,2011,https://ramirezmendozaandross.com,Fast feeling similar material travel follow theory across.,18,ramirez-mendoza-and-ross,2023,USD,217522,57442,160080,146426,13654,0,13654,2175,4350,9304,62211,368883,203542,165341,,217522,965.54,4153.0,0.0992,77,232.8,1000.0,62.21,0.7359
1628,Leonard-Allen,False,KE,West Grant,Marketplaces,2015,https://leonard-allen.com,Mention short event lawyer call book former.,15,leonard-allen,2023,USD,833994,338414,495580,632103,-136523,0,-136523,8339,16679,-153202,39490,578887,158797,420090,,833994,20.0,72.01,0.0419,1418,48.99,33526.14,1.18,0.5942
1629,Dunlap Group,False,ZA,West Amandamouth,Marketplaces,2020,https://dunlapgroup.com,Example what up his street none her class clearly.,33,dunlap-group,2023,USD,788205,304847,483358,655735,-172377,0,-172377,7882,15764,-188141,26745,516709,47413,469296,,788205,396.04,198.02,0.002,202,324.55,49120.91,0.54,0.6132
1630,Brown-Barajas,False,DE,East Diane,AI/ML,2017,https://brown-barajas.com,Some put fact consider develop bar policy TV cause hit animal.,17,brown-barajas,2023,EUR,440195,147778,292417,309307,-16890,0,-16890,4401,8803,-25693,34142,288076,110899,177177,,440195,20.0,117.48,0.143,1834,20.0,3512.18,9.72,0.6643
1631,Buck and Sons,False,ZA,Longland,Marketplaces,2009,https://buckandsons.com,Citizen magazine week outside stop ago beautiful less until.,20,buck-and-sons,2023,USD,838575,197864,640711,513719,126992,19519,107473,8385,16771,90702,98129,559862,280206,279656,,838575,20.0,52.94,0.0677,3494,20.0,15657.27,6.27,0.764
1632,Stein LLC,False,TN,New Gregory,Energy,2021,https://steinllc.com,Him decide teach strong how worry standard seem.,20,stein-llc,2023,USD,1338239,619190,719049,404109,314940,0,314940,13382,26764,288176,156374,974511,703641,270870,,1338239,447.49,1107.8,0.0549,907,122.82,39265.5,3.98,0.5373
1633,Martinez and Sons,False,AU,New Brandon,Marketplaces,2018,https://martinezandsons.com,Sister start account character individual provide any office poor deep.,28,martinez-and-sons,2023,USD,108422,36176,72246,62819,9427,10635,-1208,1084,2168,-3376,2797,184591,84182,100409,,108422,20.0,48.52,0.0478,54,166.07,4656.34,0.6,0.6663
1634,Perez Munoz and Miller,False,NG,North Briantown,SaaS,2008,https://perezmunozandmiller.com,Remember possible involve heavy contain future.,15,perez-munoz-and-miller,2023,USD,653388,365056,288332,125113,163219,5793,157426,6533,13067,144359,61032,495473,237811,257662,54449.0,653388,377.91,1755.09,0.056,10889,5.0,2346.52,26.01,0.4413
1635,Robbins Campbell and Vasquez,False,ZA,Michaelport,AgriTech,2014,https://robbinscampbellandvasquez.com,Road often perform together.,29,robbins-campbell-and-vasquez,2023,USD,193284,100262,93022,93266,-244,11887,-12131,1932,3865,-15996,4348,181291,9064,172227,,193284,603.63,3423.0,0.0409,64,250.27,21853.19,0.2,0.4813
1636,Smith LLC,False,KE,East Julia,Mobility,2015,https://smithllc.com,While prepare light trouble move.,16,smith-llc,2023,USD,204686,62434,142252,116252,26000,0,26000,2046,4093,21907,24278,147459,35310,112149,,204686,246.98,982.46,0.0357,97,175.0,4334.77,5.6,0.695
1637,Mitchell Group,False,BR,Scottport,Cybersecurity,2019,https://mitchellgroup.com,Know site brother fast series cultural pass.,15,mitchell-group,2023,USD,2397199,852347,1544852,306112,1238740,0,1238740,23971,47943,1190797,65857,1309197,562860,746337,,2397199,20.0,72.25,0.0591,3666,54.49,12168.16,5.41,0.6444
1638,Mora Ltd,False,AU,Dicksonchester,IoT,2014,https://moraltd.com,Represent future general probably possible service at ago offer.,27,mora-ltd,2023,USD,103272,47511,55761,45331,10430,0,10430,1032,2065,8365,20843,188437,60121,128316,,103272,702.59,569.13,0.0072,28,301.13,22838.66,0.91,0.5399
1639,Miller Graves and Morris,False,AU,South Eileenton,Cybersecurity,2014,https://millergravesandmorris.com,Car attorney box long natural until.,18,miller-graves-and-morris,2023,USD,1320858,464459,856399,1084166,-227767,0,-227767,13208,26417,-254184,106938,934254,274188,660066,,1320858,269.28,1688.1,0.0797,5503,20.0,110399.94,0.97,0.6484
1640,Hughes Group,False,IN,Harrisbury,Mobility,2013,https://hughesgroup.com,Character range but green choice than.,25,hughes-group,2023,USD,227719,52537,175182,169887,5295,7515,-2220,2277,4554,-6774,4025,139341,98721,40620,,227719,2399.27,9368.19,0.001,948,20.0,3212.15,1.25,0.7693
1641,Cardenas-Black,False,BR,Deborahstad,Fintech,2013,https://cardenas-black.com,Determine marriage bar suffer paper court always voice each.,20,cardenas-black,2023,USD,3091644,1093609,1998035,2011738,-13703,13569,-27272,30916,61832,-89104,518458,2209617,340396,1869221,,3091644,20.0,96.97,0.001,1462,176.11,180416.53,2.87,0.6463
1642,Mejia-Sanchez,False,GB,Port John,Cybersecurity,2024,https://mejia-sanchez.com,Debate employee general probably maybe.,25,mejia-sanchez,2023,USD,613769,226118,387651,92123,295528,0,295528,6137,12275,283253,14808,355060,100420,254640,,613769,396.86,1387.0,0.166,481,106.26,1000.0,14.81,0.6316
1643,James-Clark,False,FR,Fischerside,Energy,2009,https://james-clark.com,Billion probably cut raise include now think.,22,james-clark,2023,EUR,747638,390140,357498,200983,156515,13861,142654,7476,14952,127702,224320,696043,315090,380953,,747638,1872.45,7418.44,0.0888,3115,20.0,31108.37,7.21,0.4782
1644,Woodard-Calhoun,False,TN,North Clinton,AgriTech,2016,https://woodard-calhoun.com,Project air hold good red hotel contain.,19,woodard-calhoun,2023,USD,73464,23470,49994,36868,13126,0,13126,734,1469,11657,11366,86453,4322,82131,,73464,20.0,10.0,0.0395,30,198.65,53585.24,0.21,0.6805
1645,Glenn-Mcdowell,False,GB,Bryceberg,HealthTech,2016,https://glenn-mcdowell.com,Consumer evidence wall determine space eat wear half hot.,22,glenn-mcdowell,2023,USD,1496249,369167,1127082,791707,335375,0,335375,14962,29924,305451,131185,1023691,441266,582425,124687.42,1496249,443.33,822.13,0.0738,2416,51.6,62851.45,2.09,0.7533
1646,Austin-Madden,False,US,Allisonhaven,E-commerce,2022,https://austin-madden.com,Open civil everything soon explain happen build.,27,austin-madden,2023,USD,1055593,502984,552609,213211,339398,3614,335784,10555,21111,314673,62550,692114,177769,514345,,1055593,1100.23,2876.19,0.0294,512,171.7,1000.0,62.55,0.5235
1647,Russell-Taylor,False,ZA,South Bethshire,HealthTech,2009,https://russell-taylor.com,Force move free body stand approach instead call language.,24,russell-taylor,2023,USD,8048575,3190242,4858333,3519481,1338852,0,1338852,80485,160971,1177881,61476,4137842,1594690,2543152,670714.58,8048575,713.91,2385.56,0.0616,5501,121.91,287422.7,0.21,0.6036
1648,Dawson-White,False,GB,Lake Luis,E-commerce,2009,https://dawson-white.com,Pass once democratic range.,24,dawson-white,2023,USD,907981,254457,653524,586817,66707,4159,62548,9079,18159,44389,44622,558644,396391,162253,,907981,20.0,92.62,0.0296,3783,20.0,66131.32,0.67,0.7198
1649,Delacruz-Jones,False,AU,West Samuelstad,Marketplaces,2017,https://delacruz-jones.com,Control skin fall management.,28,delacruz-jones,2023,USD,316639,134120,182519,102831,79688,19404,60284,3166,6332,53952,168447,522803,98862,423941,,316639,1419.16,709.58,0.001,1005,26.23,18301.97,9.2,0.5764
1650,Riggs Norris and Bond,False,EG,West Reneefort,IoT,2019,https://riggsnorrisandbond.com,Less theory health tell fact pretty learn data power morning.,20,riggs-norris-and-bond,2023,USD,210913,47155,163758,87893,75865,0,75865,2109,4218,71647,4455,274724,66076,208648,,210913,20.0,22.07,0.0813,878,20.0,1000.0,4.46,0.7764
1651,Carter PLC,False,FR,Port John,Cybersecurity,2018,https://carterplc.com,Population thing really unit recognize especially ask two major.,18,carter-plc,2023,EUR,2760649,606326,2154323,909170,1245153,20561,1224592,27606,55212,1169380,301669,1783647,228018,1555629,,2760649,20.0,104.33,0.001,762,301.71,45412.68,6.64,0.7804
1652,Wallace Foster and Russell,False,NG,Lake Donald,EdTech,2013,https://wallacefosterandrussell.com,International above attack catch soldier charge start subject through result.,13,wallace-foster-and-russell,2023,USD,131801,45507,86294,100926,-14632,0,-14632,1318,2636,-17268,26899,192840,39962,152878,10983.42,131801,40.29,239.21,0.001,177,61.89,21948.16,1.23,0.6547
1653,Carter Hull and Martinez,False,NG,Kerriside,Fintech,2024,https://carterhullandmartinez.com,Daughter sell institution later office age.,23,carter-hull-and-martinez,2023,USD,293185,113681,179504,82916,96588,0,96588,2931,5863,90725,9691,278387,47048,231339,,293185,887.8,5301.49,0.0207,122,200.12,1000.0,9.69,0.6123
1654,Jackson Madden and Fernandez,False,GB,Jimenezland,Energy,2020,https://jacksonmaddenandfernandez.com,High system policy education true three.,24,jackson-madden-and-fernandez,2023,USD,356549,80315,276234,95871,180363,33819,146544,3565,7130,139414,35693,237216,153062,84154,,356549,341.03,1221.82,0.0766,165,179.63,10940.6,3.26,0.7747
1655,Anderson Hart and Wood,False,FR,Ramirezton,E-commerce,2015,https://andersonhartandwood.com,Term certainly perform shake behavior.,13,anderson-hart-and-wood,2023,EUR,995738,333864,661874,448980,212894,25919,186975,9957,19914,167061,38865,662774,204382,458392,,995738,573.03,919.24,0.1136,309,268.22,40830.67,0.95,0.6647
1656,Arias Brooks and Summers,False,DE,North Danielmouth,Marketplaces,2018,https://ariasbrooksandsummers.com,Hot little skin most real remain art.,17,arias-brooks-and-summers,2023,EUR,573807,313999,259808,204254,55554,0,55554,5738,11476,44078,11632,402186,94063,308123,,573807,20.0,10.0,0.0133,263,181.57,32487.19,0.36,0.4528
1657,Robinson PLC,False,CA,West Jonathanland,E-commerce,2017,https://robinsonplc.com,Example evening ask if throw.,17,robinson-plc,2023,USD,3149592,1262844,1886748,570938,1315810,0,1315810,31495,62991,1252819,38542,1735938,240771,1495167,,3149592,20.0,78.99,0.0213,3554,73.85,39583.61,0.97,0.599
1658,Jones-Lewis,False,DE,Jamesville,IoT,2024,https://jones-lewis.com,Middle describe financial floor media culture person.,19,jones-lewis,2023,EUR,336361,155912,180449,252939,-72490,0,-72490,3363,6727,-79217,8375,374689,133780,240909,,336361,1595.45,4574.98,0.024,223,125.63,45916.16,0.18,0.5365
1659,Garcia Group,False,EG,Patrickmouth,AI/ML,2008,https://garciagroup.com,Main spring nature already while.,11,garcia-group,2023,USD,2692470,1233152,1459318,134623,1324695,6615,1318080,26924,53849,1264231,106517,1641091,717648,923443,,2692470,103.34,575.74,0.1181,1362,164.7,7736.83,13.77,0.542
1660,Johnson Oneal and Tyler,False,FR,South Phyllishaven,Marketplaces,2019,https://johnsononealandtyler.com,Position daughter reduce job blood middle home wonder military institution.,20,johnson-oneal-and-tyler,2023,EUR,319811,30089,289722,137115,152607,0,152607,3198,6396,146211,27939,377466,197746,179720,,319811,1609.96,2339.99,0.0245,1332,20.0,1000.0,27.94,0.9059
1661,Carroll Group,False,EG,Gonzalesshire,EdTech,2015,https://carrollgroup.com,Dark current including live among fly agreement wide movie heart.,19,carroll-group,2023,USD,617100,221605,395495,263032,132463,0,132463,6171,12342,120121,188941,557289,31944,525345,51425.0,617100,435.14,1592.07,0.0418,5951,8.64,43043.46,4.39,0.6409
1662,Kelly-Ryan,False,US,Robertmouth,Marketplaces,2018,https://kelly-ryan.com,Nation east weight would official order.,21,kelly-ryan,2023,USD,148174,20284,127890,92336,35554,44788,-9234,1481,2963,-12197,2474,100080,36747,63333,,148174,20.0,10.0,0.0104,226,54.54,4082.67,0.61,0.8631
1663,Martin Moore and Ross,False,TN,North Taylor,Fintech,2020,https://martinmooreandross.com,Friend analysis race much environment interesting nature painting debate.,16,martin-moore-and-ross,2023,USD,1223351,283494,939857,832456,107401,26382,81019,12233,24467,56552,47301,743180,494382,248798,,1223351,763.01,636.16,0.0628,1658,61.47,67320.31,0.7,0.7683
1664,Smith PLC,False,IN,Jamesmouth,AI/ML,2017,https://smithplc.com,Look his or specific develop first.,27,smith-plc,2023,USD,978178,198588,779590,163908,615682,0,615682,9781,19563,596119,185044,677426,395783,281643,,978178,264.59,482.64,0.072,4075,20.0,29994.43,6.17,0.797
1665,Watson Rodgers and Brown,False,US,Davidhaven,AI/ML,2019,https://watsonrodgersandbrown.com,Want interview why above name stand walk account.,19,watson-rodgers-and-brown,2023,USD,463877,211465,252412,192981,59431,0,59431,4638,9277,50154,14856,277375,57662,219713,,463877,1551.36,6295.68,0.0435,396,97.41,1000.0,14.86,0.5441
1666,Bradshaw Martinez and Bowen,False,NG,Lake Stephenbury,AI/ML,2022,https://bradshawmartinezandbowen.com,Ten suddenly wear soldier light turn wear break these may.,17,bradshaw-martinez-and-bowen,2023,USD,617245,77492,539753,276017,263736,46354,217382,6172,12344,205038,37551,415188,168108,247080,,617245,160.3,387.75,0.0444,300,171.31,11629.11,3.23,0.8745
1667,Flores Ltd,False,EG,Delgadofurt,SaaS,2017,https://floresltd.com,Ability owner across traditional chair answer.,25,flores-ltd,2023,USD,474904,150086,324818,198552,126266,0,126266,4749,9498,116768,25414,423409,21170,402239,39575.33,474904,306.21,1384.91,0.0623,895,44.21,29277.97,0.87,0.684
1668,Moran LLC,False,BR,East Kenneth,EdTech,2018,https://moranllc.com,Major thousand who give probably support reality.,25,moran-llc,2023,USD,670978,209376,461602,253243,208359,0,208359,6709,13419,194940,96463,448317,165766,282551,55914.83,670978,242.45,653.07,0.001,1341,41.69,49984.5,1.93,0.688
1669,Duke-Davis,False,NG,Michaelshire,Fintech,2011,https://duke-davis.com,Piece board half particular glass human show image American participant.,26,duke-davis,2023,USD,987546,404680,582866,399987,182879,0,182879,9875,19750,163129,28930,604803,283967,320836,,987546,349.44,606.72,0.0922,4114,20.0,41521.96,0.7,0.5902
1670,Gray Bond and Lee,False,GB,Allenstad,AI/ML,2008,https://graybondandlee.com,Claim station example catch purpose radio.,18,gray-bond-and-lee,2023,USD,2593147,1030241,1562906,991197,571709,10980,560729,25931,51862,508867,461759,1817903,327056,1490847,,2593147,1234.94,3014.38,0.0542,1616,133.72,107854.4,4.28,0.6027
1671,Gonzalez-Ellis,False,BR,Lake Ian,Fintech,2014,https://gonzalez-ellis.com,Often set during perhaps actually.,27,gonzalez-ellis,2023,USD,399473,176721,222752,110947,111805,9861,101944,3994,7989,93955,34265,380889,43745,337144,,399473,76.38,293.75,0.125,157,211.17,10151.39,3.38,0.5576
1672,Cox LLC,False,BR,Powerschester,Marketplaces,2014,https://coxllc.com,Several free small only bar.,24,cox-llc,2023,USD,448719,144105,304614,242558,62056,0,62056,4487,8974,53082,72574,337835,115551,222284,,448719,1653.86,4019.86,0.0584,169,219.97,57629.31,1.26,0.6789
1673,Johnson-Park,False,BR,North Randyberg,Energy,2011,https://johnson-park.com,Across mean care give occur decade energy light from.,28,johnson-park,2023,USD,500171,220708,279463,279985,-522,26764,-27286,5001,10003,-37289,40990,306598,169931,136667,,500171,1251.42,2591.77,0.1285,800,52.05,25556.5,1.6,0.5587
1674,Boyer-Sellers,False,DE,East Lucas,AI/ML,2021,https://boyer-sellers.com,Matter debate man become cost exist idea now stand.,24,boyer-sellers,2023,EUR,2722206,1353073,1369133,2718071,-1348938,36207,-1385145,27222,54444,-1439589,327209,1766289,786694,979595,,2722206,431.24,1752.17,0.001,4886,46.42,235349.18,1.39,0.5029
1675,Sanchez-Kemp,False,BR,Mercerfurt,Fintech,2012,https://sanchez-kemp.com,Quickly drive choose theory before yet manager.,19,sanchez-kemp,2023,USD,843396,193192,650204,280584,369620,14341,355279,8433,16867,338412,98710,644820,392000,252820,,843396,1227.95,3685.25,0.067,3514,20.0,12451.58,7.93,0.7709
1676,Roth Group,False,US,Diazhaven,Mobility,2018,https://rothgroup.com,Financial much enough threat top write.,31,roth-group,2023,USD,1017699,75063,942636,673210,269426,41158,228268,10176,20353,207915,17541,699629,241710,457919,,1017699,20.0,65.96,0.001,784,108.15,84917.45,0.21,0.9262
1677,Santiago-Roberts,False,US,Port Austinberg,Fintech,2010,https://santiago-roberts.com,National professional beat project.,20,santiago-roberts,2023,USD,842508,311697,530811,42125,488686,37868,450818,8425,16850,433968,30628,623656,168414,455242,,842508,1003.57,501.78,0.059,1964,35.73,14625.49,2.09,0.63
1678,Tyler-Flores,False,US,New Katieview,HealthTech,2016,https://tyler-flores.com,Station many boy west data arm.,16,tyler-flores,2023,USD,1347839,692628,655211,207377,447834,12406,435428,13478,26956,408472,34111,711440,296237,415203,112319.92,1347839,215.82,827.76,0.0601,2115,53.09,29642.24,1.15,0.4861
1679,Horton Gonzalez and Young,False,NG,Kirkborough,Fintech,2015,https://hortongonzalezandyoung.com,Our several to speech become around reveal operation.,17,horton-gonzalez-and-young,2023,USD,273747,82766,190981,153007,37974,5647,32327,2737,5474,26853,8879,154293,60835,93458,,273747,135.4,757.49,0.001,217,104.75,1000.0,8.88,0.6977
1680,Hoover Chapman and Jones,False,IN,Meyertown,Energy,2020,https://hooverchapmanandjones.com,Table mother and money word discover recognize.,15,hoover-chapman-and-jones,2023,USD,1951188,674681,1276507,1007915,268592,29570,239022,19511,39023,199999,15297,1149140,92710,1056430,,1951188,20.0,86.87,0.001,3448,47.15,60630.24,0.25,0.6542
1681,Brown-Stephens,False,EG,New Felicia,Marketplaces,2020,https://brown-stephens.com,Science any energy determine kitchen interesting drug individual color trouble agent.,19,brown-stephens,2023,USD,826018,276327,549691,242164,307527,26903,280624,8260,16520,264104,23313,593744,109429,484315,,826018,459.61,852.45,0.0338,2393,28.76,34078.63,0.68,0.6655
1682,Taylor and Sons,False,TN,Meyerstad,E-commerce,2008,https://taylorandsons.com,Field learn recently eight leader about girl response available stock.,21,taylor-and-sons,2023,USD,573475,219011,354464,305183,49281,17516,31765,5734,11469,20296,45269,421242,30152,391090,,573475,20.0,136.71,0.0921,1049,45.53,5873.69,7.71,0.6181
1683,Johnson LLC,False,TN,Lake Kimberly,Marketplaces,2011,https://johnsonllc.com,Across party market dark language mean without.,15,johnson-llc,2023,USD,136305,36283,100022,56203,43819,12652,31167,1363,2726,28441,23865,156606,43602,113004,,136305,20.0,108.74,0.0198,567,20.0,12951.77,1.84,0.7338
1684,Grant Inc,False,NG,Donaldchester,SaaS,2010,https://grantinc.com,Do your safe green agreement rock if magazine look term.,19,grant-inc,2023,USD,1241914,487222,754692,663296,91396,0,91396,12419,24838,66558,162215,957417,237452,719965,103492.83,1241914,424.1,1516.32,0.0429,20698,5.0,25761.09,6.3,0.6077
1685,Simpson Sanders and Hurst,False,AU,South Sara,Cybersecurity,2009,https://simpsonsandersandhurst.com,Name town project agency rock however simply policy least.,18,simpson-sanders-and-hurst,2023,USD,2208728,804317,1404411,889320,515091,0,515091,22087,44174,470917,58345,1215557,740321,475236,,2208728,989.21,4106.94,0.0678,1160,158.64,98919.42,0.59,0.6358
1686,Jackson-Moore,False,ZA,Reynoldsmouth,Fintech,2019,https://jackson-moore.com,Store method now reach language however wear writer foot cost.,12,jackson-moore,2023,USD,516200,80154,436046,335544,100502,53254,47248,5162,10324,36924,75716,465464,23273,442191,,516200,1158.05,6522.58,0.001,2150,20.0,3858.51,19.62,0.8447
1687,Guzman Mcclain and Medina,False,NG,South Kellyshire,Fintech,2017,https://guzmanmcclainandmedina.com,Space not blood food performance lose charge.,18,guzman-mcclain-and-medina,2023,USD,982365,296978,685387,568253,117134,0,117134,9823,19647,97487,29186,546985,340924,206061,,982365,1146.32,1154.81,0.0632,607,134.73,61275.26,0.48,0.6977
1688,Villegas-Huff,False,AU,Phillipsside,Marketplaces,2017,https://villegas-huff.com,Treatment hard score agency ahead authority.,20,villegas-huff,2023,USD,2811287,1368075,1443212,140564,1302648,36045,1266603,28112,56225,1210378,68018,1576966,370230,1206736,,2811287,82.03,66.62,0.0585,1039,225.27,5022.57,13.54,0.5134
1689,Pugh Carter and Mejia,False,KE,Port Paulfort,Fintech,2017,https://pughcarterandmejia.com,Old occur well cause whatever television test go behavior mouth.,14,pugh-carter-and-mejia,2023,USD,1323688,626214,697474,765821,-68347,0,-68347,13236,26473,-94820,312168,1064288,532446,531842,,1323688,1269.77,4198.57,0.001,5515,20.0,69900.07,4.47,0.5269
1690,Wong LLC,False,AU,Williamsstad,Mobility,2020,https://wongllc.com,Above owner energy organization police.,25,wong-llc,2023,USD,1089223,65399,1023824,361837,661987,3219,658768,10892,21784,636984,40532,781181,156779,624402,,1089223,20.0,22.16,0.0579,4538,20.0,17943.92,2.26,0.94
1691,Gould Hoffman and Small,False,TN,Danielleton,Marketplaces,2008,https://gouldhoffmanandsmall.com,Do admit center cultural but room change plant as medical structure.,19,gould-hoffman-and-small,2023,USD,2469231,929345,1539886,1609181,-69295,19920,-89215,24692,49384,-138599,13432,1359488,472679,886809,,2469231,20.0,78.22,0.0277,708,290.37,147448.33,0.09,0.6236
1692,Snyder and Sons,False,EG,South Dorothystad,HealthTech,2015,https://snyderandsons.com,Yet class surface impact decision budget.,20,snyder-and-sons,2023,USD,302179,119625,182554,83233,99321,0,99321,3021,6043,93278,53180,286438,67352,219086,25181.58,302179,696.65,5570.57,0.0118,165,152.04,1113.95,47.74,0.6041
1693,Smith Jackson and Williams,False,GB,Fowlertown,Cybersecurity,2020,https://smithjacksonandwilliams.com,Speech size toward prepare interest employee.,27,smith-jackson-and-williams,2023,USD,808580,465260,343320,463151,-119831,34818,-154649,8085,16171,-170820,18533,544423,144938,399485,,808580,1433.23,10236.24,0.1036,397,169.59,42652.24,0.43,0.4246
1694,Hayes Allen and Landry,False,AU,Virginiamouth,AI/ML,2017,https://hayesallenandlandry.com,This real southern several figure watch which happen impact.,22,hayes-allen-and-landry,2023,USD,1491080,450440,1040640,900160,140480,31072,109408,14910,29821,79587,456666,1300244,494271,805973,,1491080,1052.25,3591.67,0.0122,6212,20.0,73880.1,6.18,0.6979
1695,Scott-Le,False,BR,Mccormickstad,HealthTech,2017,https://scott-le.com,Education head effort right exactly pretty to.,16,scott-le,2023,USD,1409212,586498,822714,805720,16994,6850,10144,14092,28184,-18040,196541,978769,584872,393897,117434.33,1409212,503.02,2169.92,0.0456,3167,37.08,82343.79,2.39,0.5838
1696,Bates Barnes and Pennington,False,BR,Lake Julie,Cybersecurity,2019,https://batesbarnesandpennington.com,Media skill no task product unit pressure.,22,bates-barnes-and-pennington,2023,USD,191165,51435,139730,147598,-7868,24741,-32609,1911,3823,-36432,8270,202415,25059,177356,,191165,1112.87,5337.16,0.0821,796,20.0,4587.75,1.8,0.7309
1697,Soto-Bond,False,US,Lewisfurt,AI/ML,2012,https://soto-bond.com,Military drive ahead production leave half likely.,23,soto-bond,2023,USD,3942009,1131400,2810609,1617307,1193302,0,1193302,39420,78840,1114462,336181,2428309,1858038,570271,,3942009,571.23,2700.75,0.001,16425,20.0,147664.61,2.28,0.713
1698,Santana Roberts and Moore,False,FR,Wiseside,SaaS,2008,https://santanarobertsandmoore.com,Prevent power feeling the rock you.,13,santana-roberts-and-moore,2023,EUR,2873265,600174,2273091,799109,1473982,0,1473982,28732,57465,1416517,160929,1630162,926770,703392,239438.75,2873265,10.0,29.12,0.001,47887,5.0,50138.56,3.21,0.7911
1699,Rogers Nichols and Kelly,False,KE,Luiston,IoT,2020,https://rogersnicholsandkelly.com,Yes all company especially less run account leader.,19,rogers-nichols-and-kelly,2023,USD,4076742,1943243,2133499,203837,1929662,0,1929662,40767,81534,1848128,138535,2337891,375628,1962263,,4076742,959.11,3773.84,0.0807,3033,112.0,16165.01,8.57,0.5233
1700,Jackson-Odom,False,NG,New Brandon,AI/ML,2010,https://jackson-odom.com,Land trip majority center will fire play two project.,18,jackson-odom,2023,USD,6106714,3352807,2753907,2152752,601155,2795,598360,61067,122134,476226,457417,3547096,936948,2610148,,6106714,49.82,77.93,0.0292,2434,209.0,139197.41,3.29,0.451
1701,Smith Hart and Johnson,False,IN,Taylorside,EdTech,2019,https://smithhartandjohnson.com,Body although car recent above yeah age continue.,19,smith-hart-and-johnson,2023,USD,313052,99475,213577,141975,71602,18068,53534,3130,6261,47273,14858,205871,15990,189881,26087.67,313052,444.47,2195.94,0.0865,357,72.91,31818.76,0.47,0.6822
1702,Davis Clark and Perez,False,DE,East Reginaview,Energy,2024,https://davisclarkandperez.com,Station seek per strategy former bad return.,26,davis-clark-and-perez,2023,EUR,997343,307003,690340,430035,260305,0,260305,9973,19946,240359,72160,736788,190465,546323,,997343,20.0,45.47,0.0916,4155,20.0,45506.97,1.59,0.6922
1703,Rodriguez and Sons,False,GB,Barbaraview,HealthTech,2013,https://rodriguezandsons.com,Husband continue leave enough necessary subject.,29,rodriguez-and-sons,2023,USD,726984,272464,454520,205929,248591,0,248591,7269,14539,234052,42288,464582,176874,287708,60582.0,726984,38.49,232.96,0.0084,12116,5.0,1000.0,42.29,0.6252
1704,Escobar-Drake,False,DE,Danielton,IoT,2016,https://escobar-drake.com,Guy development court resource glass fall west employee series with.,18,escobar-drake,2023,EUR,129169,57212,71957,112329,-40372,0,-40372,1291,2583,-42955,6698,95869,4793,91076,,129169,920.95,2653.81,0.0648,111,96.42,21117.1,0.32,0.5571
1705,Colon Garrett and Richards,False,DE,Claytonfort,Fintech,2013,https://colongarrettandrichards.com,General group sense detail law all share.,21,colon-garrett-and-richards,2023,EUR,620109,199319,420790,176561,244229,26477,217752,6201,12402,205350,9599,474306,297043,177263,,620109,128.06,259.55,0.0855,2583,20.0,37328.4,0.26,0.6786
1706,Wells PLC,False,BR,South Stanleybury,IoT,2009,https://wellsplc.com,Economic believe successful suffer property store hear institution return.,14,wells-plc,2023,USD,377237,124888,252349,73086,179263,5487,173776,3772,7544,166232,10081,390769,145052,245717,,377237,20.0,84.51,0.0234,91,344.55,21805.55,0.46,0.6689
1707,Jackson Coleman and Andrade,False,AU,Port Roger,AI/ML,2022,https://jacksoncolemanandandrade.com,Election budget wish pretty hot add perform arrive number base.,18,jackson-coleman-and-andrade,2023,USD,543139,122082,421057,27156,393901,13148,380753,5431,10862,369891,14364,346863,102558,244305,,543139,20.0,56.32,0.0392,516,87.65,1000.0,14.36,0.7752
1708,Allen-Tyler,False,BR,New Carla,AI/ML,2010,https://allen-tyler.com,Job management arrive friend Republican.,17,allen-tyler,2023,USD,1288315,225095,1063220,539282,523938,1413,522525,12883,25766,496759,28211,797395,214281,583114,,1288315,20.0,60.02,0.0078,409,262.21,16897.88,1.67,0.8253
1709,Gilbert Lawrence and Thomas,False,IN,Lake Jane,Marketplaces,2010,https://gilbertlawrenceandthomas.com,Key quality beyond community set exactly director simple turn.,22,gilbert-lawrence-and-thomas,2023,USD,2782489,1232683,1549806,954009,595797,0,595797,27824,55649,540148,771755,2209890,783323,1426567,,2782489,1602.26,801.13,0.0988,1368,169.39,82123.8,9.4,0.557
1710,Bernard Parker and Cooper,False,IN,Lake Kellyberg,Fintech,2014,https://bernardparkerandcooper.com,Certainly part drug fear animal.,18,bernard-parker-and-cooper,2023,USD,799891,348835,451056,161524,289532,0,289532,7998,15997,273535,102754,524743,180920,343823,,799891,219.32,643.6,0.001,239,278.29,17174.08,5.98,0.5639
1711,Thomas Thompson and Bowen,False,ZA,East Jonathanfort,IoT,2023,https://thomasthompsonandbowen.com,Short kid level paper ask responsibility fall agency.,24,thomas-thompson-and-bowen,2023,USD,1675932,860007,815925,149349,666576,19454,647122,16759,33518,613604,160033,1015516,271128,744388,,1675932,93.11,525.82,0.0245,6983,20.0,22307.27,7.17,0.4868
1712,Fuller-Lee,False,CA,New Melissaborough,E-commerce,2012,https://fuller-lee.com,Eat third head trip be although president.,16,fuller-lee,2023,USD,580750,175231,405519,199772,205747,0,205747,5807,11615,194132,40589,443550,22177,421373,,580750,20.0,72.55,0.0992,562,86.01,24180.07,1.68,0.6983
1713,Beck PLC,False,BR,Webbville,Marketplaces,2015,https://beckplc.com,Administration chair once we very painting hope site.,16,beck-plc,2023,USD,1498956,874772,624184,1202263,-578079,0,-578079,14989,29979,-608058,69326,902322,264789,637533,,1498956,20.0,10.0,0.0644,6245,20.0,114987.88,0.6,0.4164
1714,Lamb-Browning,False,FR,Port Evan,AgriTech,2010,https://lamb-browning.com,Success center pass season room.,29,lamb-browning,2023,EUR,83159,25120,58039,70717,-12678,0,-12678,831,1663,-14341,6855,164839,26609,138230,,83159,20.0,13.49,0.0723,26,265.23,19116.7,0.36,0.6979
1715,Perez-Montgomery,False,DE,North Brittney,E-commerce,2023,https://perez-montgomery.com,However tonight skin kind quickly itself machine.,18,perez-montgomery,2023,EUR,1131699,307790,823909,983107,-159198,27884,-187082,11316,22633,-209715,167117,834367,424545,409822,,1131699,411.9,1687.01,0.001,271,347.38,95679.15,1.75,0.728
1716,Howard PLC,False,EG,Freemanmouth,E-commerce,2017,https://howardplc.com,Get organization peace rock health cultural effect.,20,howard-plc,2023,USD,920673,93133,827540,244349,583191,11131,572060,9206,18413,553647,34145,605331,164288,441043,,920673,511.65,888.73,0.0491,745,102.86,41385.64,0.83,0.8988
1717,Williams-Lamb,False,ZA,North David,IoT,2012,https://williams-lamb.com,Score minute night never alone defense vote point.,15,williams-lamb,2023,USD,785406,330801,454605,418861,35744,37942,-2198,7854,15708,-17906,13709,411298,349654,61644,,785406,452.69,654.85,0.001,345,189.54,54802.95,0.25,0.5788
1718,Jackson LLC,False,KE,Chavezfurt,IoT,2019,https://jacksonllc.com,Down single evening painting responsibility.,13,jackson-llc,2023,USD,350296,91154,259142,146517,112625,12763,99862,3502,7005,92857,1316,353474,119617,233857,,350296,22.85,18.51,0.001,141,206.01,6584.52,0.2,0.7398
1719,Nelson Ltd,False,AU,Sheltonport,E-commerce,2021,https://nelsonltd.com,Attention represent certainly small must benefit away during near car common.,17,nelson-ltd,2023,USD,5095000,2436088,2658912,2947205,-288293,21315,-309608,50950,101900,-411508,133299,2826250,154959,2671291,,5095000,20.0,52.82,0.0638,1724,246.14,285779.35,0.47,0.5219
1720,Savage LLC,False,GB,East Johnfurt,SaaS,2018,https://savagellc.com,Beyond financial chance better movement.,26,savage-llc,2023,USD,7070950,1396622,5674328,2647660,3026668,8989,3017679,70709,141419,2876260,616755,4218684,210934,4007750,589245.83,7070950,10.0,10.0,0.0847,7222,81.58,203476.59,3.03,0.8025
1721,Jackson Flynn and Thompson,False,DE,Lake Jessica,EdTech,2021,https://jacksonflynnandthompson.com,Mission rich PM develop subject down north property.,24,jackson-flynn-and-thompson,2023,EUR,2122717,352455,1770262,447804,1322458,0,1322458,21227,42454,1280004,270297,1471734,997580,474154,176893.08,2122717,479.06,1381.52,0.001,2362,74.89,17259.74,15.66,0.834
1722,Wong Ltd,False,IN,Mooneyfurt,E-commerce,2012,https://wongltd.com,Actually see or fill magazine lot animal age can either.,15,wong-ltd,2023,USD,3119064,742326,2376738,2311624,65114,6736,58378,31190,62381,-4003,29218,1695761,964465,731296,,3119064,2272.8,1136.4,0.1106,12996,20.0,199407.76,0.15,0.762
1723,Garcia Williams and Wells,False,BR,South Dannybury,Cybersecurity,2018,https://garciawilliamsandwells.com,Night the agree pressure mouth parent bit.,22,garcia-williams-and-wells,2023,USD,1071583,257815,813768,485087,328681,0,328681,10715,21431,307250,33075,662022,104012,558010,,1071583,1023.72,2341.84,0.001,4464,20.0,21348.64,1.55,0.7594
1724,Ellis PLC,False,EG,Christopherville,Mobility,2022,https://ellisplc.com,Send performance sometimes fight employee guy painting center house full.,20,ellis-plc,2023,USD,320329,97248,223081,170901,52180,38519,13661,3203,6406,7255,14070,326092,46152,279940,,320329,20.0,11.23,0.0678,368,72.43,51544.07,0.27,0.6964
1725,Greene Group,False,CA,Jimenezbury,AgriTech,2023,https://greenegroup.com,Land range break sense may indeed center international once.,26,greene-group,2023,USD,318068,110007,208061,256757,-48696,0,-48696,3180,6361,-55057,623,352926,61597,291329,,318068,725.54,937.26,0.0843,126,209.24,29156.94,0.02,0.6541
1726,Rodriguez-Harmon,False,NG,Mcleanmouth,Fintech,2013,https://rodriguez-harmon.com,Despite agent guy debate better name system local expert yeah.,25,rodriguez-harmon,2023,USD,1171399,222880,948519,227053,721466,0,721466,11713,23427,698039,407577,1096456,213043,883413,,1171399,359.16,2441.7,0.0074,425,229.51,1000.0,407.58,0.8097
1727,Blair and Sons,False,BR,Elizabethland,IoT,2010,https://blairandsons.com,Father hospital high management daughter despite father.,27,blair-and-sons,2023,USD,260473,49590,210883,132120,78763,0,78763,2604,5209,73554,17698,227076,64007,163069,,260473,604.28,1767.4,0.0698,1085,20.0,21744.27,0.81,0.8096
1728,Rodriguez Trujillo and Butler,False,IN,Lake Kennethville,HealthTech,2014,https://rodrigueztrujilloandbutler.com,Control memory both however mother instead thought indeed.,13,rodriguez-trujillo-and-butler,2023,USD,1427802,645492,782310,393757,388553,0,388553,14278,28556,359997,30159,760846,252925,507921,118983.5,1427802,289.95,1167.3,0.0499,1524,78.07,32914.08,0.92,0.5479
1729,Johnson-Wright,False,IN,Nicholasshire,Cybersecurity,2010,https://johnson-wright.com,Or total until describe necessary single discuss agreement.,25,johnson-wright,2023,USD,357644,64217,293427,158709,134718,6716,128002,3576,7152,120850,22574,353703,100620,253083,,357644,20.0,75.74,0.0452,1490,20.0,31969.88,0.71,0.8204
1730,Robinson Vega and Knapp,False,ZA,South Jessica,Fintech,2008,https://robinsonvegaandknapp.com,She office Congress weight single.,14,robinson-vega-and-knapp,2023,USD,818649,229425,589224,455077,134147,0,134147,8186,16372,117775,21195,545236,275642,269594,,818649,1837.54,4595.17,0.108,348,195.81,34674.41,0.61,0.7198
1731,Travis Wheeler and Stanley,False,NG,South Savannah,Marketplaces,2008,https://traviswheelerandstanley.com,Form development ask traditional anyone sea rate often.,18,travis-wheeler-and-stanley,2023,USD,3918977,2438051,1480926,597839,883087,30540,852547,39189,78379,774168,77296,2109185,1228404,880781,,3918977,981.93,490.96,0.0996,16329,20.0,86008.76,0.9,0.3779
1732,Daniels and Sons,False,KE,New Eric,IoT,2020,https://danielsandsons.com,Buy court beautiful box recent significant watch present summer.,18,daniels-and-sons,2023,USD,2841047,775326,2065721,1902927,162794,29075,133719,28410,56820,76899,276081,1836139,993849,842290,,2841047,20.0,91.5,0.0045,1638,144.5,182217.56,1.52,0.7271
1733,Cook-West,False,AU,Marissafort,IoT,2014,https://cook-west.com,Ok large outside firm upon care make.,11,cook-west,2023,USD,2360149,662885,1697264,2589277,-892013,0,-892013,23601,47202,-939215,97682,1311640,403029,908611,,2360149,20.0,77.2,0.0716,1399,140.53,196034.7,0.5,0.7191
1734,Ramirez Group,False,US,Vanessastad,AI/ML,2016,https://ramirezgroup.com,Scene need movement bill wait whose item manage place range.,28,ramirez-group,2023,USD,399957,175103,224854,127023,97831,0,97831,3999,7999,89832,5661,331009,188402,142607,,399957,20.0,42.79,0.104,1666,20.0,46037.31,0.12,0.5622
1735,Edwards Hensley and Davis,False,NG,Gonzalezville,AI/ML,2023,https://edwardshensleyanddavis.com,Others wonder hand good stand seat.,22,edwards-hensley-and-davis,2023,USD,2342320,439647,1902673,1577450,325223,0,325223,23423,46846,278377,55925,1355531,581705,773826,,2342320,20.0,10.0,0.0512,9759,20.0,129151.71,0.43,0.8123
1736,Garcia-Carlson,False,BR,Robinsonside,HealthTech,2019,https://garcia-carlson.com,Audience off through moment ready operation oil one hot.,24,garcia-carlson,2023,USD,856546,307938,548608,72788,475820,10599,465221,8565,17130,448091,41933,652571,317275,335296,71378.83,856546,10.0,21.38,0.0562,1866,38.25,5827.78,7.2,0.6405
1737,Wolfe Inc,False,TN,Lake Madeline,EdTech,2017,https://wolfeinc.com,Baby yard girl somebody receive boy develop worker create.,23,wolfe-inc,2023,USD,888881,445128,443753,241804,201949,17038,184911,8888,17777,167134,27851,505070,66234,438836,74073.42,888881,10.0,51.43,0.0485,1293,57.26,23273.0,1.2,0.4992
1738,Lang and Sons,False,GB,South Christinahaven,Mobility,2024,https://langandsons.com,Environment already summer financial own argue live clear.,18,lang-and-sons,2023,USD,1014265,403033,611232,246460,364772,0,364772,10142,20285,344487,67018,595897,283937,311960,,1014265,1501.01,5162.11,0.0222,4226,20.0,5512.46,12.16,0.6026
1739,Brady-Watson,False,NG,Wesleymouth,Fintech,2020,https://brady-watson.com,Tough star doctor our only serve buy loss everything.,19,brady-watson,2023,USD,459249,115746,343503,22962,320541,0,320541,4592,9184,311357,89858,504488,297775,206713,,459249,955.64,5151.68,0.1058,417,91.68,12216.57,7.36,0.748
1740,Robinson Chen and Thomas,False,CA,Kimberlymouth,AI/ML,2008,https://robinsonchenandthomas.com,Just evening street red contain.,21,robinson-chen-and-thomas,2023,USD,1881466,493776,1387690,1120907,266783,4254,262529,18814,37629,224900,8989,1114205,366197,748008,,1881466,553.16,3421.6,0.077,1164,134.66,67210.43,0.13,0.7376
1741,Gilmore Jones and Stevenson,False,BR,Marilynchester,EdTech,2013,https://gilmorejonesandstevenson.com,Toward blood reflect consider could specific.,33,gilmore-jones-and-stevenson,2023,USD,220917,77604,143313,156058,-12745,0,-12745,2209,4418,-17163,18100,245334,121750,123584,18409.75,220917,10.0,10.0,0.0453,262,70.03,11554.88,1.57,0.6487
1742,Horton Group,False,AU,New Carmen,AI/ML,2012,https://hortongroup.com,Election station rich never five behind hope simply.,21,horton-group,2023,USD,1036424,433539,602885,470836,132049,21199,110850,10364,20728,90122,6144,598964,314214,284750,,1036424,20.0,43.4,0.0707,1821,47.42,51180.34,0.12,0.5817
1743,Allen Jacobson and Owen,False,EG,Boydmouth,HealthTech,2013,https://allenjacobsonandowen.com,Animal onto receive figure think often let picture trip allow world.,18,allen-jacobson-and-owen,2023,USD,538814,112441,426373,62125,364248,0,364248,5388,10776,353472,38871,446094,224955,221139,44901.17,538814,10.0,45.12,0.0112,1682,26.69,15497.88,2.51,0.7913
1744,Jacobs Thompson and Rodriguez,False,KE,Fieldsborough,IoT,2012,https://jacobsthompsonandrodriguez.com,Practice set behavior hundred ask theory democratic perform.,19,jacobs-thompson-and-rodriguez,2023,USD,1497006,246326,1250680,74850,1175830,15890,1159940,14970,29940,1130000,92451,969165,191719,777446,,1497006,1009.44,2193.87,0.0871,6237,20.0,28154.0,3.28,0.8355
1745,Villa Group,False,ZA,South Heatherville,Cybersecurity,2023,https://villagroup.com,Prevent religious window relationship Congress car commercial color surface.,19,villa-group,2023,USD,836687,276142,560545,365125,195420,0,195420,8366,16733,178687,19484,464714,36039,428675,,836687,20.0,92.13,0.042,460,151.41,5294.1,3.68,0.67
1746,Davis-Jensen,False,CA,Port Lisa,SaaS,2015,https://davis-jensen.com,Purpose early safe its final add through between.,14,davis-jensen,2023,USD,145295,46675,98620,63593,35027,0,35027,1452,2905,32122,4819,106365,37751,68614,12107.92,145295,62.16,213.4,0.0084,263,45.91,13333.93,0.36,0.6788
1747,Roberts-Jackson,False,AU,Erictown,Mobility,2015,https://roberts-jackson.com,Really each student happy recently film.,19,roberts-jackson,2023,USD,1425563,506636,918927,879796,39131,18935,20196,14255,28511,-8315,87531,995798,340598,655200,,1425563,402.57,1179.15,0.1006,5939,20.0,97977.34,0.89,0.6446
1748,Bell-Kline,False,FR,North Elizabethhaven,AgriTech,2019,https://bell-kline.com,Price woman indicate ever partner office billion manager court.,23,bell-kline,2023,EUR,63285,15985,47300,27757,19543,0,19543,632,1265,18278,9509,48882,28844,20038,,63285,987.47,1895.76,0.001,29,177.57,1000.0,9.51,0.7474
1749,Harvey Brown and Lee,False,DE,West Larryberg,SaaS,2014,https://harveybrownandlee.com,Stuff wrong range perhaps meet station history.,18,harvey-brown-and-lee,2023,EUR,507337,120297,387040,295813,91227,0,91227,5073,10146,81081,159018,566258,310213,256045,42278.08,507337,10.0,43.03,0.0811,8455,5.0,13014.68,12.22,0.7629
1750,Contreras Inc,False,NG,Lake Jamesfurt,E-commerce,2020,https://contrerasinc.com,Pattern Congress official wrong along whatever drop him.,16,contreras-inc,2023,USD,756900,266953,489947,320710,169237,0,169237,7569,15138,154099,62585,521671,122855,398816,,756900,20.0,10.0,0.0827,182,346.45,49054.33,1.28,0.6473
1751,Reynolds-Beck,False,EG,Greeneburgh,Mobility,2009,https://reynolds-beck.com,Get discuss himself notice behavior assume state site court quality.,16,reynolds-beck,2023,USD,884868,255686,629182,693986,-64804,0,-64804,8848,17697,-82501,55710,693277,325562,367715,,884868,20.0,95.58,0.1053,316,232.64,69168.51,0.81,0.711
1752,Mcguire Logan and Torres,False,US,Desireeberg,Marketplaces,2018,https://mcguireloganandtorres.com,Able interesting concern seat establish course south.,11,mcguire-logan-and-torres,2023,USD,227413,80335,147078,90851,56227,0,56227,2274,4548,51679,13115,206626,61182,145444,,227413,48.71,279.29,0.0603,75,251.5,1000.0,13.12,0.6467
1753,Holmes Munoz and Farley,False,FR,Jasonstad,Cybersecurity,2024,https://holmesmunozandfarley.com,Voice scene high total effort.,19,holmes-munoz-and-farley,2023,EUR,2364281,691597,1672684,1570308,102376,13750,88626,23642,47285,41341,84258,1304600,65230,1239370,,2364281,780.09,4840.34,0.1171,9851,20.0,129383.79,0.65,0.7075
1754,Romero LLC,False,BR,Gregorybury,AgriTech,2016,https://romerollc.com,Computer want war never gas last daughter start against technology.,17,romero-llc,2023,USD,135492,38386,97106,76232,20874,0,20874,1354,2709,18165,5485,94458,53551,40907,,135492,960.36,3610.03,0.1331,564,20.0,26474.62,0.21,0.7167
1755,Dickson PLC,False,KE,Chelseafort,AI/ML,2013,https://dicksonplc.com,Tend eat interview toward them instead force follow benefit technology if.,15,dickson-plc,2023,USD,533720,172268,361452,439254,-77802,21015,-98817,5337,10674,-109491,12050,343183,147761,195422,,533720,42.22,21.11,0.0989,187,236.7,34899.64,0.35,0.6772
1756,Green Inc,False,TN,North Benjamin,Marketplaces,2020,https://greeninc.com,Sometimes future carry meet lay various worry science particular I.,19,green-inc,2023,USD,1203131,400395,802736,1013527,-210791,18374,-229165,12031,24062,-253227,29879,797988,390997,406991,,1203131,899.15,782.44,0.0303,5013,20.0,101654.15,0.29,0.6672
1757,Black-Hamilton,False,CA,Chapmanshire,IoT,2010,https://black-hamilton.com,Lead impact blood record talk against tell.,15,black-hamilton,2023,USD,799830,356546,443284,359711,83573,36631,46942,7998,15996,30946,28589,579521,345701,233820,,799830,1568.42,3988.59,0.0851,432,153.94,30917.17,0.92,0.5542
1758,Silva-Miller,False,NG,Christineland,AgriTech,2020,https://silva-miller.com,Ago serve sometimes end week.,34,silva-miller,2023,USD,392847,175604,217243,233945,-16702,7168,-23870,3928,7856,-31726,10634,212974,70076,142898,,392847,893.52,1618.74,0.001,316,103.47,1000.0,10.63,0.553
1759,Randolph West and Rogers,False,DE,Calderonchester,AI/ML,2020,https://randolphwestandrogers.com,Road a full myself measure want rather his product.,24,randolph-west-and-rogers,2023,EUR,1014232,272339,741893,507699,234194,0,234194,10142,20284,213910,42111,707553,189564,517989,,1014232,20.0,57.51,0.1591,2134,39.6,77722.47,0.54,0.7315
1760,Hart-Cummings,False,CA,East Justin,E-commerce,2023,https://hart-cummings.com,Wide happy thought work offer foreign.,21,hart-cummings,2023,USD,1274275,118092,1156183,63713,1092470,0,1092470,12742,25485,1066985,684167,1461133,389212,1071921,,1274275,860.16,862.93,0.0554,5309,20.0,1000.0,684.17,0.9073
1761,Nguyen-Blankenship,False,AU,Kimberlychester,Mobility,2008,https://nguyen-blankenship.com,Social director gas animal station see enough concern night authority.,14,nguyen-blankenship,2023,USD,468130,151155,316975,154376,162599,0,162599,4681,9362,153237,75632,370879,70360,300519,,468130,20.0,127.74,0.0983,91,424.34,1000.0,75.63,0.6771
1762,Herrera Jackson and Rivera,False,NG,Martinezton,HealthTech,2022,https://herrerajacksonandrivera.com,Form woman radio drive food relationship.,18,herrera-jackson-and-rivera,2023,USD,1282954,124953,1158001,144788,1013213,12633,1000580,12829,25659,974921,102658,793056,110451,682605,106912.83,1282954,10.0,22.48,0.0179,2031,52.62,20967.61,4.9,0.9026
1763,Patterson-Thompson,False,GB,Baxterport,EdTech,2010,https://patterson-thompson.com,Yeah author in sense military explain each security teacher test.,24,patterson-thompson,2023,USD,95792,33450,62342,38393,23949,0,23949,957,1915,22034,10161,147137,44128,103009,7982.67,95792,25.02,62.32,0.085,349,22.84,1000.0,10.16,0.6508
1764,Cruz Morris and Bell,False,NG,Lake Marytown,Marketplaces,2016,https://cruzmorrisandbell.com,Sure center near help four.,19,cruz-morris-and-bell,2023,USD,609556,117257,492299,353018,139281,0,139281,6095,12191,127090,127479,613156,78612,534544,,609556,1257.92,8879.03,0.0045,2181,23.28,27734.32,4.6,0.8076
1765,Wong Smith and Carter,False,DE,Dylanfort,HealthTech,2013,https://wongsmithandcarter.com,Go heavy little through hold increase appear create institution.,24,wong-smith-and-carter,2023,EUR,1029180,251953,777227,303313,473914,2139,471775,10291,20583,451192,176097,754370,165389,588981,85765.0,1029180,158.02,1006.35,0.0116,744,115.14,70215.53,2.51,0.7552
1766,Torres-Campbell,False,GB,Richardfurt,E-commerce,2011,https://torres-campbell.com,Discussion Mr purpose character develop keep instead.,23,torres-campbell,2023,USD,276512,87180,189332,219285,-29953,0,-29953,2765,5530,-35483,26729,274576,147968,126608,,276512,801.37,784.81,0.0225,152,151.41,35141.42,0.76,0.6847
1767,Klein-Newton,False,BR,South Nicoleville,EdTech,2021,https://klein-newton.com,Feeling term leave though community including career each hotel.,19,klein-newton,2023,USD,239939,84658,155281,55229,100052,0,100052,2399,4798,95254,19289,256866,171143,85723,19994.92,239939,10.0,57.64,0.0167,408,48.94,19184.29,1.01,0.6472
1768,Edwards Williams and Mendez,False,AU,Cervantesview,E-commerce,2011,https://edwardswilliamsandmendez.com,Whom teach party range practice wait stuff require catch.,20,edwards-williams-and-mendez,2023,USD,1288939,933142,355797,758853,-403056,7925,-410981,12889,25778,-436759,43675,720565,103648,616917,,1288939,393.77,1008.11,0.1718,224,479.49,72369.46,0.6,0.276
1769,Allison-Griffin,False,EG,Cobbtown,Marketplaces,2023,https://allison-griffin.com,Live letter newspaper example enter change when.,20,allison-griffin,2023,USD,741660,183459,558201,457768,100433,41973,58460,7416,14833,43627,179515,609841,65791,544050,,741660,2010.36,8466.37,0.0475,3090,20.0,34853.41,5.15,0.7526
1770,Fisher-Gomez,False,EG,Candicestad,EdTech,2013,https://fisher-gomez.com,Fear away senior short prepare debate.,22,fisher-gomez,2023,USD,147670,34158,113512,29228,84284,0,84284,1476,2953,81331,3017,213025,68690,144335,12305.83,147670,10.0,17.61,0.0188,203,60.58,4420.87,0.68,0.7687
1771,Chapman Mccormick and Schneider,False,BR,New Melissaton,Energy,2008,https://chapmanmccormickandschneider.com,Head ground media drug fact enjoy each work.,21,chapman-mccormick-and-schneider,2023,USD,216127,127611,88516,55859,32657,0,32657,2161,4322,28335,33906,142709,16757,125952,,216127,580.65,2257.62,0.0218,900,20.0,1000.0,33.91,0.4096
1772,Pena-Henderson,False,DE,West Stephanie,SaaS,2012,https://pena-henderson.com,Ten candidate in worker piece trip.,23,pena-henderson,2023,EUR,281353,126775,154578,131087,23491,0,23491,2813,5627,17864,15137,313139,33564,279575,23446.08,281353,81.29,390.96,0.0091,4689,5.0,1000.0,15.14,0.5494
1773,Farmer Hensley and Johnson,False,KE,Johnsonshire,IoT,2013,https://farmerhensleyandjohnson.com,Audience save spring once send.,24,farmer-hensley-and-johnson,2023,USD,171270,46756,124514,128913,-4399,14883,-19282,1712,3425,-22707,11961,225973,49784,176189,,171270,1341.84,2678.65,0.001,713,20.0,24256.51,0.49,0.727
1774,Summers-Miller,False,GB,Bassland,Marketplaces,2024,https://summers-miller.com,Natural raise five Democrat which.,24,summers-miller,2023,USD,1944329,749202,1195127,814077,381050,3160,377890,19443,38886,339004,160146,1321230,996724,324506,,1944329,20.0,50.63,0.0322,8101,20.0,104143.95,1.54,0.6147
1775,Morales-Jones,False,US,Thomaschester,IoT,2012,https://morales-jones.com,Member shake impact main a.,21,morales-jones,2023,USD,683450,318062,365388,311032,54356,21305,33051,6834,13669,19382,13290,503477,39777,463700,,683450,428.55,2331.38,0.1041,2847,20.0,28026.76,0.47,0.5346
1776,Murray Silva and Ross,False,US,Kelleyberg,HealthTech,2016,https://murraysilvaandross.com,Administration health card identify within only admit politics attack responsibility reduce.,21,murray-silva-and-ross,2023,USD,285386,98437,186949,197698,-10749,0,-10749,2853,5707,-16456,6593,285579,51411,234168,23782.17,285386,10.0,34.75,0.0485,327,72.59,2398.9,2.75,0.6551
1777,Hall Blair and Andrews,False,GB,South Roberto,AI/ML,2020,https://hallblairandandrews.com,Talk firm study quite perhaps institution trip.,25,hall-blair-and-andrews,2023,USD,965263,465520,499743,867159,-367416,173,-367589,9652,19305,-386894,91984,671095,149309,521786,,965263,374.86,1115.54,0.0805,4021,20.0,62234.23,1.48,0.5177
1778,King LLC,False,KE,East Nancyside,IoT,2008,https://kingllc.com,Heavy final film test degree opportunity bed law.,29,king-llc,2023,USD,472608,188378,284230,313399,-29169,19660,-48829,4726,9452,-58281,194930,520024,235959,284065,,472608,20.0,84.51,0.0827,1969,20.0,11660.85,16.72,0.6014
1779,Mason Jackson and Gibson,False,ZA,Mariatown,Cybersecurity,2017,https://masonjacksonandgibson.com,Force energy billion us second public.,29,mason-jackson-and-gibson,2023,USD,1512581,363658,1148923,897028,251895,16964,234931,15125,30251,204680,136671,904483,377266,527217,,1512581,804.85,402.42,0.042,624,201.82,72947.16,1.87,0.7596
1780,Perez Wagner and Brewer,False,FR,Victoriaside,EdTech,2022,https://perezwagnerandbrewer.com,Including understand ten look believe bed data hand.,18,perez-wagner-and-brewer,2023,EUR,2507124,645021,1862103,912566,949537,0,949537,25071,50142,899395,1108765,2393878,389355,2004523,208927.0,2507124,250.43,639.62,0.0631,1771,117.92,85940.6,12.9,0.7427
1781,Craig Smith and Kelly,False,KE,Jameschester,Mobility,2023,https://craigsmithandkelly.com,Movement bad decide perform money Mrs point really.,19,craig-smith-and-kelly,2023,USD,1285551,116794,1168757,605838,562919,8159,554760,12855,25711,529049,19682,663700,268220,395480,,1285551,1888.03,1831.69,0.0217,824,129.91,92121.72,0.21,0.9091
1782,Pierce-Murphy,False,GB,Port Barbaraport,EdTech,2021,https://pierce-murphy.com,True wife network heart guess.,21,pierce-murphy,2023,USD,327557,76477,251080,155451,95629,26551,69078,3275,6551,62527,40318,371717,35233,336484,27296.42,327557,531.82,2965.45,0.0268,543,50.24,38605.69,1.04,0.7665
1783,Franco Dudley and Rodriguez,False,KE,Reedburgh,HealthTech,2013,https://francodudleyandrodriguez.com,Mrs wall best detail mouth west.,21,franco-dudley-and-rodriguez,2023,USD,575384,309276,266108,477359,-211251,10067,-221318,5753,11507,-232825,97724,550903,106733,444170,47948.67,575384,338.26,749.42,0.001,620,77.22,12821.72,7.62,0.4625
1784,Kelley Ltd,False,KE,Lake Brianborough,Marketplaces,2024,https://kelleyltd.com,Assume election history else region word community trip bill part.,16,kelley-ltd,2023,USD,282126,94075,188051,107091,80960,12591,68369,2821,5642,62727,3603,301442,145051,156391,,282126,343.27,477.46,0.0827,218,107.56,42487.96,0.08,0.6665
1785,Andrews-Garner,False,IN,Port Melanie,HealthTech,2018,https://andrews-garner.com,Save big as fire line cover before beautiful rich because.,20,andrews-garner,2023,USD,334052,57171,276881,55955,220926,12593,208333,3340,6681,201652,25041,366455,235285,131170,27837.67,334052,200.42,1631.05,0.0069,385,72.25,22331.47,1.12,0.8289
1786,Miller Ltd,False,EG,Michaelton,IoT,2010,https://millerltd.com,Fly although arrive film act.,18,miller-ltd,2023,USD,805559,148093,657466,225151,432315,3724,428591,8055,16111,412480,79574,528412,168368,360044,,805559,1684.6,3824.64,0.0444,252,265.9,1000.0,79.57,0.8162
1787,Patel-Powers,False,DE,North Christinachester,Energy,2020,https://patel-powers.com,Pass field should floor image style it see.,11,patel-powers,2023,EUR,1258184,618633,639551,693513,-53962,0,-53962,12581,25163,-79125,4911,726589,334517,392072,,1258184,855.22,3927.19,0.0981,372,281.62,54498.15,0.09,0.5083
1788,Nguyen-Mercado,False,GB,Port Angelaburgh,Fintech,2008,https://nguyen-mercado.com,Opportunity center voice tax our game area fill bank peace.,20,nguyen-mercado,2023,USD,1294925,544519,750406,864540,-114134,17858,-131992,12949,25898,-157890,56957,819371,554691,264680,,1294925,1224.7,5045.82,0.0252,1260,85.59,80285.21,0.71,0.5795
1789,Lara Johnson and Bonilla,False,DE,Hendrixfurt,AI/ML,2024,https://larajohnsonandbonilla.com,Behavior arrive send style reduce money car professional care science identify.,16,lara-johnson-and-bonilla,2023,EUR,1382443,564944,817499,1553204,-735705,1890,-737595,13824,27648,-765243,40727,765797,409357,356440,,1382443,20.0,108.55,0.0445,3211,35.87,133442.94,0.31,0.5913
1790,Butler PLC,False,BR,East Gloria,Energy,2012,https://butlerplc.com,Green point color site structure nothing high certainly more.,23,butler-plc,2023,USD,2449683,122484,2327199,1343026,984173,10099,974074,24496,48993,925081,95123,1465562,653503,812059,,2449683,20.0,109.47,0.0674,1992,102.43,115368.72,0.82,0.95
1791,Nelson Berry and Randolph,False,KE,Lake Adamstad,Fintech,2013,https://nelsonberryandrandolph.com,Discover product plant two water goal can car physical any.,20,nelson-berry-and-randolph,2023,USD,224120,92540,131580,140801,-9221,37888,-47109,2241,4482,-51591,4283,183902,34618,149284,,224120,20.0,100.25,0.1302,259,71.94,1000.0,4.28,0.5871
1792,Moore Inc,False,EG,Lake Donnaview,IoT,2009,https://mooreinc.com,Fund management can source news vote certain glass far control.,16,moore-inc,2023,USD,1050148,386165,663983,253837,410146,0,410146,10501,21002,389144,24027,649955,32497,617458,,1050148,813.38,1040.27,0.0245,358,243.86,36328.02,0.66,0.6323
1793,Shepherd Rivera and Forbes,False,AU,Lake Sarahhaven,AI/ML,2024,https://shepherdriveraandforbes.com,Administration herself explain agreement social story energy industry.,15,shepherd-rivera-and-forbes,2023,USD,2830426,1027067,1803359,1091087,712272,0,712272,28304,56608,655664,102617,1531650,187439,1344211,,2830426,20.0,43.19,0.0534,11793,20.0,63263.6,1.62,0.6371
1794,Boone-Tanner,False,AU,Shannonfurt,Fintech,2010,https://boone-tanner.com,Whom among often either base me rock measure job white.,20,boone-tanner,2023,USD,673362,335747,337615,206614,131001,0,131001,6733,13467,117534,15676,386969,280509,106460,,673362,959.76,4051.32,0.0636,558,100.44,22464.56,0.7,0.5014
1795,Harris-Davis,False,EG,Murphystad,Marketplaces,2012,https://harris-davis.com,Source determine next most unit kind they girl recently.,19,harris-davis,2023,USD,1406870,577225,829645,1046637,-216992,0,-216992,14068,28137,-245129,76531,866433,155048,711385,,1406870,674.26,1881.24,0.1275,2757,42.51,80098.03,0.96,0.5897
1796,Hanson Young and Harris,False,KE,South Deborahberg,AI/ML,2008,https://hansonyoungandharris.com,Age because best risk cover him two lot operation program.,22,hanson-young-and-harris,2023,USD,1344989,558253,786736,434839,351897,7338,344559,13449,26899,317660,106676,805496,665820,139676,,1344989,412.82,973.43,0.1409,574,194.98,52385.54,2.04,0.5849
1797,Orr-Miller,False,AU,East Williamborough,Marketplaces,2021,https://orr-miller.com,Building return eight yes only wrong follow early.,15,orr-miller,2023,USD,385181,158444,226737,27140,199597,0,199597,3851,7703,191894,25932,271624,96568,175056,,385181,20.0,73.14,0.0331,1604,20.0,12944.12,2.0,0.5887
1798,Sampson PLC,False,NG,Kyleshire,Energy,2019,https://sampsonplc.com,Employee speak room whatever do key.,24,sampson-plc,2023,USD,287568,60963,226605,202923,23682,1955,21727,2875,5751,15976,6227,194552,50114,144438,,287568,634.7,5446.68,0.0565,1198,20.0,20933.96,0.3,0.788
1799,Allen Howard and Davis,False,US,Wellston,Cybersecurity,2024,https://allenhowardanddavis.com,Former determine price hour account news ten service identify phone.,29,allen-howard-and-davis,2023,USD,548885,143963,404922,69642,335280,4349,330931,5488,10977,319954,9082,380238,243545,136693,,548885,20.0,77.44,0.0124,126,361.11,1000.0,9.08,0.7377
1800,Carrillo Davenport and Rivera,False,TN,New Patricia,EdTech,2023,https://carrillodavenportandrivera.com,Similar vote movement control though moment clearly movie.,15,carrillo-davenport-and-rivera,2023,USD,688835,128854,559981,417113,142868,16047,126821,6888,13776,113045,25901,402121,146766,255355,57402.92,688835,562.11,1436.35,0.001,764,75.08,30659.13,0.84,0.8129
1801,Wolf Inc,False,AU,East John,Energy,2019,https://wolfinc.com,Among together method interview road race.,20,wolf-inc,2023,USD,5431166,973181,4457985,1876894,2581091,0,2581091,54311,108623,2472468,403787,3318966,1584363,1734603,,5431166,621.53,1309.82,0.0169,2786,162.43,175812.8,2.3,0.8208
1802,Washington-Ortiz,False,KE,Shawfurt,Cybersecurity,2011,https://washington-ortiz.com,Food necessary look especially exactly for offer.,22,washington-ortiz,2023,USD,2589004,1108212,1480792,444137,1036655,15809,1020846,25890,51780,969066,45320,1492730,146193,1346537,,2589004,20.0,93.31,0.0208,10787,20.0,56279.54,0.81,0.572
1803,Thomas-Hall,False,TN,North Sharon,HealthTech,2016,https://thomas-hall.com,Today raise remember outside city me performance ever.,15,thomas-hall,2023,USD,730389,106937,623452,401622,221830,0,221830,7303,14607,207223,12701,454785,134274,320511,60865.75,730389,10.0,33.09,0.0128,843,72.19,26621.42,0.48,0.8536
1804,Ellis Hill and Rasmussen,False,EG,Lake Daisyhaven,EdTech,2010,https://ellishillandrasmussen.com,Range work choose kitchen set stuff present so.,20,ellis-hill-and-rasmussen,2023,USD,40709,16574,24135,5150,18985,0,18985,407,814,18171,11480,121420,26601,94819,3392.42,40709,757.82,2290.88,0.0358,82,40.92,1000.0,11.48,0.5929
1805,Snyder Scott and Walker,False,IN,Kellymouth,IoT,2021,https://snyderscottandwalker.com,Should single job thought particularly.,16,snyder-scott-and-walker,2023,USD,217127,49207,167920,62862,105058,0,105058,2171,4342,100716,14527,265024,35282,229742,,217127,828.1,2645.96,0.0049,904,20.0,1000.0,14.53,0.7734
1806,Moreno-Simmons,False,IN,Port Brendanborough,EdTech,2008,https://moreno-simmons.com,Say stand article book six student beat say.,22,moreno-simmons,2023,USD,1599561,430032,1169529,79978,1089551,20293,1069258,15995,31991,1037267,115403,941524,258982,682542,133296.75,1599561,454.4,1977.64,0.0311,1403,94.99,7684.19,15.02,0.7312
1807,Alvarez Fowler and Thompson,False,ZA,Duanehaven,Cybersecurity,2008,https://alvarezfowlerandthompson.com,Service social Democrat sign outside look improve.,16,alvarez-fowler-and-thompson,2023,USD,1613966,386591,1227375,1265573,-38198,15642,-53840,16139,32279,-86119,40548,1000902,366449,634453,,1613966,832.73,3420.82,0.012,6724,20.0,92721.88,0.44,0.7605
1808,Bradley PLC,False,KE,Ryanton,AI/ML,2011,https://bradleyplc.com,Source them wife ever soldier.,17,bradley-plc,2023,USD,437646,170826,266820,313143,-46323,4525,-50848,4376,8752,-59600,77636,432988,107475,325513,,437646,788.67,2296.06,0.047,147,246.69,22655.86,3.43,0.6097
1809,Kent PLC,False,NG,North Marymouth,SaaS,2020,https://kentplc.com,Just drop some money hundred section bit.,20,kent-plc,2023,USD,765130,318790,446340,487108,-40768,0,-40768,7651,15302,-56070,94342,609941,58386,551555,63760.83,765130,202.87,250.11,0.0115,1067,59.71,12466.62,7.57,0.5834
1810,Nguyen-Nelson,False,BR,West Johnberg,EdTech,2018,https://nguyen-nelson.com,American three machine environment security wrong plan case.,29,nguyen-nelson,2023,USD,558821,193783,365038,274106,90932,15396,75536,5588,11176,64360,83623,459646,211232,248414,46568.42,558821,488.51,2449.02,0.0414,8803,5.29,36802.2,2.27,0.6532
1811,Williams LLC,False,TN,South Sara,E-commerce,2011,https://williamsllc.com,Perhaps as out check most word impact.,23,williams-llc,2023,USD,908178,316494,591684,256099,335585,0,335585,9081,18163,317422,32422,600802,163184,437618,,908178,670.33,1748.94,0.0564,3784,20.0,7337.85,4.42,0.6515
1812,Sims Vega and Pratt,False,GB,Joannburgh,Energy,2016,https://simsvegaandpratt.com,These we wide reveal sure.,22,sims-vega-and-pratt,2023,USD,4909929,1806709,3103220,1849135,1254085,13978,1240107,49099,98198,1141909,334420,2824014,607798,2216216,,4909929,20.0,10.0,0.0803,1255,326.0,125428.84,2.67,0.632
1813,Roberson Robinson and Sanchez,False,IN,Lake Tylermouth,AI/ML,2021,https://robersonrobinsonandsanchez.com,Near become city consumer employee wall he local.,14,roberson-robinson-and-sanchez,2023,USD,569289,189470,379819,315227,64592,25258,39334,5692,11385,27949,7381,332055,41472,290583,,569289,899.71,2797.53,0.001,2372,20.0,28085.48,0.26,0.6672
1814,Adams Goodman and Smith,False,KE,Port Timothymouth,E-commerce,2016,https://adamsgoodmanandsmith.com,Program throw recent visit parent.,21,adams-goodman-and-smith,2023,USD,692169,368386,323783,644578,-320795,11537,-332332,6921,13843,-346175,35393,391087,91047,300040,,692169,20.0,22.04,0.001,411,140.29,70033.28,0.51,0.4678
1815,Bryant LLC,False,BR,Caseyshire,Energy,2014,https://bryantllc.com,Federal soldier page close deal beyond truth.,22,bryant-llc,2023,USD,1632286,509927,1122359,696685,425674,0,425674,16322,32645,393029,209122,1101964,616749,485215,,1632286,1366.22,1211.46,0.0873,818,166.16,59193.56,3.53,0.6876
1816,Weaver Meyer and Chambers,False,TN,New Kimberly,AI/ML,2023,https://weavermeyerandchambers.com,Production live key its here five today loss.,15,weaver-meyer-and-chambers,2023,USD,1045575,690570,355005,818653,-463648,0,-463648,10455,20911,-484559,17564,667285,205483,461802,,1045575,254.51,127.26,0.001,1713,50.84,63885.24,0.27,0.3395
1817,Nguyen-Swanson,False,GB,Deborahborough,E-commerce,2023,https://nguyen-swanson.com,Development she Mr price big teacher song.,21,nguyen-swanson,2023,USD,1330074,370486,959588,284454,675134,17493,657641,13300,26601,631040,20744,885265,598780,286485,,1330074,1441.43,1085.9,0.0337,5541,20.0,52330.75,0.4,0.7215
1818,Sampson Ltd,False,IN,Port Branditon,AgriTech,2019,https://sampsonltd.com,If we drop tend generation growth less by anything.,15,sampson-ltd,2023,USD,2231212,1009558,1221654,982274,239380,0,239380,22312,44624,194756,138897,1358852,745268,613584,,2231212,1473.07,6713.45,0.0577,663,280.05,59557.23,2.33,0.5475
1819,Rodriguez LLC,False,AU,Stevenbury,Cybersecurity,2020,https://rodriguezllc.com,Pass enjoy production stand process reason low.,20,rodriguez-llc,2023,USD,2265270,113263,2152007,354444,1797563,0,1797563,22652,45305,1752258,93888,1380411,511640,868771,,2265270,20.0,96.61,0.0474,811,232.61,44226.63,2.12,0.95
1820,Gomez LLC,False,ZA,Haydenmouth,HealthTech,2011,https://gomezllc.com,Effort development establish whom plant finally hour forget.,21,gomez-llc,2023,USD,898301,365989,532312,321482,210830,36417,174413,8983,17966,156447,85209,620408,103474,516934,74858.42,898301,419.92,874.64,0.0393,1514,49.42,34310.31,2.48,0.5926
1821,Brooks Lewis and Ortega,False,ZA,East Michelle,EdTech,2022,https://brookslewisandortega.com,Happen health need street purpose old whose general section feeling.,18,brooks-lewis-and-ortega,2023,USD,623082,181297,441785,162752,279033,43848,235185,6230,12461,222724,48631,390071,256427,133644,51923.5,623082,608.31,2553.91,0.0566,1749,29.68,1000.0,48.63,0.709
1822,Cox-Mason,False,AU,Powellberg,Cybersecurity,2013,https://cox-mason.com,Significant energy policy since improve draw score pretty while few.,15,cox-mason,2023,USD,1417432,547900,869532,370448,499084,4632,494452,14174,28348,466104,43290,801031,175338,625693,,1417432,343.8,1467.45,0.0661,1458,81.0,54835.57,0.79,0.6135
1823,Turner Group,False,FR,West Richardshire,EdTech,2024,https://turnergroup.com,Plant benefit role manage operation result southern really wind.,13,turner-group,2023,EUR,352675,124696,227979,167469,60510,0,60510,3526,7053,53457,52228,336312,183983,152329,29389.58,352675,10.0,71.6,0.0291,613,47.91,1000.0,52.23,0.6464
1824,Hawkins Ltd,False,TN,Ashleyton,E-commerce,2009,https://hawkinsltd.com,Require material exist research I but agent part home affect.,21,hawkins-ltd,2023,USD,1613249,837377,775872,507692,268180,27855,240325,16132,32264,208061,57287,949990,127306,822684,,1613249,20.0,49.36,0.001,740,181.62,49174.66,1.16,0.4809
1825,Bailey-Byrd,False,GB,Port Danielton,Energy,2008,https://bailey-byrd.com,Least so especially almost myself red concern more.,23,bailey-byrd,2023,USD,662681,228266,434415,37678,396737,32286,364451,6626,13253,351198,33772,367024,176170,190854,,662681,601.58,1144.96,0.001,230,239.41,6716.14,5.03,0.6555
1826,Frazier-Sanders,False,AU,North Kara,Fintech,2012,https://frazier-sanders.com,Official sister professor side type interest I economic.,20,frazier-sanders,2023,USD,356388,92072,264316,191140,73176,1814,71362,3563,7127,64235,9714,337107,224022,113085,,356388,20.0,105.47,0.1108,214,138.41,1732.37,5.61,0.7417
1827,Gibbs Group,False,EG,West Natasha,IoT,2021,https://gibbsgroup.com,Reflect organization animal around campaign move Democrat single.,20,gibbs-group,2023,USD,692994,229392,463602,126029,337573,0,337573,6929,13859,323714,22668,484473,25395,459078,,692994,802.01,2307.11,0.043,732,78.85,1000.0,22.67,0.669
1828,Hall LLC,False,FR,Port Jamestown,Fintech,2016,https://hallllc.com,Evening another life tax close.,22,hall-llc,2023,EUR,941473,472959,468514,644322,-175808,0,-175808,9414,18829,-194637,25114,578417,344050,234367,,941473,894.51,2612.97,0.1108,419,187.02,28552.25,0.88,0.4976
1829,Collins Mendez and Reynolds,False,DE,West Timothy,E-commerce,2010,https://collinsmendezandreynolds.com,Increase shoulder this week environmental white cultural should wind property.,23,collins-mendez-and-reynolds,2023,EUR,400097,107360,292737,51521,241216,15207,226009,4000,8001,218008,1513,371769,146715,225054,,400097,794.87,397.44,0.0559,1667,20.0,23093.15,0.07,0.7317
1830,Williams Bryant and Le,False,KE,Kimchester,SaaS,2020,https://williamsbryantandle.com,Night check station message window garden we protect.,18,williams-bryant-and-le,2023,USD,655474,276644,378830,81150,297680,25622,272058,6554,13109,258949,78697,487391,241593,245798,54622.83,655474,14.03,62.47,0.026,685,79.65,1000.0,78.7,0.5779
1831,Prince Group,False,TN,Jasmineland,IoT,2024,https://princegroup.com,Though tell mission investment on because.,15,prince-group,2023,USD,3759038,1555291,2203747,1588406,615341,24177,591164,37590,75180,515984,411546,2304183,463236,1840947,,3759038,311.24,1108.16,0.018,1217,257.34,116193.46,3.54,0.5863
1832,Chambers and Sons,False,IN,North Joseph,Cybersecurity,2009,https://chambersandsons.com,Focus city help type one smile.,23,chambers-and-sons,2023,USD,1503362,454545,1048817,1071207,-22390,3287,-25677,15033,30067,-55744,10982,920724,304873,615851,,1503362,1183.06,3014.65,0.1055,769,162.79,84863.77,0.13,0.6976
1833,Bradley Good and Cameron,False,AU,Phillipmouth,HealthTech,2023,https://bradleygoodandcameron.com,White pick evening trip record Congress rather first expert.,30,bradley-good-and-cameron,2023,USD,1598121,294363,1303758,810626,493132,16844,476288,15981,31962,444326,222752,1152615,529349,623266,133176.75,1598121,514.36,3180.26,0.0628,1551,85.83,60471.53,3.68,0.8158
1834,Rodriguez Inc,False,EG,Christopherfurt,SaaS,2014,https://rodriguezinc.com,Could whom reach certain deal stay poor beyond or.,17,rodriguez-inc,2023,USD,1820031,679331,1140700,760959,379741,0,379741,18200,36400,343341,126030,1198922,223208,975714,151669.25,1820031,92.52,179.69,0.0331,30333,5.0,109037.46,1.16,0.6267
1835,Monroe-Bowen,False,BR,Kimberlyside,AI/ML,2017,https://monroe-bowen.com,Technology voice employee provide coach watch end.,25,monroe-bowen,2023,USD,1290737,196299,1094438,621667,472771,0,472771,12907,25814,446957,28297,801956,244353,557603,,1290737,20.0,78.2,0.0741,594,181.03,43555.28,0.65,0.8479
1836,Sanchez Sanchez and Adams,False,DE,North Danielmouth,SaaS,2024,https://sanchezsanchezandadams.com,Must treat activity ability loss sing.,19,sanchez-sanchez-and-adams,2023,EUR,1330941,508145,822796,631294,191502,24075,167427,13309,26618,140809,123716,872129,299123,573006,110911.75,1330941,235.73,1165.88,0.001,1983,55.91,54988.95,2.25,0.6182
1837,Harrison-Webb,False,NG,South Dorisfort,Cybersecurity,2015,https://harrison-webb.com,Board myself simple help science health low pressure ready.,19,harrison-webb,2023,USD,4846921,1485422,3361499,546392,2815107,35110,2779997,48469,96938,2683059,694406,3296924,1243663,2053261,,4846921,602.82,2128.96,0.1475,20195,20.0,45449.36,15.28,0.6935
1838,Fields and Sons,False,KE,South Dylanport,HealthTech,2009,https://fieldsandsons.com,Model might night prevent bill hope off and though provide.,16,fields-and-sons,2023,USD,2091133,819295,1271838,855054,416784,0,416784,20911,41822,374962,62374,1270555,188657,1081898,174261.08,2091133,10.0,33.34,0.0357,34852,5.0,74480.36,0.84,0.6082
1839,Kirk-Pena,False,CA,Scottchester,EdTech,2008,https://kirk-pena.com,Fear open bar already responsibility range discuss race hit.,18,kirk-pena,2023,USD,33637,16130,17507,15932,1575,6366,-4791,336,672,-5463,21801,56637,29462,27175,2803.08,33637,105.87,453.58,0.001,37,74.24,1000.0,21.8,0.5205
1840,Flynn-Carroll,False,GB,Brewerbury,Fintech,2016,https://flynn-carroll.com,Candidate sport your relate other radio but.,9,flynn-carroll,2023,USD,4856280,1730883,3125397,3314515,-189118,9640,-198758,48562,97125,-295883,903772,3398182,2462908,935274,,4856280,20.0,30.39,0.1,1871,216.22,300459.92,3.01,0.6436
1841,Mclaughlin LLC,False,AU,East Randyside,Energy,2019,https://mclaughlinllc.com,Often let action everyone brother forward.,14,mclaughlin-llc,2023,USD,1337795,514781,823014,844698,-21684,20547,-42231,13377,26755,-68986,23275,866157,240842,625315,,1337795,20.0,68.31,0.1675,5574,20.0,68950.66,0.34,0.6152
1842,Jones and Sons,False,BR,Chandlermouth,Energy,2020,https://jonesandsons.com,Husband about company interest same series.,14,jones-and-sons,2023,USD,5166083,1302028,3864055,1383110,2480945,2555,2478390,51660,103321,2375069,387488,3161172,334498,2826674,,5166083,486.39,872.55,0.001,21525,20.0,122776.37,3.16,0.748
1843,Zimmerman Gibson and Sparks,False,KE,East Michellebury,EdTech,2024,https://zimmermangibsonandsparks.com,Significant happy discuss me fear radio.,25,zimmerman-gibson-and-sparks,2023,USD,242510,30778,211732,52241,159491,0,159491,2425,4850,154641,54166,277344,152861,124483,20209.17,242510,318.07,1930.47,0.0446,796,25.36,8835.31,6.13,0.8731
1844,Fowler Smith and Cox,False,US,Port Mark,Cybersecurity,2010,https://fowlersmithandcox.com,Lose full effect off sign.,17,fowler-smith-and-cox,2023,USD,2560134,1060603,1499531,128006,1371525,33331,1338194,25601,51202,1286992,173378,1585013,538556,1046457,,2560134,1065.68,3118.5,0.1537,10667,20.0,21944.11,7.9,0.5857
1845,Reed Johnson and Martin,False,FR,West Brandonland,AI/ML,2017,https://reedjohnsonandmartin.com,Treat each beautiful form message play.,17,reed-johnson-and-martin,2023,EUR,1728353,590279,1138074,442422,695652,33090,662562,17283,34567,627995,23723,940973,396160,544813,,1728353,45.15,189.87,0.0504,741,194.34,48796.5,0.49,0.6585
1846,Olson Lane and Huynh,False,ZA,Lindseymouth,AI/ML,2019,https://olsonlaneandhuynh.com,Manage manage tax recognize court.,19,olson-lane-and-huynh,2023,USD,839201,356722,482479,557326,-74847,0,-74847,8392,16784,-91631,260260,761200,286233,474967,,839201,20.0,24.49,0.0664,3496,20.0,51126.72,5.09,0.5749
1847,Jenkins-Hayes,False,CA,New Kevinberg,AgriTech,2015,https://jenkins-hayes.com,Travel recognize above behavior hot must discussion.,20,jenkins-hayes,2023,USD,360319,68303,292016,148106,143910,50467,93443,3603,7206,86237,25364,325279,77423,247856,,360319,782.02,1449.39,0.0361,96,311.58,33467.34,0.76,0.8104
1848,Welch Garza and Clark,False,KE,Cruzview,EdTech,2022,https://welchgarzaandclark.com,Series law strategy leader tend.,18,welch-garza-and-clark,2023,USD,206210,29389,176821,25837,150984,0,150984,2062,4124,146860,41198,226870,75748,151122,17184.17,206210,232.12,660.41,0.0115,230,74.4,14227.69,2.9,0.8575
1849,Mathews-Smith,False,TN,Jeffreymouth,IoT,2008,https://mathews-smith.com,Sometimes lawyer play success successful police line door direction computer.,29,mathews-smith,2023,USD,142655,68637,74018,114679,-40661,8038,-48699,1426,2853,-51552,19358,120502,65702,54800,,142655,20.0,65.95,0.0444,78,152.27,1000.0,19.36,0.5189
1850,Moody Goodman and Sharp,False,IN,Cookfort,HealthTech,2021,https://moodygoodmanandsharp.com,Yes future single few exactly mouth amount.,28,moody-goodman-and-sharp,2023,USD,271019,83959,187060,32962,154098,24775,129323,2710,5420,123903,52008,356374,126141,230233,22584.92,271019,181.79,704.96,0.0642,305,73.93,12473.86,4.17,0.6902
1851,Haynes-Lucero,False,NG,Port Dave,Fintech,2010,https://haynes-lucero.com,Yard hit task suddenly class.,23,haynes-lucero,2023,USD,1663503,631045,1032458,1055048,-22590,0,-22590,16635,33270,-55860,44222,1034899,205166,829733,,1663503,397.98,1584.63,0.0437,2872,48.26,96316.02,0.46,0.6207
1852,Gibson PLC,False,NG,Lisaport,AgriTech,2018,https://gibsonplc.com,Including bring blue machine year line fill last face.,15,gibson-plc,2023,USD,141285,39868,101417,109043,-7626,19520,-27146,1412,2825,-29971,3406,272001,68604,203397,,141285,20.0,26.87,0.0118,63,186.21,14599.58,0.23,0.7178
1853,Bell Peterson and Hernandez,False,FR,Hernandezfurt,AI/ML,2016,https://bellpetersonandhernandez.com,Decide medical environmental writer agent data action medical what herself.,20,bell-peterson-and-hernandez,2023,EUR,648328,255044,393284,299917,93367,0,93367,6483,12966,80401,3386,356774,69880,286894,,648328,20.0,96.58,0.0886,235,229.73,28945.58,0.12,0.6066
1854,Harmon-Smith,False,NG,Grayshire,IoT,2016,https://harmon-smith.com,Consider tend practice television attack mind use site live person.,21,harmon-smith,2023,USD,1277106,568210,708896,698463,10433,0,10433,12771,25542,-15109,86913,785126,337680,447446,,1277106,911.09,2092.32,0.001,3851,27.63,52826.19,1.65,0.5551
1855,Ware-Zamora,False,ZA,Carlsonmouth,Mobility,2020,https://ware-zamora.com,Series day north stay certain.,21,ware-zamora,2023,USD,1549418,516812,1032606,814955,217651,11337,206314,15494,30988,175326,74441,925629,405600,520029,,1549418,20.0,94.0,0.0468,760,169.68,83167.62,0.9,0.6664
1856,Crawford PLC,False,KE,Lake Lindsey,Mobility,2015,https://crawfordplc.com,Attorney size area just draw group candidate others common.,13,crawford-plc,2023,USD,2183706,487948,1695758,609502,1086256,0,1086256,21837,43674,1042582,644411,1796605,891183,905422,,2183706,20.0,22.19,0.0611,9098,20.0,58528.67,11.01,0.7766
1857,Mcguire Russell and Rasmussen,False,AU,West James,E-commerce,2022,https://mcguirerussellandrasmussen.com,Cover walk drop skin democratic operation discover.,15,mcguire-russell-and-rasmussen,2023,USD,1928625,833232,1095393,1076469,18924,0,18924,19286,38572,-19648,50287,1102679,448034,654645,,1928625,1028.41,3379.73,0.0339,8035,20.0,104739.95,0.48,0.568
1858,Gray-Cobb,False,BR,Port Melaniefurt,Mobility,2008,https://gray-cobb.com,World else difficult true human gas candidate game Mrs hot.,18,gray-cobb,2023,USD,2963459,1079818,1883641,1501705,381936,56718,325218,29634,59269,265949,168679,1694464,559159,1135305,,2963459,20.0,36.08,0.001,1081,228.44,101225.75,1.67,0.6356
1859,George Inc,False,EG,New Matthew,Fintech,2016,https://georgeinc.com,Resource any size technology enter most stock from mother.,20,george-inc,2023,USD,2825626,961663,1863963,1807492,56471,0,56471,28256,56512,-41,399035,1851713,344476,1507237,,2825626,895.55,3266.34,0.0785,1936,121.6,139834.93,2.85,0.6597
1860,Sanchez-Wilson,False,FR,West Garrettstad,Energy,2015,https://sanchez-wilson.com,Toward morning according easy know set few.,21,sanchez-wilson,2023,EUR,766290,327537,438753,465983,-27230,0,-27230,7662,15325,-42555,31555,487256,187680,299576,,766290,20.0,80.46,0.0934,3192,20.0,12976.79,2.43,0.5726
1861,Diaz Inc,False,BR,Hawkinschester,Cybersecurity,2015,https://diazinc.com,Morning whether name agree Congress director operation candidate business thought.,22,diaz-inc,2023,USD,1016499,532015,484484,545679,-61195,16227,-77422,10164,20329,-97751,20468,627959,31397,596562,,1016499,387.41,1375.06,0.0413,4235,20.0,36338.63,0.56,0.4766
1862,Johnson-Lam,False,AU,Annchester,E-commerce,2021,https://johnson-lam.com,Week simply product music line modern.,20,johnson-lam,2023,USD,751403,101389,650014,502292,147722,0,147722,7514,15028,132694,19204,442786,110765,332021,,751403,202.66,964.85,0.1027,1123,55.73,26997.37,0.71,0.8651
1863,Moore-Blackwell,False,CA,Harrisland,AI/ML,2008,https://moore-blackwell.com,Soon south note something community stage listen.,19,moore-blackwell,2023,USD,1353005,289540,1063465,686016,377449,0,377449,13530,27060,350389,30984,838041,310284,527757,,1353005,547.49,460.7,0.001,3169,35.57,31581.53,0.98,0.786
1864,Ray Collins and Wilson,False,ZA,East Jamesburgh,AgriTech,2015,https://raycollinsandwilson.com,News according above food reduce condition maintain full bad voice.,21,ray-collins-and-wilson,2023,USD,280701,164004,116697,188455,-71758,0,-71758,2807,5614,-77372,8653,233216,98649,134567,,280701,1239.44,5633.85,0.0894,1169,20.0,1000.0,8.65,0.4157
1865,Becker Ltd,False,IN,North Jenniferfort,Fintech,2020,https://beckerltd.com,Father water at every marriage case ten attention.,22,becker-ltd,2023,USD,675729,256974,418755,507872,-89117,37659,-126776,6757,13514,-140290,59991,502446,123389,379057,,675729,225.97,537.59,0.001,2815,20.0,39963.31,1.5,0.6197
1866,Sullivan-Anderson,False,BR,Florestown,Cybersecurity,2018,https://sullivan-anderson.com,Green if quite language every.,15,sullivan-anderson,2023,USD,675878,243843,432035,167552,264483,0,264483,6758,13517,250966,45493,467505,262853,204652,,675878,1400.13,700.06,0.0182,542,103.77,11157.23,4.08,0.6392
1867,Hall Ltd,False,FR,Brownside,AI/ML,2013,https://hallltd.com,Factor myself voice country add whose medical management.,17,hall-ltd,2023,EUR,2876776,1197605,1679171,2335709,-656538,6307,-662845,28767,57535,-720380,122714,1645682,145563,1500119,,2876776,1180.09,2779.41,0.001,7816,30.67,202310.96,0.61,0.5837
1868,Barker and Sons,False,EG,Nicholstown,E-commerce,2019,https://barkerandsons.com,Any because employee knowledge organization director husband away score.,19,barker-and-sons,2023,USD,2011929,1119033,892896,827721,65175,27533,37642,20119,40238,-2596,87243,1166019,437487,728532,,2011929,244.86,1326.78,0.0423,1251,134.02,108283.1,0.81,0.4438
1869,Peterson Padilla and Oliver,False,DE,Smithstad,IoT,2016,https://petersonpadillaandoliver.com,Reveal not many wonder wish.,18,peterson-padilla-and-oliver,2023,EUR,1065938,535248,530690,371016,159674,13229,146445,10659,21318,125127,12157,696921,105093,591828,,1065938,1364.89,8583.47,0.001,4441,20.0,40489.82,0.3,0.4979
1870,Anderson Williamson and Bell,False,GB,North David,Cybersecurity,2014,https://andersonwilliamsonandbell.com,Choice rich good draw relate wide last about environmental positive.,14,anderson-williamson-and-bell,2023,USD,1917781,824919,1092862,568151,524711,655,524056,19177,38355,485701,216075,1291855,726568,565287,,1917781,20.0,83.32,0.062,715,223.39,23836.77,9.06,0.5699
1871,Molina PLC,False,EG,Williamshire,Cybersecurity,2014,https://molinaplc.com,Gas who place head follow.,22,molina-plc,2023,USD,903363,405202,498161,439926,58235,29023,29212,9033,18067,11145,298394,945721,278203,667518,,903363,20.0,55.65,0.0787,417,180.35,38368.15,7.78,0.5515
1872,Jones and Sons,False,DE,Millerburgh,Cybersecurity,2015,https://jonesandsons.com,Tough level store least.,19,jones-and-sons,2023,EUR,1462173,329702,1132471,326517,805954,0,805954,14621,29243,776711,364810,1293412,228766,1064646,,1462173,239.86,1146.41,0.0757,396,307.17,32490.2,11.23,0.7745
1873,Villarreal Cooley and Richmond,False,IN,West Anna,EdTech,2015,https://villarrealcooleyandrichmond.com,Step old citizen candidate over military nation really concern.,25,villarreal-cooley-and-richmond,2023,USD,190353,106057,84296,24402,59894,20630,39264,1903,3807,35457,2453,260762,74801,185961,15862.75,190353,731.89,3473.48,0.0369,140,112.67,1000.0,2.45,0.4428
1874,Andrews Davila and Conner,False,DE,Lunabury,EdTech,2019,https://andrewsdavilaandconner.com,Remain leave commercial seem father play culture third teacher.,25,andrews-davila-and-conner,2023,EUR,335093,129640,205453,68531,136922,0,136922,3350,6701,130221,214992,389253,19462,369791,27924.42,335093,357.1,1822.97,0.001,343,81.36,1000.0,214.99,0.6131
1875,Mosley Stone and Martin,False,GB,Coxville,Fintech,2011,https://mosleystoneandmartin.com,Tough sell surface development million put amount church.,19,mosley-stone-and-martin,2023,USD,2019519,547802,1471717,1165000,306717,1020,305697,20195,40390,265307,337437,1388222,497332,890890,,2019519,851.79,3434.34,0.1056,516,326.05,85804.77,3.93,0.7287
1876,Williams Shaffer and Nelson,False,FR,Lake Kennethport,Marketplaces,2023,https://williamsshafferandnelson.com,Ok industry anything air anyone expert over industry great.,17,williams-shaffer-and-nelson,2023,EUR,1139628,333807,805821,874261,-68440,2193,-70633,11396,22792,-93425,26102,708576,219058,489518,,1139628,1533.21,8461.75,0.0191,1071,88.61,86619.39,0.3,0.7071
1877,Woods and Sons,False,KE,Natashafurt,SaaS,2009,https://woodsandsons.com,Reason why street call energy child almost include.,20,woods-and-sons,2023,USD,2619263,756372,1862891,1047487,815404,0,815404,26192,52385,763019,44264,1447796,72389,1375407,218271.92,2619263,528.17,528.17,0.0312,3130,69.72,68234.93,0.65,0.7112
1878,Hall Larson and Miller,False,EG,Sandraton,E-commerce,2018,https://halllarsonandmiller.com,Quickly chance drop want box.,27,hall-larson-and-miller,2023,USD,319179,57531,261648,341397,-79749,23226,-102975,3191,6383,-109358,80845,361200,205567,155633,,319179,20.0,90.69,0.1378,90,293.31,16544.67,4.89,0.8198
1879,Lopez-White,False,EG,Rhondaview,IoT,2016,https://lopez-white.com,Whether foreign occur small these plant miss call particular.,14,lopez-white,2023,USD,362697,80581,282116,247972,34144,2875,31269,3626,7253,24016,899,323000,74102,248898,,362697,1641.79,6979.35,0.0517,1511,20.0,1000.0,0.9,0.7778
1880,Robinson LLC,False,EG,Shaneport,HealthTech,2024,https://robinsonllc.com,Citizen much drug soldier seven seven.,24,robinson-llc,2023,USD,799172,215773,583399,304518,278881,9923,268958,7991,15983,252975,20974,505845,389902,115943,66597.67,799172,10.0,32.72,0.001,655,101.55,11984.97,1.75,0.73
1881,Butler Perry and Steele,False,IN,Roblesland,Energy,2015,https://butlerperryandsteele.com,Eat organization smile coach shoulder clear feeling rock.,18,butler-perry-and-steele,2023,USD,590889,269317,321572,29544,292028,49517,242511,5908,11817,230694,21415,512344,317358,194986,,590889,20.0,10.0,0.001,133,368.28,23124.32,0.93,0.5442
1882,Powell Inc,False,AU,Lake Jamesshire,IoT,2012,https://powellinc.com,Off reflect player it.,28,powell-inc,2023,USD,351481,116350,235131,176104,59027,15704,43323,3514,7029,36294,11424,290122,88072,202050,,351481,449.17,2792.35,0.1639,561,52.17,1000.0,11.42,0.669
1883,Russell-Hancock,False,US,Kevinmouth,AI/ML,2021,https://russell-hancock.com,Major success relationship fish probably appear TV compare eat.,26,russell-hancock,2023,USD,1360911,510553,850358,792889,57469,0,57469,13609,27218,30251,117247,883478,65433,818045,,1360911,20.0,10.6,0.0832,1836,61.74,23552.17,4.98,0.6248
1884,Harvey-George,False,EG,Lake Ryanstad,AI/ML,2009,https://harvey-george.com,Watch different cultural what range hundred affect.,17,harvey-george,2023,USD,296589,130611,165978,120644,45334,0,45334,2965,5931,39403,1817,258340,115822,142518,,296589,605.21,2463.83,0.0156,1235,20.0,1000.0,1.82,0.5596
1885,Nash-Stevenson,False,NG,Port Victoria,E-commerce,2020,https://nash-stevenson.com,Company light really free cup still step better.,21,nash-stevenson,2023,USD,505575,202792,302783,387665,-84882,0,-84882,5055,10111,-94993,9090,279347,97147,182200,,505575,20.0,67.82,0.0158,225,186.76,57164.08,0.16,0.5989
1886,Sanchez Group,False,BR,West Matthew,HealthTech,2022,https://sanchezgroup.com,Together quickly anything worry institution big condition fall little effect plant.,20,sanchez-group,2023,USD,370132,99912,270220,143962,126258,16139,110119,3701,7402,102717,5676,281325,105316,176009,30844.33,370132,260.25,1034.53,0.034,497,61.99,46723.31,0.12,0.7301
1887,Brooks Klein and Ellis,False,FR,East Jerryton,Cybersecurity,2024,https://brookskleinandellis.com,Trouble hundred by start force standard maintain bed.,24,brooks-klein-and-ellis,2023,EUR,1306068,203915,1102153,65303,1036850,46656,990194,13060,26121,964073,38367,869832,197147,672685,,1306068,679.18,3504.39,0.001,482,225.63,45115.81,0.85,0.8439
1888,Nguyen-Villarreal,False,EG,Port Brianaview,E-commerce,2008,https://nguyen-villarreal.com,Event charge positive reach federal.,19,nguyen-villarreal,2023,USD,1759968,676749,1083219,400560,682659,15398,667261,17599,35199,632062,32840,1046939,211229,835710,,1759968,157.05,78.53,0.0934,2877,50.97,14425.27,2.28,0.6155
1889,Long-Jones,False,US,West Lisa,Marketplaces,2014,https://long-jones.com,Capital discussion song along main.,17,long-jones,2023,USD,463776,100514,363262,369680,-6418,37224,-43642,4637,9275,-52917,63026,384386,154916,229470,,463776,1145.48,2724.44,0.0141,198,194.24,21396.5,2.95,0.7833
1890,Jones Davis and Wright,False,TN,Rebeccastad,IoT,2011,https://jonesdavisandwright.com,Role financial which use wind pattern themselves.,15,jones-davis-and-wright,2023,USD,377276,41343,335933,197800,138133,21873,116260,3772,7545,108715,23426,252741,54094,198647,,377276,555.99,712.66,0.0171,194,161.54,25554.93,0.92,0.8904
1891,Cook Group,False,CA,Michaelville,E-commerce,2016,https://cookgroup.com,It discover when place capital everyone early style.,18,cook-group,2023,USD,845708,363854,481854,344100,137754,0,137754,8457,16914,120840,19867,641382,125366,516016,,845708,197.12,972.32,0.1418,331,212.42,29224.17,0.68,0.5698
1892,Martinez-Jenkins,False,GB,Lake Elizabethside,AI/ML,2016,https://martinez-jenkins.com,Through respond down capital them a job available.,19,martinez-jenkins,2023,USD,460058,241167,218891,381227,-162336,25229,-187565,4600,9201,-196766,17035,377158,275247,101911,,460058,739.93,2189.6,0.0593,792,48.37,22963.27,0.74,0.4758
1893,Roberts Inc,False,DE,Catherinefurt,AgriTech,2023,https://robertsinc.com,Speak property information knowledge theory fill rate realize institution.,19,roberts-inc,2023,EUR,520718,219185,301533,219947,81586,0,81586,5207,10414,71172,11382,406923,200366,206557,,520718,20.0,11.4,0.001,2169,20.0,1000.0,11.38,0.5791
1894,Williams Cannon and Johnson,False,KE,North Sabrinachester,E-commerce,2019,https://williamscannonandjohnson.com,Support run outside magazine message.,27,williams-cannon-and-johnson,2023,USD,1910776,411964,1498812,123317,1375495,0,1375495,19107,38215,1337280,191033,1321131,126219,1194912,,1910776,1121.21,4103.39,0.0772,784,203.1,32253.83,5.92,0.7844
1895,Grant Medina and Clark,False,GB,Laurenfurt,Mobility,2021,https://grantmedinaandclark.com,History during mission imagine meet.,25,grant-medina-and-clark,2023,USD,2848296,1598491,1249805,494335,755470,13170,742300,28482,56965,685335,54448,1553559,231815,1321744,,2848296,20.0,68.23,0.016,1002,236.68,37692.63,1.44,0.4388
1896,Nichols Gomez and Rose,False,DE,Sarahton,Energy,2019,https://nicholsgomezandrose.com,Physical produce high year serve movie civil long.,18,nichols-gomez-and-rose,2023,EUR,1947915,585028,1362887,1069847,293040,27019,266021,19479,38958,227063,18306,1049876,481404,568472,,1947915,721.23,4158.33,0.008,690,235.14,74180.7,0.25,0.6997
1897,Johnson Mendoza and Moore,False,CA,Mooretown,Energy,2016,https://johnsonmendozaandmoore.com,Both protect ten language place leader goal executive letter development.,25,johnson-mendoza-and-moore,2023,USD,1520786,527745,993041,279011,714030,0,714030,15207,30415,683615,132799,1006332,549824,456508,,1520786,20.0,44.98,0.0167,6336,20.0,5006.07,26.53,0.653
1898,Joseph Johnson and Ferguson,False,EG,Port Richardmouth,HealthTech,2012,https://josephjohnsonandferguson.com,Set once write he political get exist nature in through.,25,joseph-johnson-and-ferguson,2023,USD,1653058,409063,1243995,82652,1161343,7975,1153368,16530,33061,1120307,528809,1421815,292849,1128966,137754.83,1653058,480.33,2105.35,0.0486,1939,71.02,8300.48,63.71,0.7525
1899,Hughes-Baker,False,KE,South Nicholashaven,Marketplaces,2015,https://hughes-baker.com,Last attention night several throw base fight issue go.,17,hughes-baker,2023,USD,388703,53013,335690,217210,118480,0,118480,3887,7774,110706,28250,312946,89670,223276,,388703,984.68,3271.96,0.001,844,38.36,1000.0,28.25,0.8636
1900,Flynn Nicholson and Clark,False,FR,Johnland,Cybersecurity,2016,https://flynnnicholsonandclark.com,Any personal keep open chair rest care more which.,22,flynn-nicholson-and-clark,2023,EUR,1255211,249454,1005757,732268,273489,36369,237120,12552,25104,212016,49399,701057,79575,621482,,1255211,1085.39,6361.92,0.1073,384,271.99,72868.68,0.68,0.8013
1901,Rivera-Gibbs,False,AU,Port Terry,EdTech,2021,https://rivera-gibbs.com,Lot drop quality between manager newspaper board situation style.,22,rivera-gibbs,2023,USD,173572,55159,118413,108782,9631,20130,-10499,1735,3471,-13970,17722,164639,44443,120196,14464.33,173572,38.26,126.08,0.0607,316,45.72,5729.97,3.09,0.6822
1902,Watson PLC,False,TN,Nuneztown,EdTech,2012,https://watsonplc.com,Century professor catch heart stand.,27,watson-plc,2023,USD,285388,109674,175714,141761,33953,20079,13874,2853,5707,8167,32935,317465,104527,212938,23782.33,285388,225.07,293.06,0.0498,536,44.31,1000.0,32.94,0.6157
1903,Morris-Barrett,False,AU,Kennethton,Cybersecurity,2012,https://morris-barrett.com,Year result program only nearly decade suggest husband leader.,21,morris-barrett,2023,USD,553981,233631,320350,183447,136903,26311,110592,5539,11079,99513,11590,353525,111934,241591,,553981,20.0,35.63,0.1158,2308,20.0,14688.38,0.79,0.5783
1904,Hicks Taylor and Gray,False,EG,Lewisborough,SaaS,2013,https://hickstaylorandgray.com,Eat detail provide agree oil fact fine.,19,hicks-taylor-and-gray,2023,USD,271791,75856,195935,211327,-15392,13302,-28694,2717,5435,-34129,8494,215953,10797,205156,22649.25,271791,195.68,649.6,0.0238,386,58.58,12772.0,0.67,0.7209
1905,Parker Giles and Odom,False,TN,Holtview,Mobility,2012,https://parkergilesandodom.com,Join nothing which include wrong.,20,parker-giles-and-odom,2023,USD,12669185,3005865,9663320,7458043,2205277,22897,2182380,126691,253383,1928997,429067,6854325,735445,6118880,,12669185,254.17,804.7,0.1059,13121,80.46,603609.12,0.71,0.7627
1906,Webster-Hernandez,False,BR,Steelestad,AI/ML,2018,https://webster-hernandez.com,Miss sometimes church front laugh.,18,webster-hernandez,2023,USD,3321452,1370582,1950870,1851966,98904,0,98904,33214,66429,32475,263239,2108213,703000,1405213,,3321452,20.0,96.52,0.1182,13839,20.0,104530.25,2.52,0.5874
1907,Welch-Brown,False,AU,East John,Mobility,2017,https://welch-brown.com,Difference west although him life table.,22,welch-brown,2023,USD,730687,295635,435052,660776,-225724,29519,-255243,7306,14613,-269856,59879,596392,133146,463246,,730687,384.73,2276.48,0.1044,843,72.22,94104.4,0.64,0.5954
1908,Lopez Inc,False,IN,Aprilton,AI/ML,2009,https://lopezinc.com,Bill might pick sign medical traditional front.,18,lopez-inc,2023,USD,1098688,227941,870747,705095,165652,0,165652,10986,21973,143679,2587,666618,33330,633288,,1098688,1283.79,641.9,0.051,4577,20.0,47289.92,0.05,0.7925
1909,Powell-Williams,False,TN,Port Hectorshire,Fintech,2013,https://powell-williams.com,Maintain network side magazine pass on.,17,powell-williams,2023,USD,915159,337515,577644,331367,246277,17053,229224,9151,18303,210921,9799,562281,70621,491660,,915159,1449.87,3918.27,0.0663,293,260.23,36611.17,0.27,0.6312
1910,Marsh-Butler,False,US,Donaldfurt,EdTech,2016,https://marsh-butler.com,Follow necessary speech tax few choice certain son else new economy.,21,marsh-butler,2023,USD,135815,50029,85786,94611,-8825,11100,-19925,1358,2716,-22641,3369,144712,72238,72474,11317.92,135815,10.0,72.25,0.0336,254,44.53,1000.0,3.37,0.6316
1911,Copeland Lee and Jones,False,EG,Youngland,Marketplaces,2011,https://copelandleeandjones.com,Happen difficult available structure body mouth receive.,18,copeland-lee-and-jones,2023,USD,500426,290755,209671,152046,57625,33949,23676,5004,10008,13668,21954,374140,42565,331575,,500426,508.96,254.48,0.0736,395,105.4,16536.9,1.33,0.419
1912,Shelton-Welch,False,EG,West Kristinbury,Cybersecurity,2018,https://shelton-welch.com,Impact himself agency lawyer site begin may street buy big.,20,shelton-welch,2023,USD,589487,222260,367227,259240,107987,0,107987,5894,11789,96198,10709,368586,141048,227538,,589487,20.0,59.55,0.0022,123,397.68,60399.38,0.18,0.623
1913,Brock Gilbert and Gross,False,IN,Huberberg,E-commerce,2019,https://brockgilbertandgross.com,Risk important need since face why determine.,19,brock-gilbert-and-gross,2023,USD,776169,275015,501154,283265,217889,0,217889,7761,15523,202366,83892,670785,474630,196155,,776169,756.94,378.47,0.001,362,178.59,13401.05,6.26,0.6457
1914,Campbell and Sons,False,NG,New Daleside,AI/ML,2016,https://campbellandsons.com,Fine we game beat region.,19,campbell-and-sons,2023,USD,1606270,528152,1078118,1041159,36959,18493,18466,16062,32125,-13659,29245,900094,45004,855090,,1606270,89.36,228.29,0.0175,1307,102.4,86520.97,0.34,0.6712
1915,Edwards Inc,False,CA,Russotown,SaaS,2021,https://edwardsinc.com,Find although guess ability seat society southern.,20,edwards-inc,2023,USD,100019,26140,73879,32860,41019,0,41019,1000,2000,39019,35369,136314,45029,91285,8334.92,100019,698.66,3730.36,0.0602,436,19.09,1000.0,35.37,0.7386
1916,Chavez-Phillips,False,FR,Roseland,E-commerce,2014,https://chavez-phillips.com,Cup enjoy southern several.,21,chavez-phillips,2023,EUR,1177810,406797,771013,677773,93240,0,93240,11778,23556,69684,254533,992580,189547,803033,,1177810,1127.33,2776.6,0.1082,1795,54.65,49887.7,5.1,0.6546
1917,Nelson-Wells,False,KE,South Mark,IoT,2013,https://nelson-wells.com,Outside so lawyer environment development tax visit enter peace.,18,nelson-wells,2023,USD,323576,138435,185141,108535,76606,0,76606,3235,6471,70135,3804,241403,12070,229333,,323576,20.0,23.02,0.001,1204,22.38,30875.93,0.12,0.5722
1918,Austin Montes and Cole,False,AU,East Charlene,AgriTech,2019,https://austinmontesandcole.com,Hotel wide past become staff identify feel.,15,austin-montes-and-cole,2023,USD,173747,62772,110975,47065,63910,24847,39063,1737,3474,35589,13526,204348,112587,91761,,173747,1296.13,3208.48,0.051,723,20.0,1000.0,13.53,0.6387
1919,Bass Inc,False,CA,East Ronald,Marketplaces,2024,https://bassinc.com,Go wait reflect news girl understand however because student.,29,bass-inc,2023,USD,256157,104911,151246,139137,12109,15813,-3704,2561,5123,-8827,28979,221946,49982,171964,,256157,641.04,2092.13,0.0372,1067,20.0,27426.13,1.06,0.5904
1920,Johnson PLC,False,EG,Schneiderport,Cybersecurity,2022,https://johnsonplc.com,Skill close difficult also use again exactly fact.,20,johnson-plc,2023,USD,1416896,323769,1093127,1058001,35126,0,35126,14168,28337,6789,21893,912116,550413,361703,,1416896,20.0,110.17,0.1275,1290,91.51,64591.62,0.34,0.7715
1921,Ross Greene and Mcdowell,False,FR,Hamptonshire,Energy,2017,https://rossgreeneandmcdowell.com,Opportunity meeting might level together east space agent approach throughout.,15,ross-greene-and-mcdowell,2023,EUR,953882,294440,659442,556401,103041,1392,101649,9538,19077,82572,53905,707358,226915,480443,,953882,745.95,3029.45,0.001,249,318.65,38664.64,1.39,0.6913
1922,Smith-Jones,False,EG,Herringbury,Marketplaces,2012,https://smith-jones.com,Finish traditional other speak staff various know billion use.,15,smith-jones,2023,USD,362023,80422,281601,222996,58605,22290,36315,3620,7240,29075,26975,373215,144916,228299,,362023,20.0,15.71,0.0744,1508,20.0,14463.79,1.87,0.7779
1923,Ramos PLC,False,GB,Collierton,Marketplaces,2018,https://ramosplc.com,Pattern color behavior expert beat will ground.,23,ramos-plc,2023,USD,117180,37326,79854,20309,59545,0,59545,1171,2343,57202,5977,181142,152962,28180,,117180,1102.64,640.24,0.0394,77,125.76,1000.0,5.98,0.6815
1924,Henderson Ramirez and Hall,False,TN,Elizabethchester,Marketplaces,2020,https://hendersonramirezandhall.com,Hear class nothing board simply ago decision doctor.,18,henderson-ramirez-and-hall,2023,USD,807534,341669,465865,700979,-235114,0,-235114,8075,16150,-251264,46782,534815,26740,508075,,807534,20.0,106.35,0.0597,426,157.77,41253.83,1.13,0.5769
1925,Meadows Inc,False,FR,Christinashire,Fintech,2013,https://meadowsinc.com,Conference phone woman Democrat history born science local story dog.,18,meadows-inc,2023,EUR,518355,256190,262165,225921,36244,0,36244,5183,10367,25877,34861,461393,187186,274207,,518355,1268.94,10147.14,0.0515,410,105.11,45299.35,0.77,0.5058
1926,Robinson-Bradley,False,CA,Kathrynberg,EdTech,2018,https://robinson-bradley.com,Media response charge truth society speech state.,25,robinson-bradley,2023,USD,635760,287931,347829,398146,-50317,26329,-76646,6357,12715,-89361,86433,494610,237087,257523,52980.0,635760,16.38,126.58,0.001,846,62.6,5903.13,14.64,0.5471
1927,Bennett Rivera and Stanley,False,CA,Port Timothy,Marketplaces,2017,https://bennettriveraandstanley.com,Network professional end back understand drop office social.,18,bennett-rivera-and-stanley,2023,USD,3228559,1033310,2195249,1139593,1055656,14932,1040724,32285,64571,976153,379577,2119067,1657344,461723,,3228559,2470.26,1635.69,0.0098,1159,232.13,148672.19,2.55,0.6799
1928,Lowery-Myers,False,ZA,South Adamstad,AgriTech,2020,https://lowery-myers.com,Political local director floor parent budget response home fund hotel.,21,lowery-myers,2023,USD,440454,119000,321454,187536,133918,0,133918,4404,8809,125109,45829,284432,24310,260122,,440454,20.0,108.01,0.0483,616,59.53,25253.49,1.81,0.7298
1929,Grant Lopez and Mcdowell,False,IN,Phillipfurt,Mobility,2019,https://grantlopezandmcdowell.com,Standard movement other administration voice production.,15,grant-lopez-and-mcdowell,2023,USD,1067170,501723,565447,459954,105493,0,105493,10671,21343,84150,106415,793035,71343,721692,,1067170,20.0,93.77,0.0588,339,261.64,42395.96,2.51,0.5299
1930,Brewer Ward and Smith,False,ZA,New Jennifer,IoT,2024,https://brewerwardandsmith.com,Product little style between must house west.,25,brewer-ward-and-smith,2023,USD,5966467,2638436,3328031,1648406,1679625,0,1679625,59664,119329,1560296,78951,3112393,1864687,1247706,,5966467,226.31,759.06,0.0701,3221,154.33,140101.95,0.56,0.5578
1931,Hanna Cox and Martinez,False,EG,West Andrewburgh,Energy,2013,https://hannacoxandmartinez.com,World according project six someone book side area.,20,hanna-cox-and-martinez,2023,USD,432272,167508,264764,163025,101739,0,101739,4322,8645,93094,42001,450110,22505,427605,,432272,1290.82,4940.33,0.059,167,215.13,1000.0,42.0,0.6125
1932,Coleman-Perry,False,GB,Leeview,SaaS,2012,https://coleman-perry.com,Whose section phone bank way talk ability.,18,coleman-perry,2023,USD,2619992,982287,1637705,888669,749036,19470,729566,26199,52399,677167,212660,1597936,289446,1308490,218332.67,2619992,28.97,121.98,0.002,3069,71.14,79765.17,2.67,0.6251
1933,Singh Hunt and Rios,False,ZA,New Melissa,EdTech,2016,https://singhhuntandrios.com,Strategy person share rather threat remember night if.,20,singh-hunt-and-rios,2023,USD,396429,82273,314156,261888,52268,3273,48995,3964,7928,41067,29360,246985,133330,113655,33035.75,396429,10.0,18.26,0.0166,1377,23.99,1000.0,29.36,0.7925
1934,Gonzalez and Sons,False,ZA,North Josephview,Cybersecurity,2010,https://gonzalezandsons.com,By put want letter physical physical include too guy first.,15,gonzalez-and-sons,2023,USD,717076,161443,555633,283137,272496,12125,260371,7170,14341,246030,14711,535753,252293,283460,,717076,689.7,2907.98,0.1316,2987,20.0,20006.45,0.74,0.7749
1935,Jones-Taylor,False,DE,Port Vickieside,HealthTech,2020,https://jones-taylor.com,These again degree bank road huge.,17,jones-taylor,2023,EUR,111170,32602,78568,93692,-15124,1550,-16674,1111,2223,-18897,23269,105052,41554,63498,9264.17,111170,244.19,1047.83,0.0296,1852,5.0,1000.0,23.27,0.7067
1936,Martinez-Cruz,False,FR,Port Anthony,Fintech,2010,https://martinez-cruz.com,Including share real job draw medical.,14,martinez-cruz,2023,EUR,525630,194016,331614,204213,127401,7833,119568,5256,10512,109056,10130,285494,201745,83749,,525630,417.88,208.94,0.0791,396,110.4,6395.58,1.58,0.6309
1937,Gentry-Lynch,False,EG,South Melaniechester,AI/ML,2009,https://gentry-lynch.com,Address during different officer attack number direction.,24,gentry-lynch,2023,USD,1003314,234117,769197,94236,674961,8307,666654,10033,20066,646588,54267,701745,611363,90382,,1003314,1287.78,3397.21,0.0686,229,364.58,1000.0,54.27,0.7667
1938,Madden and Sons,False,US,Lake Linda,Energy,2024,https://maddenandsons.com,Treatment company thousand drive on painting person fly team.,14,madden-and-sons,2023,USD,1187216,531553,655663,565194,90469,0,90469,11872,23744,66725,18322,618898,188811,430087,,1187216,2912.06,3501.16,0.0663,519,190.56,75963.44,0.24,0.5523
1939,Edwards PLC,False,AU,Gillview,Fintech,2011,https://edwardsplc.com,Raise everything which soon section investment region.,16,edwards-plc,2023,USD,1934042,1267082,666960,1178009,-511049,0,-511049,19340,38680,-549729,46981,1186377,299345,887032,,1934042,20.0,110.13,0.0138,2366,68.1,109256.09,0.43,0.3449
1940,Graham Rodriguez and Stanton,False,IN,North Kylebury,IoT,2012,https://grahamrodriguezandstanton.com,Animal election painting mind fly matter be.,28,graham-rodriguez-and-stanton,2023,USD,704919,297728,407191,547401,-140210,23666,-163876,7049,14098,-177974,162129,686719,369112,317607,,704919,20.0,123.16,0.0435,2937,20.0,22801.39,7.11,0.5776
1941,Stewart-Bailey,False,FR,Port Daniellefurt,Marketplaces,2020,https://stewart-bailey.com,Sister most upon appear two officer.,32,stewart-bailey,2023,EUR,1522805,482629,1040176,538190,501986,22473,479513,15228,30456,449057,114018,1030395,336307,694088,,1522805,943.28,2595.38,0.0294,1738,73.0,23052.23,4.95,0.6831
1942,Hernandez Reeves and Adams,False,IN,Mckaymouth,EdTech,2015,https://hernandezreevesandadams.com,Break condition right however right describe.,25,hernandez-reeves-and-adams,2023,USD,719758,252320,467438,272754,194684,0,194684,7197,14395,180289,132154,650108,65202,584906,59979.83,719758,278.81,830.45,0.0527,1476,40.63,18530.43,7.13,0.6494
1943,Nguyen LLC,False,ZA,New Lauraburgh,AgriTech,2022,https://nguyenllc.com,Floor price operation week life dinner lay true number own grow.,20,nguyen-llc,2023,USD,135571,41567,94004,113646,-19642,40456,-60098,1355,2711,-62809,5624,151403,70486,80917,,135571,20.0,10.0,0.001,231,48.77,1000.0,5.62,0.6934
1944,Farrell-Stewart,False,BR,Carlosberg,HealthTech,2012,https://farrell-stewart.com,Rest especially be ask push would white.,15,farrell-stewart,2023,USD,587829,86967,500862,116739,384123,7556,376567,5878,11756,364811,126442,495216,301321,193895,48985.75,587829,10.0,51.22,0.0054,4665,10.5,35209.75,3.59,0.8521
1945,Smith-Page,False,NG,Hernandezstad,HealthTech,2008,https://smith-page.com,When leg issue billion half new room civil.,18,smith-page,2023,USD,711500,198453,513047,346373,166674,0,166674,7115,14230,152444,63318,448253,194822,253431,59291.67,711500,473.62,2423.64,0.0331,439,135.02,5989.48,10.57,0.7211
1946,Johnson Inc,False,US,West Raymondbury,Marketplaces,2019,https://johnsoninc.com,Sea meet certainly who pick.,18,johnson-inc,2023,USD,724235,302783,421452,578357,-156905,33886,-190791,7242,14484,-205275,14721,541863,140183,401680,,724235,881.64,2059.91,0.1603,1127,53.53,59525.32,0.25,0.5819
1947,Hansen Dixon and Walker,False,CA,Port Daniel,Mobility,2022,https://hansendixonandwalker.com,Raise miss dark commercial kid respond word several fact.,28,hansen-dixon-and-walker,2023,USD,648811,298947,349864,437174,-87310,30070,-117380,6488,12976,-130356,20875,448109,47254,400855,,648811,161.18,528.94,0.003,2073,26.08,3768.59,5.54,0.5392
1948,Hernandez-Smith,False,NG,North Caleb,AgriTech,2022,https://hernandez-smith.com,Suddenly nearly case like stop attorney radio civil party.,17,hernandez-smith,2023,USD,670542,267386,403156,271258,131898,0,131898,6705,13410,118488,19431,482641,164792,317849,,670542,380.34,1777.04,0.0089,2793,20.0,25745.33,0.75,0.6012
1949,Gill-Clark,False,GB,Nguyenburgh,Cybersecurity,2013,https://gill-clark.com,Rule force forward range affect whatever those allow boy field Mrs.,19,gill-clark,2023,USD,507890,280173,227717,58732,168985,12971,156014,5078,10157,145857,125086,555734,306255,249479,,507890,226.86,748.22,0.001,383,110.5,17208.48,7.27,0.4484
1950,Mckinney-Anderson,False,KE,East Hannah,IoT,2022,https://mckinney-anderson.com,Decide action later can.,21,mckinney-anderson,2023,USD,851033,528222,322811,810092,-487281,5344,-492625,8510,17020,-509645,41613,530130,114741,415389,,851033,1714.98,1725.05,0.0302,965,73.49,90355.82,0.46,0.3793
1951,Johnson-Reese,False,BR,North Janice,Cybersecurity,2021,https://johnson-reese.com,Prove raise theory policy culture lead.,18,johnson-reese,2023,USD,287329,79576,207753,126503,81250,0,81250,2873,5746,75504,8610,265858,97140,168718,,287329,1192.48,763.49,0.001,403,59.39,1000.0,8.61,0.723
1952,Andrews Group,False,NG,Port Sue,Marketplaces,2017,https://andrewsgroup.com,Ten born indeed how buy.,21,andrews-group,2023,USD,226014,47874,178140,139108,39032,5901,33131,2260,4520,28611,1465,234610,29069,205541,,226014,20.0,13.75,0.0644,161,116.42,19898.69,0.07,0.7882
1953,Salazar-Huff,False,CA,Acostaport,Mobility,2015,https://salazar-huff.com,Eat teach effect everything.,25,salazar-huff,2023,USD,719786,275652,444134,529341,-85207,21643,-106850,7197,14395,-121245,15753,454097,161471,292626,,719786,735.06,1100.56,0.1392,301,199.22,49035.91,0.32,0.617
1954,Brown-Smith,False,AU,South Petershire,Fintech,2022,https://brown-smith.com,Above rate explain small former agree forget pretty majority.,21,brown-smith,2023,USD,7351163,2690604,4660559,1102005,3558554,18204,3540350,73511,147023,3393327,224431,4032241,3174070,858171,,7351163,92.51,286.38,0.0183,19410,31.56,136003.77,1.65,0.634
1955,Thomas-Dougherty,False,IN,New Adam,E-commerce,2021,https://thomas-dougherty.com,Fast budget accept stand pressure who.,23,thomas-dougherty,2023,USD,6034735,3347272,2687463,2834176,-146713,0,-146713,60347,120694,-267407,225963,3285105,793656,2491449,,6034735,844.53,543.36,0.001,17449,28.82,241005.84,0.94,0.4453
1956,Gilbert-Good,False,IN,Garciaborough,HealthTech,2017,https://gilbert-good.com,Form class former civil each class.,9,gilbert-good,2023,USD,1413786,390393,1023393,276723,746670,29985,716685,14137,28275,688410,66757,808283,40414,767869,117815.5,1413786,71.96,183.41,0.0292,18408,6.4,1198.71,55.69,0.7239
1957,Mcguire Tran and Williams,False,US,South Deborah,SaaS,2024,https://mcguiretranandwilliams.com,Dog TV science west surface fill yet.,28,mcguire-tran-and-williams,2023,USD,705344,242808,462536,431836,30700,29895,805,7053,14106,-13301,27150,552736,402177,150559,58778.67,705344,10.0,57.99,0.0596,1100,53.39,22368.98,1.21,0.6558
1958,Mays Ltd,False,AU,New Michael,HealthTech,2019,https://maysltd.com,Beautiful trip simply stage floor.,23,mays-ltd,2023,USD,14159170,5911671,8247499,8921268,-673769,39184,-712953,141591,283183,-996136,538323,7741823,3908724,3833099,1179930.83,14159170,537.14,4280.38,0.0114,9632,122.5,764066.96,0.7,0.5825
1959,Graham White and Griffin,False,IN,South Billy,Mobility,2008,https://grahamwhiteandgriffin.com,Work everybody onto wide after.,18,graham-white-and-griffin,2023,USD,475651,111619,364032,203221,160811,0,160811,4756,9513,151298,128819,512934,47828,465106,,475651,1454.72,727.36,0.0602,201,196.69,2139.85,60.2,0.7653
1960,Lang-Ferguson,False,ZA,Lake Katherinefort,Mobility,2023,https://lang-ferguson.com,Student it son support finally too.,20,lang-ferguson,2023,USD,1456781,180862,1275919,671380,604539,5111,599428,14567,29135,570293,37177,793376,39668,753708,,1456781,20.0,63.95,0.0927,1338,90.67,61536.64,0.6,0.8758
1961,Lynch and Sons,False,IN,Susanmouth,SaaS,2021,https://lynchandsons.com,Produce hair these and say good image.,22,lynch-and-sons,2023,USD,878811,603671,275140,442189,-167049,23983,-191032,8788,17576,-208608,23849,644144,434064,210080,73234.25,878811,355.06,637.62,0.0037,1718,42.61,53211.63,0.45,0.3131
1962,Wallace-Greene,False,AU,North Erinmouth,AgriTech,2015,https://wallace-greene.com,Something difference remember serve life will kind economic short raise.,27,wallace-greene,2023,USD,134535,27757,106778,93576,13202,0,13202,1345,2690,10512,13208,174864,70220,104644,,134535,1583.99,3480.51,0.0335,560,20.0,3886.58,3.4,0.7937
1963,Osborn Inc,False,AU,Tammyshire,SaaS,2019,https://osborninc.com,Treatment although series there process who consider since cut.,17,osborn-inc,2023,USD,3055599,836728,2218871,1856151,362720,0,362720,30555,61111,301609,81440,1782502,180046,1602456,254633.25,3055599,10.0,58.66,0.0235,2850,89.33,182279.45,0.45,0.7262
1964,Boyd Frank and Brown,False,DE,West Stephen,Energy,2021,https://boydfrankandbrown.com,Candidate medical official might pay.,16,boyd-frank-and-brown,2023,EUR,26322481,10949495,15372986,14316798,1056188,0,1056188,263224,526449,529739,680428,13846512,6039178,7807334,,26322481,20.0,103.54,0.0545,44995,48.75,1234779.92,0.55,0.584
1965,Smith Group,False,TN,Peterville,EdTech,2013,https://smithgroup.com,Security room occur sense look.,27,smith-group,2023,USD,267361,107230,160131,38004,122127,0,122127,2673,5347,116780,37727,369140,216228,152912,22280.08,267361,10.0,53.5,0.0685,310,71.69,17164.51,2.2,0.5989
1966,Martinez Garcia and Escobar,False,ZA,Heatherton,Cybersecurity,2020,https://martinezgarciaandescobar.com,Deep quality security think quality think certainly.,17,martinez-garcia-and-escobar,2023,USD,2669569,1354105,1315464,1645621,-330157,55,-330212,26695,53391,-383603,101698,1631557,742424,889133,,2669569,1270.8,635.4,0.0684,2739,81.21,141662.59,0.72,0.4928
1967,Gross-Richmond,False,TN,Huntville,EdTech,2016,https://gross-richmond.com,Significant election dog offer how drug Republican to across about.,19,gross-richmond,2023,USD,77040,20248,56792,45245,11547,8907,2640,770,1540,1100,11845,70463,10009,60454,6420.0,77040,105.98,610.42,0.001,53,119.97,4239.1,2.79,0.7372
1968,Crawford LLC,False,FR,Kimberlymouth,Energy,2015,https://crawfordllc.com,Range politics education son everyone sure amount idea town.,16,crawford-llc,2023,EUR,982671,536755,445916,483193,-37277,49987,-87264,9826,19653,-106917,107642,790211,353048,437163,,982671,1087.57,4613.6,0.001,1729,47.36,44492.42,2.42,0.4538
1969,Manning and Sons,False,NG,Bowmanmouth,IoT,2016,https://manningandsons.com,Pressure fear later great nothing ready all.,21,manning-and-sons,2023,USD,1694323,450461,1243862,815664,428198,1337,426861,16943,33886,392975,84527,977294,241528,735766,,1694323,20.0,74.8,0.0793,1351,104.47,56414.36,1.5,0.7341
1970,Green Peterson and Pearson,False,IN,New Zachary,Marketplaces,2016,https://greenpetersonandpearson.com,Pm television scientist left paper situation whom hair talk late series.,20,green-peterson-and-pearson,2023,USD,305289,81804,223485,191308,32177,3984,28193,3052,6105,22088,5153,177108,8855,168253,,305289,1022.93,1138.8,0.0578,82,309.18,20663.39,0.25,0.732
1971,Crawford Butler and Andersen,False,TN,South Thomasport,EdTech,2010,https://crawfordbutlerandandersen.com,Yard quality major western decision you.,14,crawford-butler-and-andersen,2023,USD,531528,260301,271227,26576,244651,0,244651,5315,10630,234021,8326,473484,93422,380062,44294.0,531528,241.97,1619.26,0.0063,687,64.39,1000.0,8.33,0.5103
1972,Santiago Drake and Larsen,False,GB,Bernardville,HealthTech,2017,https://santiagodrakeandlarsen.com,First agent phone man movement hold.,16,santiago-drake-and-larsen,2023,USD,318183,78010,240173,65438,174735,8495,166240,3181,6363,159877,15477,336267,127409,208858,26515.25,318183,126.23,331.35,0.0483,5303,5.0,10393.42,1.49,0.7548
1973,Hernandez and Sons,False,FR,Justinbury,Marketplaces,2022,https://hernandezandsons.com,Impact onto future west four she.,19,hernandez-and-sons,2023,EUR,401761,150044,251717,310560,-58843,0,-58843,4017,8035,-66878,8994,306002,187556,118446,,401761,20.0,121.35,0.1029,1674,20.0,33575.3,0.27,0.6265
1974,Lopez Miller and Key,False,KE,Port Frances,Mobility,2016,https://lopezmillerandkey.com,Fire city down reason represent speak expect late.,20,lopez-miller-and-key,2023,USD,367026,109490,257536,270035,-12499,4554,-17053,3670,7340,-24393,5720,339306,92179,247127,,367026,325.68,2126.87,0.001,299,102.16,18755.97,0.3,0.7017
1975,Wheeler-Brown,False,ZA,East John,IoT,2023,https://wheeler-brown.com,Maintain factor society form almost drug ground happy reason.,18,wheeler-brown,2023,USD,287615,122718,164897,23446,141451,20616,120835,2876,5752,115083,24424,330399,251461,78938,,287615,20.0,60.42,0.001,165,144.71,7773.1,3.14,0.5733
1976,Gentry and Sons,False,DE,North Robertfort,E-commerce,2008,https://gentryandsons.com,Available individual finally view society nor son.,10,gentry-and-sons,2023,EUR,888381,422082,466299,364644,101655,38452,63203,8883,17767,45436,66104,682968,71077,611891,,888381,20.0,73.6,0.0627,238,309.76,3578.62,18.47,0.5249
1977,Rodriguez-Moore,False,GB,Lake Carla,SaaS,2008,https://rodriguez-moore.com,Local run size successful foot join.,20,rodriguez-moore,2023,USD,664725,225519,439206,476178,-36972,9498,-46470,6647,13294,-59764,70963,426995,187478,239517,55393.75,664725,117.38,660.98,0.0795,2344,23.63,27578.44,2.57,0.6607
1978,Garcia-Moore,False,GB,New Debra,Fintech,2017,https://garcia-moore.com,Ago hit exist newspaper good provide view he food vote oil.,21,garcia-moore,2023,USD,11679357,4489367,7189990,3413365,3776625,0,3776625,116793,233587,3543038,430774,6450745,3728051,2722694,,11679357,1043.16,521.58,0.0993,48663,20.0,270520.07,1.59,0.6156
1979,Martinez Group,False,IN,Lake Marvin,HealthTech,2022,https://martinezgroup.com,Matter maintain much soon.,17,martinez-group,2023,USD,271993,110495,161498,74736,86762,0,86762,2719,5439,81323,54921,318844,252585,66259,22666.08,271993,300.15,1141.97,0.0138,295,76.77,37979.18,1.45,0.5938
1980,Livingston-Robinson,False,ZA,South Robert,SaaS,2015,https://livingston-robinson.com,Office over enjoy statement along mind.,11,livingston-robinson,2023,USD,4692282,1074095,3618187,2617337,1000850,0,1000850,46922,93845,907005,70288,2584565,1790673,793892,391023.5,4692282,450.73,1004.05,0.001,4298,90.97,198941.85,0.35,0.7711
1981,Harmon Sanchez and Cunningham,False,FR,South Pamela,HealthTech,2008,https://harmonsanchezandcunningham.com,Admit water contain artist know we put hundred leader painting.,31,harmon-sanchez-and-cunningham,2023,EUR,3328412,683679,2644733,1026195,1618538,37654,1580884,33284,66568,1514316,33954,1704362,671310,1033052,277367.67,3328412,557.34,2060.85,0.0453,3101,89.42,95396.28,0.36,0.7946
1982,Schneider-Moon,False,EG,Lake Carlosmouth,EdTech,2018,https://schneider-moon.com,Common argue once decade finally.,26,schneider-moon,2023,USD,186139,54073,132066,129157,2909,31099,-28190,1861,3722,-31912,31382,260969,175577,85392,15511.58,186139,10.0,58.71,0.0308,1363,11.38,24260.31,1.29,0.7095
1983,Bryant PLC,False,TN,Shannonville,AgriTech,2023,https://bryantplc.com,Consumer available power rate sense stand open play.,23,bryant-plc,2023,USD,56673,24468,32205,16552,15653,10110,5543,566,1133,4410,6409,170402,45235,125167,,56673,20.0,10.0,0.0251,119,39.66,1000.0,6.41,0.5683
1984,Yang and Sons,False,CA,Loganberg,Mobility,2009,https://yangandsons.com,Able front agent be community.,18,yang-and-sons,2023,USD,587751,312081,275670,146088,129582,0,129582,5877,11755,117827,25589,333928,28878,305050,,587751,1120.63,1780.16,0.0456,401,121.95,1000.0,25.59,0.469
1985,Williams-Brown,False,CA,East William,Fintech,2012,https://williams-brown.com,Know evidence law approach experience nice make must threat.,11,williams-brown,2023,USD,1046859,587776,459083,1125252,-666169,0,-666169,10468,20937,-687106,31389,610334,266365,343969,,1046859,138.18,142.95,0.001,1234,70.68,133926.63,0.23,0.4385
1986,Macdonald and Sons,False,US,South Jamesburgh,AgriTech,2020,https://macdonaldandsons.com,Store section ago bad you instead officer apply fact indeed.,18,macdonald-and-sons,2023,USD,307409,121840,185569,152770,32799,23765,9034,3074,6148,2886,32066,329473,129147,200326,,307409,692.96,1086.13,0.0413,343,74.51,8618.98,3.72,0.6037
1987,Diaz-Riley,False,FR,Lake Nicole,AI/ML,2023,https://diaz-riley.com,Impact suddenly indicate realize affect interview store enter choose.,20,diaz-riley,2023,EUR,1924694,1098914,825780,987242,-161462,413,-161875,19246,38493,-200368,35857,1097520,113468,984052,,1924694,20.0,92.27,0.0072,4650,34.49,75548.77,0.47,0.429
1988,Scott Velasquez and Cooper,False,GB,Stevenmouth,EdTech,2016,https://scottvelasquezandcooper.com,Letter economy manager town end kid special recognize evening fish.,26,scott-velasquez-and-cooper,2023,USD,287664,46949,240715,77299,163416,0,163416,2876,5753,157663,11450,242346,121588,120758,23972.0,287664,10.0,32.33,0.0186,319,75.07,40770.46,0.28,0.8368
1989,Ellis-Dillon,False,TN,Millerhaven,SaaS,2011,https://ellis-dillon.com,Parent well check fill human article out mention writer.,16,ellis-dillon,2023,USD,1305247,474132,831115,678069,153046,0,153046,13052,26104,126942,97655,872301,221835,650466,108770.58,1305247,68.58,357.9,0.049,7579,14.35,69873.62,1.4,0.6367
1990,Mcdaniel-Jones,False,AU,Scottmouth,Cybersecurity,2015,https://mcdaniel-jones.com,Ability cultural manage population walk.,21,mcdaniel-jones,2023,USD,571016,252607,318409,257411,60998,34629,26369,5710,11420,14949,29512,488343,101195,387148,,571016,773.25,386.62,0.1029,185,256.05,23958.42,1.23,0.5576
1991,Cook Ltd,False,TN,Danielstown,Mobility,2015,https://cookltd.com,Avoid stuff political her yourself wide.,22,cook-ltd,2023,USD,3104300,1367919,1736381,1520267,216114,11804,204310,31043,62086,142224,17776,1587717,793364,794353,,3104300,1019.1,1114.74,0.0259,1090,237.12,81973.72,0.22,0.5593
1992,Massey Fields and Thomas,False,ZA,North Nicole,SaaS,2014,https://masseyfieldsandthomas.com,Card range draw health rate bar human.,20,massey-fields-and-thomas,2023,USD,1041731,436696,605035,612029,-6994,0,-6994,10417,20834,-27828,4577,661052,339617,321435,86810.92,1041731,153.79,579.97,0.0738,1681,51.64,68651.26,0.07,0.5808
1993,Miller PLC,False,EG,New Angelaview,Cybersecurity,2011,https://millerplc.com,After key us budget ability method rich hundred the bill.,18,miller-plc,2023,USD,304039,88195,215844,144142,71702,0,71702,3040,6080,65622,23341,203100,36617,166483,,304039,20.0,36.62,0.0729,147,171.68,26520.77,0.88,0.7099
1994,Williams Group,False,NG,Lake Stacyfort,Marketplaces,2014,https://williamsgroup.com,Around difficult interesting nature health kind here.,20,williams-group,2023,USD,352548,159631,192917,153511,39406,0,39406,3525,7050,32356,86146,366085,119862,246223,,352548,20.0,10.0,0.0384,170,172.24,9511.44,9.06,0.5472
1995,Hernandez Barr and Gutierrez,False,EG,West Terriland,Energy,2017,https://hernandezbarrandgutierrez.com,Unit number a put anything.,14,hernandez-barr-and-gutierrez,2023,USD,1094068,209048,885020,892267,-7247,33112,-40359,10940,21881,-62240,220820,880321,99378,780943,,1094068,699.45,1947.27,0.001,1752,52.02,100477.56,2.2,0.8089
1996,Crawford Ltd,False,CA,Anthonyburgh,HealthTech,2009,https://crawfordltd.com,Head chance professor north.,13,crawford-ltd,2023,USD,5156556,2736695,2419861,4757416,-2337555,1624,-2339179,51565,103131,-2442310,207184,2850872,1004754,1846118,429713.0,5156556,164.87,295.74,0.0105,85942,5.0,400234.1,0.52,0.4693
1997,Parks Ltd,False,ZA,Lake Felicia,AI/ML,2024,https://parksltd.com,Allow activity push per though hair.,15,parks-ltd,2023,USD,2471215,513639,1957576,1595623,361953,0,361953,24712,49424,312529,321293,1682707,447988,1234719,,2471215,20.0,57.91,0.0888,2479,83.07,152119.03,2.11,0.7922
1998,Gibbs Kennedy and Wong,False,FR,Daniellechester,AgriTech,2023,https://gibbskennedyandwong.com,Organization security later finally story cold character production.,26,gibbs-kennedy-and-wong,2023,EUR,976075,262623,713452,340882,372570,2595,369975,9760,19521,350454,99229,723296,164294,559002,,976075,20.0,71.48,0.0858,875,92.9,15857.71,6.26,0.7309
1999,Gilbert Harmon and Caldwell,False,BR,North Juan,AgriTech,2014,https://gilbertharmonandcaldwell.com,Exist glass responsibility kid always soldier quite hand.,15,gilbert-harmon-and-caldwell,2023,USD,832384,114048,718336,237552,480784,19183,461601,8323,16647,444954,22139,524541,113531,411010,,832384,1151.58,3251.95,0.0473,332,208.57,25149.67,0.88,0.863
2000,Allen PLC,False,CA,Port Sean,SaaS,2014,https://allenplc.com,Someone how of situation part here boy put heavy.,22,allen-plc,2023,USD,3421950,754744,2667206,1304760,1362446,554,1361892,34219,68439,1293453,706779,2503374,646524,1856850,285162.5,3421950,456.84,1280.23,0.0367,5731,49.75,112630.37,6.28,0.7794
2001,Monroe LLC,False,FR,Tylerland,EdTech,2021,https://monroellc.com,Feeling price son minute past hospital meeting every open.,27,monroe-llc,2023,EUR,415449,138389,277060,181404,95656,0,95656,4154,8308,87348,17721,276862,37921,238941,34620.75,415449,1159.69,3335.25,0.0507,831,41.62,5249.01,3.38,0.6669
2002,Robertson and Sons,False,CA,Wesleyburgh,SaaS,2013,https://robertsonandsons.com,Same purpose know enter agree pay newspaper.,15,robertson-and-sons,2023,USD,2497173,799283,1697890,124858,1573032,0,1573032,24971,49943,1523089,182849,1612095,518523,1093572,208097.75,2497173,72.66,166.68,0.0187,3455,60.23,18142.28,10.08,0.6799
2003,White LLC,False,AU,West Dustin,AgriTech,2011,https://whitellc.com,Say body top bed while treat million song technology.,24,white-llc,2023,USD,139846,81250,58596,38213,20383,457,19926,1398,2796,17130,32865,170895,8544,162351,,139846,20.0,45.63,0.0171,59,196.69,25551.94,1.29,0.419
2004,Wright Byrd and Prince,False,TN,Candaceburgh,EdTech,2008,https://wrightbyrdandprince.com,Drug step include matter decide.,17,wright-byrd-and-prince,2023,USD,623984,133671,490313,488123,2190,5522,-3332,6239,12479,-15811,90493,540260,27013,513247,51998.67,623984,59.25,331.24,0.0165,1343,38.71,62656.32,1.44,0.7858
2005,Gibson Benson and Curtis,False,US,Port Billberg,IoT,2023,https://gibsonbensonandcurtis.com,Prevent industry choice pattern way production.,15,gibson-benson-and-curtis,2023,USD,528791,135865,392926,262380,130546,0,130546,5287,10575,119971,28482,450006,132994,317012,,528791,358.53,858.42,0.0177,2203,20.0,64925.43,0.44,0.7431
2006,Smith LLC,False,ZA,Amyburgh,IoT,2012,https://smithllc.com,Military this machine social ten responsibility cell ask serve example.,23,smith-llc,2023,USD,373470,174143,199327,126671,72656,20212,52444,3734,7469,44975,14697,386133,62662,323471,,373470,2039.61,2167.42,0.0588,1556,20.0,7378.96,1.99,0.5337
2007,Scott Daniel and Ramirez,False,CA,Paulport,Fintech,2015,https://scottdanielandramirez.com,On very when loss natural edge.,21,scott-daniel-and-ramirez,2023,USD,1377704,68885,1308819,332943,975876,19892,955984,13777,27554,928430,132569,836256,133524,702732,,1377704,574.23,619.83,0.0445,609,188.3,22952.69,5.78,0.95
2008,Hatfield-Hobbs,False,GB,West Russellmouth,Mobility,2010,https://hatfield-hobbs.com,Material movement speak general century strategy.,24,hatfield-hobbs,2023,USD,664210,270019,394191,375810,18381,0,18381,6642,13284,5097,22288,401220,97838,303382,,664210,838.2,3420.33,0.001,729,75.92,20606.7,1.08,0.5935
2009,Coleman Group,False,BR,Lawrenceside,IoT,2018,https://colemangroup.com,Leave like fall forget election later far attorney everyone break.,14,coleman-group,2023,USD,432822,181931,250891,43247,207644,19129,188515,4328,8656,179859,7013,404160,161530,242630,,432822,1027.16,4030.45,0.0911,237,151.74,1000.0,7.01,0.5797
2010,Howe Taylor and Walls,False,AU,South Wanda,Marketplaces,2009,https://howetaylorandwalls.com,Reality while itself receive.,18,howe-taylor-and-walls,2023,USD,2330081,1086744,1243337,1756779,-513442,3940,-517382,23300,46601,-563983,199365,1455288,503156,952132,,2330081,234.32,520.51,0.0089,2076,93.53,114059.52,1.75,0.5336
2011,Alvarado-Brown,False,US,West Nicholas,E-commerce,2012,https://alvarado-brown.com,Middle agree check everything within expert far.,19,alvarado-brown,2023,USD,801988,267777,534211,580559,-46348,43663,-90011,8019,16039,-106050,47049,529145,168585,360560,,801988,526.26,263.13,0.1189,516,129.52,78959.94,0.6,0.6661
2012,Sanchez Higgins and Caldwell,False,ZA,Wilsonland,AI/ML,2011,https://sanchezhigginsandcaldwell.com,Important sound carry car TV test artist walk.,24,sanchez-higgins-and-caldwell,2023,USD,817699,345193,472506,259297,213209,0,213209,8176,16353,196856,77109,585369,148217,437152,,817699,306.19,993.35,0.0381,1642,41.49,29529.39,2.61,0.5778
2013,Johnson-Barnes,False,GB,Aprilmouth,Mobility,2015,https://johnson-barnes.com,Bill along religious last under drop apply.,21,johnson-barnes,2023,USD,505073,164566,340507,25253,315254,23874,291380,5050,10101,281279,18594,356174,148795,207379,,505073,519.06,2499.23,0.132,2104,20.0,1000.0,18.59,0.6742
2014,Horne-Thompson,False,CA,Joneschester,AI/ML,2019,https://horne-thompson.com,Expect lead them industry technology son.,17,horne-thompson,2023,USD,921026,356892,564134,642532,-78398,7868,-86266,9210,18420,-104686,9505,506201,133942,372259,,921026,20.0,101.51,0.1436,1324,57.93,25348.02,0.37,0.6125
2015,Anderson Inc,False,AU,New Holly,Mobility,2014,https://andersoninc.com,Name control tough much something town indicate five think.,20,anderson-inc,2023,USD,562173,206420,355753,140104,215649,9684,205965,5621,11243,194722,20955,426874,120066,306808,,562173,20.0,94.11,0.001,813,57.56,26822.6,0.78,0.6328
2016,Dean-Dixon,False,US,Bennettstad,Cybersecurity,2020,https://dean-dixon.com,For street bag us close take quite compare cause.,26,dean-dixon,2023,USD,1251109,271152,979957,359300,620657,40546,580111,12511,25022,555089,122598,886969,79716,807253,,1251109,1332.61,6876.53,0.0816,987,105.63,17735.41,6.91,0.7833
2017,Melendez PLC,False,CA,Reynoldston,Cybersecurity,2012,https://melendezplc.com,Street party hope two paper seven compare may.,19,melendez-plc,2023,USD,2812969,1558392,1254577,1343787,-89210,3037,-92247,28129,56259,-148506,173302,1604354,632157,972197,,2812969,655.62,355.04,0.0261,1665,140.73,111039.53,1.56,0.446
2018,Holder PLC,False,IN,Shaneton,SaaS,2023,https://holderplc.com,Child drug prove style cold pay new toward.,24,holder-plc,2023,USD,185067,53016,132051,141971,-9920,29492,-39412,1850,3701,-43113,16883,287099,29085,258014,15422.25,185067,72.11,161.04,0.0705,1452,10.62,1000.0,16.88,0.7135
2019,Sparks and Sons,False,ZA,Lake Erik,Mobility,2017,https://sparksandsons.com,Debate item high job.,22,sparks-and-sons,2023,USD,855459,474537,380922,118906,262016,0,262016,8554,17109,244907,53294,481156,176668,304488,,855459,269.91,648.61,0.0654,557,127.91,1000.0,53.29,0.4453
2020,Martinez-Ramos,False,NG,Gardnerberg,Cybersecurity,2023,https://martinez-ramos.com,War reflect sing control century leg her ahead during.,14,martinez-ramos,2023,USD,442092,46415,395677,376040,19637,11843,7794,4420,8841,-1047,61061,369708,53737,315971,,442092,1692.72,10848.3,0.0589,661,55.67,55874.32,1.09,0.895
2021,Wagner Group,False,DE,Hoffmanview,IoT,2013,https://wagnergroup.com,Wide what account consider Mr statement entire plan spend.,22,wagner-group,2023,EUR,469973,133149,336824,216712,120112,0,120112,4699,9399,110713,14581,281948,132421,149527,,469973,778.04,1169.52,0.0348,280,139.46,1828.69,7.97,0.7167
2022,Padilla Castillo and Peterson,False,NG,Thompsonberg,E-commerce,2018,https://padillacastilloandpeterson.com,Matter research already effort defense most relationship like article.,17,padilla-castillo-and-peterson,2023,USD,1298917,534668,764249,654893,109356,39084,70272,12989,25978,44294,164114,883547,140263,743284,,1298917,20.0,10.0,0.0978,303,356.59,44707.92,3.67,0.5884
2023,Parsons and Sons,False,ZA,East Andrea,Mobility,2016,https://parsonsandsons.com,Type against remember small among risk charge garden face.,19,parsons-and-sons,2023,USD,5303346,2456573,2846773,2110716,736057,0,736057,53033,106066,629991,70024,2809332,594840,2214492,,5303346,781.77,3434.53,0.001,2137,206.72,178789.48,0.39,0.5368
2024,Boyd-Barber,False,KE,New Laura,AI/ML,2013,https://boyd-barber.com,Power fall billion live newspaper take attorney small instead.,20,boyd-barber,2023,USD,682639,184116,498523,452675,45848,16265,29583,6826,13652,15931,15008,501708,25085,476623,,682639,605.53,2172.5,0.0197,811,70.09,26580.83,0.56,0.7303
2025,Ross-Newman,False,FR,New Peter,AI/ML,2012,https://ross-newman.com,Herself act white everything provide today second issue.,25,ross-newman,2023,EUR,227232,80060,147172,160157,-12985,0,-12985,2272,4544,-17529,13337,231479,100262,131217,,227232,20.0,10.0,0.1352,177,106.63,1000.0,13.34,0.6477
2026,Perez Lopez and White,False,EG,Lake Frankside,AgriTech,2016,https://perezlopezandwhite.com,Form movement truth just action support through dream past vote.,19,perez-lopez-and-white,2023,USD,79748,28010,51738,18841,32897,13314,19583,797,1594,17989,5934,89089,47331,41758,,79748,1462.54,5844.23,0.0594,83,79.34,17650.37,0.34,0.6488
2027,Pittman Byrd and Ramirez,False,NG,South Joshua,E-commerce,2022,https://pittmanbyrdandramirez.com,Include player organization deal be want another teacher each.,25,pittman-byrd-and-ramirez,2023,USD,2114110,758436,1355674,105705,1249969,22262,1227707,21141,42282,1185425,160335,1401541,1170902,230639,,2114110,20.0,79.55,0.0147,1806,97.53,22588.67,7.1,0.6413
2028,Johnson Wilson and Griffith,False,US,Davisfurt,Marketplaces,2024,https://johnsonwilsonandgriffith.com,Name easy interest person fly thought.,18,johnson-wilson-and-griffith,2023,USD,1084025,350014,734011,54201,679810,0,679810,10840,21680,658130,247412,951120,394047,557073,,1084025,187.0,318.16,0.0518,360,250.73,12656.14,19.55,0.6771
2029,Johnson Ltd,False,TN,North Michaelborough,Cybersecurity,2013,https://johnsonltd.com,Lead study culture idea again player.,17,johnson-ltd,2023,USD,3329675,814635,2515040,1354541,1160499,1451,1159048,33296,66593,1092455,35673,1767869,747113,1020756,,3329675,1771.83,4561.85,0.1855,13873,20.0,125929.13,0.28,0.7553
2030,Henry-Dixon,False,US,Jonesmouth,IoT,2019,https://henry-dixon.com,Hand issue per leg trouble property fast whether.,18,henry-dixon,2023,USD,496691,235002,261689,542255,-280566,0,-280566,4966,9933,-290499,18630,315046,121231,193815,,496691,106.35,53.18,0.001,2069,20.0,27587.51,0.68,0.5269
2031,Carroll-Carr,False,AU,Theresatown,IoT,2015,https://carroll-carr.com,Food possible read hit none place kitchen feel.,23,carroll-carr,2023,USD,145726,39833,105893,89047,16846,0,16846,1457,2914,13932,35566,122572,47278,75294,,145726,1228.42,2593.01,0.001,607,20.0,1000.0,35.57,0.7267
2032,Hutchinson-Krueger,False,CA,Priscillaside,Cybersecurity,2010,https://hutchinson-krueger.com,Person walk ready capital table to century.,23,hutchinson-krueger,2023,USD,834850,264373,570477,570822,-345,0,-345,8348,16697,-17042,85507,665587,255023,410564,,834850,1715.52,4516.45,0.0959,3478,20.0,24657.75,3.47,0.6833
2033,Dunlap Ltd,False,BR,Port Katherine,AI/ML,2020,https://dunlapltd.com,Practice benefit attack pick continue federal traditional man.,16,dunlap-ltd,2023,USD,777801,183265,594536,432860,161676,3751,157925,7778,15556,142369,281273,728187,199764,528423,,777801,20.0,117.44,0.001,406,159.59,37260.99,7.55,0.7644
2034,Phillips Hernandez and Lara,False,DE,Port Lindsayberg,AI/ML,2023,https://phillipshernandezandlara.com,Piece share think leg agent room natural feel arm.,27,phillips-hernandez-and-lara,2023,EUR,122472,11202,111270,29413,81857,0,81857,1224,2449,79408,43306,286629,106012,180617,,122472,1886.07,8661.62,0.2271,34,292.51,5572.55,7.77,0.9085
2035,Cox Garrison and Jackson,False,AU,Port Garyport,AI/ML,2012,https://coxgarrisonandjackson.com,Act reduce old your job face structure.,20,cox-garrison-and-jackson,2023,USD,599728,321474,278254,241886,36368,31524,4844,5997,11994,-7150,67033,442141,180770,261371,,599728,20.0,67.56,0.0758,2498,20.0,27094.47,2.47,0.464
2036,Johnston Inc,False,KE,Port Jennifer,AgriTech,2018,https://johnstoninc.com,Top gun store clearly long first nothing religious executive stage.,17,johnston-inc,2023,USD,472759,143453,329306,60620,268686,13986,254700,4727,9455,245245,80774,463574,122495,341079,,472759,205.02,430.44,0.001,665,59.2,1000.0,80.77,0.6966
2037,Gentry Davis and Mcbride,False,TN,East Mark,Marketplaces,2018,https://gentrydavisandmcbride.com,Account network organization western site daughter few white.,16,gentry-davis-and-mcbride,2023,USD,723076,253171,469905,408349,61556,0,61556,7230,14461,47095,1322,488049,110640,377409,,723076,1208.01,1448.07,0.014,949,63.47,45662.49,0.03,0.6499
2038,Green PLC,False,FR,Thomasborough,Fintech,2024,https://greenplc.com,Over rate it compare left natural.,21,green-plc,2023,EUR,2468415,902560,1565855,1465645,100210,0,100210,24684,49368,50842,93768,1330091,522553,807538,,2468415,20.0,125.08,0.0262,1488,138.16,174742.79,0.54,0.6344
2039,Lopez and Sons,False,BR,Loriville,Fintech,2009,https://lopezandsons.com,Character significant people third remain.,17,lopez-and-sons,2023,USD,1605870,735213,870657,1233970,-363313,0,-363313,16058,32117,-395430,57513,976451,706162,270289,,1605870,20.0,10.0,0.001,6691,20.0,96827.06,0.59,0.5422
2040,Miller Walker and Davis,False,GB,Annburgh,HealthTech,2009,https://millerwalkeranddavis.com,Moment own new population represent official quality few guess could station.,24,miller-walker-and-davis,2023,USD,1216519,451886,764633,60825,703808,2265,701543,12165,24330,677213,54693,846120,166278,679842,101376.58,1216519,541.82,1570.74,0.0288,1561,64.93,1000.0,54.69,0.6285
2041,Lowe PLC,False,DE,New Ericborough,Fintech,2023,https://loweplc.com,Fly who risk recent behind where.,22,lowe-plc,2023,EUR,2158069,860674,1297395,1808758,-511363,0,-511363,21580,43161,-554524,43296,1200940,675293,525647,,2158069,20.0,15.31,0.001,582,308.93,186780.24,0.23,0.6012
2042,Hodges Ltd,False,DE,Burnsport,Fintech,2009,https://hodgesltd.com,Treat be teach design natural.,20,hodges-ltd,2023,EUR,400937,225531,175406,49068,126338,26740,99598,4009,8018,91580,20331,375860,111256,264604,,400937,1113.45,5270.6,0.001,1670,20.0,4490.78,4.53,0.4375
2043,Davis Wilson and Hunter,False,KE,Robertsmouth,Marketplaces,2020,https://daviswilsonandhunter.com,Born reveal site age thought.,17,davis-wilson-and-hunter,2023,USD,407224,168358,238866,388001,-149135,0,-149135,4072,8144,-157279,47114,264619,134830,129789,,407224,241.09,120.54,0.0936,1460,23.24,38102.8,1.24,0.5866
2044,Nelson LLC,False,BR,Russellfort,Mobility,2024,https://nelsonllc.com,Eight mind show general step.,17,nelson-llc,2023,USD,870013,422342,447671,770385,-322714,11156,-333870,8700,17400,-351270,43191,564759,28237,536522,,870013,20.0,53.1,0.0128,301,240.59,85735.81,0.5,0.5146
2045,Chavez-Potter,False,KE,West Jasmine,Cybersecurity,2016,https://chavez-potter.com,Charge away help second brother ago cultural marriage politics.,18,chavez-potter,2023,USD,330182,20150,310032,190604,119428,5646,113782,3301,6603,107179,20552,289058,148025,141033,,330182,907.76,4853.45,0.0446,120,228.65,9096.74,2.26,0.939
2046,Jones Pearson and Farrell,False,US,West Kayleemouth,E-commerce,2015,https://jonespearsonandfarrell.com,West service of here sign.,18,jones-pearson-and-farrell,2023,USD,1994409,589707,1404702,99720,1304982,0,1304982,19944,39888,1265094,278225,1414159,1027908,386251,,1994409,1913.35,8957.46,0.0468,908,182.9,1000.0,278.23,0.7043
2047,Coleman Group,False,KE,North Michaelview,Cybersecurity,2010,https://colemangroup.com,Trial television whose however painting technology carry she.,10,coleman-group,2023,USD,173443,86947,86496,75861,10635,0,10635,1734,3468,7167,16189,220894,39503,181391,,173443,2083.23,9057.42,0.0702,722,20.0,1000.0,16.19,0.4987
2048,Vaughn Inc,False,US,South Danielmouth,EdTech,2023,https://vaughninc.com,Standard sit oil term assume pretty nice cup consumer fear.,17,vaughn-inc,2023,USD,800847,227190,573657,124190,449467,14301,435166,8008,16016,419150,57734,577368,57329,520039,66737.25,800847,273.49,772.4,0.001,2315,28.82,23378.99,2.47,0.7163
2049,Lloyd Group,False,FR,Pamelafort,Mobility,2009,https://lloydgroup.com,Experience receive really need performance prepare during.,20,lloyd-group,2023,EUR,1240706,522772,717934,749674,-31740,0,-31740,12407,24814,-56554,347181,969747,105028,864719,,1240706,1559.08,2705.12,0.001,562,183.82,79963.59,4.34,0.5786
2050,Greene-Smith,False,CA,Lopezhaven,AI/ML,2021,https://greene-smith.com,Tree stuff center health watch sea green your.,15,greene-smith,2023,USD,279864,83206,196658,148275,48383,11532,36851,2798,5597,31254,15569,214573,55225,159348,,279864,282.43,1617.55,0.001,194,119.71,7124.35,2.19,0.7027
2051,Lewis Inc,False,CA,Harringtonborough,Cybersecurity,2009,https://lewisinc.com,Mind close seem into my training natural.,20,lewis-inc,2023,USD,601414,173252,428162,168124,260038,13698,246340,6014,12028,234312,39785,354633,38586,316047,,601414,20.0,57.28,0.1057,2505,20.0,2199.84,18.09,0.7119
2052,Gonzalez-Humphrey,False,KE,East Stephanie,AgriTech,2024,https://gonzalez-humphrey.com,Admit election dog effort hair find inside son military scene.,19,gonzalez-humphrey,2023,USD,209314,70025,139289,88160,51129,0,51129,2093,4186,46943,18539,191892,55516,136376,,209314,931.21,2075.8,0.1569,489,35.62,28428.12,0.65,0.6655
2053,Baker Long and Henry,False,US,East Benjaminbury,Cybersecurity,2010,https://bakerlongandhenry.com,Leader generation collection kind hundred.,18,baker-long-and-henry,2023,USD,969152,251898,717254,651386,65868,0,65868,9691,19383,46485,44135,689145,135014,554131,,969152,424.05,243.69,0.1254,741,108.95,56929.99,0.78,0.7401
2054,Green PLC,False,IN,Adamville,Fintech,2014,https://greenplc.com,See especially son have condition.,23,green-plc,2023,USD,1098083,514323,583760,246454,337306,15209,322097,10980,21961,300136,121701,823681,436102,387579,,1098083,1397.88,5811.92,0.0877,478,191.29,1000.0,121.7,0.5316
2055,Mann Ltd,False,NG,Lake Nicholas,Fintech,2011,https://mannltd.com,Authority much brother film true.,11,mann-ltd,2023,USD,3519205,658200,2861005,175960,2685045,0,2685045,35192,70384,2614661,140118,2024797,101239,1923558,,3519205,575.85,287.92,0.0843,1377,212.84,21572.42,6.5,0.813
2056,Rich Inc,False,ZA,New Cathyfurt,EdTech,2020,https://richinc.com,Site game remember especially.,16,rich-inc,2023,USD,941939,406527,535412,618170,-82758,0,-82758,9419,18838,-101596,59758,554818,47501,507317,78494.92,941939,10.0,14.24,0.001,15698,5.0,49323.6,1.21,0.5684
2057,Browning-Thompson,False,DE,Masonbury,EdTech,2024,https://browning-thompson.com,Media eight support single suffer discuss later write.,24,browning-thompson,2023,EUR,288612,110939,177673,33969,143704,0,143704,2886,5772,137932,52960,374566,236324,138242,24051.0,288612,847.03,2650.15,0.0754,565,42.5,6100.72,8.68,0.6156
2058,Gonzalez Ltd,False,BR,Crystalmouth,EdTech,2013,https://gonzalezltd.com,Yeah summer government improve interest across yeah.,24,gonzalez-ltd,2023,USD,35914,12358,23556,27232,-3676,0,-3676,359,718,-4394,2501,142539,61959,80580,2992.83,35914,10.0,29.73,0.0147,21,136.25,8656.55,0.29,0.6559
2059,Davis Group,False,NG,East Tyler,Cybersecurity,2021,https://davisgroup.com,What why heavy onto trade reach.,31,davis-group,2023,USD,1247664,520129,727535,410521,317014,14351,302663,12476,24953,277710,1041383,1803341,632794,1170547,,1247664,20.0,71.16,0.0357,5198,20.0,92263.09,11.29,0.5831
2060,Garcia Vincent and Church,False,ZA,Manningborough,Fintech,2019,https://garciavincentandchurch.com,Something discussion happen skill area ok study piece.,26,garcia-vincent-and-church,2023,USD,1812976,647195,1165781,737505,428276,0,428276,18129,36259,392017,159313,1115644,557642,558002,,1812976,20.0,10.0,0.0825,497,303.64,88745.45,1.8,0.643
2061,Whitney PLC,False,BR,West Anthony,Mobility,2021,https://whitneyplc.com,Of image try guess myself attorney in really employee through.,21,whitney-plc,2023,USD,470745,122834,347911,122891,225020,6741,218279,4707,9414,208865,26274,314249,61606,252643,,470745,20.0,68.89,0.0868,184,212.35,30319.41,0.87,0.7391
2062,Allen PLC,False,FR,Annaborough,HealthTech,2013,https://allenplc.com,Spend almost real common main now Republican office then.,27,allen-plc,2023,EUR,233511,25323,208188,93553,114635,0,114635,2335,4670,109965,2823,312048,164593,147455,19459.25,233511,474.97,1947.09,0.001,216,89.96,1423.82,1.98,0.8916
2063,Torres and Sons,False,NG,Jonathanfurt,Energy,2024,https://torresandsons.com,Office family structure wonder seem live receive wide suddenly.,24,torres-and-sons,2023,USD,934260,349610,584650,132440,452210,11810,440400,9342,18685,421715,44638,572443,185560,386883,,934260,1395.76,2593.49,0.001,2246,34.66,13666.22,3.27,0.6258
2064,Wells and Sons,False,CA,North Danielland,Marketplaces,2013,https://wellsandsons.com,Daughter fill oil situation recent five contain fine brother.,18,wells-and-sons,2023,USD,718627,335704,382923,443878,-60955,16684,-77639,7186,14372,-92011,11000,568534,42232,526302,,718627,63.36,205.86,0.0432,482,124.11,30019.48,0.37,0.5329
2065,Dawson-Pierce,False,NG,South Joshua,IoT,2022,https://dawson-pierce.com,Paper responsibility rather raise animal bed actually news watch by.,25,dawson-pierce,2023,USD,428851,148979,279872,212897,66975,0,66975,4288,8577,58398,39435,275800,43651,232149,,428851,348.19,761.35,0.0644,200,178.1,34169.58,1.15,0.6526
2066,Dean Fields and Morgan,False,CA,Cranebury,E-commerce,2018,https://deanfieldsandmorgan.com,Task them sing vote feeling.,19,dean-fields-and-morgan,2023,USD,903947,210047,693900,404434,289466,7119,282347,9039,18078,264269,41637,674329,332675,341654,,903947,20.0,39.08,0.0514,280,268.85,49716.46,0.84,0.7676
2067,Davis-Mccall,False,CA,Glennbury,Energy,2021,https://davis-mccall.com,Require similar skin thought throughout dark degree college.,18,davis-mccall,2023,USD,1061458,437848,623610,1112943,-489333,4605,-493938,10614,21229,-515167,27813,668492,158174,510318,,1061458,2092.85,11478.64,0.0245,1529,57.83,104793.98,0.27,0.5875
2068,Pacheco Marquez and Villarreal,False,ZA,Berryside,E-commerce,2015,https://pachecomarquezandvillarreal.com,Process answer catch those her PM.,12,pacheco-marquez-and-villarreal,2023,USD,1972898,658887,1314011,696754,617257,10520,606737,19728,39457,567280,874941,2041378,1538682,502696,,1972898,20.0,67.35,0.001,508,323.36,55356.89,15.81,0.666
2069,Kennedy Clayton and Peterson,False,KE,Lake Jessica,AI/ML,2014,https://kennedyclaytonandpeterson.com,Structure tend whether where push.,24,kennedy-clayton-and-peterson,2023,USD,338977,221521,117456,103306,14150,0,14150,3389,6779,7371,50661,343036,128810,214226,,338977,699.6,4471.87,0.0674,117,239.49,34191.98,1.48,0.3465
2070,Tyler Ramirez and Randolph,False,TN,South Jessicaville,AI/ML,2016,https://tylerramirezandrandolph.com,Writer budget feel husband effort.,9,tyler-ramirez-and-randolph,2023,USD,423202,108901,314301,410203,-95902,0,-95902,4232,8464,-104366,58309,384560,22910,361650,,423202,302.23,1024.54,0.0767,747,47.19,73376.03,0.79,0.7427
2071,Banks Faulkner and Kidd,False,CA,North Katherine,Mobility,2022,https://banksfaulknerandkidd.com,Guy field rule few truth defense rule show might.,23,banks-faulkner-and-kidd,2023,USD,2515271,855904,1659367,1324700,334667,12917,321750,25152,50305,271445,350757,1735340,1016299,719041,,2515271,744.47,7214.62,0.0862,1240,168.96,123583.16,2.84,0.6597
2072,Hodge Cannon and Cordova,False,TN,East Tyler,SaaS,2009,https://hodgecannonandcordova.com,Wife nice stuff road learn argue night thought plan.,19,hodge-cannon-and-cordova,2023,USD,452017,108824,343193,179508,163685,13802,149883,4520,9040,140843,14241,285480,31056,254424,37668.08,452017,365.99,896.11,0.0357,721,52.2,1000.0,14.24,0.7592
2073,Allen-Cook,False,IN,East Christopherside,IoT,2008,https://allen-cook.com,Nearly clear coach low will.,22,allen-cook,2023,USD,1166538,398577,767961,58326,709635,2345,707290,11665,23330,683960,327737,936288,518024,418264,,1166538,20.0,71.92,0.0085,4860,20.0,13621.24,24.06,0.6583
2074,Mendez Ltd,False,NG,Jenkinstown,HealthTech,2017,https://mendezltd.com,Must guess rest data yeah stock.,25,mendez-ltd,2023,USD,398041,145675,252366,141463,110903,40038,70865,3980,7960,62905,51477,262531,97679,164852,33170.08,398041,358.25,607.07,0.0014,6634,5.0,1000.0,51.48,0.634
2075,Bright Stevens and Ortiz,False,US,Changhaven,AgriTech,2015,https://brightstevensandortiz.com,Window shoulder ability add raise seat.,20,bright-stevens-and-ortiz,2023,USD,173307,59787,113520,56236,57284,1416,55868,1733,3466,52402,14504,139461,37479,101982,,173307,20.0,11.59,0.1075,722,20.0,1000.0,14.5,0.655
2076,Collier Ltd,False,DE,South Brandonbury,E-commerce,2008,https://collierltd.com,Minute article place sell indicate require shake seem voice.,16,collier-ltd,2023,EUR,547618,79627,467991,29886,438105,3863,434242,5476,10952,423290,45023,515633,195712,319921,,547618,1610.21,1878.44,0.023,226,201.81,8943.56,5.03,0.8546
2077,Martin Group,False,AU,New Tamarahaven,Cybersecurity,2016,https://martingroup.com,Event even choice receive itself reveal must.,20,martin-group,2023,USD,3451802,1191033,2260769,2285443,-24674,0,-24674,34518,69036,-93710,91374,1851487,598710,1252777,,3451802,803.22,2755.0,0.0647,2389,120.39,168682.6,0.54,0.655
2078,Peck-Thompson,False,NG,Baileyfort,AI/ML,2012,https://peck-thompson.com,Pull especially future first card likely growth.,17,peck-thompson,2023,USD,963422,514555,448867,104136,344731,0,344731,9634,19268,325463,21898,517355,207040,310315,,963422,20.0,120.3,0.001,389,206.02,30462.44,0.72,0.4659
2079,Davis-George,False,FR,New Dakota,SaaS,2022,https://davis-george.com,Even live glass teacher southern create free car chance control.,21,davis-george,2023,EUR,356264,116441,239823,227616,12207,5664,6543,3562,7125,-582,6238,207159,76642,130517,29688.67,356264,240.49,260.73,0.0011,463,64.11,8149.76,0.77,0.6732
2080,Sanders and Sons,False,CA,East Davidfurt,HealthTech,2012,https://sandersandsons.com,Generation well he kitchen drop partner resource.,20,sanders-and-sons,2023,USD,405497,104034,301463,132722,168741,0,168741,4054,8109,160632,15200,408171,111475,296696,33791.42,405497,308.29,1094.25,0.0305,422,79.92,28200.74,0.54,0.7434
2081,Duarte Group,False,IN,Kimberlyton,E-commerce,2015,https://duartegroup.com,Dinner beautiful middle chair chance let seat happy.,28,duarte-group,2023,USD,2919141,855386,2063755,1253445,810310,29896,780414,29191,58382,722032,246210,1899588,131863,1767725,,2919141,106.03,464.57,0.0399,1918,126.78,99890.62,2.46,0.707
2082,Cooper PLC,False,DE,South Kathleen,AgriTech,2017,https://cooperplc.com,Order agent result group study decide rich short over decade.,23,cooper-plc,2023,EUR,58240,25860,32380,25887,6493,0,6493,582,1164,5329,11635,106304,55394,50910,,58240,1852.77,5141.3,0.0958,242,20.0,3795.26,3.07,0.556
2083,Vasquez and Sons,False,FR,West David,IoT,2020,https://vasquezandsons.com,Want recent city water mind let time strategy sport market.,18,vasquez-and-sons,2023,EUR,424340,191687,232653,221583,11070,0,11070,4243,8486,2584,22561,302990,56432,246558,,424340,1313.8,4479.95,0.0927,1768,20.0,8195.29,2.75,0.5483
2084,Lopez PLC,False,KE,North Austin,EdTech,2010,https://lopezplc.com,Response station safe research apply myself once.,29,lopez-plc,2023,USD,94254,27586,66668,47106,19562,14375,5187,942,1885,3302,53418,144500,7225,137275,7854.5,94254,638.05,3393.95,0.015,106,73.47,1000.0,53.42,0.7073
2085,Pena LLC,False,ZA,East Juliatown,E-commerce,2023,https://penallc.com,Culture do seven radio place Mr specific.,11,pena-llc,2023,USD,399921,46546,353375,367627,-14252,0,-14252,3999,7998,-22250,3234,333365,229664,103701,,399921,631.56,1423.26,0.0257,159,208.99,1000.0,3.23,0.8836
2086,Ferguson LLC,False,GB,Waltersland,Mobility,2011,https://fergusonllc.com,Growth main natural two especially despite.,17,ferguson-llc,2023,USD,1233243,523148,710095,826785,-116690,0,-116690,12332,24664,-141354,40012,779280,158305,620975,,1233243,2076.11,13996.14,0.001,2731,37.62,52375.8,0.76,0.5758
2087,Vargas Ltd,False,KE,Karenville,Marketplaces,2017,https://vargasltd.com,We number history admit with physical fast such ground.,21,vargas-ltd,2023,USD,621833,355686,266147,206407,59740,41317,18423,6218,12436,5987,81341,485379,163791,321588,,621833,20.0,22.44,0.0459,225,230.17,20461.49,3.98,0.428
2088,Luna-Vazquez,False,US,West Tracyside,Cybersecurity,2020,https://luna-vazquez.com,Less protect itself air deal certainly station.,21,luna-vazquez,2023,USD,3196718,967588,2229130,1981115,248015,0,248015,31967,63934,184081,161231,1839814,394900,1444914,,3196718,1297.72,5037.45,0.0906,845,315.24,127250.65,1.27,0.6973
2089,Holland PLC,False,FR,Boydstad,SaaS,2018,https://hollandplc.com,Daughter rise car yeah degree sort also owner party parent trial.,24,holland-plc,2023,EUR,133217,58859,74358,12519,61839,0,61839,1332,2664,59175,37671,281110,41770,239340,11101.42,133217,472.58,2721.47,0.0013,122,90.31,12695.94,2.97,0.5582
2090,Powers Huffman and Byrd,False,CA,Lake Nathanbury,Energy,2021,https://powershuffmanandbyrd.com,Behind member serious station inside generation.,12,powers-huffman-and-byrd,2023,USD,774958,353530,421428,809105,-387677,4343,-392020,7749,15499,-407519,12855,494863,96241,398622,,774958,732.49,1660.49,0.0629,253,254.64,51074.75,0.25,0.5438
2091,Chan-Becker,False,FR,East Martinfurt,EdTech,2008,https://chan-becker.com,Its treatment power if provide already position development fear.,19,chan-becker,2023,EUR,215223,81506,133717,53504,80213,18459,61754,2152,4304,57450,40057,314244,77329,236915,17935.25,215223,242.01,1430.29,0.0466,189,94.52,15966.06,2.51,0.6213
2092,Ruiz-Pitts,False,BR,Wrightside,Marketplaces,2020,https://ruiz-pitts.com,Group past three a month continue chair like collection billion.,18,ruiz-pitts,2023,USD,519226,73948,445278,205770,239508,14069,225439,5192,10384,215055,5206,396984,128883,268101,,519226,570.26,4361.35,0.1638,295,146.21,10961.89,0.47,0.8576
2093,Knight-Morales,False,US,Phillipsshire,AgriTech,2024,https://knight-morales.com,Direction page past true eye cut none fly season.,17,knight-morales,2023,USD,699614,285487,414127,157090,257037,28066,228971,6996,13992,214979,12550,495298,160194,335104,,699614,1228.35,4132.61,0.0134,2915,20.0,13116.07,0.96,0.5919
2094,Cox-Osborne,False,US,Jamesfort,E-commerce,2012,https://cox-osborne.com,Message describe approach scene before.,21,cox-osborne,2023,USD,591614,125575,466039,76412,389627,10010,379617,5916,11832,367785,33834,413635,235860,177775,,591614,1132.31,566.16,0.0548,2465,20.0,1000.0,33.83,0.7877
2095,Thomas Roman and Mcdonald,False,CA,South Emily,AI/ML,2015,https://thomasromanandmcdonald.com,Raise win go hospital some daughter relate.,21,thomas-roman-and-mcdonald,2023,USD,1184120,520866,663254,257077,406177,24933,381244,11841,23682,357562,282687,1012465,401573,610892,,1184120,532.47,947.71,0.001,533,184.83,1000.0,282.69,0.5601
2096,Jackson Ltd,False,GB,West Samantha,SaaS,2020,https://jacksonltd.com,Environmental degree woman international hot someone oil almost action.,20,jackson-ltd,2023,USD,1047670,321257,726413,465069,261344,48584,212760,10476,20953,191807,111107,661776,33088,628688,87305.83,1047670,140.6,245.01,0.001,17461,5.0,9447.44,11.76,0.6934
2097,Stone Foster and Cordova,False,EG,Lake Scottberg,IoT,2024,https://stonefosterandcordova.com,Finally under language shoulder though physical culture light.,16,stone-foster-and-cordova,2023,USD,1278370,262985,1015385,516190,499195,0,499195,12783,25567,473628,110937,810120,286314,523806,,1278370,460.74,985.19,0.0809,768,138.69,52968.28,2.09,0.7943
2098,Mendez-Mccoy,False,FR,Christopherchester,EdTech,2021,https://mendez-mccoy.com,Skin pattern age cup benefit.,25,mendez-mccoy,2023,EUR,136216,31660,104556,55427,49129,9543,39586,1362,2724,36862,3154,110182,24638,85544,11351.33,136216,23.25,89.62,0.0535,525,21.61,4991.62,0.63,0.7676
2099,Carter-Pace,False,IN,Danielleside,Energy,2012,https://carter-pace.com,Address glass make east evening.,25,carter-pace,2023,USD,2925972,1742222,1183750,1763310,-579560,0,-579560,29259,58519,-638079,59204,1548344,837017,711327,,2925972,20.0,27.13,0.0523,1101,221.39,142900.48,0.41,0.4046
2100,Ali-Conley,False,GB,Robinborough,E-commerce,2010,https://ali-conley.com,Much should think season skill war for.,17,ali-conley,2023,USD,495067,202590,292477,224787,67690,0,67690,4950,9901,57789,12694,285347,127427,157920,,495067,708.33,2192.42,0.001,285,144.73,48538.85,0.26,0.5908
2101,Harding Johnson and Rivera,False,EG,Cooperland,IoT,2009,https://hardingjohnsonandrivera.com,Course my thus science kind order two music door knowledge.,14,harding-johnson-and-rivera,2023,USD,2086586,507722,1578864,914194,664670,8395,656275,20865,41731,614544,82748,1280532,518168,762364,,2086586,706.15,3039.54,0.1294,2465,70.53,89570.07,0.92,0.7567
2102,Ochoa LLC,False,NG,New Lorihaven,Energy,2016,https://ochoallc.com,People me house section around dream memory number.,20,ochoa-llc,2023,USD,923144,424613,498531,282423,216108,0,216108,9231,18462,197646,11909,562454,236333,326121,,923144,527.47,553.24,0.0664,1148,66.98,49013.62,0.24,0.54
2103,Poole Price and Long,False,FR,West Sarah,Energy,2024,https://poolepriceandlong.com,Simple discussion economy if form you cost.,18,poole-price-and-long,2023,EUR,484235,169304,314931,320500,-5569,0,-5569,4842,9684,-15253,44533,444623,334381,110242,,484235,20.0,142.17,0.02,2017,20.0,51997.86,0.86,0.6504
2104,Parks Group,False,TN,Port Joemouth,Cybersecurity,2012,https://parksgroup.com,Above national decide test information.,27,parks-group,2023,USD,634799,229850,404949,346205,58744,0,58744,6347,12695,46049,10188,442436,183231,259205,,634799,243.36,1197.15,0.1055,139,379.62,32790.26,0.31,0.6379
2105,James-Smith,False,AU,Brendaton,HealthTech,2023,https://james-smith.com,Local employee everybody involve trial business.,18,james-smith,2023,USD,1738647,391675,1346972,233045,1113927,5787,1108140,17386,34772,1073368,76431,1081808,139019,942789,144887.25,1738647,227.77,227.77,0.0367,28977,5.0,18296.77,4.18,0.7747
2106,Keith Simmons and Lopez,False,NG,Port Matthewbury,EdTech,2023,https://keithsimmonsandlopez.com,Staff if fine go small report represent reduce point total.,21,keith-simmons-and-lopez,2023,USD,238648,81718,156930,11932,144998,23592,121406,2386,4772,116634,30475,264696,45303,219393,19887.33,238648,532.59,3641.36,0.0696,184,107.69,1000.0,30.48,0.6576
2107,Williams LLC,False,TN,West Adrianabury,Marketplaces,2014,https://williamsllc.com,Describe capital name research product ability.,25,williams-llc,2023,USD,297381,81595,215786,181445,34341,16986,17355,2973,5947,11408,86501,255062,52479,202583,,297381,20.0,10.0,0.0495,1239,20.0,29222.43,2.96,0.7256
2108,Robertson LLC,False,NG,Port Michelleburgh,IoT,2024,https://robertsonllc.com,Full take cover million black then all continue family government.,17,robertson-llc,2023,USD,1415956,556019,859937,598777,261160,21212,239948,14159,28319,211629,108874,923110,355992,567118,,1415956,20.0,101.45,0.0394,627,188.05,36554.73,2.98,0.6073
2109,Davis-Weaver,False,DE,Angelicafurt,EdTech,2010,https://davis-weaver.com,Our parent side break tree.,19,davis-weaver,2023,EUR,231657,47859,183798,131676,52122,7941,44181,2316,4633,39548,30885,304344,150029,154315,19304.75,231657,39.72,119.31,0.075,975,19.79,15756.83,1.96,0.7934
2110,Mueller Brooks and Wiley,False,IN,Davidville,Energy,2018,https://muellerbrooksandwiley.com,Development up in just maybe some manage low movie politics.,21,mueller-brooks-and-wiley,2023,USD,2782304,1277398,1504906,2035370,-530464,0,-530464,27823,55646,-586110,312271,1802262,378328,1423934,,2782304,20.0,35.92,0.0567,936,247.49,165117.03,1.89,0.5409
2111,Gould Harper and Harris,False,BR,Port Mary,IoT,2010,https://gouldharperandharris.com,Trade west suggest writer admit truth reduce outside base while.,17,gould-harper-and-harris,2023,USD,603127,201632,401495,148126,253369,0,253369,6031,12062,241307,206084,618614,114011,504603,,603127,149.93,76.19,0.0395,206,243.36,1012.45,203.55,0.6657
2112,Clark and Sons,False,FR,Port Jamesshire,Marketplaces,2021,https://clarkandsons.com,Clear care none walk sign enter program want.,19,clark-and-sons,2023,EUR,1150602,912421,238181,558721,-320540,6783,-327323,11506,23012,-350335,12315,687709,443378,244331,,1150602,1089.31,1573.05,0.0502,4794,20.0,34108.59,0.36,0.207
2113,Woods Ltd,False,TN,South Tylerhaven,E-commerce,2019,https://woodsltd.com,Give choice large must home blood real to word toward.,17,woods-ltd,2023,USD,524872,175433,349439,389537,-40098,0,-40098,5248,10497,-50595,40285,410992,55205,355787,,524872,724.46,4171.1,0.001,145,299.67,51220.2,0.79,0.6658
2114,Anderson Johnson and Hall,False,DE,South Brittanystad,E-commerce,2019,https://andersonjohnsonandhall.com,Investment make behavior body never.,25,anderson-johnson-and-hall,2023,EUR,1524626,859532,665094,76231,588863,28798,560065,15246,30492,529573,67017,957908,148545,809363,,1524626,20.0,25.93,0.001,716,177.31,1000.0,67.02,0.4362
2115,Decker Inc,False,KE,North Elizabethberg,Marketplaces,2008,https://deckerinc.com,Themselves pass participant develop arrive foot on.,18,decker-inc,2023,USD,1594005,446762,1147243,1291625,-144382,11981,-156363,15940,31880,-188243,50276,956315,303757,652558,,1594005,20.0,57.11,0.1252,889,149.28,89212.16,0.56,0.7197
2116,Romero Simpson and Le,False,AU,North Ruben,AgriTech,2013,https://romerosimpsonandle.com,Determine so staff future involve probably.,21,romero-simpson-and-le,2023,USD,201700,68217,133483,64540,68943,5948,62995,2017,4034,58961,9393,197286,102763,94523,,201700,607.15,598.19,0.07,840,20.0,24430.05,0.38,0.6618
2117,Haynes Davies and Ochoa,False,CA,New Janeville,IoT,2022,https://haynesdaviesandochoa.com,Several team answer explain air clear assume senior successful society.,24,haynes-davies-and-ochoa,2023,USD,331161,97722,233439,198091,35348,6418,28930,3311,6623,22307,3537,171562,90633,80929,,331161,950.67,4542.87,0.001,99,276.83,39935.61,0.09,0.7049
2118,Stone Group,False,KE,Kimberlyside,HealthTech,2022,https://stonegroup.com,Education section southern style.,24,stone-group,2023,USD,601884,252782,349102,143426,205676,46126,159550,6018,12037,147513,184690,540930,248572,292358,50157.0,601884,476.45,3061.12,0.0397,676,74.17,1000.0,184.69,0.58
2119,Miles Holt and Porter,False,US,West Benjaminside,EdTech,2014,https://milesholtandporter.com,Event nor enjoy not good star activity.,16,miles-holt-and-porter,2023,USD,1194723,448969,745754,333234,412520,1016,411504,11947,23894,387610,224236,834302,394530,439772,99560.25,1194723,333.75,1277.59,0.001,3166,31.44,24653.21,9.1,0.6242
2120,Cain Singh and Poole,False,BR,South Mariamouth,E-commerce,2012,https://cainsinghandpoole.com,Future it newspaper range point trip give.,22,cain-singh-and-poole,2023,USD,1298218,384570,913648,381861,531787,0,531787,12982,25964,505823,25215,729055,198553,530502,,1298218,1415.24,6426.37,0.0767,1640,65.95,36261.74,0.7,0.7038
2121,Williams Scott and Franklin,False,AU,Christianberg,Cybersecurity,2010,https://williamsscottandfranklin.com,Price face grow upon you kitchen issue first course seven move.,14,williams-scott-and-franklin,2023,USD,374511,99866,274645,164511,110134,0,110134,3745,7490,102644,22184,214015,66582,147433,,374511,814.22,1645.84,0.0429,1560,20.0,1000.0,22.18,0.7333
2122,Sullivan-Myers,False,FR,New Lindsayborough,Cybersecurity,2009,https://sullivan-myers.com,Believe visit whose many modern.,19,sullivan-myers,2023,EUR,7112625,2437400,4675225,3094437,1580788,38217,1542571,71126,142252,1400319,402490,3998907,421438,3577469,,7112625,450.91,1045.4,0.0361,29635,20.0,250510.32,1.61,0.6573
2123,Morales Harrison and Carter,False,DE,Wumouth,IoT,2012,https://moralesharrisonandcarter.com,Trade care site rather can southern whatever be serve hit.,23,morales-harrison-and-carter,2023,EUR,766654,159341,607313,210725,396588,0,396588,7666,15333,381255,156370,692880,341065,351815,,766654,304.8,724.39,0.0397,3194,20.0,32593.75,4.8,0.7922
2124,Fernandez Graham and Tate,False,IN,Candiceberg,SaaS,2018,https://fernandezgrahamandtate.com,Space hundred nature true young push low.,21,fernandez-graham-and-tate,2023,USD,406819,173967,232852,237794,-4942,0,-4942,4068,8136,-13078,37469,341869,185333,156536,33901.58,406819,10.0,64.79,0.0446,528,64.14,1000.0,37.47,0.5724
2125,Martinez LLC,False,ZA,Moorefort,Fintech,2017,https://martinezllc.com,Start far citizen to state market car beautiful visit.,15,martinez-llc,2023,USD,1028979,378678,650301,376954,273347,0,273347,10289,20579,252768,10255,628277,262273,366004,,1028979,853.28,426.64,0.0399,4287,20.0,30914.22,0.33,0.632
2126,Hernandez-White,False,EG,West Edward,Mobility,2008,https://hernandez-white.com,Story a fly student study final hospital artist.,23,hernandez-white,2023,USD,316045,166691,149354,166910,-17556,0,-17556,3160,6320,-23876,6003,299774,197653,102121,,316045,323.66,1845.16,0.0213,1316,20.0,1000.0,6.0,0.4726
2127,Rodriguez Inc,False,CA,Kendratown,EdTech,2014,https://rodriguezinc.com,Growth rule direction current because rest middle he including forget whether.,19,rodriguez-inc,2023,USD,180619,55346,125273,97411,27862,4107,23755,1806,3612,20143,2918,266957,166071,100886,15051.58,180619,342.41,1922.21,0.0749,437,34.4,24221.61,0.12,0.6936
2128,Hall Beck and Allen,False,DE,Lake Jennifer,AI/ML,2024,https://hallbeckandallen.com,According be chair there even election.,26,hall-beck-and-allen,2023,EUR,1667761,536395,1131366,1040884,90482,19447,71035,16677,33355,37680,133450,1096592,110081,986511,,1667761,743.98,3142.08,0.0295,2196,63.26,141418.14,0.94,0.6784
2129,Perez Rodriguez and Olsen,False,AU,West Michelleside,AgriTech,2023,https://perezrodriguezandolsen.com,Mention enter trade teach race play then loss seven.,16,perez-rodriguez-and-olsen,2023,USD,894015,378038,515977,454090,61887,0,61887,8940,17880,44007,66243,619614,417497,202117,,894015,513.37,1261.34,0.0186,3725,20.0,45097.41,1.47,0.5771
2130,Norris LLC,False,KE,Port Edgarville,Cybersecurity,2012,https://norrisllc.com,Us challenge behavior man wait tend top military maybe.,24,norris-llc,2023,USD,1975688,417509,1558179,364768,1193411,10389,1183022,19756,39513,1143509,290334,1374960,68748,1306212,,1975688,20.0,65.84,0.0388,1342,122.66,37351.83,7.77,0.7887
2131,Smith Williams and Becker,False,ZA,Hernandezport,Cybersecurity,2008,https://smithwilliamsandbecker.com,Wind gas leg sign senior itself.,25,smith-williams-and-becker,2023,USD,2205906,783022,1422884,1512812,-89928,0,-89928,22059,44118,-134046,592332,1861860,430319,1431541,,2205906,186.36,457.58,0.1341,9191,20.0,137767.59,4.3,0.645
2132,Shelton LLC,False,TN,Hayesport,IoT,2024,https://sheltonllc.com,Term indicate short feel mission mouth crime serious.,11,shelton-llc,2023,USD,1396937,854181,542756,593375,-50619,17889,-68508,13969,27938,-96446,27079,741312,45420,695892,,1396937,1597.06,3574.42,0.0809,5820,20.0,116796.69,0.23,0.3885
2133,Holloway-Hernandez,False,US,Kennethburgh,AgriTech,2013,https://holloway-hernandez.com,Police dark bring together wide quickly.,19,holloway-hernandez,2023,USD,264285,109200,155085,13214,141871,13822,128049,2642,5285,122764,10019,150808,50447,100361,,264285,457.68,1502.23,0.1067,86,255.58,2783.89,3.6,0.5868
2134,Spencer LLC,False,US,East Johnathanstad,AgriTech,2014,https://spencerllc.com,Network money member line according energy however.,29,spencer-llc,2023,USD,167153,35820,131333,140676,-9343,0,-9343,1671,3343,-12686,13860,163899,71384,92515,,167153,701.34,350.67,0.0097,81,171.76,28721.86,0.48,0.7857
2135,James-Gray,False,AU,New Davidside,Cybersecurity,2016,https://james-gray.com,Federal religious still land reveal can personal finish authority.,20,james-gray,2023,USD,994632,449523,545109,551180,-6071,0,-6071,9946,19892,-25963,24466,568860,139622,429238,,994632,454.74,1107.61,0.0521,4144,20.0,41000.31,0.6,0.5481
2136,Love Group,False,US,Cassandraville,Mobility,2008,https://lovegroup.com,Since remember how believe pressure lose far together.,16,love-group,2023,USD,4693558,546869,4146689,1689714,2456975,0,2456975,46935,93871,2363104,41667,2449070,1217023,1232047,,4693558,925.97,1238.13,0.001,1634,239.24,127259.87,0.33,0.8835
2137,Scott LLC,False,FR,North Cynthia,Energy,2016,https://scottllc.com,Address hold everyone experience central small.,29,scott-llc,2023,EUR,3308160,1070032,2238128,1263853,974275,37003,937272,33081,66163,871109,82925,1766032,846479,919553,,3308160,670.79,1264.16,0.001,2948,93.51,122016.33,0.68,0.6765
2138,Reyes Torres and Zimmerman,False,BR,Josephborough,Marketplaces,2019,https://reyestorresandzimmerman.com,Attorney somebody sure benefit business surface.,24,reyes-torres-and-zimmerman,2023,USD,2143102,931560,1211542,1034704,176838,0,176838,21431,42862,133976,335595,1449557,188198,1261359,,2143102,20.0,81.28,0.0716,8929,20.0,76101.11,4.41,0.5653
2139,Perez and Sons,False,FR,Kristenmouth,SaaS,2017,https://perezandsons.com,Performance success level begin seek second.,20,perez-and-sons,2023,EUR,1094709,514586,580123,221435,358688,29193,329495,10947,21894,307601,293548,945037,416693,528344,91225.75,1094709,278.0,1630.12,0.0391,3184,28.65,20618.93,14.24,0.5299
2140,Turner Phillips and Greene,False,BR,Diazside,Energy,2015,https://turnerphillipsandgreene.com,Sport response phone safe model begin usually memory.,17,turner-phillips-and-greene,2023,USD,8471343,4085936,4385407,3304843,1080564,17071,1063493,84713,169426,894067,726943,5004474,1269223,3735251,,8471343,1154.95,3314.98,0.0587,7045,100.2,244684.44,2.97,0.5177
2141,Gould and Sons,False,TN,West Ashleyberg,AI/ML,2011,https://gouldandsons.com,Parent design join truth middle make eye test weight.,17,gould-and-sons,2023,USD,565587,202266,363321,362969,352,0,352,5655,11311,-10959,41092,392770,252825,139945,,565587,860.0,3271.01,0.1437,283,166.24,42283.04,0.97,0.6424
2142,Lewis and Sons,False,CA,East Jermaine,Mobility,2010,https://lewisandsons.com,Focus news upon keep face deal brother fine walk scene.,26,lewis-and-sons,2023,USD,1062347,593638,468709,414498,54211,8590,45621,10623,21246,24375,1133998,1675084,130794,1544290,,1062347,737.08,945.92,0.001,423,209.04,28743.21,39.45,0.4412
2143,Robinson Sanders and Ford,False,GB,Ruizfort,EdTech,2024,https://robinsonsandersandford.com,According adult idea in your several I.,14,robinson-sanders-and-ford,2023,USD,170264,79829,90435,43354,47081,16598,30483,1702,3405,27078,33833,186898,35351,151547,14188.67,170264,687.4,4959.14,0.0527,2837,5.0,1000.0,33.83,0.5311
2144,Chambers Group,False,EG,Riversberg,AI/ML,2008,https://chambersgroup.com,Talk near choice tend Congress reach.,23,chambers-group,2023,USD,3377186,861808,2515378,1540170,975208,14734,960474,33771,67543,892931,37783,1740165,432617,1307548,,3377186,1441.11,2412.04,0.0233,8767,32.1,159038.0,0.24,0.7448
2145,Martinez Carpenter and Reilly,False,US,Grimesside,EdTech,2024,https://martinezcarpenterandreilly.com,Lose so several card end so.,14,martinez-carpenter-and-reilly,2023,USD,1076542,378850,697692,508059,189633,10977,178656,10765,21530,157126,205488,942194,134930,807264,89711.83,1076542,544.74,2534.04,0.0551,2322,38.62,46787.33,4.39,0.6481
2146,Harris Jefferson and Escobar,False,IN,Dawnchester,E-commerce,2023,https://harrisjeffersonandescobar.com,Coach set too husband whom allow event good discuss consider.,16,harris-jefferson-and-escobar,2023,USD,2049343,646390,1402953,790257,612696,13867,598829,20493,40986,557843,119366,1148730,284295,864435,,2049343,1417.84,6641.6,0.0345,1102,154.86,94918.53,1.26,0.6846
2147,Valdez-Baker,False,TN,Adrianaview,Cybersecurity,2013,https://valdez-baker.com,There none both minute finally team item better whom consider.,19,valdez-baker,2023,USD,631409,267873,363536,455460,-91924,27681,-119605,6314,12628,-132233,58470,403397,113680,289717,,631409,20.0,10.0,0.001,357,147.06,33283.06,1.76,0.5758
2148,Salas Ltd,False,US,South Angela,E-commerce,2019,https://salasltd.com,Listen remain film report visit.,27,salas-ltd,2023,USD,748005,239941,508064,265026,243038,0,243038,7480,14960,228078,15597,430672,249455,181217,,748005,20.0,111.69,0.0162,280,221.95,1000.0,15.6,0.6792
2149,King-Herring,False,CA,North Hannahmouth,Marketplaces,2017,https://king-herring.com,Glass guess world need personal head usually cold performance matter.,19,king-herring,2023,USD,111882,48717,63165,73622,-10457,0,-10457,1118,2237,-12694,3115,172562,92256,80306,,111882,405.61,1109.16,0.1456,119,77.82,13832.06,0.23,0.5646
2150,Morse and Sons,False,DE,Leefurt,AI/ML,2016,https://morseandsons.com,Office concern hundred into manage maintain nothing guess.,21,morse-and-sons,2023,EUR,285414,142976,142438,175609,-33171,24847,-58018,2854,5708,-63726,4611,200939,10046,190893,,285414,20.0,62.65,0.0207,1189,20.0,3064.05,1.5,0.4991
2151,Coleman Clark and Rowe,False,AU,South Jonathanland,SaaS,2016,https://colemanclarkandrowe.com,Get similar yet age natural name fear it man candidate.,21,coleman-clark-and-rowe,2023,USD,526557,289155,237402,227834,9568,0,9568,5265,10531,-963,2624,298898,31196,267702,43879.75,526557,37.23,156.38,0.0433,642,68.31,23059.74,0.11,0.4509
2152,Franklin Inc,False,TN,Atkinsonville,SaaS,2016,https://franklininc.com,Tend almost avoid difference blood final whom film.,27,franklin-inc,2023,USD,1511413,437273,1074140,878979,195161,5351,189810,15114,30228,159582,47146,865016,294450,570566,125951.08,1511413,10.0,37.81,0.0167,1509,83.43,84850.87,0.56,0.7107
2153,Curry Group,False,DE,Victorburgh,HealthTech,2018,https://currygroup.com,End one actually able risk.,19,curry-group,2023,EUR,715726,272367,443359,125022,318337,11080,307257,7157,14314,292943,21007,497651,225359,272292,59643.83,715726,10.0,51.51,0.0196,550,108.41,1000.0,21.01,0.6195
2154,Davis-Peck,False,TN,Margarettown,Marketplaces,2012,https://davis-peck.com,Stuff wonder probably number become wonder loss.,21,davis-peck,2023,USD,2166211,789896,1376315,308501,1067814,21511,1046303,21662,43324,1002979,817334,1989740,99487,1890253,,2166211,1925.81,962.9,0.001,1811,99.63,40758.93,20.05,0.6354
2155,Stanley Johnson and Gibson,False,FR,Murraybury,Cybersecurity,2020,https://stanleyjohnsonandgibson.com,Later within once hour and Congress create Congress.,24,stanley-johnson-and-gibson,2023,EUR,517663,190000,327663,458710,-131047,0,-131047,5176,10353,-141400,72049,352131,171115,181016,,517663,20.0,10.0,0.0225,2156,20.0,47988.21,1.5,0.633
2156,Walker-Thompson,False,NG,Williamfurt,Marketplaces,2015,https://walker-thompson.com,Not wonder time treat per light professor send hair trip.,23,walker-thompson,2023,USD,998529,283296,715233,557382,157851,0,157851,9985,19970,137881,206939,750708,102491,648217,,998529,373.82,1116.03,0.0517,4160,20.0,56331.53,3.67,0.7163
2157,Williamson-Moore,False,TN,Owensville,EdTech,2012,https://williamson-moore.com,Race final peace street level.,24,williamson-moore,2023,USD,589302,318036,271266,328672,-57406,3610,-61016,5893,11786,-72802,252317,643036,214264,428772,49108.5,589302,10.0,28.33,0.0335,610,80.46,7783.33,32.42,0.4603
2158,Harris-Stokes,False,TN,Smithshire,AgriTech,2018,https://harris-stokes.com,Meet image necessary movie political nearly senior alone series.,21,harris-stokes,2023,USD,595645,284384,311261,121570,189691,0,189691,5956,11912,177779,18973,423735,335433,88302,,595645,20.0,70.71,0.0548,193,256.28,7284.96,2.6,0.5226
2159,Nunez-Wells,False,EG,Vincentfort,AI/ML,2012,https://nunez-wells.com,Fall defense recent create talk event this anything him character.,22,nunez-wells,2023,USD,1927268,481686,1445582,1809483,-363901,35440,-399341,19272,38545,-437886,166716,1172790,121566,1051224,,1927268,1672.37,4428.52,0.1524,993,161.58,158920.34,1.05,0.7501
2160,Franco-Barrett,False,DE,Brookeview,Marketplaces,2012,https://franco-barrett.com,Million pretty hold people standard plan win season.,20,franco-barrett,2023,EUR,538971,159229,379742,253884,125858,17704,108154,5389,10779,97375,23174,453938,194971,258967,,538971,619.13,2954.59,0.0578,173,259.46,1000.0,23.17,0.7046
2161,Gomez-Fuller,False,KE,West Melissa,AI/ML,2014,https://gomez-fuller.com,Tell positive response can age hair kind.,35,gomez-fuller,2023,USD,1589996,355426,1234570,774238,460332,0,460332,15899,31799,428533,171847,1161821,123401,1038420,,1589996,916.94,3127.2,0.1007,1463,90.55,59598.43,2.88,0.7765
2162,Burke Inc,False,GB,Erinhaven,AgriTech,2024,https://burkeinc.com,Huge these politics else there down source glass network walk significant.,21,burke-inc,2023,USD,466237,169904,296333,127951,168382,10371,158011,4662,9324,148687,95114,522732,278610,244122,,466237,20.0,146.11,0.0825,297,130.74,26210.79,3.63,0.6356
2163,Warren-Brooks,False,GB,East Jessica,Energy,2012,https://warren-brooks.com,Understand oil cost parent easy over field science.,18,warren-brooks,2023,USD,660455,296386,364069,163340,200729,0,200729,6604,13209,187520,30552,521659,49306,472353,,660455,2092.91,1643.96,0.1235,227,241.46,32260.67,0.95,0.5512
2164,Horton LLC,False,BR,South Jeffreyborough,IoT,2013,https://hortonllc.com,Whose then beautiful ability they.,28,horton-llc,2023,USD,81506,31831,49675,70452,-20777,16805,-37582,815,1630,-39212,2393,75846,30197,45649,,81506,922.0,3742.77,0.096,56,119.66,10411.32,0.23,0.6095
2165,Thompson Ltd,False,CA,Marymouth,Fintech,2011,https://thompsonltd.com,Animal scene center guess discover.,22,thompson-ltd,2023,USD,2356128,965294,1390834,932231,458603,9859,448744,23561,47122,401622,79364,1375615,312022,1063593,,2356128,536.05,3175.84,0.1,9817,20.0,66312.52,1.2,0.5903
2166,Hayes Perkins and Harris,False,GB,Sandramouth,E-commerce,2012,https://hayesperkinsandharris.com,Positive entire work small too tell seat.,24,hayes-perkins-and-harris,2023,USD,435947,151717,284230,215944,68286,0,68286,4359,8718,59568,22305,334015,64205,269810,,435947,1773.96,8924.51,0.001,1816,20.0,33973.49,0.66,0.652
2167,Robinson and Sons,False,ZA,Gonzalezshire,SaaS,2018,https://robinsonandsons.com,Listen born organization site remember serious exist staff apply become condition.,17,robinson-and-sons,2023,USD,596533,274272,322261,194458,127803,0,127803,5965,11930,115873,22355,378890,82798,296092,49711.08,596533,782.57,2146.65,0.0253,1280,38.83,1000.0,22.36,0.5402
2168,Graham-Webb,False,TN,Lake Morganmouth,Energy,2017,https://graham-webb.com,Hot with energy thing little.,10,graham-webb,2023,USD,1448163,534368,913795,355162,558633,34290,524343,14481,28963,495380,73750,929213,597227,331986,,1448163,2009.93,6976.51,0.001,6034,20.0,54032.79,1.36,0.631
2169,Harrison Holmes and Forbes,False,EG,South Christopherview,Cybersecurity,2016,https://harrisonholmesandforbes.com,Threat language pretty especially water month.,21,harrison-holmes-and-forbes,2023,USD,2641471,594773,2046698,931069,1115629,18689,1096940,26414,52829,1044111,75823,1491255,1040927,450328,,2641471,20.0,77.03,0.122,11006,20.0,111443.98,0.68,0.7748
2170,Wyatt Inc,False,GB,Elizabethburgh,EdTech,2011,https://wyattinc.com,All set ahead idea month free series art.,23,wyatt-inc,2023,USD,132886,40085,92801,10656,82145,0,82145,1328,2657,79488,30735,190531,68985,121546,11073.83,132886,178.16,726.69,0.001,247,44.67,9880.79,3.11,0.6984
2171,Fields Ltd,False,GB,East Carolbury,HealthTech,2008,https://fieldsltd.com,Two television now camera man effect our open.,24,fields-ltd,2023,USD,916813,248500,668313,420095,248218,27066,221152,9168,18336,202816,24787,546152,66723,479429,76401.08,916813,225.86,1394.08,0.0075,1071,71.33,12506.56,1.98,0.729
2172,Choi-Garcia,False,AU,East Tyrone,IoT,2016,https://choi-garcia.com,Knowledge free really sing activity official serve physical send.,22,choi-garcia,2023,USD,302204,93751,208453,46301,162152,0,162152,3022,6044,156108,4207,303516,131913,171603,,302204,438.15,2495.57,0.1182,1259,20.0,28797.4,0.15,0.6898
2173,Cox Tanner and Cardenas,False,KE,Billyton,IoT,2015,https://coxtannerandcardenas.com,Month seven quite feeling most especially why south direction.,25,cox-tanner-and-cardenas,2023,USD,579468,232066,347402,242093,105309,0,105309,5794,11589,93720,37466,461777,318703,143074,,579468,20.0,127.77,0.0082,261,184.43,23056.27,1.62,0.5995
2174,Skinner Bell and Lewis,False,KE,Donnatown,EdTech,2015,https://skinnerbellandlewis.com,There per look method pass country term.,14,skinner-bell-and-lewis,2023,USD,129887,40876,89011,6929,82082,20996,61086,1298,2597,58489,14280,104139,10661,93478,10823.92,129887,146.93,724.02,0.0344,247,43.74,1000.0,14.28,0.6853
2175,Booth Hunter and Conner,False,BR,Laraview,SaaS,2019,https://boothhunterandconner.com,School bar manage mind second me environment.,19,booth-hunter-and-conner,2023,USD,579565,110227,469338,312347,156991,14288,142703,5795,11591,131112,25784,334865,35994,298871,48297.08,579565,10.0,36.23,0.0163,9659,5.0,22605.92,1.14,0.8098
2176,Mcknight-Oneal,False,FR,Wendyshire,Cybersecurity,2023,https://mcknight-oneal.com,Agency yet will almost phone he.,21,mcknight-oneal,2023,EUR,1422947,563336,859611,961182,-101571,1871,-103442,14229,28458,-131900,61262,927862,302195,625667,,1422947,20.0,43.14,0.001,3131,37.87,55634.85,1.1,0.6041
2177,Kirk LLC,False,GB,South Christine,AI/ML,2023,https://kirkllc.com,Buy gun deal treatment also.,31,kirk-llc,2023,USD,1407792,544372,863420,543127,320293,0,320293,14077,28155,292138,65532,929171,466535,462636,,1407792,252.52,790.84,0.0305,717,163.53,71995.92,0.91,0.6133
2178,Lawson PLC,False,ZA,Jamesbury,Marketplaces,2019,https://lawsonplc.com,Where state close early.,30,lawson-plc,2023,USD,1051611,606415,445196,293014,152182,22691,129491,10516,21032,108459,79565,694923,306002,388921,,1051611,635.23,2990.44,0.0138,4381,20.0,30416.96,2.62,0.4233
2179,Gomez-Costa,False,GB,North Scott,Energy,2023,https://gomez-costa.com,Bring good source success sound radio decade clear brother term.,22,gomez-costa,2023,USD,454444,222093,232351,22722,209629,40861,168768,4544,9088,159680,7255,285448,110735,174713,,454444,421.64,1167.16,0.0497,640,59.13,13987.79,0.52,0.5113
2180,Lynch Lewis and Hansen,False,EG,Adamport,HealthTech,2013,https://lynchlewisandhansen.com,Customer professor mother record serve realize.,20,lynch-lewis-and-hansen,2023,USD,3437525,1348249,2089276,1227773,861503,26599,834904,34375,68750,766154,105712,2019243,434862,1584381,286460.42,3437525,321.98,1718.98,0.0455,3259,87.89,118894.81,0.89,0.6078
2181,Mahoney-Martinez,False,DE,West Allisonville,EdTech,2009,https://mahoney-martinez.com,Note travel argue whether father.,21,mahoney-martinez,2023,EUR,990432,479256,511176,721573,-210397,0,-210397,9904,19808,-230205,395699,1023295,719393,303902,82536.0,990432,93.94,232.07,0.057,2086,39.55,72401.81,5.47,0.5161
2182,Fletcher-Robinson,False,TN,Scottfort,SaaS,2016,https://fletcher-robinson.com,Language daughter specific wait character store forget quite door stop.,28,fletcher-robinson,2023,USD,357670,132824,224846,260011,-35165,0,-35165,3576,7153,-42318,1876,306526,129310,177216,29805.83,357670,159.99,938.22,0.044,539,55.25,65744.02,0.03,0.6286
2183,Hodge-Nichols,False,TN,Thomasborough,EdTech,2014,https://hodge-nichols.com,That job ever capital great what mean continue gun position.,18,hodge-nichols,2023,USD,1479227,817374,661853,347877,313976,0,313976,14792,29584,284392,61840,922018,582451,339567,123268.92,1479227,10.0,10.0,0.0484,1672,73.7,40678.36,1.52,0.4474
2184,Barnes Rose and Fox,False,AU,West Rebeccashire,EdTech,2010,https://barnesroseandfox.com,During view buy institution risk.,18,barnes-rose-and-fox,2023,USD,2240830,619181,1621649,1318690,302959,0,302959,22408,44816,258143,121338,1305380,464284,841096,186735.83,2240830,408.89,1514.63,0.0365,1822,102.48,94529.53,1.28,0.7237
2185,Murphy Turner and Harmon,False,GB,Hughesmouth,Mobility,2023,https://murphyturnerandharmon.com,Station several mention example.,18,murphy-turner-and-harmon,2023,USD,1651566,330835,1320731,774683,546048,0,546048,16515,33031,513017,33542,1020716,278759,741957,,1651566,1027.32,2353.99,0.0168,607,226.73,46124.68,0.73,0.7997
2186,Wilson Marquez and Nguyen,False,ZA,New Ashleyview,E-commerce,2022,https://wilsonmarquezandnguyen.com,Imagine fact down forward kitchen surface other.,25,wilson-marquez-and-nguyen,2023,USD,1797932,444835,1353097,715304,637793,0,637793,17979,35958,601835,43990,1027405,359712,667693,,1797932,20.0,74.58,0.001,749,199.82,76483.87,0.58,0.7526
2187,Reed-Bell,False,DE,West Michelle,Energy,2020,https://reed-bell.com,Member teach meet Republican professional land simply feel should later.,13,reed-bell,2023,EUR,354264,216713,137551,363585,-226034,0,-226034,3542,7085,-233119,5880,196420,71853,124567,,354264,1825.11,5730.69,0.0298,1238,23.83,40811.33,0.14,0.3883
2188,Peck-Nelson,False,AU,West Justin,SaaS,2020,https://peck-nelson.com,Call method chance eye only specific.,19,peck-nelson,2023,USD,679201,351723,327478,350232,-22754,15589,-38343,6792,13584,-51927,29161,559725,27986,531739,56600.08,679201,81.28,458.45,0.0421,701,80.66,9137.47,3.19,0.4822
2189,Carlson-Gilbert,False,ZA,South Bryanport,E-commerce,2020,https://carlson-gilbert.com,Throughout outside exist story notice say left enter.,24,carlson-gilbert,2023,USD,8621926,4172533,4449393,3821762,627631,30190,597441,86219,172438,425003,2390443,6725896,481075,6244821,,8621926,57.32,80.5,0.0438,35924,20.0,281270.72,8.5,0.5161
2190,Bruce Garcia and Simmons,False,KE,Lake Anne,Cybersecurity,2024,https://brucegarciaandsimmons.com,Probably major child hair determine top us since issue.,18,bruce-garcia-and-simmons,2023,USD,513239,138783,374456,389949,-15493,4182,-19675,5132,10264,-29939,4583,448120,126080,322040,,513239,610.88,1819.47,0.0099,378,112.89,1000.0,4.58,0.7296
2191,Hanson-Moody,False,BR,Turnerberg,Cybersecurity,2009,https://hanson-moody.com,Make quickly however culture artist executive.,17,hanson-moody,2023,USD,708431,192244,516187,190392,325795,13487,312308,7084,14168,298140,28617,438198,194852,243346,,708431,58.21,305.3,0.0748,718,82.13,1000.0,28.62,0.7286
2192,Fry-Steele,False,NG,West Dakota,Fintech,2022,https://fry-steele.com,Argue executive hair new so.,14,fry-steele,2023,USD,688913,408901,280012,329451,-49439,0,-49439,6889,13778,-63217,11205,536618,130771,405847,,688913,1852.13,6723.12,0.001,427,134.43,65296.88,0.17,0.4065
2193,Kelly-Richmond,False,EG,Sandraburgh,SaaS,2015,https://kelly-richmond.com,Interest next wide Democrat health wide.,16,kelly-richmond,2023,USD,2478127,742444,1735683,1423288,312395,13502,298893,24781,49562,249331,192409,1542414,985396,557018,206510.58,2478127,676.52,4156.83,0.0605,2800,73.75,85500.86,2.25,0.7004
2194,Webb Waller and Duran,False,NG,Hicksside,AI/ML,2020,https://webbwallerandduran.com,Green account write season before me service anything cut list have.,12,webb-waller-and-duran,2023,USD,477475,100658,376817,264893,111924,24934,86990,4774,9549,77441,5908,416393,155579,260814,,477475,390.69,1413.46,0.0581,1989,20.0,25468.39,0.23,0.7892
2195,Becker-Hansen,False,ZA,North Connie,SaaS,2020,https://becker-hansen.com,Lead discuss hospital himself animal visit race drug attention quite.,25,becker-hansen,2023,USD,784412,350300,434112,56812,377300,0,377300,7844,15688,361612,52573,623624,214368,409256,65367.67,784412,421.47,1821.21,0.0101,2262,28.89,1000.0,52.57,0.5534
2196,Mills PLC,False,NG,Debbietown,Marketplaces,2009,https://millsplc.com,Almost head several culture bad.,13,mills-plc,2023,USD,2359119,344195,2014924,919655,1095269,8968,1086301,23591,47182,1039119,64247,1263122,297264,965858,,2359119,604.02,3028.38,0.0733,1507,130.43,87203.43,0.74,0.8541
2197,Wood and Sons,False,DE,North Evan,AgriTech,2022,https://woodandsons.com,Any particularly couple question down describe number.,14,wood-and-sons,2023,EUR,313504,148102,165402,205820,-40418,977,-41395,3135,6270,-47665,14767,301870,51174,250696,,313504,20.0,25.75,0.0179,1306,20.0,17952.91,0.82,0.5276
2198,Porter Inc,False,TN,North Elizabeth,AgriTech,2017,https://porterinc.com,Myself player million want yes artist mother.,26,porter-inc,2023,USD,102478,49436,53042,36273,16769,4440,12329,1024,2049,10280,5159,101015,51754,49261,,102478,199.78,731.42,0.0036,426,20.0,1000.0,5.16,0.5176
2199,Rice LLC,False,EG,Stonechester,HealthTech,2021,https://ricellc.com,It eat think thing source school myself federal record.,16,rice-llc,2023,USD,1518823,321351,1197472,1247392,-49920,4884,-54804,15188,30376,-85180,80570,847875,42393,805482,126568.58,1518823,392.78,637.0,0.0293,1631,77.58,103519.91,0.78,0.7884
2200,Carter Ltd,False,IN,Grahamfort,IoT,2009,https://carterltd.com,Chance staff film summer election possible create.,23,carter-ltd,2023,USD,577871,186108,391763,519722,-127959,2536,-130495,5778,11557,-142052,148129,567531,256725,310806,,577871,20.0,68.18,0.0595,198,242.26,33387.89,4.44,0.6779
2201,Hubbard Gill and Greene,False,ZA,Russellmouth,AI/ML,2012,https://hubbardgillandgreene.com,Size force behavior realize listen station few participant collection hold.,22,hubbard-gill-and-greene,2023,USD,5597415,2425687,3171728,5134068,-1962340,41922,-2004262,55974,111948,-2116210,171190,2989679,167693,2821986,,5597415,938.94,3323.44,0.0631,23322,20.0,441188.91,0.39,0.5666
2202,Alvarado-Torres,False,EG,Patrickborough,Marketplaces,2022,https://alvarado-torres.com,Pattern friend begin force space idea president cultural evidence walk.,25,alvarado-torres,2023,USD,848672,299162,549510,286940,262570,18807,243763,8486,16973,226790,81367,657374,404525,252849,,848672,2453.09,6640.69,0.0268,321,220.22,41118.93,1.98,0.6475
2203,Gray Bauer and Blake,False,FR,Adamsshire,Cybersecurity,2024,https://graybauerandblake.com,Hospital property space ask today product Mrs style.,20,gray-bauer-and-blake,2023,EUR,452929,191497,261432,37252,224180,3071,221109,4529,9058,212051,22301,372985,98017,274968,,452929,200.14,638.98,0.0604,131,286.59,1000.0,22.3,0.5772
2204,Harrington Thomas and Ortega,False,FR,West Patrick,HealthTech,2012,https://harringtonthomasandortega.com,Case tough difficult debate magazine newspaper establish wonder push.,21,harrington-thomas-and-ortega,2023,EUR,1837504,626379,1211125,1291231,-80106,27198,-107304,18375,36750,-144054,102562,1181478,144333,1037145,153125.33,1837504,202.08,831.82,0.0242,19236,7.96,127478.46,0.8,0.6591
2205,Harris Group,False,TN,Gillespiehaven,Energy,2018,https://harrisgroup.com,Many each up skin foreign his son threat.,23,harris-group,2023,USD,1378377,625102,753275,404699,348576,20562,328014,13783,27567,300447,30751,747052,507598,239454,,1378377,1053.22,3813.28,0.003,1251,91.81,56047.49,0.55,0.5465
2206,Rowe Bates and Pearson,False,EG,Margaretmouth,SaaS,2013,https://rowebatesandpearson.com,History quality approach good attack same trouble PM look.,20,rowe-bates-and-pearson,2023,USD,297294,125428,171866,173203,-1337,0,-1337,2972,5945,-7282,17200,338811,116327,222484,24774.5,297294,10.0,23.31,0.0506,244,101.46,9902.3,1.74,0.5781
2207,Green-Scott,False,EG,Jasonchester,IoT,2014,https://green-scott.com,Close already in effort its cover edge.,18,green-scott,2023,USD,1160739,497019,663720,592940,70780,0,70780,11607,23214,47566,19067,604119,205040,399079,,1160739,331.78,1272.6,0.0792,4836,20.0,36457.25,0.52,0.5718
2208,Thompson-Brown,False,EG,North Tina,Fintech,2016,https://thompson-brown.com,Issue economic resource tend case economic bar off occur month.,16,thompson-brown,2023,USD,2614941,187256,2427685,819061,1608624,14883,1593741,26149,52298,1541443,325682,1786394,300363,1486031,,2614941,353.1,1702.54,0.0999,1179,184.8,42171.91,7.72,0.9284
2209,Raymond Smith and Peterson,False,CA,Courtneybury,Cybersecurity,2013,https://raymondsmithandpeterson.com,First system floor myself personal writer treatment.,16,raymond-smith-and-peterson,2023,USD,991997,485236,506761,442515,64246,0,64246,9919,19839,44407,31334,550249,115536,434713,,991997,20.0,59.09,0.0354,1095,75.47,83337.64,0.38,0.5108
2210,Mckinney PLC,False,ZA,Nolanchester,Cybersecurity,2011,https://mckinneyplc.com,Control majority opportunity respond single can.,13,mckinney-plc,2023,USD,1627695,878249,749446,1192810,-443364,5755,-449119,16276,32553,-481672,52220,902935,538631,364304,,1627695,20.0,29.67,0.016,955,141.89,95780.55,0.55,0.4604
2211,Kelley Inc,False,FR,Williamshaven,Fintech,2022,https://kelleyinc.com,Wife say make although character owner more glass too pressure street.,18,kelley-inc,2023,EUR,263645,91205,172440,100888,71552,15196,56356,2636,5272,51084,11005,216071,125424,90647,,263645,20.0,93.27,0.001,199,109.99,31111.97,0.35,0.6541
2212,Carpenter-Wang,False,BR,Christinetown,E-commerce,2010,https://carpenter-wang.com,Suggest list reflect goal per believe both face.,17,carpenter-wang,2023,USD,1210320,416201,794119,1008717,-214598,2093,-216691,12103,24206,-240897,68939,721547,390209,331338,,1210320,154.42,802.82,0.0714,730,137.99,78152.08,0.88,0.6561
2213,Berger-Gordon,False,NG,North Larry,Cybersecurity,2020,https://berger-gordon.com,Physical look to rest.,17,berger-gordon,2023,USD,881280,289860,591420,221385,370035,7992,362043,8812,17625,344418,22967,572549,215971,356578,,881280,20.0,43.88,0.0363,406,180.71,21263.6,1.08,0.6711
2214,Walker Group,False,ZA,North Caitlinberg,AI/ML,2013,https://walkergroup.com,Board near lay fund very statement.,11,walker-group,2023,USD,1432060,639945,792115,1451935,-659820,7469,-667289,14320,28641,-695930,149445,941835,229120,712715,,1432060,1303.54,3713.9,0.0339,1161,102.77,114886.48,1.3,0.5531
2215,Campbell Group,False,TN,Port Eric,AI/ML,2020,https://campbellgroup.com,Early participant kitchen eat beautiful including in.,18,campbell-group,2023,USD,529088,201056,328032,26454,301578,0,301578,5290,10581,290997,97814,534985,232178,302807,,529088,485.01,2817.79,0.0346,2204,20.0,1000.0,97.81,0.62
2216,Chase-Thompson,False,US,South Christopher,HealthTech,2018,https://chase-thompson.com,Whose fund against several economy for full inside.,26,chase-thompson,2023,USD,1855300,966739,888561,771191,117370,45452,71918,18553,37106,34812,16305,1007487,214710,792777,154608.33,1855300,129.67,226.57,0.0447,6615,23.37,58330.58,0.28,0.4789
2217,Shannon Ltd,False,KE,South Crystal,Marketplaces,2012,https://shannonltd.com,Section century right both account whether tough suddenly true.,23,shannon-ltd,2023,USD,3037177,491351,2545826,396950,2148876,5061,2143815,30371,60743,2083072,170772,1765287,515747,1249540,,3037177,20.0,117.2,0.0465,643,393.44,16705.83,10.22,0.8382
2218,Pierce-Williams,False,GB,West Stevenland,HealthTech,2013,https://pierce-williams.com,Will bar mission support law.,18,pierce-williams,2023,USD,1015579,440954,574625,453918,120707,16540,104167,10155,20311,83856,51339,566552,234222,332330,84631.58,1015579,242.32,1382.36,0.0799,16926,5.0,39164.92,1.31,0.5658
2219,George Patrick and Bonilla,False,AU,Laurenborough,Cybersecurity,2009,https://georgepatrickandbonilla.com,Sound set try admit ten evening example old floor bank.,21,george-patrick-and-bonilla,2023,USD,1682871,814353,868518,1320663,-452145,21469,-473614,16828,33657,-507271,73071,1112593,270065,842528,,1682871,20.0,35.78,0.001,1663,84.28,122603.48,0.6,0.5161
2220,Rivera-Roth,False,TN,Perkinsborough,AgriTech,2017,https://rivera-roth.com,Team relationship dinner challenge computer raise.,13,rivera-roth,2023,USD,577668,307973,269695,372864,-103169,0,-103169,5776,11553,-114722,23794,501240,217158,284082,,577668,336.85,221.78,0.0631,902,53.35,66098.83,0.36,0.4669
2221,Brady-Mueller,False,ZA,Jocelynshire,Mobility,2017,https://brady-mueller.com,Central alone attention simple town.,25,brady-mueller,2023,USD,1988152,666696,1321456,887857,433599,0,433599,19881,39763,393836,264517,1339487,594258,745229,,1988152,20.0,13.89,0.0299,2447,67.68,12123.57,21.82,0.6647
2222,Mckinney-Stephens,False,BR,Port Leslieton,HealthTech,2011,https://mckinney-stephens.com,Determine expect simple rich difference indicate shake according lot sign.,22,mckinney-stephens,2023,USD,1423952,600722,823230,447230,376000,25010,350990,14239,28479,322511,149703,1036119,361394,674725,118662.67,1423952,234.1,236.35,0.001,1383,85.79,27570.2,5.43,0.5781
2223,Turner Owens and Harrell,False,GB,New Loriport,EdTech,2008,https://turnerowensandharrell.com,If yard do upon almost positive.,20,turner-owens-and-harrell,2023,USD,634152,109776,524376,460322,64054,0,64054,6341,12683,51371,142761,613775,62265,551510,52846.0,634152,236.59,1239.81,0.0278,1119,47.2,22009.38,6.49,0.8269
2224,Hartman Inc,False,KE,Scottville,AgriTech,2008,https://hartmaninc.com,Game record performance necessary quite source.,21,hartman-inc,2023,USD,283458,133121,150337,44291,106046,0,106046,2834,5669,100377,14888,231535,71790,159745,,283458,20.0,65.22,0.0291,729,32.4,7988.72,1.86,0.5304
2225,Knapp Ltd,False,EG,Davisside,Mobility,2023,https://knappltd.com,Herself board her know already page management science.,20,knapp-ltd,2023,USD,2514521,822266,1692255,1392698,299557,7395,292162,25145,50290,241872,164273,1469063,475515,993548,,2514521,20.0,10.0,0.0251,959,218.3,115990.57,1.42,0.673
2226,Schroeder Allen and Gallagher,False,NG,North Ginastad,SaaS,2023,https://schroederallenandgallagher.com,Base her shoulder country response available open yet heart poor.,22,schroeder-allen-and-gallagher,2023,USD,690603,43647,646956,504375,142581,20098,122483,6906,13812,108671,52921,578807,45194,533613,57550.25,690603,50.95,143.08,0.012,568,101.24,58202.78,0.91,0.9368
2227,Stone Ltd,False,DE,Jenniferton,EdTech,2023,https://stoneltd.com,Go response picture up thank stock without free.,13,stone-ltd,2023,EUR,273117,36771,236346,65400,170946,0,170946,2731,5462,165484,10433,319826,154424,165402,22759.75,273117,53.3,148.17,0.0322,2910,7.82,1000.0,10.43,0.8654
2228,Velazquez LLC,False,EG,Smithfort,Energy,2022,https://velazquezllc.com,Ten according end conference activity Mrs possible international.,20,velazquez-llc,2023,USD,6948936,1807182,5141754,863296,4278458,16793,4261665,69489,138978,4122687,126359,3697856,184892,3512964,,6948936,20.0,47.74,0.0797,1707,339.1,106719.44,1.18,0.7399
2229,David White and Rodriguez,False,FR,South Anthony,IoT,2008,https://davidwhiteandrodriguez.com,Within store price skin standard ask.,25,david-white-and-rodriguez,2023,EUR,328021,151818,176203,204778,-28575,0,-28575,3280,6560,-35135,29264,278698,17988,260710,,328021,170.45,1375.62,0.0505,136,199.57,11211.68,2.61,0.5372
2230,Graham Valencia and Smith,False,DE,North Veronicabury,AI/ML,2016,https://grahamvalenciaandsmith.com,Stuff onto attention everything occur sport attack level any.,19,graham-valencia-and-smith,2023,EUR,720752,307189,413563,80724,332839,7931,324908,7207,14415,310493,96672,528677,29582,499095,,720752,1759.47,3733.78,0.1061,700,85.77,20145.69,4.8,0.5738
2231,Vang Group,False,KE,Estradahaven,Marketplaces,2014,https://vanggroup.com,General such property real left.,20,vang-group,2023,USD,820926,345253,475673,533269,-57596,29025,-86621,8209,16418,-103039,82361,666700,264890,401810,,820926,20.0,25.28,0.0257,245,279.13,54249.07,1.52,0.5794
2232,Rosales-Glover,False,US,West Emilymouth,HealthTech,2012,https://rosales-glover.com,Recently media thing beyond none interview.,14,rosales-glover,2023,USD,1020929,124190,896739,265459,631280,33163,598117,10209,20418,577699,27449,610800,30540,580260,85077.42,1020929,196.4,899.45,0.001,688,123.53,48538.1,0.57,0.8784
2233,Mejia Greene and Morales,False,US,Johnsonfort,Marketplaces,2019,https://mejiagreeneandmorales.com,Dark fish organization hospital sometimes rate wrong stage chance.,25,mejia-greene-and-morales,2023,USD,2100336,1071559,1028777,604749,424028,840,423188,21003,42006,381182,56963,1250018,661283,588735,,2100336,1358.38,8768.7,0.106,8751,20.0,67788.78,0.84,0.4898
2234,Grimes-Valenzuela,False,US,East Michealbury,HealthTech,2009,https://grimes-valenzuela.com,Value production someone room site particular goal any ground interesting.,19,grimes-valenzuela,2023,USD,1321431,174749,1146682,845414,301268,12851,288417,13214,26428,261989,16234,716345,103889,612456,110119.25,1321431,285.08,953.89,0.0685,3170,34.73,87717.25,0.19,0.8678
2235,Baker Cochran and Warren,False,BR,Lopezside,IoT,2017,https://bakercochranandwarren.com,Necessary room majority market meeting want.,20,baker-cochran-and-warren,2023,USD,368999,108319,260680,207196,53484,27695,25789,3689,7379,18410,9723,265835,33129,232706,,368999,995.72,3681.17,0.0382,697,44.07,1000.0,9.72,0.7065
2236,Porter-Lawson,False,CA,Michellemouth,Fintech,2009,https://porter-lawson.com,Fill Mr health page opportunity seem concern certain already bag.,20,porter-lawson,2023,USD,3137598,1007343,2130255,926771,1203484,20084,1183400,31375,62751,1120649,320646,1944016,148457,1795559,,3137598,20.0,74.95,0.0266,1019,256.35,97477.91,3.29,0.6789
2237,Brown Group,False,FR,Ronaldshire,Energy,2013,https://browngroup.com,Chance special born become inside one.,23,brown-group,2023,EUR,4172595,1526426,2646169,3134671,-488502,2936,-491438,41725,83451,-574889,70199,2298388,594173,1704215,,4172595,1151.21,2826.65,0.0878,1889,184.01,290970.12,0.24,0.6342
2238,Clark and Sons,False,GB,East Courtneybury,Marketplaces,2017,https://clarkandsons.com,Long describe fly hotel car something rich local discussion forget.,19,clark-and-sons,2023,USD,1006054,460807,545247,421277,123970,0,123970,10060,20121,103849,100634,780668,275261,505407,,1006054,1488.49,2892.89,0.0758,1612,52.0,53536.76,1.88,0.542
2239,Thompson-Norris,False,KE,East Carmenview,Marketplaces,2013,https://thompson-norris.com,What effect mean box next idea take operation face happy.,20,thompson-norris,2023,USD,474664,220032,254632,293708,-39076,335,-39411,4746,9493,-48904,8326,310739,173277,137462,,474664,405.68,2488.12,0.0883,140,281.97,1303.91,6.39,0.5364
2240,Hall-Beltran,False,EG,East Beth,Cybersecurity,2019,https://hall-beltran.com,Key least issue town account.,21,hall-beltran,2023,USD,1608997,365312,1243685,801405,442280,18551,423729,16089,32179,391550,44673,925612,46280,879332,,1608997,20.0,64.66,0.0439,1090,122.91,72049.57,0.62,0.773
2241,Bradley LLC,False,US,Brookston,Fintech,2017,https://bradleyllc.com,For lot produce right sit none learn data.,12,bradley-llc,2023,USD,4893974,1392130,3501844,1628659,1873185,0,1873185,48939,97879,1775306,201309,2828762,1221951,1606811,,4893974,549.21,274.6,0.0975,8896,45.84,127459.45,1.58,0.7155
2242,Caldwell and Sons,False,CA,Danielleborough,E-commerce,2020,https://caldwellandsons.com,Easy understand baby ready manager all onto tonight.,16,caldwell-and-sons,2023,USD,317388,77728,239660,148589,91071,26035,65036,3173,6347,58689,10524,223439,11171,212268,,317388,347.47,1400.53,0.0204,305,86.68,8981.4,1.17,0.7551
2243,Moore-Montgomery,False,FR,Lake Kristinfurt,Energy,2010,https://moore-montgomery.com,Reduce health poor yeah cost partner culture office imagine help.,27,moore-montgomery,2023,EUR,2530352,1042910,1487442,126517,1360925,13595,1347330,25303,50607,1296723,54585,1433611,1072768,360843,,2530352,1106.59,5272.9,0.059,10543,20.0,13376.06,4.08,0.5878
2244,Bray-Drake,False,IN,Markfurt,Mobility,2012,https://bray-drake.com,Service direction two poor evening soon art response administration certainly.,23,bray-drake,2023,USD,1268189,455259,812930,189435,623495,28823,594672,12681,25363,569309,56881,736984,168759,568225,,1268189,818.44,1704.13,0.001,1053,100.35,13268.75,4.29,0.641
2245,Chan-Watkins,False,FR,Cindystad,Cybersecurity,2016,https://chan-watkins.com,Success change TV ability surface son measure.,18,chan-watkins,2023,EUR,623944,224292,399652,180476,219176,0,219176,6239,12478,206698,37641,530981,255109,275872,,623944,461.89,1637.58,0.001,528,98.4,40917.46,0.92,0.6405
2246,Mendez Carr and Hurley,False,CA,East Susanshire,AI/ML,2021,https://mendezcarrandhurley.com,Hard wife fly more someone thought back.,19,mendez-carr-and-hurley,2023,USD,266367,152219,114148,13318,100830,28509,72321,2663,5327,66994,4750,181240,66287,114953,,266367,674.08,2221.91,0.001,166,133.57,8692.07,0.55,0.4285
2247,Nguyen Group,False,NG,Port Jacobmouth,EdTech,2014,https://nguyengroup.com,How poor that student experience usually reach his.,28,nguyen-group,2023,USD,225974,48157,177817,112945,64872,7783,57089,2259,4519,52570,1921,116087,31358,84729,18831.17,225974,10.0,93.9,0.0491,738,25.49,1000.0,1.92,0.7869
2248,Collier-Cook,False,KE,Justinburgh,SaaS,2011,https://collier-cook.com,Treatment which store game.,24,collier-cook,2023,USD,544440,242696,301744,187075,114669,11116,103553,5444,10888,92665,30415,476428,157437,318991,45370.0,544440,704.87,3101.88,0.0829,1053,43.08,1000.0,30.42,0.5542
2249,Mcguire-Dean,False,KE,East Elizabeth,Cybersecurity,2024,https://mcguire-dean.com,Expect majority team seek early far everybody him artist weight.,21,mcguire-dean,2023,USD,1007629,192380,815249,539142,276107,50485,225622,10076,20152,205470,78276,634266,216130,418136,,1007629,2047.66,6482.25,0.1318,4198,20.0,41841.45,1.87,0.8091
2250,Howe Whitaker and Green,False,FR,Lake Ebonychester,Mobility,2017,https://howewhitakerandgreen.com,Someone economic number table baby.,20,howe-whitaker-and-green,2023,EUR,542490,152385,390105,271818,118287,4305,113982,5424,10849,103133,31090,424692,35739,388953,,542490,20.0,98.61,0.0645,2260,20.0,1000.0,31.09,0.7191
2251,Lane-Ayala,False,TN,South Jamesberg,IoT,2018,https://lane-ayala.com,Employee several be concern tree.,14,lane-ayala,2023,USD,375004,174980,200024,240518,-40494,26861,-67355,3750,7500,-74855,18321,226177,119105,107072,,375004,20.0,63.77,0.0584,197,158.6,1000.0,18.32,0.5334
2252,Carter Inc,False,IN,Morganland,AI/ML,2019,https://carterinc.com,Method town front education stop more west from.,13,carter-inc,2023,USD,577331,214214,363117,233078,130039,16887,113152,5773,11546,101606,24390,319301,230650,88651,,577331,20.0,116.44,0.0437,194,247.56,13870.07,1.76,0.629
2253,Lee Ltd,False,GB,South Philip,IoT,2023,https://leeltd.com,Cell future wait son.,16,lee-ltd,2023,USD,859538,538048,321490,42976,278514,43868,234646,8595,17190,217456,194368,677874,213163,464711,,859538,122.52,362.81,0.0805,3581,20.0,41681.71,4.66,0.374
2254,Murphy Group,False,NG,Andreamouth,Cybersecurity,2023,https://murphygroup.com,Between health list color arrive forget scene fight condition beat once.,21,murphy-group,2023,USD,575706,224234,351472,430960,-79488,0,-79488,5757,11514,-91002,49141,423420,212846,210574,,575706,20.0,102.76,0.0037,2398,20.0,34763.62,1.41,0.6105
2255,Day Inc,False,EG,Ernestshire,HealthTech,2015,https://dayinc.com,Establish both body according base spring which really however officer.,15,day-inc,2023,USD,5017048,2345870,2671178,2364572,306606,21814,284792,50170,100340,184452,237209,2820056,1561313,1258743,418087.33,5017048,10.0,36.07,0.001,20821,20.08,222203.97,1.07,0.5324
2256,Carpenter LLC,False,ZA,South Marc,AgriTech,2014,https://carpenterllc.com,Town stock star air.,20,carpenter-llc,2023,USD,297565,72077,225488,211638,13850,0,13850,2975,5951,7899,59934,222399,96150,126249,,297565,323.32,164.99,0.0443,163,151.61,10387.37,5.77,0.7578
2257,Turner-Williams,False,US,New Rachelport,Fintech,2008,https://turner-williams.com,Job woman message minute idea person myself.,23,turner-williams,2023,USD,1220932,276016,944916,1153774,-208858,13329,-222187,12209,24418,-246605,134771,806475,451314,355161,,1220932,796.51,3220.02,0.0133,2367,42.98,67874.28,1.99,0.7739
2258,Daniels Ford and Ayers,False,EG,East Ebonymouth,Marketplaces,2011,https://danielsfordandayers.com,We weight tree fine event police buy training.,22,daniels-ford-and-ayers,2023,USD,1826964,727602,1099362,183426,915936,0,915936,18269,36539,879397,307459,1308542,379291,929251,,1826964,565.8,1147.97,0.0969,579,262.7,8921.45,34.46,0.6017
2259,Lee-Hernandez,False,ZA,New Diamondville,EdTech,2021,https://lee-hernandez.com,Course military third design grow.,24,lee-hernandez,2023,USD,1708103,772790,935313,1010740,-75427,60018,-135445,17081,34162,-169607,41058,906985,180541,726444,142341.92,1708103,10.0,41.1,0.0525,1049,135.69,63887.7,0.64,0.5476
2260,Saunders Eaton and Young,False,TN,New John,SaaS,2018,https://saunderseatonandyoung.com,Road challenge risk same.,16,saunders-eaton-and-young,2023,USD,528042,306515,221527,244963,-23436,0,-23436,5280,10560,-33996,133697,428912,116318,312594,44003.5,528042,573.03,3886.62,0.0112,1552,28.35,1000.0,133.7,0.4195
2261,Foster-Bender,False,CA,Bassbury,AI/ML,2014,https://foster-bender.com,Act cause east strong serious education.,25,foster-bender,2023,USD,960626,154736,805890,800454,5436,0,5436,9606,19212,-13776,22712,590402,85969,504433,,960626,20.0,108.07,0.0705,471,169.9,102484.02,0.22,0.8389
2262,Herrera Group,False,US,Port Shanefurt,Marketplaces,2014,https://herreragroup.com,Financial care try cup year.,19,herrera-group,2023,USD,931182,307921,623261,222500,400761,0,400761,9311,18623,382138,312658,779645,283266,496379,,931182,1413.73,3684.85,0.0295,601,128.99,1000.0,312.66,0.6693
2263,Guerrero Potter and Snyder,False,ZA,Ericksonfort,AgriTech,2016,https://guerreropotterandsnyder.com,Appear much theory tend main care always.,20,guerrero-potter-and-snyder,2023,USD,245537,99254,146283,76863,69420,0,69420,2455,4910,64510,18952,237559,84484,153075,,245537,20.0,77.74,0.0258,56,359.33,16095.27,1.18,0.5958
2264,Morgan Leon and Cameron,False,AU,North Johnborough,Fintech,2017,https://morganleonandcameron.com,Think have authority reach sport.,22,morgan-leon-and-cameron,2023,USD,2617700,1331331,1286369,1693793,-407424,0,-407424,26177,52354,-459778,75172,1412634,628686,783948,,2617700,1420.74,3714.91,0.0732,1048,208.1,146004.57,0.51,0.4914
2265,Espinoza Snyder and Stark,False,IN,Laurenberg,AI/ML,2018,https://espinozasnyderandstark.com,Everybody it eye ask seat project mother provide.,12,espinoza-snyder-and-stark,2023,USD,385100,165593,219507,93115,126392,0,126392,3851,7702,118690,18653,259080,166082,92998,,385100,20.0,117.42,0.005,1604,20.0,7253.89,2.57,0.57
2266,Thompson Bolton and Hamilton,False,AU,New Andrea,SaaS,2011,https://thompsonboltonandhamilton.com,Detail price source college until office.,20,thompson-bolton-and-hamilton,2023,USD,486659,106053,380606,113382,267224,47432,219792,4866,9733,210059,19640,419327,279014,140313,40554.92,486659,10.0,56.82,0.0452,825,49.1,17762.78,1.11,0.7821
2267,Wong-Cordova,False,BR,Port Mary,E-commerce,2018,https://wong-cordova.com,Prepare might long worker truth ever practice discussion tough lead.,21,wong-cordova,2023,USD,1360064,698104,661960,680891,-18931,21393,-40324,13600,27201,-67525,7538,760693,315577,445116,,1360064,20.0,153.88,0.1302,1243,91.12,58405.18,0.13,0.4867
2268,Hall Meyer and Guzman,False,TN,North Lori,Cybersecurity,2008,https://hallmeyerandguzman.com,Race or purpose practice five fine life arm according.,22,hall-meyer-and-guzman,2023,USD,7830671,3528052,4302619,843574,3459045,0,3459045,78306,156613,3302432,1734617,5729565,2790673,2938892,,7830671,20.0,76.88,0.001,1735,375.97,95392.01,18.18,0.5495
2269,Lucero-Barajas,False,GB,South Timothytown,EdTech,2018,https://lucero-barajas.com,Necessary similar father executive official partner tree cup get help.,19,lucero-barajas,2023,USD,3189802,927110,2262692,1386746,875946,29929,846017,31898,63796,782221,138844,1827897,91394,1736503,265816.83,3189802,587.2,2188.61,0.0696,5402,49.2,124608.85,1.11,0.7094
2270,Bush-Perry,False,CA,East Amytown,Marketplaces,2023,https://bush-perry.com,Treatment grow particularly statement need science everyone commercial.,18,bush-perry,2023,USD,642213,380503,261710,54336,207374,0,207374,6422,12844,194530,35515,458173,223192,234981,,642213,352.28,1071.96,0.0368,149,358.05,1000.0,35.52,0.4075
2271,Aguilar-Rogers,False,EG,Port Meghan,SaaS,2012,https://aguilar-rogers.com,Remain score partner go benefit including.,20,aguilar-rogers,2023,USD,1376499,549625,826874,641573,185301,23523,161778,13764,27529,134249,70881,948359,254292,694067,114708.25,1376499,10.0,60.34,0.001,2888,39.71,101613.54,0.7,0.6007
2272,Barker Rodriguez and Adkins,False,EG,North Candicefort,HealthTech,2022,https://barkerrodriguezandadkins.com,Garden pull with southern investment I green.,30,barker-rodriguez-and-adkins,2023,USD,697846,238140,459706,519842,-60136,7911,-68047,6978,13956,-82003,20714,541351,311153,230198,58153.83,697846,10.0,42.44,0.0677,514,113.02,21959.65,0.94,0.6587
2273,Smith Castaneda and Gross,False,NG,Calvinbury,E-commerce,2022,https://smithcastanedaandgross.com,Third town cell end information reduce successful skin letter.,19,smith-castaneda-and-gross,2023,USD,806644,478013,328631,58787,269844,0,269844,8066,16132,253712,24381,427788,64737,363051,,806644,20.0,63.29,0.001,329,204.15,6518.66,3.74,0.4074
2274,Kaiser and Sons,False,AU,East Cynthia,Energy,2009,https://kaiserandsons.com,Born middle kid thought their staff president now discover war.,23,kaiser-and-sons,2023,USD,343221,173556,169665,78528,91137,0,91137,3432,6864,84273,19010,347800,17390,330410,,343221,1171.13,1401.63,0.0577,304,93.85,36654.14,0.52,0.4943
2275,Leonard-Harmon,False,NG,Natalieville,AgriTech,2018,https://leonard-harmon.com,Total kid first ok each.,25,leonard-harmon,2023,USD,315283,84533,230750,63580,167170,0,167170,3152,6305,160865,22780,187640,94115,93525,,315283,245.37,122.68,0.001,171,153.28,1000.0,22.78,0.7319
2276,Vance-Robinson,False,NG,West Catherineborough,AI/ML,2008,https://vance-robinson.com,Wrong black administration movement idea wind approach.,34,vance-robinson,2023,USD,1241408,330888,910520,848971,61549,1900,59649,12414,24828,34821,57374,831445,724001,107444,,1241408,20.0,37.9,0.001,546,189.32,44267.62,1.3,0.7335
2277,Dennis-Cook,False,DE,Emilytown,IoT,2018,https://dennis-cook.com,Dog until believe song during.,18,dennis-cook,2023,EUR,1195352,571238,624114,262481,361633,0,361633,11953,23907,337726,138250,839822,300085,539737,,1195352,751.44,3366.93,0.0058,1305,76.32,18087.41,7.64,0.5221
2278,Evans-Crane,False,AU,Lake Benjaminton,E-commerce,2010,https://evans-crane.com,Attack check away education name language.,30,evans-crane,2023,USD,4043000,1501014,2541986,2109125,432861,28345,404516,40430,80860,323656,122457,2244742,1777214,467528,,4043000,20.0,134.0,0.1384,4912,68.58,186625.63,0.66,0.6287
2279,Holmes Group,False,GB,South Cynthiafort,AgriTech,2008,https://holmesgroup.com,Knowledge society court service example paper long trip action professor.,25,holmes-group,2023,USD,308945,96660,212285,86782,125503,4674,120829,3089,6178,114651,26691,224567,85972,138595,,308945,20.0,64.88,0.061,72,355.64,1000.0,26.69,0.6871
2280,Ramirez Ltd,False,CA,Elizabethview,Energy,2013,https://ramirezltd.com,Right fill can analysis guess that.,28,ramirez-ltd,2023,USD,4049516,2217350,1832166,3036609,-1204443,0,-1204443,40495,80990,-1285433,100262,2188563,585289,1603274,,4049516,20.0,45.39,0.054,5290,63.78,239142.96,0.42,0.4524
2281,Phillips Group,False,KE,North Alexanderport,IoT,2020,https://phillipsgroup.com,Current doctor hand whether lay.,17,phillips-group,2023,USD,1412873,398248,1014625,695082,319543,0,319543,14128,28257,291286,63506,875895,455040,420855,,1412873,90.6,590.69,0.0574,5886,20.0,60058.3,1.06,0.7181
2282,Anderson-Le,False,GB,Lake Erin,IoT,2011,https://anderson-le.com,Others ground sense yet less prevent major.,14,anderson-le,2023,USD,1473909,520052,953857,244956,708901,8672,700229,14739,29478,670751,31886,833821,372635,461186,,1473909,33.24,105.08,0.0484,6141,20.0,19204.82,1.66,0.6472
2283,Page PLC,False,AU,Espinozamouth,AgriTech,2018,https://pageplc.com,Interest save truth ten design lose prevent can defense.,23,page-plc,2023,USD,2119876,952954,1166922,105993,1060929,0,1060929,21198,42397,1018532,180432,1360758,69173,1291585,,2119876,20.0,98.56,0.0019,8832,20.0,47209.6,3.82,0.5505
2284,Miller Maddox and Walker,False,ZA,Dayburgh,SaaS,2016,https://millermaddoxandwalker.com,Everyone live although guess only.,28,miller-maddox-and-walker,2023,USD,400377,41785,358592,114300,244292,12135,232157,4003,8007,224150,22949,305967,148265,157702,33364.75,400377,716.53,3054.77,0.0255,586,56.93,25478.74,0.9,0.8956
2285,Peterson-Mason,False,TN,Lake Jillmouth,Fintech,2023,https://peterson-mason.com,Exactly Mrs together air which official idea.,15,peterson-mason,2023,USD,274689,142611,132078,208929,-76851,0,-76851,2746,5493,-82344,20815,216487,53141,163346,,274689,765.36,568.37,0.001,672,34.02,16360.25,1.27,0.4808
2286,Luna-Williams,False,DE,West Nancymouth,E-commerce,2022,https://luna-williams.com,Former cover notice short much foot product result almost too.,24,luna-williams,2023,EUR,512106,199838,312268,154926,157342,36900,120442,5121,10242,110200,51226,313382,15669,297713,,512106,20.0,19.77,0.0181,2133,20.0,28644.1,1.79,0.6098
2287,Burke-Saunders,False,IN,South Christopher,EdTech,2024,https://burke-saunders.com,First all improve might suggest to across with school white.,16,burke-saunders,2023,USD,335251,135617,199634,135357,64277,36542,27735,3352,6705,21030,24560,256812,45546,211266,27937.58,335251,76.79,528.27,0.001,537,51.98,38597.16,0.64,0.5955
2288,Saunders and Sons,False,IN,Hansenview,HealthTech,2011,https://saundersandsons.com,Area time grow power rest sense.,25,saunders-and-sons,2023,USD,363218,126900,236318,102818,133500,8079,125421,3632,7264,118157,9053,219346,48733,170613,30268.17,363218,306.93,537.77,0.0071,893,33.87,1000.0,9.05,0.6506
2289,Flores Campbell and Malone,False,CA,South Katherinehaven,SaaS,2014,https://florescampbellandmalone.com,Quality lay recognize me moment will onto theory popular today.,19,flores-campbell-and-malone,2023,USD,446026,100885,345141,143568,201573,9720,191853,4460,8920,182933,8905,328698,182219,146479,37168.83,446026,49.93,396.54,0.0077,434,85.57,15994.01,0.56,0.7738
2290,Proctor Inc,False,FR,Lake Benjaminberg,Mobility,2024,https://proctorinc.com,Understand against series financial.,17,proctor-inc,2023,EUR,152636,45585,107051,40559,66492,0,66492,1526,3052,63440,18844,150058,51200,98858,,152636,893.62,5622.09,0.0128,102,124.44,14568.05,1.29,0.7013
2291,Benitez and Sons,False,US,Richardmouth,Mobility,2024,https://benitezandsons.com,Protect Mr administration want believe thought weight world.,18,benitez-and-sons,2023,USD,1847672,686815,1160857,486885,673972,7093,666879,18476,36953,629926,131473,1120655,533598,587057,,1847672,20.0,76.03,0.1587,7698,20.0,22353.41,5.88,0.6283
2292,Patterson Webb and Boyd,False,GB,Stephanieberg,EdTech,2018,https://pattersonwebbandboyd.com,Call factor statement which arrive else nature like boy.,14,patterson-webb-and-boyd,2023,USD,764603,365912,398691,182831,215860,0,215860,7646,15292,200568,60570,520661,100146,420515,63716.92,764603,87.77,367.38,0.0102,1861,34.23,25036.5,2.42,0.5214
2293,Petty PLC,False,EG,Owenstown,Cybersecurity,2024,https://pettyplc.com,Drug for since realize process difference senior.,29,petty-plc,2023,USD,289013,128237,160776,247777,-87001,1810,-88811,2890,5780,-94591,48318,256142,88227,167915,,289013,366.06,183.03,0.0257,628,38.3,20737.88,2.33,0.5563
2294,Sanchez-Parker,False,IN,Hopkinshaven,E-commerce,2012,https://sanchez-parker.com,Yeah themselves price eight specific quickly senior police arm something.,24,sanchez-parker,2023,USD,2924742,300490,2624252,2169449,454803,0,454803,29247,58494,396309,166584,1828897,1069360,759537,,2924742,1558.77,779.38,0.0735,12186,20.0,195834.7,0.85,0.8973
2295,Palmer Inc,False,AU,Ramoshaven,Fintech,2024,https://palmerinc.com,Of end success claim level executive month black various court.,27,palmer-inc,2023,USD,1420296,433099,987197,480193,507004,0,507004,14202,28405,478599,82622,910789,324696,586093,,1420296,1318.1,6569.5,0.001,696,169.91,1000.0,82.62,0.6951
2296,Hunt LLC,False,BR,East John,HealthTech,2014,https://huntllc.com,Two ready spring best skin coach happen.,18,hunt-llc,2023,USD,6102600,669108,5433492,2231585,3201907,8060,3193847,61026,122052,3071795,1645767,4762979,238148,4524831,508550.0,6102600,10.0,70.75,0.001,8278,61.43,193485.16,8.51,0.8904
2297,Merritt Group,False,ZA,North Johnbury,SaaS,2022,https://merrittgroup.com,Establish rock choice thousand south light agreement speech whose.,16,merritt-group,2023,USD,778178,281264,496914,320928,175986,14745,161241,7781,15563,145678,45556,445747,226118,219629,64848.17,778178,549.48,1844.97,0.0354,527,122.94,29782.32,1.53,0.6386
2298,Rivera James and Edwards,False,TN,East David,Cybersecurity,2024,https://riverajamesandedwards.com,Election PM box structure too policy agree activity.,16,rivera-james-and-edwards,2023,USD,5783972,2268440,3515532,3765820,-250288,0,-250288,57839,115679,-365967,474026,3402237,2145381,1256856,,5783972,20.0,11.37,0.0604,17831,27.03,322735.78,1.47,0.6078
2299,Wright Group,False,FR,North Kristen,SaaS,2017,https://wrightgroup.com,That computer within finally clearly ten six just.,13,wright-group,2023,EUR,541174,268610,272564,255481,17083,21588,-4505,5411,10823,-15328,13686,439929,137963,301966,45097.83,541174,10.0,11.55,0.001,1256,35.9,5822.21,2.35,0.5037
2300,Goodman LLC,False,US,New Joseph,Marketplaces,2010,https://goodmanllc.com,Firm interesting buy important white fine.,21,goodman-llc,2023,USD,219257,90192,129065,122238,6827,98,6729,2192,4385,2344,2305,132514,77179,55335,,219257,899.63,3458.91,0.1189,59,309.26,1000.0,2.31,0.5886
2301,Duncan Carr and Nelson,False,CA,South Laura,Mobility,2009,https://duncancarrandnelson.com,Move surface forget decide shake.,24,duncan-carr-and-nelson,2023,USD,990725,444552,546173,363123,183050,5789,177261,9907,19814,157447,71465,607003,253342,353661,,990725,20.0,10.0,0.0945,596,138.35,44309.0,1.61,0.5513
2302,Nichols-Moore,False,FR,Lake Danielle,AI/ML,2017,https://nichols-moore.com,Art blood surface oil system financial all sometimes.,23,nichols-moore,2023,EUR,392747,206169,186578,334254,-147676,16109,-163785,3927,7854,-171639,16440,343459,265925,77534,,392747,642.67,2689.2,0.076,114,284.89,40467.29,0.41,0.4751
2303,Lee PLC,False,US,Brittanystad,IoT,2017,https://leeplc.com,Argue deal prove usually four population meet air agreement south.,17,lee-plc,2023,USD,334019,99080,234939,281747,-46808,0,-46808,3340,6680,-53488,119017,369153,159119,210034,,334019,135.12,412.02,0.001,1391,20.0,12368.84,9.62,0.7034
2304,Williams-Crawford,False,BR,New Ginamouth,EdTech,2018,https://williams-crawford.com,Guess small state treatment group exactly.,17,williams-crawford,2023,USD,554399,372820,181579,336611,-155032,26626,-181658,5543,11087,-192745,50698,449292,22464,426828,46199.92,554399,270.88,1196.74,0.0339,2805,16.47,5735.95,8.84,0.3275
2305,Kennedy Burns and King,False,DE,Arianaview,EdTech,2017,https://kennedyburnsandking.com,Early fill executive apply itself hit mother memory career fear.,22,kennedy-burns-and-king,2023,EUR,413283,183107,230176,74926,155250,14717,140533,4132,8265,132268,11652,311357,86801,224556,34440.25,413283,290.12,1022.69,0.0367,2002,17.2,1000.0,11.65,0.5569
2306,Martinez-Harmon,False,IN,Diazstad,AI/ML,2018,https://martinez-harmon.com,Market order size spring none tough.,17,martinez-harmon,2023,USD,2267341,409481,1857860,1162139,695721,0,695721,22673,45346,650375,30427,1256953,972634,284319,,2267341,297.03,240.93,0.0698,9447,20.0,99613.03,0.31,0.8194
2307,Delgado-James,False,AU,East Davidview,Mobility,2011,https://delgado-james.com,Life teacher education within room.,24,delgado-james,2023,USD,2711891,842709,1869182,1765532,103650,36293,67357,27118,54237,13120,407896,1778864,574139,1204725,,2711891,20.0,45.88,0.1139,1621,139.34,164683.63,2.48,0.6893
2308,Graham Davis and Hamilton,False,IN,East Megan,HealthTech,2013,https://grahamdavisandhamilton.com,Light key century weight guess visit soldier.,20,graham-davis-and-hamilton,2023,USD,163819,76455,87364,8190,79174,24592,54582,1638,3276,51306,117758,363606,101654,261952,13651.58,163819,327.75,721.35,0.0796,226,60.33,4216.26,27.93,0.5333
2309,Woods Harris and Jennings,False,IN,East Davidton,Fintech,2008,https://woodsharrisandjennings.com,See without since father purpose our various.,15,woods-harris-and-jennings,2023,USD,1990606,757836,1232770,410240,822530,7801,814729,19906,39812,774917,162124,1215131,329305,885826,,1990606,601.92,4000.43,0.0446,1172,141.46,43918.13,3.69,0.6193
2310,Gould-Pace,False,KE,Hawkinsstad,AI/ML,2024,https://gould-pace.com,Rate drug before surface option enough.,26,gould-pace,2023,USD,3919374,1302928,2616446,1439794,1176652,0,1176652,39193,78387,1098265,136673,2097203,104860,1992343,,3919374,808.25,404.12,0.0176,1438,227.03,118057.73,1.16,0.6676
2311,Swanson-Rogers,False,FR,Cassandrastad,EdTech,2019,https://swanson-rogers.com,Government lead medical break large cover body report explain road probably.,22,swanson-rogers,2023,EUR,168706,38375,130331,129544,787,1334,-547,1687,3374,-3921,32327,194630,57770,136860,14058.83,168706,448.93,2147.73,0.0223,2811,5.0,1000.0,32.33,0.7725
2312,Gonzales Inc,False,NG,East Melissa,E-commerce,2016,https://gonzalesinc.com,Total claim outside decade television trial little.,28,gonzales-inc,2023,USD,439471,195049,244422,335835,-91413,0,-91413,4394,8789,-100202,68834,394136,81726,312410,,439471,1520.08,1086.62,0.0663,212,172.62,18922.87,3.64,0.5562
2313,Murray LLC,False,GB,Port Elizabethton,Cybersecurity,2017,https://murrayllc.com,Rock hope professional between clear help measure.,14,murray-llc,2023,USD,1614337,518999,1095338,352956,742382,33398,708984,16143,32286,676698,84978,947718,47385,900333,,1614337,643.89,2278.39,0.1068,748,179.63,24190.44,3.51,0.6785
2314,Hanna LLC,False,KE,East Jasmineberg,EdTech,2013,https://hannallc.com,Responsibility class live practice quickly full ground soldier usually with.,18,hanna-llc,2023,USD,850825,256121,594704,219491,375213,0,375213,8508,17016,358197,268894,790656,277253,513403,70902.08,850825,723.83,3334.89,0.001,964,73.54,14549.07,18.48,0.699
2315,Ramos Group,False,FR,Olsonview,AgriTech,2018,https://ramosgroup.com,Deal decision recognize describe sell star.,23,ramos-group,2023,EUR,546221,157746,388475,59015,329460,16790,312670,5462,10924,301746,8109,432394,211268,221126,,546221,20.0,113.55,0.0797,2275,20.0,27718.71,0.29,0.7112
2316,Lee-Cobb,False,NG,Meyerborough,Mobility,2009,https://lee-cobb.com,Industry second cost station general American case ability kid close.,18,lee-cobb,2023,USD,3810552,1241428,2569124,871572,1697552,8266,1689286,38105,76211,1613075,49157,2045754,346588,1699166,,3810552,20.0,132.55,0.0815,1391,228.18,56301.08,0.87,0.6742
2317,Lee-Burton,False,GB,Stephaniehaven,SaaS,2023,https://lee-burton.com,What notice skin will unit gas themselves attention.,18,lee-burton,2023,USD,673148,392999,280149,577765,-297616,37168,-334784,6731,13462,-348246,61898,584370,183735,400635,56095.67,673148,143.05,645.05,0.0349,443,126.43,32782.26,1.89,0.4162
2318,Alvarez-Rodriguez,False,BR,West Hunterside,SaaS,2011,https://alvarez-rodriguez.com,Nice assume law air special write appear performance subject level.,18,alvarez-rodriguez,2023,USD,1933556,698504,1235052,519440,715612,0,715612,19335,38671,676941,109149,1180509,386865,793644,161129.67,1933556,319.32,617.43,0.0729,3423,47.07,38299.54,2.85,0.6387
2319,Garcia and Sons,False,TN,Zhangview,SaaS,2010,https://garciaandsons.com,Score military appear without civil.,18,garcia-and-sons,2023,USD,1799428,703039,1096389,787283,309106,33975,275131,17994,35988,239143,3655,936089,560281,375808,149952.33,1799428,200.35,1006.24,0.0626,29990,5.0,42996.13,0.09,0.6093
2320,Chavez Gaines and Brooks,False,TN,New Edwardside,Energy,2013,https://chavezgainesandbrooks.com,A arrive character agree.,20,chavez-gaines-and-brooks,2023,USD,644207,246382,397825,346990,50835,0,50835,6442,12884,37951,28765,353500,98753,254747,,644207,149.19,274.47,0.048,260,206.25,2082.79,13.81,0.6175
2321,Fuller Miller and Moore,False,ZA,New Breannaview,IoT,2022,https://fullermillerandmoore.com,Conference other poor follow including also doctor away.,30,fuller-miller-and-moore,2023,USD,1312767,498687,814080,120577,693503,32045,661458,13127,26255,635203,275977,1097771,408934,688837,,1312767,1041.49,1245.3,0.0421,4711,23.22,9991.01,27.62,0.6201
2322,Cochran-Meadows,False,KE,Shahville,E-commerce,2017,https://cochran-meadows.com,Guess smile ahead cold add very moment arm its.,21,cochran-meadows,2023,USD,636206,292959,343247,312409,30838,0,30838,6362,12724,18114,277947,681128,367172,313956,,636206,34.16,163.43,0.0457,139,378.85,15656.33,17.75,0.5395
2323,Mercado LLC,False,CA,South Matthewburgh,EdTech,2010,https://mercadollc.com,Business determine agency kitchen personal institution power.,20,mercado-llc,2023,USD,1043193,150345,892848,1016498,-123650,13196,-136846,10431,20863,-157709,17267,684284,270789,413495,86932.75,1043193,592.09,1210.29,0.001,17386,5.0,94114.6,0.18,0.8559
2324,Haynes Washington and Peterson,False,AU,Stefanietown,Mobility,2012,https://hayneswashingtonandpeterson.com,Full send field amount peace training compare easy include fact.,21,haynes-washington-and-peterson,2023,USD,1150436,392276,758160,778744,-20584,0,-20584,11504,23008,-43592,47964,726348,315685,410663,,1150436,150.6,139.68,0.0195,4793,20.0,66704.91,0.72,0.659
2325,Anderson-Thompson,False,FR,Mosesville,Cybersecurity,2022,https://anderson-thompson.com,Treat explain ready always soldier try prepare establish product tree.,15,anderson-thompson,2023,EUR,3062795,1028024,2034771,974023,1060748,0,1060748,30627,61255,999493,23555,1620928,495340,1125588,,3062795,20.0,77.61,0.0633,1684,151.48,58684.04,0.4,0.6644
2326,Best Green and Morales,False,FR,South Nancyview,Mobility,2017,https://bestgreenandmorales.com,Upon painting cut off expert international.,24,best-green-and-morales,2023,EUR,673110,205220,467890,85631,382259,12063,370196,6731,13462,356734,24908,418372,259789,158583,,673110,511.66,1566.88,0.0056,247,226.42,1000.0,24.91,0.6951
2327,Goodwin Gray and Scott,False,BR,South Angelaside,Marketplaces,2022,https://goodwingrayandscott.com,Nor save ten recent structure growth fire establish away.,14,goodwin-gray-and-scott,2023,USD,550071,161465,388606,329018,59588,4551,55037,5500,11001,44036,74389,472049,136726,335323,,550071,1936.59,6569.7,0.1116,580,78.96,53525.76,1.39,0.7065
2328,Brown Ltd,False,EG,Ellisberg,EdTech,2015,https://brownltd.com,Face before language door often Mrs throughout describe list.,19,brown-ltd,2023,USD,248661,95422,153239,178765,-25526,15448,-40974,2486,4973,-45947,8685,332512,37528,294984,20721.75,248661,10.0,40.4,0.0463,259,79.88,8654.83,1.0,0.6163
2329,Rasmussen LLC,False,GB,Port Daniel,IoT,2016,https://rasmussenllc.com,Ground prove miss chair throw word worry.,20,rasmussen-llc,2023,USD,356507,133525,222982,93139,129843,0,129843,3565,7130,122713,5947,352310,176717,175593,,356507,1609.38,3315.45,0.0886,207,143.5,1000.0,5.95,0.6255
2330,Payne-Nelson,False,CA,West Benjaminshire,Energy,2013,https://payne-nelson.com,Home attention meeting language hour oil.,19,payne-nelson,2023,USD,684300,244101,440199,572422,-132223,2671,-134894,6843,13686,-148580,43156,499053,46394,452659,,684300,20.0,40.78,0.0307,908,62.79,36907.33,1.17,0.6433
2331,Yoder-Orr,False,ZA,Port Brendan,Marketplaces,2018,https://yoder-orr.com,Property we city well white simply brother.,26,yoder-orr,2023,USD,1589125,633297,955828,461144,494684,11453,483231,15891,31782,451449,293290,1199343,220695,978648,,1589125,301.71,753.59,0.0429,2635,50.24,60916.68,4.81,0.6015
2332,Price-Webb,False,AU,North Eric,E-commerce,2022,https://price-webb.com,Above need game process television give only.,22,price-webb,2023,USD,1377165,339379,1037786,525965,511821,0,511821,13771,27543,484278,91961,894181,270612,623569,,1377165,1701.38,5029.84,0.0592,5738,20.0,85393.3,1.08,0.7536
2333,Young-Thornton,False,EG,West Kimberly,SaaS,2010,https://young-thornton.com,After oil six take then four make Mrs.,22,young-thornton,2023,USD,540664,231760,308904,136206,172698,11420,161278,5406,10813,150465,33068,404154,205358,198796,45055.33,540664,723.08,723.08,0.0324,612,73.55,1000.0,33.07,0.5713
2334,Valdez-Williams,False,EG,North James,Fintech,2019,https://valdez-williams.com,Available travel early PM full country open.,18,valdez-williams,2023,USD,625111,302966,322145,222240,99905,11918,87987,6251,12502,75485,76628,539056,355754,183302,,625111,1267.49,3549.33,0.001,565,92.1,29430.06,2.6,0.5153
2335,Hamilton-Mayer,False,EG,Christinamouth,Mobility,2013,https://hamilton-mayer.com,Staff agree marriage analysis analysis material voice between everyone.,18,hamilton-mayer,2023,USD,6224140,2629957,3594183,1524434,2069749,19642,2050107,62241,124482,1925625,121836,3426550,171327,3255223,,6224140,20.0,104.41,0.0897,3837,135.16,127637.21,0.95,0.5775
2336,Wright Group,False,IN,North Kristenshire,E-commerce,2012,https://wrightgroup.com,Role produce yeah through exist.,26,wright-group,2023,USD,1369400,726908,642492,715235,-72743,0,-72743,13694,27388,-100131,178900,949238,330470,618768,,1369400,1078.45,8476.05,0.0945,518,220.0,32668.2,5.48,0.4692
2337,Castro-Miller,False,NG,Allenmouth,Fintech,2020,https://castro-miller.com,Cost bag group long majority feeling according foot win.,20,castro-miller,2023,USD,1374559,390639,983920,882510,101410,0,101410,13745,27491,73919,43215,767588,38379,729209,,1374559,1016.97,2094.55,0.001,583,196.37,35482.07,1.22,0.7158
2338,Kim Martinez and Hernandez,False,ZA,Parkerview,Fintech,2018,https://kimmartinezandhernandez.com,Major gun doctor as board safe.,13,kim-martinez-and-hernandez,2023,USD,1078106,312008,766098,338491,427607,0,427607,10781,21562,406045,23084,681824,350638,331186,,1078106,20.0,63.96,0.1379,890,100.89,11705.11,1.97,0.7106
2339,Mason Thompson and Clark,False,NG,Ginaburgh,Marketplaces,2010,https://masonthompsonandclark.com,Plan carry research office one.,14,mason-thompson-and-clark,2023,USD,487122,188029,299093,263575,35518,7343,28175,4871,9742,18433,44668,383015,168862,214153,,487122,20.0,55.2,0.023,2029,20.0,27716.22,1.61,0.614
2340,Prince Montoya and Moore,False,AU,Annatown,AgriTech,2022,https://princemontoyaandmoore.com,Leave state deep wide.,13,prince-montoya-and-moore,2023,USD,213529,111510,102019,10676,91343,54789,36554,2135,4270,32284,17147,128956,31391,97565,,213529,20.0,71.29,0.1212,86,205.15,1000.0,17.15,0.4778
2341,Horton Roberts and Nelson,False,TN,Sandrastad,IoT,2021,https://hortonrobertsandnelson.com,Law somebody author stop project book week practice here.,24,horton-roberts-and-nelson,2023,USD,119591,34256,85335,85044,291,0,291,1195,2391,-2100,2266,194633,112140,82493,,119591,355.0,1656.32,0.0713,54,182.0,5616.42,0.4,0.7136
2342,Phillips Group,False,DE,New Christopher,IoT,2015,https://phillipsgroup.com,I standard financial key husband.,19,phillips-group,2023,EUR,721950,316511,405439,380663,24776,0,24776,7219,14439,10337,9700,420509,267717,152792,,721950,20.0,85.76,0.001,2799,21.49,36651.85,0.26,0.5616
2343,Shah Walton and Ross,False,NG,Lisachester,HealthTech,2023,https://shahwaltonandross.com,Husband edge win another good across provide up.,18,shah-walton-and-ross,2023,USD,1921894,817819,1104075,837059,267016,9590,257426,19218,38437,218989,82651,1087996,594525,493471,160157.83,1921894,23.88,78.94,0.036,2284,70.11,103379.88,0.8,0.5745
2344,Taylor Graham and Rivera,False,TN,Saraland,Fintech,2018,https://taylorgrahamandrivera.com,Hair explain perhaps mind more order may you life.,31,taylor-graham-and-rivera,2023,USD,632047,215141,416906,114048,302858,0,302858,6320,12640,290218,10653,378090,118076,260014,,632047,349.08,664.25,0.0492,1403,37.54,17644.39,0.6,0.6596
2345,Yang-Thomas,False,DE,South Chaseside,Cybersecurity,2021,https://yang-thomas.com,Realize increase parent organization movie situation discussion moment.,13,yang-thomas,2023,EUR,1954431,1077232,877199,533719,343480,11686,331794,19544,39088,292706,80760,1217014,220544,996470,,1954431,105.14,52.57,0.0063,844,192.78,1000.0,80.76,0.4488
2346,Hill Brown and Mcbride,False,AU,West Robert,Energy,2018,https://hillbrownandmcbride.com,Dark also class term either area become recent yourself.,27,hill-brown-and-mcbride,2023,USD,2236512,985020,1251492,732565,518927,0,518927,22365,44730,474197,50865,1291421,292516,998905,,2236512,20.0,128.76,0.0531,9318,20.0,79234.1,0.64,0.5596
2347,Allen Inc,False,NG,North Sandrahaven,Cybersecurity,2015,https://alleninc.com,Protect hundred edge mother gas marriage he.,18,allen-inc,2023,USD,550421,132748,417673,27521,390152,13519,376633,5504,11008,365625,37286,375771,230899,144872,,550421,472.96,1349.45,0.0718,2293,20.0,30986.14,1.2,0.7588
2348,Roberts Hernandez and Long,False,GB,Charlesborough,Marketplaces,2010,https://robertshernandezandlong.com,Part view get religious model fish visit whatever.,23,roberts-hernandez-and-long,2023,USD,739241,137822,601419,206239,395180,768,394412,7392,14784,379628,63622,476132,206942,269190,,739241,614.72,307.36,0.1027,539,114.11,1000.0,63.62,0.8136
2349,Gonzalez Shaw and Marquez,False,ZA,Lake Johnstad,Cybersecurity,2023,https://gonzalezshawandmarquez.com,Western trial it theory prevent data subject Republican.,17,gonzalez-shaw-and-marquez,2023,USD,584019,219099,364920,389631,-24711,25439,-50150,5840,11680,-61830,24074,417537,228853,188684,,584019,987.71,493.86,0.0152,946,51.42,12996.4,1.85,0.6248
2350,Kelly Mcclure and Medina,False,FR,Carlosside,IoT,2022,https://kellymcclureandmedina.com,Force radio tough realize outside seek.,16,kelly-mcclure-and-medina,2023,EUR,791070,321498,469572,400970,68602,5729,62873,7910,15821,47052,86341,574091,180395,393696,,791070,1320.59,660.3,0.0809,295,222.96,49769.05,1.73,0.5936
2351,Hampton Ltd,False,CA,Andersonchester,AI/ML,2011,https://hamptonltd.com,Fill like region collection cultural soon range Mr case modern.,21,hampton-ltd,2023,USD,2015765,475806,1539959,787991,751968,8726,743242,20157,40315,702927,178302,1227139,186908,1040231,,2015765,772.76,1888.18,0.001,484,346.88,61888.69,2.88,0.764
2352,Copeland-Washington,False,EG,Leefort,HealthTech,2017,https://copeland-washington.com,Risk paper worry bed there capital write stage manager baby.,14,copeland-washington,2023,USD,1918741,833724,1085017,360039,724978,9680,715298,19187,38374,676924,144839,1253547,387091,866456,159895.08,1918741,297.1,870.84,0.0258,16655,9.6,15705.22,9.22,0.5655
2353,Frazier PLC,False,TN,Melissaberg,Fintech,2011,https://frazierplc.com,Could western lawyer beyond.,18,frazier-plc,2023,USD,1907882,701901,1205981,1281552,-75571,0,-75571,19078,38157,-113728,91100,1132991,299602,833389,,1907882,20.0,36.49,0.0307,706,225.08,120489.65,0.76,0.6321
2354,Martinez LLC,False,BR,New Blakeview,IoT,2020,https://martinezllc.com,Room him step spring rich indicate consumer along.,21,martinez-llc,2023,USD,228036,97914,130122,85866,44256,21589,22667,2280,4560,18107,616,185357,38611,146746,,228036,20.0,48.28,0.1363,145,130.72,37531.64,0.02,0.5706
2355,Rogers-Russell,False,CA,New Jason,Mobility,2009,https://rogers-russell.com,Already choose country capital campaign drive Mrs west.,22,rogers-russell,2023,USD,790219,270374,519845,300348,219497,18091,201406,7902,15804,185602,732390,1271796,538396,733400,,790219,499.39,1269.06,0.1223,3292,20.0,1000.0,732.39,0.6578
2356,Young Ltd,False,FR,Edwardshaven,EdTech,2012,https://youngltd.com,Assume event city center executive father send.,17,young-ltd,2023,EUR,348954,153142,195812,145548,50264,0,50264,3489,6979,43285,48313,251648,92984,158664,29079.5,348954,82.25,199.61,0.066,340,85.35,2734.31,17.67,0.5611
2357,Williams-Ramirez,False,KE,Port Stephanieborough,Marketplaces,2008,https://williams-ramirez.com,Walk middle talk policy think part letter.,12,williams-ramirez,2023,USD,4186427,696278,3490149,2912315,577834,0,577834,41864,83728,494106,143412,2314742,1152859,1161883,,4186427,490.64,1402.32,0.0504,1239,281.36,293600.57,0.49,0.8337
2358,Baker Inc,False,AU,Sarahborough,HealthTech,2012,https://bakerinc.com,Agency people life benefit newspaper.,17,baker-inc,2023,USD,829181,367899,461282,77014,384268,14011,370257,8291,16583,353674,20103,462026,170513,291513,69098.42,829181,229.5,1229.86,0.0736,1493,46.28,17482.02,1.15,0.5563
2359,Byrd Ltd,False,EG,East Katherine,AI/ML,2017,https://byrdltd.com,Listen poor majority great either huge join kitchen live.,19,byrd-ltd,2023,USD,785468,367864,417604,803461,-385857,6443,-392300,7854,15709,-408009,76599,665963,33298,632665,,785468,930.2,611.83,0.085,1323,49.46,84334.35,0.91,0.5317
2360,Morgan LLC,False,TN,West Taylorville,IoT,2022,https://morganllc.com,Training image black through east describe.,23,morgan-llc,2023,USD,768835,380496,388339,43643,344696,7648,337048,7688,15376,321672,36715,441886,281786,160100,,768835,243.58,882.94,0.0198,452,141.5,57492.53,0.64,0.5051
2361,Mcgee Anderson and Adams,False,DE,Zimmermanberg,EdTech,2018,https://mcgeeandersonandadams.com,Generation value better those store.,24,mcgee-anderson-and-adams,2023,EUR,205276,111180,94096,195644,-101548,12719,-114267,2052,4105,-118372,13671,214223,33993,180230,17106.33,205276,10.0,10.0,0.0275,675,25.33,2028.09,6.74,0.4584
2362,Fields PLC,False,IN,South Ericside,IoT,2017,https://fieldsplc.com,Popular form Congress explain land country relate strategy attorney capital ten.,26,fields-plc,2023,USD,807716,469412,338304,595385,-257081,5600,-262681,8077,16154,-278835,79152,507950,168031,339919,,807716,1005.47,2533.63,0.0019,381,176.34,80581.77,0.98,0.4188
2363,Walker Inc,False,TN,East Valeriestad,Cybersecurity,2019,https://walkerinc.com,Drug recent guy left turn we soon base school instead.,24,walker-inc,2023,USD,324780,90471,234309,77138,157171,19929,137242,3247,6495,130747,60608,421836,132988,288848,,324780,20.0,23.14,0.1012,210,128.84,9823.83,6.17,0.7214
2364,Lopez Thompson and Whitaker,False,FR,Gatesmouth,IoT,2008,https://lopezthompsonandwhitaker.com,Become about everybody edge hour theory hot face decision civil.,24,lopez-thompson-and-whitaker,2023,EUR,580367,359023,221344,349166,-127822,0,-127822,5803,11607,-139429,28033,471744,76097,395647,,580367,1699.83,2339.04,0.0554,118,407.45,17120.75,1.64,0.3814
2365,Stokes Barnes and Davis,False,KE,East Hannah,AI/ML,2020,https://stokesbarnesanddavis.com,Place leg change turn.,29,stokes-barnes-and-davis,2023,USD,1595521,541351,1054170,79776,974394,0,974394,15955,31910,942484,300579,1227091,375768,851323,,1595521,47.46,23.73,0.001,6192,21.47,1000.0,300.58,0.6607
2366,Sanders-Mason,False,GB,Erichaven,AgriTech,2009,https://sanders-mason.com,Suggest medical think land nation.,20,sanders-mason,2023,USD,479865,96284,383581,158670,224911,26004,198907,4798,9597,189310,10747,361860,191816,170044,,479865,20.0,106.85,0.0109,1999,20.0,1000.0,10.75,0.7994
2367,Olson Brown and Moon,False,CA,New Karen,AI/ML,2009,https://olsonbrownandmoon.com,Always analysis analysis art institution plant.,19,olson-brown-and-moon,2023,USD,657214,156091,501123,122721,378402,11373,367029,6572,13144,353885,14652,385151,88098,297053,,657214,144.86,364.49,0.0066,1561,35.07,15812.56,0.93,0.7625
2368,Peterson Ltd,False,US,Brewerfort,Cybersecurity,2019,https://petersonltd.com,Those exist hard including look need finally leg agreement.,17,peterson-ltd,2023,USD,385400,171055,214345,105619,108726,35946,72780,3854,7708,65072,2305,387255,103387,283868,,385400,973.11,3146.43,0.0711,491,65.36,1000.0,2.31,0.5562
2369,Hill-Fisher,False,FR,East Ivan,AgriTech,2008,https://hill-fisher.com,Star government smile set including tell expect.,19,hill-fisher,2023,EUR,263848,129009,134839,24558,110281,46775,63506,2638,5276,58230,15676,223776,44254,179522,,263848,20.0,41.48,0.0397,198,110.73,20005.65,0.78,0.511
2370,Cook Ltd,False,DE,Navarromouth,Energy,2020,https://cookltd.com,Letter manager finish write attention writer.,21,cook-ltd,2023,EUR,4571562,1386267,3185295,562487,2622808,53817,2568991,45715,91431,2477560,1356727,3705061,670794,3034267,,4571562,772.35,3344.92,0.0866,1955,194.8,14642.6,92.66,0.6968
2371,Rodriguez-Daniel,False,BR,Fosterfurt,E-commerce,2020,https://rodriguez-daniel.com,Region not tree impact smile actually size policy.,25,rodriguez-daniel,2023,USD,489646,90992,398654,243513,155141,0,155141,4896,9792,145349,3376,425066,128584,296482,,489646,508.98,406.98,0.0824,232,175.47,3880.51,0.87,0.8142
2372,Thornton Group,False,TN,Ericshire,Energy,2021,https://thorntongroup.com,Say middle PM because nor contain thought for.,26,thornton-group,2023,USD,1437351,423932,1013419,71867,941552,0,941552,14373,28747,912805,76554,942780,260951,681829,,1437351,306.67,730.98,0.0592,5988,20.0,9354.86,8.18,0.7051
2373,Baker Gomez and Hardin,False,NG,Maryborough,EdTech,2013,https://bakergomezandhardin.com,Political discover however and audience century involve degree continue.,12,baker-gomez-and-hardin,2023,USD,950953,275544,675409,229232,446177,0,446177,9509,19019,427158,24656,569476,231953,337523,79246.08,950953,274.09,1253.08,0.0306,1116,70.95,7461.89,3.3,0.7102
2374,Williams-Jones,False,EG,Mooreshire,HealthTech,2014,https://williams-jones.com,Central administration single gun serious find without couple check parent.,20,williams-jones,2023,USD,3755097,1345426,2409671,2221015,188656,0,188656,37550,75101,113555,85828,2018729,362663,1656066,312924.75,3755097,10.0,43.12,0.0088,2562,122.12,166347.9,0.52,0.6417
2375,Johnson-Moran,False,NG,Ashleyberg,Energy,2019,https://johnson-moran.com,Employee leave it position option foreign owner TV life value.,18,johnson-moran,2023,USD,2161414,171578,1989836,1244498,745338,0,745338,21614,43228,702110,16509,1281510,931591,349919,,2161414,20.0,115.24,0.065,647,278.2,128343.56,0.13,0.9206
2376,Lutz Carter and Porter,False,TN,Mcdanieltown,HealthTech,2017,https://lutzcarterandporter.com,Week just choose field issue.,29,lutz-carter-and-porter,2023,USD,317639,109118,208521,165954,42567,2801,39766,3176,6352,33414,11120,363866,182258,181608,26469.92,317639,69.97,325.28,0.0304,5293,5.0,12990.72,0.86,0.6565
2377,Bennett-Parker,False,BR,South Sarah,HealthTech,2012,https://bennett-parker.com,Quite north finally million.,26,bennett-parker,2023,USD,324480,94900,229580,125127,104453,14116,90337,3244,6489,83848,41657,258682,83705,174977,27040.0,324480,99.32,291.01,0.0413,274,98.5,12582.71,3.31,0.7075
2378,Moore Fleming and Kelly,False,US,New Markshire,Fintech,2008,https://mooreflemingandkelly.com,Free plan close live continue herself.,16,moore-fleming-and-kelly,2023,USD,502659,113392,389267,281275,107992,20294,87698,5026,10053,77645,11164,379472,243977,135495,,502659,716.84,2239.34,0.2205,343,122.01,41416.27,0.27,0.7744
2379,Clark and Sons,False,GB,Sethburgh,Cybersecurity,2023,https://clarkandsons.com,Each watch responsibility think two star paper close which.,20,clark-and-sons,2023,USD,2934608,516192,2418416,1397561,1020855,0,1020855,29346,58692,962163,62424,1575880,972623,603257,,2934608,1463.54,1421.09,0.0233,758,322.49,69390.62,0.9,0.8241
2380,Fleming Mcdonald and Lee,False,BR,West Dana,Energy,2012,https://flemingmcdonaldandlee.com,Indicate black government visit fear rock hit national woman.,20,fleming-mcdonald-and-lee,2023,USD,1813597,455673,1357924,438216,919708,0,919708,18135,36271,883437,65899,1111651,55582,1056069,,1813597,728.82,2775.52,0.0548,7556,20.0,56350.27,1.17,0.7487
2381,Foster Shaw and Dunn,False,FR,Benderburgh,HealthTech,2021,https://fostershawanddunn.com,Will page world threat senior quite someone.,21,foster-shaw-and-dunn,2023,EUR,849251,310439,538812,350815,187997,0,187997,8492,16985,171012,132172,640717,275190,365527,70770.92,849251,10.0,43.19,0.0053,13557,5.22,24870.25,5.31,0.6345
2382,Lowe Dean and Miller,False,EG,Howellmouth,Cybersecurity,2021,https://lowedeanandmiller.com,Son director feel another no music receive dog big.,24,lowe-dean-and-miller,2023,USD,2766737,925653,1841084,799309,1041775,0,1041775,27667,55334,986441,791103,2179772,108988,2070784,,2766737,30.89,15.44,0.001,11528,20.0,107813.42,7.34,0.6654
2383,Stephens Inc,False,KE,Rileyborough,HealthTech,2022,https://stephensinc.com,Light one source population so data whole.,24,stephens-inc,2023,USD,1096488,460029,636459,406146,230313,25857,204456,10964,21929,182527,230013,815931,175181,640750,91374.0,1096488,184.7,1094.15,0.0302,2078,43.97,31298.42,7.35,0.5805
2384,Montes Wright and Booker,False,NG,North Kimberlyburgh,Energy,2022,https://monteswrightandbooker.com,Us agree history benefit share Congress.,15,montes-wright-and-booker,2023,USD,3751198,796534,2954664,915573,2039091,4015,2035076,37511,75023,1960053,53949,1973408,98670,1874738,,3751198,20.0,43.65,0.0364,8625,36.24,81285.06,0.66,0.7877
2385,Burton and Sons,False,TN,West Edwinland,E-commerce,2015,https://burtonandsons.com,Drug step PM rate quickly fact.,18,burton-and-sons,2023,USD,153727,37941,115786,106779,9007,24912,-15905,1537,3074,-18979,10572,171463,62661,108802,,153727,20.0,47.86,0.1121,640,20.0,45152.87,0.23,0.7532
2386,Wheeler and Sons,False,GB,East Toddburgh,Energy,2008,https://wheelerandsons.com,Business organization interview cost street consumer girl.,21,wheeler-and-sons,2023,USD,230423,63506,166917,51214,115703,15437,100266,2304,4608,95658,6086,292347,145940,146407,,230423,20.0,47.37,0.0462,64,299.23,7185.36,0.85,0.7244
2387,Merritt and Sons,False,KE,Lake Kerrifort,Mobility,2015,https://merrittandsons.com,Human offer ready account accept black ok young.,17,merritt-and-sons,2023,USD,1391344,454419,936925,440817,496108,0,496108,13913,27826,468282,262562,1049268,783448,265820,,1391344,1122.93,7100.57,0.0365,792,146.38,50152.59,5.24,0.6734
2388,Miller Ford and Melton,False,ZA,Port Katherine,AI/ML,2016,https://millerfordandmelton.com,Sure morning either despite tell travel loss.,20,miller-ford-and-melton,2023,USD,352777,103187,249590,348420,-98830,0,-98830,3527,7055,-105885,37009,215547,29430,186117,,352777,135.52,115.81,0.0484,121,241.29,1000.0,37.01,0.7075
2389,Gentry-Edwards,False,TN,Torresville,AI/ML,2019,https://gentry-edwards.com,Let phone today ready laugh.,24,gentry-edwards,2023,USD,365491,120538,244953,244112,841,0,841,3654,7309,-6468,5387,386040,116813,269227,,365491,20.0,103.4,0.0286,1522,20.0,29544.61,0.18,0.6702
2390,Webb PLC,False,US,North Megan,SaaS,2023,https://webbplc.com,Another down yard rest act.,19,webb-plc,2023,USD,1180616,464059,716557,298947,417610,0,417610,11806,23612,393998,87339,804764,552919,251845,98384.67,1180616,95.57,571.96,0.008,5670,17.35,14328.14,6.1,0.6069
2391,Fitzpatrick Harris and Burton,False,ZA,East Maryburgh,E-commerce,2011,https://fitzpatrickharrisandburton.com,Herself race agent technology that.,21,fitzpatrick-harris-and-burton,2023,USD,247821,118033,129788,34187,95601,0,95601,2478,4956,90645,3836,146981,43126,103855,,247821,20.0,27.1,0.0882,130,158.57,28912.78,0.13,0.5237
2392,Thompson Ltd,False,KE,New Jesusstad,Mobility,2010,https://thompsonltd.com,Represent his guess pretty amount clearly.,16,thompson-ltd,2023,USD,408856,176297,232559,220960,11599,3014,8585,4088,8177,408,9372,318065,174901,143164,,408856,487.81,712.47,0.0126,120,282.36,13171.53,0.71,0.5688
2393,Rodriguez Group,False,GB,Elliottport,Cybersecurity,2024,https://rodriguezgroup.com,More town Democrat three management ago.,17,rodriguez-group,2023,USD,210224,82711,127513,125168,2345,44359,-42014,2102,4204,-46218,2638,273308,88289,185019,,210224,20.0,10.0,0.001,875,20.0,1000.0,2.64,0.6066
2394,Todd Morales and Wagner,False,AU,Port Ryanmouth,AgriTech,2022,https://toddmoralesandwagner.com,In career our conference benefit country however either college kind.,21,todd-morales-and-wagner,2023,USD,397223,99610,297613,298193,-580,0,-580,3972,7944,-8524,12514,274364,106368,167996,,397223,20.0,81.61,0.0404,342,96.62,27664.97,0.45,0.7492
2395,Jackson Inc,False,NG,Christophermouth,Fintech,2024,https://jacksoninc.com,Political age watch activity social back.,27,jackson-inc,2023,USD,2982719,1324828,1657891,2129140,-471249,32115,-503364,29827,59654,-563018,44634,1670277,1503249,167028,,2982719,1054.24,2697.66,0.001,7608,32.67,180866.23,0.25,0.5558
2396,Campbell Jones and Ortega,False,KE,South Marcusmouth,Fintech,2015,https://campbelljonesandortega.com,Month maybe clearly fact.,20,campbell-jones-and-ortega,2023,USD,1487640,518893,968747,171503,797244,19055,778189,14876,29752,748437,128949,882118,135254,746864,,1487640,1587.46,6432.74,0.0892,462,268.14,1000.0,128.95,0.6512
2397,Griffin-Hall,False,EG,Gordonchester,Marketplaces,2010,https://griffin-hall.com,Particular anyone according pretty dinner agency last evening family.,25,griffin-hall,2023,USD,1027007,367456,659551,414189,245362,28489,216873,10270,20540,196333,157701,829398,398056,431342,,1027007,776.78,388.39,0.043,374,228.33,42181.99,3.74,0.6422
2398,Morgan PLC,False,BR,West Mark,Marketplaces,2017,https://morganplc.com,Base total kind lawyer.,20,morgan-plc,2023,USD,2395363,1021003,1374360,1031064,343296,0,343296,23953,47907,295389,358326,1670459,91257,1579202,,2395363,20.0,110.91,0.0548,9980,20.0,45908.6,7.81,0.5738
2399,Holden Sanchez and Hardy,False,KE,New Anthony,SaaS,2018,https://holdensanchezandhardy.com,Traditional candidate guess bed citizen step eight interview crime himself.,21,holden-sanchez-and-hardy,2023,USD,376037,113144,262893,142299,120594,15463,105131,3760,7520,97611,22938,406868,86964,319904,31336.42,376037,142.5,322.14,0.0518,1752,17.88,16893.92,1.36,0.6991
2400,Jones PLC,False,NG,West Anthonyport,SaaS,2023,https://jonesplc.com,Husband ask purpose point story.,26,jones-plc,2023,USD,1848047,382549,1465498,557665,907833,0,907833,18480,36960,870873,206070,1279215,237349,1041866,154003.92,1848047,494.95,494.95,0.0858,5643,27.29,46548.22,4.43,0.793
2401,Pham-Ball,False,EG,Williamsfurt,AI/ML,2023,https://pham-ball.com,Must voice tax note treatment news weight.,18,pham-ball,2023,USD,1314596,384213,930383,808305,122078,0,122078,13145,26291,95787,29607,819981,327068,492913,,1314596,167.18,83.59,0.001,471,232.32,47786.0,0.62,0.7077
2402,Sandoval Martin and Moses,False,KE,Mariamouth,Cybersecurity,2018,https://sandovalmartinandmoses.com,Agent play myself bag east work miss officer trial between.,15,sandoval-martin-and-moses,2023,USD,1364452,629142,735310,226586,508724,0,508724,13644,27289,481435,90498,870281,43514,826767,,1364452,525.18,1947.08,0.0922,5685,20.0,15089.7,6.0,0.5389
2403,Nicholson-Rogers,False,TN,Porterfurt,E-commerce,2017,https://nicholson-rogers.com,Keep top once full environmental human ahead low nothing.,21,nicholson-rogers,2023,USD,176005,23345,152660,84859,67801,256,67545,1760,3520,64025,12480,105416,29809,75607,,176005,1040.4,5779.68,0.1825,146,100.44,1000.0,12.48,0.8674
2404,Cole LLC,False,IN,Charlesfort,HealthTech,2009,https://colellc.com,Serve always this program new edge world whatever figure.,12,cole-llc,2023,USD,411218,104361,306857,28287,278570,7517,271053,4112,8224,262829,45552,389305,96118,293187,34268.17,411218,171.28,398.92,0.019,1315,26.04,19289.41,2.36,0.7462
2405,Sawyer Alexander and Sandoval,False,ZA,Michelleberg,IoT,2017,https://sawyeralexanderandsandoval.com,Pay government open ready mother.,17,sawyer-alexander-and-sandoval,2023,USD,488117,58078,430039,24405,405634,0,405634,4881,9762,395872,25497,447161,42855,404306,,488117,1075.04,5153.77,0.0042,2033,20.0,37500.43,0.68,0.881
2406,Elliott Wells and Young,False,ZA,Thompsonmouth,IoT,2016,https://elliottwellsandyoung.com,People then couple pick fund line.,18,elliott-wells-and-young,2023,USD,847111,362525,484586,311252,173334,36468,136866,8471,16942,119924,5772,527084,434307,92777,,847111,1017.18,688.12,0.0595,1927,36.62,54207.52,0.11,0.572
2407,Sims Martin and Santana,False,US,Port Cherylshire,Marketplaces,2023,https://simsmartinandsantana.com,Husband interest research son final himself move entire quality.,15,sims-martin-and-santana,2023,USD,500701,162253,338448,101932,236516,38059,198457,5007,10014,188443,25508,387246,234689,152557,,500701,363.67,944.18,0.0844,1156,36.08,1000.0,25.51,0.6759
2408,Richards and Sons,False,KE,Jenniferfurt,HealthTech,2009,https://richardsandsons.com,Capital dream back run indicate law coach will.,26,richards-and-sons,2023,USD,442981,155162,287819,54358,233461,0,233461,4429,8859,224602,78066,332057,145602,186455,36915.08,442981,10.0,59.13,0.0218,504,73.2,1000.0,78.07,0.6497
2409,Wright-Mcpherson,False,BR,Port Jimmy,AgriTech,2008,https://wright-mcpherson.com,Time voice piece argue bit interest early.,16,wright-mcpherson,2023,USD,1205369,288304,917065,695217,221848,13515,208333,12053,24107,184226,88942,788153,334470,453683,,1205369,2294.98,9847.62,0.0839,2407,41.72,63735.15,1.4,0.7608
2410,Wilson Ltd,False,IN,North Nicholas,Mobility,2010,https://wilsonltd.com,Eight ready gas win indeed husband.,20,wilson-ltd,2023,USD,1588828,707847,880981,1342715,-461734,50887,-512621,15888,31776,-544397,239761,1090510,435354,655156,,1588828,678.41,2656.43,0.0584,565,233.96,125546.79,1.91,0.5545
2411,Hawkins White and Robinson,False,GB,Stephenport,AI/ML,2010,https://hawkinswhiteandrobinson.com,Entire guy respond science this wall data.,19,hawkins-white-and-robinson,2023,USD,2034633,907727,1126906,731291,395615,0,395615,20346,40692,354923,129646,1171805,486688,685117,,2034633,20.0,72.82,0.0471,1811,93.59,58178.66,2.23,0.5539
2412,Villa-Miller,False,AU,South Matthewshire,AgriTech,2016,https://villa-miller.com,Fall nothing long eye she ball never.,24,villa-miller,2023,USD,502743,211632,291111,177975,113136,31468,81668,5027,10054,71614,113088,497964,314590,183374,,502743,647.81,2056.57,0.0494,2094,20.0,37938.7,2.98,0.579
2413,Evans Chase and Tate,False,GB,Youngville,IoT,2016,https://evanschaseandtate.com,Avoid perhaps but travel event make particular top.,20,evans-chase-and-tate,2023,USD,1334473,473591,860882,626818,234064,14027,220037,13344,26689,193348,78970,782989,131330,651659,,1334473,1402.06,4502.13,0.001,627,177.21,45790.75,1.72,0.6451
2414,Hughes Thompson and Carlson,False,IN,Thompsonmouth,AgriTech,2008,https://hughesthompsonandcarlson.com,Follow prepare perform month many share.,24,hughes-thompson-and-carlson,2023,USD,158814,98943,59871,36763,23108,0,23108,1588,3176,19932,6805,131644,58473,73171,,158814,902.18,1580.99,0.001,79,167.23,1000.0,6.8,0.377
2415,Burnett Ward and Dickerson,False,ZA,South Leslieville,Fintech,2013,https://burnettwardanddickerson.com,Happy want away more task lose notice.,16,burnett-ward-and-dickerson,2023,USD,470373,105581,364792,23518,341274,0,341274,4703,9407,331867,63955,344424,71174,273250,,470373,2418.0,10400.66,0.075,279,140.42,1000.0,63.96,0.7755
2416,Hurst Williams and Rosario,False,KE,West Mark,Cybersecurity,2012,https://hurstwilliamsandrosario.com,Young agent me cell identify feel.,24,hurst-williams-and-rosario,2023,USD,902878,232680,670198,45143,625055,6446,618609,9028,18057,600552,9174,596356,363203,233153,,902878,1758.5,5881.22,0.0303,3761,20.0,1000.0,9.17,0.7423
2417,Newton PLC,False,BR,Caseport,Mobility,2019,https://newtonplc.com,Seat write player TV place actually.,23,newton-plc,2023,USD,2440900,1155183,1285717,1000602,285115,26836,258279,24409,48818,209461,167312,1496974,436308,1060666,,2440900,20.0,16.25,0.0191,1771,114.82,88235.48,1.9,0.5267
2418,Doyle-Garza,False,AU,Lake Anthonychester,HealthTech,2016,https://doyle-garza.com,Seek tree parent thing chair teach ask.,16,doyle-garza,2023,USD,248363,57230,191133,152256,38877,0,38877,2483,4967,33910,15631,250786,35225,215561,20696.92,248363,10.0,44.7,0.0662,422,48.93,32662.82,0.48,0.7696
2419,Harper-Graves,False,AU,South Matthewchester,Cybersecurity,2015,https://harper-graves.com,Support entire base ok bill.,22,harper-graves,2023,USD,907297,174198,733099,581343,151756,14220,137536,9072,18145,119391,15038,518415,140286,378129,,907297,101.33,492.39,0.1021,344,219.67,64241.07,0.23,0.808
2420,Flores and Sons,False,EG,North Robert,HealthTech,2024,https://floresandsons.com,Travel seven cost work.,21,flores-and-sons,2023,USD,500029,157563,342466,350563,-8097,0,-8097,5000,10000,-18097,203720,562823,43033,519790,41669.08,500029,400.6,1660.18,0.0547,462,90.0,35776.77,5.69,0.6849
2421,Grant PLC,False,US,Mccormickhaven,E-commerce,2010,https://grantplc.com,Police both common never thousand enough reduce.,29,grant-plc,2023,USD,129993,49671,80322,25481,54841,13794,41047,1299,2599,38448,7473,227664,11383,216281,,129993,20.0,63.67,0.001,148,72.88,40645.91,0.18,0.6179
2422,Phillips Watson and Jefferson,False,GB,Hinesmouth,IoT,2012,https://phillipswatsonandjefferson.com,Themselves clearly use positive experience everything especially either add.,26,phillips-watson-and-jefferson,2023,USD,884531,233001,651530,142418,509112,2397,506715,8845,17690,489025,50242,521329,69044,452285,,884531,2103.3,5950.08,0.0111,197,373.75,1000.0,50.24,0.7366
2423,Walker-Freeman,False,EG,Lake Megan,Energy,2020,https://walker-freeman.com,Attack woman often college relate successful science remember outside.,22,walker-freeman,2023,USD,799743,299022,500721,389621,111100,38313,72787,7997,15994,56793,52943,577679,40888,536791,,799743,642.7,1043.08,0.0321,550,120.98,35420.4,1.49,0.6261
2424,Hester-Keller,False,DE,Lewisfort,Marketplaces,2022,https://hester-keller.com,Mean or agreement fire long light star political support decade.,15,hester-keller,2023,EUR,801633,377801,423832,553544,-129712,15411,-145123,8016,16032,-161155,14757,466812,83661,383151,,801633,1521.88,4851.59,0.001,3340,20.0,45872.91,0.32,0.5287
2425,Hamilton-Harrison,False,ZA,North Miguelborough,Marketplaces,2013,https://hamilton-harrison.com,Evening pull billion above exactly suggest now window game speak.,26,hamilton-harrison,2023,USD,1213478,517710,695768,311323,384445,0,384445,12134,24269,360176,71427,678382,378336,300046,,1213478,1027.5,5633.1,0.001,1588,63.64,1427.19,50.05,0.5734
2426,Johnson Anderson and Kelly,False,DE,Montgomeryfurt,IoT,2019,https://johnsonandersonandkelly.com,Respond take industry ground put trade hotel trade force.,14,johnson-anderson-and-kelly,2023,EUR,2018641,944704,1073937,1080823,-6886,49064,-55950,20186,40372,-96322,79769,1202929,219639,983290,,2018641,20.0,95.11,0.0983,8411,20.0,50127.97,1.59,0.532
2427,Robles Inc,False,US,North Vincentberg,Marketplaces,2016,https://roblesinc.com,Close carry financial pretty trip money theory candidate.,20,robles-inc,2023,USD,1756512,445638,1310874,358218,952656,32,952624,17565,35130,917494,127810,1197593,471601,725992,,1756512,20.0,88.5,0.0434,7318,20.0,9724.82,13.14,0.7463
2428,Reed-Carter,False,AU,Tonibury,Fintech,2009,https://reed-carter.com,If drive church everybody each significant shake war.,15,reed-carter,2023,USD,3558518,1150831,2407687,3498597,-1090910,0,-1090910,35585,71170,-1162080,32698,1947037,387684,1559353,,3558518,1367.17,3200.22,0.0396,1769,167.56,277738.84,0.12,0.6766
2429,Johnson-West,False,GB,Morsestad,Mobility,2020,https://johnson-west.com,Learn difference then edge speech sometimes good turn.,22,johnson-west,2023,USD,366611,201381,165230,481227,-315997,0,-315997,3666,7332,-323329,25983,319540,15977,303563,,366611,180.77,170.23,0.0559,554,55.06,18619.87,1.4,0.4507
2430,Rivera and Sons,False,EG,West Sharon,AgriTech,2023,https://riveraandsons.com,Stop information soldier suffer anything process south significant system system.,21,rivera-and-sons,2023,USD,186757,41004,145753,39175,106578,0,106578,1867,3735,102843,5161,277391,23256,254135,,186757,1481.02,3677.9,0.0975,778,20.0,1000.0,5.16,0.7804
2431,Walton Velez and Howell,False,ZA,Murphyburgh,AI/ML,2015,https://waltonvelezandhowell.com,Skill however effort them wear nor.,23,walton-velez-and-howell,2023,USD,246768,50441,196327,104182,92145,31355,60790,2467,4935,55855,17812,305398,94168,211230,,246768,20.0,57.3,0.001,129,158.35,1000.0,17.81,0.7956
2432,Thomas and Sons,False,TN,Josephmouth,Marketplaces,2020,https://thomasandsons.com,Arrive energy bed now.,22,thomas-and-sons,2023,USD,1898940,875130,1023810,787113,236697,0,236697,18989,37978,198719,383969,1351824,107692,1244132,,1898940,693.61,1460.56,0.0361,3679,43.01,46107.92,8.33,0.5391
2433,Pugh LLC,False,EG,South Anne,AgriTech,2012,https://pughllc.com,Like floor student myself attorney year put part.,19,pugh-llc,2023,USD,600575,173804,426771,363543,63228,0,63228,6005,12011,51217,21078,444336,191370,252966,,600575,308.05,614.36,0.0057,654,76.48,35732.43,0.59,0.7106
2434,Brooks-Wright,False,NG,New Justin,Energy,2008,https://brooks-wright.com,Fine rich security against arrive.,16,brooks-wright,2023,USD,1328067,556656,771411,332825,438586,60,438526,13280,26561,411965,163108,966905,639383,327522,,1328067,432.51,329.96,0.056,639,172.93,10670.4,15.29,0.5809
2435,Taylor-Sanders,False,IN,East Joseph,Mobility,2020,https://taylor-sanders.com,Baby money marriage many large miss practice top.,19,taylor-sanders,2023,USD,733247,347240,386007,508416,-122409,18383,-140792,7332,14664,-155456,33579,497605,166786,330819,,733247,759.68,689.22,0.0794,414,147.57,91502.45,0.37,0.5264
2436,Orozco Lopez and Robinson,False,BR,West Curtisland,E-commerce,2024,https://orozcolopezandrobinson.com,Be this his yeah dark stock sound discuss mean.,28,orozco-lopez-and-robinson,2023,USD,588762,119273,469489,273103,196386,0,196386,5887,11775,184611,22726,336747,109661,227086,,588762,20.0,34.18,0.0223,2453,20.0,18129.46,1.25,0.7974
2437,Carter-Miller,False,BR,Johnchester,SaaS,2011,https://carter-miller.com,Professor quality piece truth beautiful.,28,carter-miller,2023,USD,989379,420718,568661,811764,-243103,6355,-249458,9893,19787,-269245,17416,575204,290558,284646,82448.25,989379,214.54,516.37,0.0696,16489,5.0,70649.93,0.25,0.5748
2438,Lozano-Fernandez,False,NG,Lake Rebekah,Marketplaces,2019,https://lozano-fernandez.com,Oil upon magazine with use.,24,lozano-fernandez,2023,USD,1160925,282237,878688,180460,698228,5302,692926,11609,23218,669708,102681,804733,277090,527643,,1160925,20.0,104.08,0.0998,1098,88.04,22570.5,4.55,0.7569
2439,Ayers-Logan,False,TN,Allenchester,IoT,2016,https://ayers-logan.com,She lay find give former those debate tonight.,17,ayers-logan,2023,USD,463680,84900,378780,289903,88877,5477,83400,4636,9273,74127,46070,439602,176617,262985,,463680,20.0,10.0,0.1077,644,59.95,23873.48,1.93,0.8169
2440,Rodriguez Rivera and Valencia,False,CA,Jamesville,AgriTech,2016,https://rodriguezriveraandvalencia.com,Top cause person off he.,15,rodriguez-rivera-and-valencia,2023,USD,518126,165438,352688,25906,326782,23915,302867,5181,10362,292505,35650,422017,227099,194918,,518126,1765.34,8000.41,0.0506,383,112.47,1000.0,35.65,0.6807
2441,Carson PLC,False,AU,East Hayley,Fintech,2016,https://carsonplc.com,Present these day quickly work find.,23,carson-plc,2023,USD,710963,270121,440842,199818,241024,9050,231974,7109,14219,217755,165736,715843,329931,385912,,710963,79.56,240.41,0.1589,429,138.01,17742.03,9.34,0.6201
2442,Meyer Rogers and Floyd,False,BR,Johnsonfurt,IoT,2020,https://meyerrogersandfloyd.com,Admit catch somebody add key response floor.,18,meyer-rogers-and-floyd,2023,USD,1573106,512955,1060151,647334,412817,45283,367534,15731,31462,336072,517009,1391746,211790,1179956,,1573106,20.0,106.85,0.0598,6554,20.0,62838.17,8.23,0.6739
2443,Francis LLC,False,EG,Lisafort,Marketplaces,2015,https://francisllc.com,Church usually toward information experience worker same effort career.,18,francis-llc,2023,USD,670479,258929,411550,267492,144058,0,144058,6704,13409,130649,17668,357574,103234,254340,,670479,951.19,4363.08,0.0354,198,280.9,16984.58,1.04,0.6138
2444,Koch Snow and Chavez,False,ZA,East Brandyton,Marketplaces,2014,https://kochsnowandchavez.com,Note stay truth general project citizen scientist simple guess.,20,koch-snow-and-chavez,2023,USD,1043566,137276,906290,528910,377380,0,377380,10435,20871,356509,46234,640013,256735,383278,,1043566,768.27,1363.03,0.1201,1120,77.62,20152.29,2.29,0.8685
2445,Clark Murray and Rodriguez,False,NG,Amyside,E-commerce,2013,https://clarkmurrayandrodriguez.com,Most short owner be prove still operation.,12,clark-murray-and-rodriguez,2023,USD,2417097,778947,1638150,738415,899735,6614,893121,24170,48341,844780,54905,1288544,445250,843294,,2417097,20.0,40.22,0.0355,1865,107.97,74315.87,0.74,0.6777
2446,Greer-Howard,False,CA,South Erikamouth,AI/ML,2008,https://greer-howard.com,Old see red everybody structure hour yourself your item should certain.,12,greer-howard,2023,USD,2106686,769044,1337642,857164,480478,0,480478,21066,42133,438345,430529,1506175,350843,1155332,,2106686,20.0,51.46,0.0226,819,214.34,105392.0,4.09,0.635
2447,Smith Scott and Schmitt,False,BR,West Morgan,SaaS,2010,https://smithscottandschmitt.com,Heart Mrs form management act attorney onto seven out get.,16,smith-scott-and-schmitt,2023,USD,998784,398145,600639,169049,431590,12086,419504,9987,19975,399529,42944,687500,72163,615337,83232.0,998784,469.35,2612.54,0.0458,6124,13.59,1000.0,42.94,0.6014
2448,Martinez Ltd,False,US,Nicholaston,Energy,2011,https://martinezltd.com,Quickly direction majority serve well tough sea traditional recently arm reality.,14,martinez-ltd,2023,USD,867262,368625,498637,304661,193976,0,193976,8672,17345,176631,66208,585515,267855,317660,,867262,20.0,10.0,0.0845,453,159.25,39687.72,1.67,0.575
2449,Jones Webb and Dawson,False,NG,Allenchester,Fintech,2022,https://joneswebbanddawson.com,Pull black best professional actually.,26,jones-webb-and-dawson,2023,USD,1450050,276294,1173756,539962,633794,3455,630339,14500,29001,601338,40996,766253,178122,588131,,1450050,20.0,90.57,0.1323,524,230.56,75851.81,0.54,0.8095
2450,Matthews-Anderson,False,CA,South Nicolestad,EdTech,2017,https://matthews-anderson.com,Food concern generation positive response represent project cut by.,22,matthews-anderson,2023,USD,112638,39821,72817,9779,63038,21573,41465,1126,2252,39213,28686,170316,8515,161801,9386.5,112638,162.76,361.77,0.001,90,103.99,1000.0,28.69,0.6465
2451,Webster Burns and Nolan,False,IN,Samanthastad,EdTech,2009,https://websterburnsandnolan.com,Institution this minute meet girl.,22,webster-burns-and-nolan,2023,USD,58562,13344,45218,28383,16835,34606,-17771,585,1171,-18942,4326,149806,59187,90619,4880.17,58562,481.18,2017.39,0.0427,903,5.4,1000.0,4.33,0.7721
2452,Mcdonald Schwartz and Diaz,False,US,Byrdland,IoT,2010,https://mcdonaldschwartzanddiaz.com,Increase worry through woman not inside second hold imagine.,14,mcdonald-schwartz-and-diaz,2023,USD,979230,175589,803641,450097,353544,18694,334850,9792,19584,315266,141484,796579,288257,508322,,979230,1424.93,9957.04,0.011,283,288.26,20103.84,7.04,0.8207
2453,Peterson LLC,False,US,Davidchester,IoT,2014,https://petersonllc.com,Tell author debate free worker.,30,peterson-llc,2023,USD,527880,160073,367807,404804,-36997,3185,-40182,5278,10557,-50739,7829,427285,55573,371712,,527880,1100.84,848.35,0.0304,2199,20.0,18733.38,0.42,0.6968
2454,Anderson LLC,False,KE,New Edgarfurt,Marketplaces,2011,https://andersonllc.com,Identify order bank certainly remember tough late school find style.,14,anderson-llc,2023,USD,408955,149496,259459,97491,161968,34326,127642,4089,8179,119463,8104,256000,136477,119523,,408955,529.05,353.55,0.0651,151,224.38,20945.63,0.39,0.6344
2455,Wiley Riley and Tran,False,ZA,Duncanhaven,Fintech,2010,https://wileyrileyandtran.com,Paper impact cup occur upon around class phone employee daughter number.,14,wiley-riley-and-tran,2023,USD,1171668,534032,637636,576913,60723,11081,49642,11716,23433,26209,257473,1001192,251932,749260,,1171668,20.0,99.0,0.0636,202,482.44,54081.74,4.76,0.5442
2456,White LLC,False,KE,South Johnbury,HealthTech,2020,https://whitellc.com,Wait care example only.,17,white-llc,2023,USD,306230,89037,217193,139229,77964,38264,39700,3062,6124,33576,29494,302827,214715,88112,25519.17,306230,149.22,447.24,0.0573,377,67.6,34270.54,0.86,0.7092
2457,Miranda Rodriguez and Myers,False,BR,Port Catherineshire,Marketplaces,2013,https://mirandarodriguezandmyers.com,Television during you prepare student guy generation speech above.,10,miranda-rodriguez-and-myers,2023,USD,247222,113537,133685,73731,59954,0,59954,2472,4944,55010,10600,221834,121636,100198,,247222,1254.71,7278.06,0.0302,323,63.72,19991.12,0.53,0.5407
2458,Thompson Inc,False,FR,Lopezchester,Cybersecurity,2013,https://thompsoninc.com,Deal say make health per eye short minute song.,24,thompson-inc,2023,EUR,510083,161683,348400,371192,-22792,0,-22792,5100,10201,-32993,26124,326775,170167,156608,,510083,20.0,30.65,0.1143,126,337.05,12397.88,2.11,0.683
2459,Lloyd Inc,False,IN,East Melissaburgh,AgriTech,2022,https://lloydinc.com,Data design camera short company know ten would debate.,21,lloyd-inc,2023,USD,146163,66504,79659,36876,42783,12212,30571,1461,2923,27648,13290,93643,63937,29706,,146163,2264.46,9793.05,0.104,118,102.67,1000.0,13.29,0.545
2460,Anderson-Hardy,False,BR,Maryland,Fintech,2022,https://anderson-hardy.com,News real character whole strong.,25,anderson-hardy,2023,USD,610734,321871,288863,57643,231220,44618,186602,6107,12214,174388,74089,423367,204201,219166,,610734,20.0,10.0,0.0551,718,70.86,1860.02,39.83,0.473
2461,Smith Cameron and Vincent,False,IN,Williamchester,Energy,2018,https://smithcameronandvincent.com,Product no customer power professor ask.,20,smith-cameron-and-vincent,2023,USD,3240894,1566734,1674160,214597,1459563,0,1459563,32408,64817,1394746,423645,2146474,1436438,710036,,3240894,20.0,58.3,0.1108,1791,150.78,15485.89,27.36,0.5166
2462,Davis and Sons,False,IN,South Toddtown,HealthTech,2010,https://davisandsons.com,Point interest hotel hot result pattern.,28,davis-and-sons,2023,USD,694145,203992,490153,460227,29926,7601,22325,6941,13882,8443,20167,527335,344576,182759,57845.42,694145,130.78,455.55,0.0041,2454,23.57,77806.38,0.26,0.7061
2463,Thompson-Jones,False,IN,East Robert,SaaS,2020,https://thompson-jones.com,Ok evidence act cut range particularly response property.,16,thompson-jones,2023,USD,3695127,1633076,2062051,1486881,575170,0,575170,36951,73902,501268,1025630,3013072,2227243,785829,307927.25,3695127,79.11,266.58,0.0215,61585,5.0,129272.57,7.93,0.558
2464,Ramirez Kaiser and Wall,False,TN,Wardstad,E-commerce,2009,https://ramirezkaiserandwall.com,Program blue cut report science call.,22,ramirez-kaiser-and-wall,2023,USD,237483,25916,211567,143461,68106,0,68106,2374,4749,63357,13936,137265,35272,101993,,237483,569.28,284.64,0.1274,219,90.22,24637.06,0.57,0.8909
2465,West Barker and Perry,False,IN,New Crystalton,AgriTech,2013,https://westbarkerandperry.com,Approach idea lawyer article smile call teach.,22,west-barker-and-perry,2023,USD,1290473,428226,862247,396928,465319,17459,447860,12904,25809,422051,304476,1009237,323232,686005,,1290473,1108.7,6749.79,0.1252,5376,20.0,43701.91,6.97,0.6682
2466,Rivera-Campbell,False,EG,Lauraland,Fintech,2023,https://rivera-campbell.com,Green son outside measure medical tonight training trade available.,22,rivera-campbell,2023,USD,1118670,440480,678190,356054,322136,0,322136,11186,22373,299763,131800,732207,280888,451319,,1118670,1929.88,10384.1,0.0961,431,216.08,13540.02,9.73,0.6062
2467,Hill Group,False,DE,Crawfordview,IoT,2020,https://hillgroup.com,Become hundred be tax key stuff case total coach card.,22,hill-group,2023,EUR,1077620,540246,537374,581526,-44152,2949,-47101,10776,21552,-68653,18484,613501,178342,435159,,1077620,721.37,2841.94,0.0271,295,304.2,43735.52,0.42,0.4987
2468,Rodriguez-Bradley,False,GB,Dianeshire,Marketplaces,2023,https://rodriguez-bradley.com,Threat whatever none no enjoy.,17,rodriguez-bradley,2023,USD,35442,7760,27682,12565,15117,0,15117,354,708,14409,3446,45860,13003,32857,,35442,438.6,1064.78,0.0634,22,132.14,33596.05,0.1,0.7811
2469,Lopez-Phelps,False,FR,Joymouth,HealthTech,2021,https://lopez-phelps.com,Lose speak important house return down my such gas.,25,lopez-phelps,2023,EUR,687833,245242,442591,351331,91260,0,91260,6878,13756,77504,44229,457724,303729,153995,57319.42,687833,264.55,634.63,0.001,11463,5.0,39907.77,1.11,0.6435
2470,Smith-Doyle,False,DE,Lake Patricialand,IoT,2011,https://smith-doyle.com,Organization result seat middle center decade recent win.,23,smith-doyle,2023,EUR,958829,437008,521821,965863,-444042,30206,-474248,9588,19176,-493424,65921,718746,422456,296290,,958829,2172.95,6533.5,0.0279,396,201.57,58598.96,1.12,0.5442
2471,Chung-Sherman,False,EG,South Lindsay,Cybersecurity,2016,https://chung-sherman.com,Often expect child least indeed.,15,chung-sherman,2023,USD,218386,127888,90498,100943,-10445,56829,-67274,2183,4367,-71641,4717,181169,47871,133298,,218386,20.0,82.79,0.0914,102,176.98,1000.0,4.72,0.4144
2472,Hoffman LLC,False,FR,South Austin,SaaS,2010,https://hoffmanllc.com,Manage among very career protect ahead teach difference plant Democrat.,23,hoffman-llc,2023,EUR,2518871,883231,1635640,607814,1027826,30081,997745,25188,50377,947368,132219,1574629,1011504,563125,209905.92,2518871,10.0,28.46,0.0215,4188,50.11,76427.08,1.73,0.6494
2473,Garcia Jones and Smith,False,FR,Fosterfort,IoT,2016,https://garciajonesandsmith.com,Without kitchen want current kitchen far economic difference time.,27,garcia-jones-and-smith,2023,EUR,456975,189632,267343,133532,133811,0,133811,4569,9139,124672,1648,348299,157313,190986,,456975,1591.33,795.66,0.129,177,214.41,1000.0,1.65,0.585
2474,Fisher-Smith,False,AU,New Cristinatown,Mobility,2008,https://fisher-smith.com,If tax make expert technology create impact long.,27,fisher-smith,2023,USD,1958525,411507,1547018,97926,1449092,0,1449092,19585,39170,1409922,150067,1185130,538227,646903,,1958525,336.61,651.91,0.0186,8160,20.0,11963.81,12.54,0.7899
2475,Green-Cardenas,False,EG,New John,HealthTech,2008,https://green-cardenas.com,Economy others opportunity sea game write thus president.,19,green-cardenas,2023,USD,29691959,4901182,24790777,10538474,14252303,10762,14241541,296919,593839,13647702,1240531,16119659,3179149,12940510,2474329.92,29691959,37.84,37.84,0.0225,37938,65.22,889417.69,1.39,0.8349
2476,Francis-Allen,False,US,Port Michaelhaven,Marketplaces,2020,https://francis-allen.com,Move around claim defense behind whose song institution think.,21,francis-allen,2023,USD,5112515,1270554,3841961,3893982,-52021,7291,-59312,51125,102250,-161562,299461,3040794,1527049,1513745,,5112515,701.96,1264.47,0.0427,2992,142.36,340319.92,0.88,0.7515
2477,Stewart Group,False,IN,Lake Antoniomouth,HealthTech,2018,https://stewartgroup.com,Appear add bed family business firm skin shoulder actually agent.,17,stewart-group,2023,USD,452414,82888,369526,226350,143176,22686,120490,4524,9048,111442,17118,272800,59314,213486,37701.17,452414,107.16,511.09,0.0294,492,76.6,33662.12,0.51,0.8168
2478,Powers Burch and Schaefer,False,TN,Clarkhaven,IoT,2008,https://powersburchandschaefer.com,Election kid serve discussion finally many during I.,32,powers-burch-and-schaefer,2023,USD,558926,162145,396781,145430,251351,0,251351,5589,11178,240173,24419,427491,21374,406117,,558926,20.0,86.11,0.039,645,72.21,1000.0,24.42,0.7099
2479,Hall Berry and Montes,False,NG,Danielville,Cybersecurity,2023,https://hallberryandmontes.com,Most watch her attack despite body where glass call produce.,19,hall-berry-and-montes,2023,USD,1748747,957082,791665,772144,19521,5279,14242,17487,34974,-20732,368353,1410289,410700,999589,,1748747,1236.34,2629.83,0.1232,562,259.08,77466.66,4.75,0.4527
2480,King Mcguire and Thompson,False,EG,North Christophershire,Energy,2020,https://kingmcguireandthompson.com,Cultural government feel security official.,21,king-mcguire-and-thompson,2023,USD,4738305,1835603,2902702,1164483,1738219,0,1738219,47383,94766,1643453,203819,2709239,726741,1982498,,4738305,161.53,617.58,0.001,1246,316.75,74991.5,2.72,0.6126
2481,Stanley LLC,False,ZA,Port Howardshire,Fintech,2015,https://stanleyllc.com,Perform scene operation rock direction sign east my language.,22,stanley-llc,2023,USD,1464613,458831,1005782,840747,165035,0,165035,14646,29292,135743,92087,961281,135327,825954,,1464613,1169.93,584.96,0.1026,6102,20.0,27752.7,3.32,0.6867
2482,Archer-Price,False,US,Johnsonfurt,Energy,2023,https://archer-price.com,Success model visit to study thus.,19,archer-price,2023,USD,1613381,569216,1044165,1140526,-96361,24987,-121348,16133,32267,-153615,109148,1061564,511226,550338,,1613381,149.89,834.92,0.001,2637,50.97,91128.67,1.2,0.6472
2483,Smith-Lewis,False,FR,Pierceside,IoT,2019,https://smith-lewis.com,Expert protect present again beyond cultural draw real nothing.,26,smith-lewis,2023,EUR,363706,113373,250333,331810,-81477,14989,-96466,3637,7274,-103740,8344,340491,163583,176908,,363706,20.0,40.44,0.001,1515,20.0,22440.98,0.37,0.6883
2484,Schultz Ltd,False,CA,Thorntonburgh,Marketplaces,2017,https://schultzltd.com,Sell drug cold above business value nice nearly.,23,schultz-ltd,2023,USD,869568,244638,624930,156976,467954,21338,446616,8695,17391,429225,46375,626178,263802,362376,,869568,843.84,4020.21,0.0483,910,79.6,21807.54,2.13,0.7187
2485,Walker Inc,False,TN,Port Terrychester,SaaS,2010,https://walkerinc.com,Game stop image laugh author.,23,walker-inc,2023,USD,716407,191675,524732,480123,44609,0,44609,7164,14328,30281,53020,570446,180307,390139,59700.58,716407,182.49,413.57,0.0461,447,133.54,56715.04,0.93,0.7324
2486,Huerta Ltd,False,CA,Port Arthur,AI/ML,2018,https://huertaltd.com,Arrive choose wide yard floor just almost.,22,huerta-ltd,2023,USD,2085409,860032,1225377,1269959,-44582,13215,-57797,20854,41708,-99505,21277,1227178,169572,1057606,,2085409,20.0,93.16,0.0759,8689,20.0,83899.49,0.25,0.5876
2487,Weber Odonnell and Allen,False,FR,East Robertfurt,Mobility,2017,https://weberodonnellandallen.com,Major lot organization poor entire others production company food.,23,weber-odonnell-and-allen,2023,EUR,6287930,2538716,3749214,4634553,-885339,0,-885339,62879,125758,-1011097,108665,3407224,1078406,2328818,,6287930,653.96,3532.7,0.061,26199,20.0,396256.82,0.27,0.5963
2488,Brown-Mclean,False,BR,Barbarachester,EdTech,2013,https://brown-mclean.com,Way recently behind seat first laugh she green rest.,30,brown-mclean,2023,USD,787307,326538,460769,39365,421404,7277,414127,7873,15746,398381,8167,530593,102163,428430,65608.92,787307,275.08,275.08,0.0625,13121,5.0,8440.9,0.97,0.5852
2489,Gregory-Avery,False,NG,Port Marcus,SaaS,2020,https://gregory-avery.com,Pressure way of any both minute way seven billion.,24,gregory-avery,2023,USD,885190,313579,571611,537165,34446,0,34446,8851,17703,16743,15407,561648,181923,379725,73765.83,885190,142.24,496.32,0.0564,1219,60.49,37497.34,0.41,0.6457
2490,Edwards Group,False,BR,Barrybury,EdTech,2017,https://edwardsgroup.com,Ten avoid least expert inside year power art including tend.,14,edwards-group,2023,USD,172700,44884,127816,119968,7848,0,7848,1727,3454,4394,11258,227456,85195,142261,14391.67,172700,10.0,50.04,0.0476,422,34.03,3001.71,3.75,0.7401
2491,Smith Franklin and Harris,False,ZA,North Michele,Energy,2011,https://smithfranklinandharris.com,Else food art service floor well appear.,25,smith-franklin-and-harris,2023,USD,2605899,808190,1797709,1737761,59948,0,59948,26058,52117,7831,45362,1467105,442895,1024210,,2605899,348.29,174.14,0.0476,10857,20.0,160981.54,0.28,0.6899
2492,Evans Reese and Cooper,False,BR,Lake John,Cybersecurity,2019,https://evansreeseandcooper.com,Since official each perhaps though catch.,24,evans-reese-and-cooper,2023,USD,1299281,64964,1234317,562829,671488,0,671488,12992,25985,645503,106491,881102,173495,707607,,1299281,20.0,31.41,0.0142,4553,23.78,39279.02,2.71,0.95
2493,Hayes-Morgan,False,EG,Michellemouth,Fintech,2022,https://hayes-morgan.com,Table voice point I movement account policy sound which.,17,hayes-morgan,2023,USD,670349,192817,477532,301648,175884,0,175884,6703,13406,162478,267057,745116,347703,397413,,670349,20.0,73.66,0.0564,695,80.34,15134.22,17.65,0.7124
2494,Stevenson Odonnell and Marshall,False,ZA,Rodriguezhaven,EdTech,2012,https://stevensonodonnellandmarshall.com,Significant resource read training help very when economy.,17,stevenson-odonnell-and-marshall,2023,USD,611271,400409,210862,40811,170051,0,170051,6112,12225,157826,38620,365742,31375,334367,50939.25,611271,112.81,430.22,0.001,10187,5.0,23515.92,1.64,0.345
2495,Cummings-White,False,US,Lake Taylor,EdTech,2008,https://cummings-white.com,Range general year light serious sell.,23,cummings-white,2023,USD,306943,136219,170724,46223,124501,0,124501,3069,6138,118363,26316,300448,156426,144022,25578.58,306943,10.0,29.09,0.001,200,127.72,1000.0,26.32,0.5562
2496,Lopez Rose and Duncan,False,ZA,North Laura,IoT,2015,https://lopezroseandduncan.com,Condition occur exactly sign require compare.,16,lopez-rose-and-duncan,2023,USD,241811,176764,65047,139238,-74191,24405,-98596,2418,4836,-103432,13936,207641,80861,126780,,241811,381.39,1340.91,0.001,110,182.47,43589.08,0.32,0.269
2497,Walker Dixon and Terry,False,EG,Lopezbury,Energy,2010,https://walkerdixonandterry.com,Economy run treatment guess game everything successful party five today.,24,walker-dixon-and-terry,2023,USD,5245737,2540381,2705356,2922025,-216669,21113,-237782,52457,104914,-342696,346246,3015792,596600,2419192,,5245737,881.86,1751.4,0.1712,21857,20.0,262366.49,1.32,0.5157
2498,Miller Inc,False,AU,East Michaelbury,AI/ML,2017,https://millerinc.com,Data trip measure issue course.,22,miller-inc,2023,USD,560897,238966,321931,235262,86669,13409,73260,5608,11217,62043,3424,373851,124072,249779,,560897,20.0,61.7,0.001,162,286.86,1000.0,3.42,0.574
2499,Turner Salazar and Parker,False,EG,Rileyside,AI/ML,2022,https://turnersalazarandparker.com,Growth beyond stock mean research pressure begin challenge.,20,turner-salazar-and-parker,2023,USD,2499953,890474,1609479,374007,1235472,0,1235472,24999,49999,1185473,31961,1300989,540671,760318,,2499953,98.6,300.65,0.0537,10416,20.0,50968.21,0.63,0.6438
2500,Leon Brown and Butler,False,US,Solomonmouth,SaaS,2018,https://leonbrownandbutler.com,Factor person fear hit rate model their Mrs.,19,leon-brown-and-butler,2023,USD,122905,31552,91353,56900,34453,13204,21249,1229,2458,18791,8192,198818,70688,128130,10242.08,122905,626.87,1545.46,0.0404,101,101.28,25373.06,0.32,0.7433
2501,Smith and Sons,False,US,Amyburgh,E-commerce,2009,https://smithandsons.com,Our prepare face level themselves degree decide however each system.,25,smith-and-sons,2023,USD,7666075,1634218,6031857,4367065,1664792,0,1664792,76660,153321,1511471,205146,4145150,1056482,3088668,,7666075,1619.37,809.68,0.006,5534,115.42,323919.77,0.63,0.7868
2502,Hughes-Garcia,False,TN,Lake Phillip,Fintech,2014,https://hughes-garcia.com,Method add war red if participant.,19,hughes-garcia,2023,USD,1366892,702379,664513,852177,-187664,22335,-209999,13668,27337,-237336,122788,934254,558400,375854,,1366892,20.0,10.0,0.0563,5695,20.0,75112.1,1.63,0.4861
2503,Bryan Campbell and Mercado,False,AU,Campbellland,Marketplaces,2024,https://bryancampbellandmercado.com,Bed southern dream table religious teach quite director believe require ready.,18,bryan-campbell-and-mercado,2023,USD,1057087,566869,490218,280207,210011,7189,202822,10570,21141,181681,91237,711797,504978,206819,,1057087,1851.26,12167.56,0.0296,897,98.18,19703.35,4.63,0.4637
2504,Jenkins-Mack,False,EG,Whiteberg,Marketplaces,2012,https://jenkins-mack.com,Ever student fill face able player law trial table her.,21,jenkins-mack,2023,USD,400997,256863,144134,135993,8141,0,8141,4009,8019,122,15262,388406,53284,335122,,400997,987.55,1533.46,0.001,96,347.76,1000.0,15.26,0.3594
2505,Jacobson LLC,False,ZA,Port Marytown,IoT,2015,https://jacobsonllc.com,Fine interview already room similar section science so consumer hope.,16,jacobson-llc,2023,USD,1223698,221123,1002575,883303,119272,0,119272,12236,24473,94799,56764,851772,179528,672244,,1223698,20.0,10.0,0.001,480,212.44,106310.74,0.53,0.8193
2506,Phillips PLC,False,FR,Lake Daltonview,SaaS,2012,https://phillipsplc.com,Process current stop person training rest through care fine authority agency.,20,phillips-plc,2023,EUR,834418,234744,599674,263187,336487,0,336487,8344,16688,319799,42068,552242,27612,524630,69534.83,834418,10.0,70.84,0.0496,710,97.92,6540.88,6.43,0.7187
2507,Sims-Gardner,False,EG,Luisfort,Marketplaces,2008,https://sims-gardner.com,Summer challenge away glass themselves treat event.,17,sims-gardner,2023,USD,190276,46806,143470,122192,21278,27759,-6481,1902,3805,-10286,6729,154396,7719,146677,,190276,770.86,1999.86,0.0135,86,183.62,24624.61,0.27,0.754
2508,Schroeder PLC,False,EG,West Joseph,IoT,2009,https://schroederplc.com,Suggest add baby attack understand reach series.,15,schroeder-plc,2023,USD,110395,27017,83378,59843,23535,0,23535,1103,2207,21328,31813,162716,89849,72867,,110395,1037.45,2847.4,0.001,127,72.25,12759.27,2.49,0.7553
2509,Black Johnson and Sanchez,False,DE,West Danielletown,Cybersecurity,2012,https://blackjohnsonandsanchez.com,Its behind must doctor develop current business shake effort.,22,black-johnson-and-sanchez,2023,EUR,3237241,1201490,2035751,773030,1262721,8863,1253858,32372,64744,1189114,111305,1745807,725478,1020329,,3237241,20.0,33.92,0.001,742,363.43,42221.79,2.64,0.6289
2510,Hodges Kelly and Moss,False,US,East Annaside,HealthTech,2009,https://hodgeskellyandmoss.com,Fall serve concern accept situation medical.,17,hodges-kelly-and-moss,2023,USD,162809,66154,96655,61110,35545,14398,21147,1628,3256,17891,11208,199700,132240,67460,13567.42,162809,471.16,4264.55,0.0844,614,22.08,37678.99,0.3,0.5937
2511,Lester Jones and Hartman,False,IN,North William,Fintech,2022,https://lesterjonesandhartman.com,Catch suddenly their natural build spring indicate involve.,24,lester-jones-and-hartman,2023,USD,776359,264145,512214,311008,201206,0,201206,7763,15527,185679,44946,489854,120045,369809,,776359,427.0,1708.42,0.0793,3234,20.0,41347.5,1.09,0.6598
2512,Hanna-Rosales,False,KE,South Jillberg,HealthTech,2010,https://hanna-rosales.com,Seek outside discuss over draw east who.,21,hanna-rosales,2023,USD,660270,254744,405526,464388,-58862,4494,-63356,6602,13205,-76561,6644,450897,92939,357958,55022.5,660270,326.25,326.25,0.0923,892,61.67,35055.66,0.19,0.6142
2513,Diaz Ltd,False,FR,South John,Fintech,2023,https://diazltd.com,Sport small dream discover whether fast serve use.,20,diaz-ltd,2023,EUR,524909,72893,452016,310119,141897,5847,136050,5249,10498,125552,34079,434516,21725,412791,,524909,84.8,258.21,0.1321,2187,20.0,38985.93,0.87,0.8611
2514,Franco Olson and Long,False,KE,Jasonshire,IoT,2015,https://francoolsonandlong.com,Entire successful no ground modern course world mission policy start.,23,franco-olson-and-long,2023,USD,299274,126838,172436,15094,157342,0,157342,2992,5985,151357,5549,313082,15654,297428,,299274,20.0,21.62,0.0445,174,142.62,5949.97,0.93,0.5762
2515,Hawkins-Rios,False,FR,New Deborah,EdTech,2021,https://hawkins-rios.com,Floor after window senior evening provide talk produce free agree.,25,hawkins-rios,2023,EUR,263512,110810,152702,107104,45598,28539,17059,2635,5270,11789,5641,330397,150280,180117,21959.33,263512,100.29,401.14,0.0553,476,46.08,1000.0,5.64,0.5795
2516,Wilson-Martinez,False,CA,South Tracy,Cybersecurity,2020,https://wilson-martinez.com,Arrive appear education either occur.,25,wilson-martinez,2023,USD,2528327,1239578,1288749,1385575,-96826,17519,-114345,25283,50566,-164911,132001,1455389,433468,1021921,,2528327,20.0,27.67,0.153,3121,67.49,91383.96,1.44,0.5097
2517,Bradley Ltd,False,CA,South Davidview,Fintech,2012,https://bradleyltd.com,Ahead report ground month.,19,bradley-ltd,2023,USD,1136499,450107,686392,378135,308257,13907,294350,11364,22729,271621,178102,817977,493507,324470,,1136499,2087.6,12827.77,0.001,3285,28.83,48584.64,3.67,0.604
2518,Watts Sexton and Moreno,False,CA,Emilyfort,EdTech,2009,https://wattssextonandmoreno.com,Long sit out if watch kind.,16,watts-sexton-and-moreno,2023,USD,598666,63696,534970,365593,169377,0,169377,5986,11973,157404,40805,471631,183568,288063,49888.83,598666,351.04,2076.3,0.0656,732,68.15,9975.41,4.09,0.8936
2519,Long Ltd,False,KE,Port Kellyfort,HealthTech,2018,https://longltd.com,Billion according black ability job order may.,20,long-ltd,2023,USD,1308396,326784,981612,675343,306269,41450,264819,13083,26167,238652,17194,782504,274801,507703,109033.0,1308396,10.0,36.13,0.0074,2352,46.34,36712.16,0.47,0.7502
2520,Kelly and Sons,False,FR,Adamborough,Fintech,2016,https://kellyandsons.com,East half I carry part remember low kid car truth.,20,kelly-and-sons,2023,EUR,284796,30421,254375,68169,186206,17940,168266,2847,5695,162571,38016,370351,245620,124731,,284796,1266.7,4780.95,0.069,156,152.13,20734.96,1.83,0.8932
2521,Castro-Valentine,False,GB,East Elizabethville,Energy,2013,https://castro-valentine.com,Cultural like attorney fire energy positive attack full maintain.,16,castro-valentine,2023,USD,2054551,1197666,856885,133158,723727,0,723727,20545,41091,682636,78912,1211472,673783,537689,,2054551,491.6,245.8,0.0553,8560,20.0,1000.0,78.91,0.4171
2522,Moore-Greer,False,ZA,Port Christina,E-commerce,2013,https://moore-greer.com,Decide person within drive.,22,moore-greer,2023,USD,788045,309906,478139,218976,259163,1410,257753,7880,15760,241993,196351,774694,332412,442282,,788045,586.8,293.4,0.1868,551,119.11,1000.0,196.35,0.6067
2523,Taylor-Wolfe,False,EG,Williamsside,EdTech,2009,https://taylor-wolfe.com,Could outside next life door relate air base.,17,taylor-wolfe,2023,USD,6069738,2444358,3625380,4350237,-724857,14958,-739815,60697,121394,-861209,26338,3083009,1148337,1934672,505811.5,6069738,431.98,1802.21,0.0122,23780,21.27,352926.27,0.07,0.5973
2524,Pacheco Burns and Cortez,False,GB,Goodview,Fintech,2020,https://pachecoburnsandcortez.com,Cut thank last leg every open pattern office indicate.,24,pacheco-burns-and-cortez,2023,USD,2150507,495185,1655322,698359,956963,0,956963,21505,43010,913953,31777,1299496,340327,959169,,2150507,2453.86,1226.93,0.072,8960,20.0,47379.98,0.67,0.7697
2525,Jones Collins and Carson,False,AU,Davilamouth,HealthTech,2008,https://jonescollinsandcarson.com,Look late participant behind upon professional significant economy gas day.,18,jones-collins-and-carson,2023,USD,865403,73641,791762,92005,699757,0,699757,8654,17308,682449,197130,723398,388037,335361,72116.92,865403,10.0,25.68,0.001,1848,39.02,10111.44,19.5,0.9149
2526,Weaver-Sweeney,False,EG,North Apriltown,Fintech,2008,https://weaver-sweeney.com,Special relationship market this investment police three.,22,weaver-sweeney,2023,USD,1332319,771910,560409,258018,302391,17385,285006,13323,26646,258360,147789,942304,231149,711155,,1332319,719.46,1460.37,0.1141,825,134.45,26203.9,5.64,0.4206
2527,Wells Ltd,False,US,Port Dalton,HealthTech,2010,https://wellsltd.com,Produce media product soon quality interesting type open hit.,15,wells-ltd,2023,USD,685474,139269,546205,505764,40441,6499,33942,6854,13709,20233,37064,444532,80359,364173,57122.83,685474,299.77,1070.31,0.001,11424,5.0,38995.58,0.95,0.7968
2528,Ford Hall and Wright,False,ZA,North Antonioside,Marketplaces,2017,https://fordhallandwright.com,Keep new research last tree wait his speak.,24,ford-hall-and-wright,2023,USD,426340,185947,240393,303518,-63125,39339,-102464,4263,8526,-110990,24155,343142,149627,193515,,426340,2237.41,1118.7,0.1366,1776,20.0,37653.47,0.64,0.5639
2529,Moore Decker and Tran,False,TN,Port Kayla,Cybersecurity,2023,https://mooredeckerandtran.com,Coach make no political move happen.,14,moore-decker-and-tran,2023,USD,11472520,4847584,6624936,5213365,1411571,0,1411571,114725,229450,1182121,297921,6194969,2230945,3964024,,11472520,573.73,2445.67,0.088,28102,34.02,415069.33,0.72,0.5775
2530,Martin Ray and Nunez,False,ZA,New Natashatown,HealthTech,2014,https://martinrayandnunez.com,Factor rest girl yourself sing then cover require article some.,20,martin-ray-and-nunez,2023,USD,636299,301382,334917,613707,-278790,3648,-282438,6362,12725,-295163,73047,477254,283301,193953,53024.92,636299,664.41,2851.39,0.001,951,55.7,76479.88,0.96,0.5264
2531,Bryant Group,False,GB,North Alyssa,Marketplaces,2016,https://bryantgroup.com,Not wife against start itself performance eight natural.,14,bryant-group,2023,USD,228996,104254,124742,77523,47219,0,47219,2289,4579,42640,842884,993899,118663,875236,,228996,921.44,460.72,0.0135,954,20.0,1000.0,842.88,0.5447
2532,Nelson LLC,False,NG,North Brianview,Mobility,2021,https://nelsonllc.com,Six hard and draw technology.,11,nelson-llc,2023,USD,970816,467136,503680,288003,215677,32915,182762,9708,19416,163346,44296,574108,362161,211947,,970816,1298.38,1532.09,0.001,2302,35.13,48570.84,0.91,0.5188
2533,Williams Group,False,DE,Tanyaton,HealthTech,2009,https://williamsgroup.com,Shoulder parent city in scientist computer no product form.,17,williams-group,2023,EUR,2252969,854291,1398678,947679,450999,9418,441581,22529,45059,396522,509167,1690403,836306,854097,187747.42,2252969,18.87,83.02,0.0098,1886,99.5,39684.39,12.83,0.6208
2534,Moore-Bradshaw,False,KE,Jonathanshire,HealthTech,2023,https://moore-bradshaw.com,Office scientist chance tell boy system turn lose crime.,24,moore-bradshaw,2023,USD,855922,699258,156664,99057,57607,24170,33437,8559,17118,16319,3996,577361,177007,400354,71326.83,855922,264.21,1635.0,0.0333,859,82.97,1000.0,4.0,0.183
2535,Russell-Holloway,False,KE,Victoriamouth,Fintech,2017,https://russell-holloway.com,Meet structure student reduce vote whose during project.,20,russell-holloway,2023,USD,396318,51701,344617,92585,252032,19062,232970,3963,7926,225044,15558,260660,100519,160141,,396318,43.11,195.93,0.0487,1651,20.0,1000.0,15.56,0.8695
2536,Kent Ltd,False,CA,Jacobshire,Energy,2008,https://kentltd.com,Great research area involve southern least.,10,kent-ltd,2023,USD,1091585,248373,843212,287608,555604,0,555604,10915,21831,533773,94539,735449,45847,689602,,1091585,1736.71,6417.49,0.0532,4383,20.75,50905.05,1.86,0.7725
2537,Nguyen Espinoza and Smith,False,NG,South Keithbury,EdTech,2014,https://nguyenespinozaandsmith.com,Either white citizen help.,25,nguyen-espinoza-and-smith,2023,USD,261319,71476,189843,31937,157906,0,157906,2613,5226,152680,9869,228920,95904,133016,21776.58,261319,73.1,73.1,0.075,466,46.72,21106.48,0.47,0.7265
2538,Williams Inc,False,FR,North Robert,AI/ML,2011,https://williamsinc.com,Suggest let challenge simply a book choose language.,17,williams-inc,2023,EUR,503982,117175,386807,189411,197396,27323,170073,5039,10079,159994,69298,356029,130420,225609,,503982,20.0,10.0,0.103,454,92.33,18671.87,3.71,0.7675
2539,Moss Harrison and Gonzales,False,KE,Lake Susan,E-commerce,2024,https://mossharrisonandgonzales.com,Improve someone fast yourself.,19,moss-harrison-and-gonzales,2023,USD,673539,229073,444466,266896,177570,33878,143692,6735,13470,130222,6342,422463,165799,256664,,673539,1531.03,5490.91,0.1217,429,130.56,12394.35,0.51,0.6599
2540,Moore-Le,False,DE,Lake Kellyhaven,Mobility,2014,https://moore-le.com,Pick main rest left career ten summer just century girl.,17,moore-le,2023,EUR,723135,304932,418203,539423,-121220,22366,-143586,7231,14462,-158048,7455,374549,18727,355822,,723135,343.84,1141.87,0.0658,968,62.2,26830.33,0.28,0.5783
2541,Sampson Group,False,IN,New Carl,SaaS,2014,https://sampsongroup.com,Finally inside though call industry step himself level through citizen.,21,sampson-group,2023,USD,1795613,924261,871352,932209,-60857,820,-61677,17956,35912,-97589,62451,1159907,353764,806143,149634.42,1795613,128.86,363.15,0.0064,1632,91.67,71236.15,0.88,0.4853
2542,Williams Harris and Oliver,False,FR,Steeleville,HealthTech,2023,https://williamsharrisandoliver.com,Report reflect allow spend hotel ask either reduce.,25,williams-harris-and-oliver,2023,EUR,328837,54930,273907,148756,125151,36119,89032,3288,6576,82456,3736,332805,178459,154346,27403.08,328837,69.18,92.28,0.0215,359,76.23,10529.25,0.35,0.833
2543,Perez-Grimes,False,EG,Port Kelli,HealthTech,2013,https://perez-grimes.com,Spring Republican himself itself wife.,18,perez-grimes,2023,USD,168566,72295,96271,25059,71212,11188,60024,1685,3371,56653,6717,214440,100342,114098,14047.17,168566,10.0,48.48,0.0086,232,60.44,1000.0,6.72,0.5711
2544,Douglas-Nguyen,False,BR,West Eric,SaaS,2009,https://douglas-nguyen.com,Reality in north determine difference.,16,douglas-nguyen,2023,USD,554165,174369,379796,159422,220374,0,220374,5541,11083,209291,13346,427611,158863,268748,46180.42,554165,149.89,583.21,0.1009,2875,16.06,1000.0,13.35,0.6853
2545,Landry PLC,False,BR,Mcintyremouth,E-commerce,2017,https://landryplc.com,Program hand threat dream whom allow four difference break her.,16,landry-plc,2023,USD,3032556,807377,2225179,2150261,74918,9434,65484,30325,60651,4833,40047,1643912,640707,1003205,,3032556,20.0,77.5,0.001,6150,41.09,185778.1,0.22,0.7338
2546,Mathews-Todd,False,DE,Phillipsmouth,Energy,2016,https://mathews-todd.com,Card book budget key year girl half marriage.,14,mathews-todd,2023,EUR,1339813,506917,832896,948526,-115630,49565,-165195,13398,26796,-191991,205352,902163,285710,616453,,1339813,1649.55,4187.54,0.001,5582,20.0,83042.8,2.47,0.6217
2547,Maynard-Moore,False,CA,Barryfurt,IoT,2022,https://maynard-moore.com,Manage something eye camera course up only study whose national.,16,maynard-moore,2023,USD,177084,59784,117300,58362,58938,0,58938,1770,3541,55397,3451,159017,60624,98393,,177084,1328.41,2161.75,0.0316,114,129.26,1000.0,3.45,0.6624
2548,Rios-Cantu,False,US,Annaberg,Fintech,2009,https://rios-cantu.com,East issue alone possible friend generation hand lot.,13,rios-cantu,2023,USD,9327325,3167758,6159567,7352012,-1192445,0,-1192445,93273,186546,-1378991,1031018,5848703,1635544,4213159,,9327325,41.34,106.93,0.0528,18410,42.22,651263.82,1.58,0.6604
2549,Brennan Griffin and Crane,False,NG,Port Brendafort,HealthTech,2013,https://brennangriffinandcrane.com,Economy free at without lawyer cup she economy test morning.,25,brennan-griffin-and-crane,2023,USD,525188,277560,247628,253948,-6320,4698,-11018,5251,10503,-21521,4391,344072,169150,174922,43765.67,525188,466.48,2542.15,0.005,334,130.87,44992.0,0.1,0.4715
2550,Caldwell PLC,False,AU,Hendersonburgh,SaaS,2023,https://caldwellplc.com,Culture especially shake however raise.,17,caldwell-plc,2023,USD,2084746,724677,1360069,1839752,-479683,9407,-489090,20847,41694,-530784,71536,1203819,352710,851109,173728.83,2084746,311.14,1381.43,0.0301,1751,99.17,173632.69,0.41,0.6524
2551,Flores Ltd,False,NG,Carrillobury,Fintech,2010,https://floresltd.com,Speech camera push energy these last.,21,flores-ltd,2023,USD,1235572,631045,604527,475488,129039,0,129039,12355,24711,104328,138853,811586,517874,293712,,1235572,712.78,1334.39,0.0381,501,205.15,26717.91,5.2,0.4893
2552,Rhodes Davis and Mayo,False,DE,West Allisonville,Cybersecurity,2022,https://rhodesdavisandmayo.com,Old kind past movement analysis style.,27,rhodes-davis-and-mayo,2023,EUR,815638,217937,597701,561733,35968,4500,31468,8156,16312,15156,17362,608141,30407,577734,,815638,343.38,2880.19,0.0331,251,269.95,67507.88,0.26,0.7328
2553,Hobbs Barrett and Sanchez,False,KE,Angelaville,IoT,2018,https://hobbsbarrettandsanchez.com,Thus middle maintain unit economic road.,20,hobbs-barrett-and-sanchez,2023,USD,243168,75799,167369,64927,102442,14929,87513,2431,4863,82650,63485,335654,147742,187912,,243168,498.7,927.33,0.13,137,147.28,20479.63,3.1,0.6883
2554,Christian Morris and Weaver,False,TN,West Melissahaven,EdTech,2018,https://christianmorrisandweaver.com,National environmental cover executive style.,18,christian-morris-and-weaver,2023,USD,688361,347049,341312,264225,77087,11694,65393,6883,13767,51626,29433,454654,192924,261730,57363.42,688361,503.13,1671.33,0.001,709,80.87,26360.48,1.12,0.4958
2555,Mcknight-Tran,False,DE,Lake Jenniferton,Fintech,2018,https://mcknight-tran.com,Heavy we determine whatever million statement it soon.,21,mcknight-tran,2023,EUR,4295573,1606321,2689252,3908912,-1219660,10891,-1230551,42955,85911,-1316462,161351,2395220,234500,2160720,,4295573,483.71,2589.33,0.001,2052,174.38,342238.6,0.47,0.6261
2556,Johnson Lopez and Garcia,False,DE,North Colton,Fintech,2015,https://johnsonlopezandgarcia.com,Nothing individual threat whether avoid tree they town while.,24,johnson-lopez-and-garcia,2023,EUR,169510,71942,97568,35176,62392,4039,58353,1695,3390,54963,5514,264880,81293,183587,,169510,20.0,47.98,0.1,34,409.47,1000.0,5.51,0.5756
2557,Parsons-Thomas,False,ZA,East Janicestad,Energy,2014,https://parsons-thomas.com,Model couple since appear stand environment meeting nice stuff once.,23,parsons-thomas,2023,USD,1945185,1068935,876250,795059,81191,23804,57387,19451,38903,18484,9165,1148061,556326,591735,,1945185,20.0,19.41,0.0451,8104,20.0,33800.41,0.27,0.4505
2558,Ramsey George and Boone,False,TN,Smithshire,EdTech,2010,https://ramseygeorgeandboone.com,A difference rich employee item individual.,19,ramsey-george-and-boone,2023,USD,154024,61921,92103,21708,70395,3923,66472,1540,3080,63392,8729,91602,42683,48919,12835.33,154024,474.0,1290.94,0.028,192,66.63,4602.36,1.9,0.598
2559,Gomez Baldwin and Savage,False,EG,Myersfort,IoT,2023,https://gomezbaldwinandsavage.com,Place decision experience offer generation arm dog may push how.,17,gomez-baldwin-and-savage,2023,USD,2108480,917297,1191183,1881158,-689975,15093,-705068,21084,42169,-747237,145145,1298329,401512,896817,,2108480,872.96,2824.37,0.001,610,287.86,171575.61,0.85,0.5649
2560,Garcia Nelson and Williams,False,US,Thomasshire,Energy,2012,https://garcianelsonandwilliams.com,Couple thought shoulder suggest age you year throw.,23,garcia-nelson-and-williams,2023,USD,1082451,551597,530854,687003,-156149,52569,-208718,10824,21649,-230367,25348,571923,156106,415817,,1082451,913.79,456.9,0.001,1003,89.85,20790.04,1.22,0.4904
2561,Lowery Cruz and Davis,False,DE,South Corey,IoT,2022,https://lowerycruzanddavis.com,Prove notice spring usually guy edge.,15,lowery-cruz-and-davis,2023,EUR,960749,300272,660477,75131,585346,27187,558159,9607,19214,538945,50895,692147,401535,290612,,960749,300.15,267.2,0.1662,213,374.6,1000.0,50.9,0.6875
2562,Sanders Gordon and Smith,False,GB,Melissaborough,Energy,2019,https://sandersgordonandsmith.com,Early this already despite even spring evidence cell police middle.,22,sanders-gordon-and-smith,2023,USD,748499,345584,402915,37424,365491,23530,341961,7484,14969,326992,21494,425337,21266,404071,,748499,1161.84,4444.47,0.0958,3118,20.0,29153.2,0.74,0.5383
2563,Cunningham-Reilly,False,GB,New Georgechester,Mobility,2014,https://cunningham-reilly.com,Him herself cultural have trip increase center learn read catch increase.,20,cunningham-reilly,2023,USD,353604,118330,235274,17680,217594,16947,200647,3536,7072,193575,34219,399215,321269,77946,,353604,1626.42,6215.75,0.0483,185,159.06,14163.42,2.42,0.6654
2564,Miller and Sons,False,BR,Petersonview,E-commerce,2016,https://millerandsons.com,Mother party parent sell general fund.,18,miller-and-sons,2023,USD,1875227,287409,1587818,941044,646774,0,646774,18752,37504,609270,73080,1102839,976467,126372,,1875227,1022.5,4660.09,0.0153,890,175.54,75779.72,0.96,0.8467
2565,Conley-Nicholson,False,DE,East Rebeccaberg,E-commerce,2012,https://conley-nicholson.com,Adult team market question ago candidate fast test adult see.,23,conley-nicholson,2023,EUR,317669,83410,234259,114128,120131,0,120131,3176,6353,113778,3692,318411,15920,302491,,317669,136.35,252.25,0.0094,116,227.78,26764.43,0.14,0.7374
2566,Chang Mitchell and Gibson,False,US,Elizabethview,Cybersecurity,2009,https://changmitchellandgibson.com,Yes stuff example east available.,27,chang-mitchell-and-gibson,2023,USD,829471,364145,465326,41473,423853,16215,407638,8294,16589,391049,45804,467398,188989,278409,,829471,20.0,37.9,0.001,293,235.26,14348.33,3.19,0.561
2567,Robinson Dodson and Fitzgerald,False,IN,Port Allisonchester,HealthTech,2011,https://robinsondodsonandfitzgerald.com,Task PM thousand instead main seat likely position career.,12,robinson-dodson-and-fitzgerald,2023,USD,4605303,2298218,2307085,2036033,271052,0,271052,46053,92106,178946,314244,2708779,1005036,1703743,383775.25,4605303,202.26,1027.72,0.0314,6087,63.04,156732.98,2.0,0.501
2568,Marquez Inc,False,EG,Lake Moniqueport,Mobility,2021,https://marquezinc.com,Necessary meeting east life.,25,marquez-inc,2023,USD,437630,141137,296493,120253,176240,0,176240,4376,8752,167488,12481,244322,66442,177880,,437630,20.0,75.6,0.0247,272,133.7,25184.75,0.5,0.6775
2569,Thompson Smith and Miller,False,GB,Harrisonfort,E-commerce,2015,https://thompsonsmithandmiller.com,Send popular could value usually central foot option wait can enough.,21,thompson-smith-and-miller,2023,USD,757017,397829,359188,631829,-272641,0,-272641,7570,15140,-287781,3582,433095,228373,204722,,757017,104.66,558.13,0.001,3154,20.0,54931.03,0.07,0.4745
2570,Dyer-Vasquez,False,IN,Carrillomouth,IoT,2013,https://dyer-vasquez.com,Edge knowledge fund close blood source moment general behavior.,13,dyer-vasquez,2023,USD,442424,187717,254707,253303,1404,61044,-59640,4424,8848,-68488,131740,540546,166672,373874,,442424,458.67,1380.26,0.0377,1397,26.39,26371.68,5.0,0.5757
2571,Fox-Reynolds,False,AU,East Jenniferborough,Marketplaces,2013,https://fox-reynolds.com,Discover still represent move my measure fear specific administration security.,26,fox-reynolds,2023,USD,1483344,279134,1204210,805661,398549,0,398549,14833,29666,368883,28123,903781,376127,527654,,1483344,20.0,137.37,0.0065,677,182.42,54716.65,0.51,0.8118
2572,Mitchell Rivera and Watts,False,KE,West Elizabeth,AI/ML,2015,https://mitchellriveraandwatts.com,Find sell argue himself reduce reveal each operation moment drop.,27,mitchell-rivera-and-watts,2023,USD,1730825,613824,1117001,1261113,-144112,0,-144112,17308,34616,-178728,115023,1170129,147923,1022206,,1730825,679.34,3189.73,0.0742,570,252.84,101143.36,1.14,0.6454
2573,Fowler Hernandez and Mcpherson,False,FR,Lanceland,Energy,2024,https://fowlerhernandezandmcpherson.com,Require region listen wear in would population moment soldier.,23,fowler-hernandez-and-mcpherson,2023,EUR,1679664,585557,1094107,432828,661279,213,661066,16796,33593,627473,230206,1120121,414676,705445,,1679664,586.91,1623.46,0.1976,4379,31.96,25511.18,9.02,0.6514
2574,Chaney Hudson and Cobb,False,EG,Lake Robert,EdTech,2023,https://chaneyhudsonandcobb.com,Their thank for responsibility sister.,25,chaney-hudson-and-cobb,2023,USD,213445,62015,151430,135551,15879,5704,10175,2134,4268,5907,11357,164274,76450,87824,17787.08,213445,10.0,71.68,0.0354,3557,5.0,22511.3,0.5,0.7095
2575,Spence-Willis,False,EG,North Jennifermouth,AgriTech,2008,https://spence-willis.com,Common well forward piece beautiful exactly degree maintain institution.,25,spence-willis,2023,USD,830831,203297,627534,478390,149144,0,149144,8308,16616,132528,13996,569285,164707,404578,,830831,20.0,34.12,0.0501,316,218.71,54434.84,0.26,0.7553
2576,Leonard-Wagner,False,ZA,Warestad,Energy,2015,https://leonard-wagner.com,She none performance management let beat long.,24,leonard-wagner,2023,USD,4074413,1012659,3061754,684013,2377741,36418,2341323,40744,81488,2259835,936240,3062023,1103824,1958199,,4074413,2482.7,11337.44,0.001,3075,110.41,36693.58,25.52,0.7515
2577,Welch Patrick and Bauer,False,DE,North Andreaville,E-commerce,2021,https://welchpatrickandbauer.com,Smile best eight mean.,25,welch-patrick-and-bauer,2023,EUR,264266,143675,120591,48282,72309,16747,55562,2642,5285,50277,21506,235748,13403,222345,,264266,20.0,107.41,0.0405,262,83.76,25490.51,0.84,0.4563
2578,Contreras-Carlson,False,KE,Whiteland,EdTech,2012,https://contreras-carlson.com,Major only blue term short seven north huge.,12,contreras-carlson,2023,USD,208328,38942,169386,49559,119827,0,119827,2083,4166,115661,2838,287162,124327,162835,17360.67,208328,583.36,2042.28,0.0263,3472,5.0,1000.0,2.84,0.8131
2579,Chen Ltd,False,KE,Lake Williamtown,SaaS,2021,https://chenltd.com,Piece good reason too evening probably low.,15,chen-ltd,2023,USD,450219,113407,336812,81310,255502,211,255291,4502,9004,246287,51798,362740,125313,237427,37518.25,450219,230.11,1870.79,0.0097,315,118.79,36386.33,1.42,0.7481
2580,Yoder Carter and Daugherty,False,US,Hendersonberg,SaaS,2023,https://yodercarteranddaugherty.com,Father might table wear generation lead only choice forward conference describe.,20,yoder-carter-and-daugherty,2023,USD,1163559,505434,658125,58177,599948,0,599948,11635,23271,576677,34722,738884,337594,401290,96963.25,1163559,39.64,78.57,0.0256,1267,76.5,1000.0,34.72,0.5656
2581,Harris-Hahn,False,ZA,Jessechester,AI/ML,2009,https://harris-hahn.com,Health language machine know economy reveal star hold strategy.,18,harris-hahn,2023,USD,905154,488010,417144,560154,-143010,24613,-167623,9051,18103,-185726,63567,683960,34198,649762,,905154,20.0,135.74,0.0619,793,95.11,22227.4,2.86,0.4609
2582,Patel-Olson,False,TN,East Elizabethtown,AI/ML,2020,https://patel-olson.com,Remember opportunity out either like local picture.,23,patel-olson,2023,USD,364357,122110,242247,152712,89535,0,89535,3643,7287,82248,50799,356614,83915,272699,,364357,963.39,2125.42,0.0365,254,119.1,24307.17,2.09,0.6649
2583,Burton Dillon and Johnson,False,EG,Millershire,Cybersecurity,2011,https://burtondillonandjohnson.com,Along success you hotel remain include several strategy event charge.,15,burton-dillon-and-johnson,2023,USD,3147058,958798,2188260,932591,1255669,0,1255669,31470,62941,1192728,132853,1714491,1036156,678335,,3147058,330.83,343.78,0.0589,3373,77.73,113706.47,1.17,0.6953
2584,Davis Wilson and Walls,False,EG,Kaylastad,Mobility,2015,https://daviswilsonandwalls.com,Institution prevent each writer anyone child serious hit.,15,davis-wilson-and-walls,2023,USD,858310,391638,466672,245095,221577,0,221577,8583,17166,204411,71999,585611,88844,496767,,858310,995.1,5048.77,0.1229,874,81.79,29669.77,2.43,0.5437
2585,Watson Thomas and Cox,False,FR,Lunafurt,AI/ML,2008,https://watsonthomasandcox.com,Deal role listen nice behavior area material mission difference.,23,watson-thomas-and-cox,2023,EUR,2138443,644425,1494018,430480,1063538,8920,1054618,21384,42768,1011850,394976,1626110,430872,1195238,,2138443,1668.53,3386.81,0.001,8910,20.0,35351.07,11.17,0.6986
2586,Evans Murray and Cruz,False,ZA,Curryland,Cybersecurity,2021,https://evansmurrayandcruz.com,Quite because participant police parent prevent.,17,evans-murray-and-cruz,2023,USD,1103430,540201,563229,859784,-296555,6847,-303402,11034,22068,-325470,101159,711705,312852,398853,,1103430,255.63,732.28,0.0673,4597,20.0,54861.85,1.84,0.5104
2587,Frederick Rodriguez and Berry,False,DE,Port Suzanne,HealthTech,2019,https://frederickrodriguezandberry.com,Free recently eight oil seven on as painting front.,16,frederick-rodriguez-and-berry,2023,EUR,3696294,960318,2735976,184814,2551162,3558,2547604,36962,73925,2473679,122423,1997966,332448,1665518,308024.5,3696294,838.0,3321.42,0.0636,5474,56.27,1000.0,122.42,0.7402
2588,Robinson-Smith,False,IN,Harrisberg,EdTech,2010,https://robinson-smith.com,Society approach quickly home argue member.,21,robinson-smith,2023,USD,284817,126033,158784,190579,-31795,2338,-34133,2848,5696,-39829,47929,303883,206156,97727,23734.75,284817,78.71,268.1,0.0189,387,61.24,20841.69,2.3,0.5575
2589,Hanna Pacheco and Bradford,False,US,Port Kevinhaven,Mobility,2017,https://hannapachecoandbradford.com,Bed scientist hair tell send.,24,hanna-pacheco-and-bradford,2023,USD,1018276,184931,833345,354507,478838,36117,442721,10182,20365,422356,10735,619779,308544,311235,,1018276,466.57,2335.75,0.1516,244,346.86,39702.77,0.27,0.8184
2590,Blair Goodman and Chaney,False,GB,New Robert,Cybersecurity,2022,https://blairgoodmanandchaney.com,Lot pick clear soon first see.,24,blair-goodman-and-chaney,2023,USD,5328712,1150340,4178372,2479732,1698640,54410,1644230,53287,106574,1537656,43163,2712001,685261,2026740,,5328712,20.0,57.87,0.076,22202,20.0,210385.3,0.21,0.7841
2591,Alexander-Harrison,False,KE,West Michaelhaven,Cybersecurity,2008,https://alexander-harrison.com,Once show listen worry really turn his she us for.,18,alexander-harrison,2023,USD,1338452,741221,597231,1035597,-438366,0,-438366,13384,26769,-465135,82688,943817,502714,441103,,1338452,1575.31,4565.8,0.001,560,198.83,103041.5,0.8,0.4462
2592,Dunn Dickson and Everett,False,EG,North Dianeshire,Mobility,2012,https://dunndicksonandeverett.com,Describe receive bit wonder hospital occur likely.,15,dunn-dickson-and-everett,2023,USD,1067270,226061,841209,446079,395130,4270,390860,10672,21345,369515,23879,628667,321510,307157,,1067270,200.99,345.44,0.1493,692,128.51,39097.43,0.61,0.7882
2593,Fisher-Moore,False,ZA,South Katherine,Energy,2013,https://fisher-moore.com,Expert growth lot really score yard money common personal hear.,13,fisher-moore,2023,USD,2128703,827891,1300812,525566,775246,6016,769230,21287,42574,726656,77114,1286464,362744,923720,,2128703,20.0,25.94,0.055,1334,132.91,27686.31,2.79,0.6111
2594,Garza Hogan and Mullins,False,AU,Grahamstad,E-commerce,2022,https://garzahoganandmullins.com,Newspaper choose detail happy third real follow make.,13,garza-hogan-and-mullins,2023,USD,610253,194842,415411,208868,206543,45864,160679,6102,12205,148474,178890,628135,243035,385100,,610253,1246.76,2624.42,0.0068,2542,20.0,36338.8,4.92,0.6807
2595,Kane Group,False,ZA,North Kristen,Marketplaces,2008,https://kanegroup.com,Should natural thank concern up something.,21,kane-group,2023,USD,2221393,1092784,1128609,1189352,-60743,0,-60743,22213,44427,-105170,67542,1293575,1077844,215731,,2221393,20.0,49.21,0.0954,2497,74.13,135575.45,0.5,0.5081
2596,Sampson-Daniels,False,BR,Rosefort,Fintech,2020,https://sampson-daniels.com,Hear throw go town power.,22,sampson-daniels,2023,USD,575502,63649,511853,182596,329257,23079,306178,5755,11510,294668,228557,704218,173801,530417,,575502,785.78,1235.68,0.0772,259,185.12,24038.63,9.51,0.8894
2597,Washington-Moore,False,ZA,Melissafort,E-commerce,2024,https://washington-moore.com,Include put fly lawyer character mind bill.,26,washington-moore,2023,USD,3344495,937837,2406658,1913393,493265,6456,486809,33444,66889,419920,106759,1822549,593461,1229088,,3344495,1350.62,6104.58,0.0666,2848,97.86,144834.62,0.74,0.7196
2598,Leblanc Inc,False,US,Jessicaton,AgriTech,2021,https://leblancinc.com,National various lose idea financial very go agent quality myself.,22,leblanc-inc,2023,USD,206432,66048,140384,97709,42675,0,42675,2064,4128,38547,9318,120679,6033,114646,,206432,1679.19,8177.06,0.0379,860,20.0,45483.3,0.2,0.68
2599,Smith Moreno and Rodriguez,False,AU,Tuckerfort,AgriTech,2014,https://smithmorenoandrodriguez.com,Effect itself open land specific role western.,18,smith-moreno-and-rodriguez,2023,USD,114203,59146,55057,28169,26888,9995,16893,1142,2284,14609,44674,194340,75034,119306,,114203,184.4,412.64,0.0844,231,41.07,1000.0,44.67,0.4821
2600,Lee-Cruz,False,AU,Paulmouth,Marketplaces,2010,https://lee-cruz.com,Very doctor stage kind season impact director.,16,lee-cruz,2023,USD,248816,30341,218475,19066,199409,145,199264,2488,4976,194288,23371,338638,125392,213246,,248816,1570.5,1989.34,0.1065,959,21.6,15559.09,1.5,0.8781
2601,Ray-Valencia,False,KE,Port Michelle,E-commerce,2009,https://ray-valencia.com,Turn color boy understand general consider machine deal though.,21,ray-valencia,2023,USD,1389544,583610,805934,802802,3132,11052,-7920,13895,27790,-35710,63077,952971,477857,475114,,1389544,20.0,101.37,0.1182,642,180.32,52137.05,1.21,0.58
2602,Sanchez-Benitez,False,NG,West Tamaraville,Marketplaces,2019,https://sanchez-benitez.com,Face floor plant education candidate indicate person ten political interview.,19,sanchez-benitez,2023,USD,9263489,933119,8330370,3956051,4374319,13439,4360880,92634,185269,4175611,630001,5451984,2221702,3230282,,9263489,637.7,3758.3,0.0512,7141,108.09,316823.78,1.99,0.8993
2603,Jones Kelly and Matthews,False,US,Youngchester,Fintech,2020,https://joneskellyandmatthews.com,Administration mouth scientist first boy news keep fear.,16,jones-kelly-and-matthews,2023,USD,602460,120465,481995,288982,193013,0,193013,6024,12049,180964,34249,457494,126896,330598,,602460,1049.41,4092.32,0.0871,2510,20.0,14696.04,2.33,0.8
2604,Hall Graham and Harris,False,CA,Brewerhaven,Mobility,2009,https://hallgrahamandharris.com,Model south media other quite total the laugh.,18,hall-graham-and-harris,2023,USD,1582260,560690,1021570,356503,665067,9362,655705,15822,31645,624060,25195,866215,174850,691365,,1582260,749.19,5675.59,0.0622,898,146.83,40401.42,0.62,0.6456
2605,Wilson Ltd,False,CA,Susanview,E-commerce,2013,https://wilsonltd.com,Usually ask itself such floor fund economy live everyone just.,20,wilson-ltd,2023,USD,1329116,66455,1262661,469648,793013,9077,783936,13291,26582,757354,31032,847124,332630,514494,,1329116,180.65,452.68,0.0916,324,341.81,50549.09,0.61,0.95
2606,Miller and Sons,False,BR,Zacharymouth,AI/ML,2010,https://millerandsons.com,Himself spring size true bank nature none mind.,10,miller-and-sons,2023,USD,713348,150710,562638,296906,265732,35452,230280,7133,14266,216014,17386,499181,140089,359092,,713348,34.22,201.08,0.0633,805,73.83,30148.29,0.58,0.7887
2607,Brooks-Watkins,False,NG,East Jessica,Cybersecurity,2014,https://brooks-watkins.com,American single truth food activity expert school just here nearly.,16,brooks-watkins,2023,USD,2740977,2028848,712129,573948,138181,0,138181,27409,54819,83362,79155,1559489,639067,920422,,2740977,20.0,64.74,0.1044,849,268.73,25974.0,3.05,0.2598
2608,Johnson-Daniel,False,GB,New Jeffreyport,E-commerce,2015,https://johnson-daniel.com,Fact call price thank billion care.,21,johnson-daniel,2023,USD,798446,343514,454932,518885,-63953,0,-63953,7984,15968,-79921,201475,725011,331391,393620,,798446,959.96,1515.03,0.0106,2385,27.89,42689.24,4.72,0.5698
2609,Young Pace and Kent,False,NG,Rogersborough,Fintech,2023,https://youngpaceandkent.com,Theory crime require partner line usually start provide.,21,young-pace-and-kent,2023,USD,2642935,1100411,1542524,1614358,-71834,0,-71834,26429,52858,-124692,83284,1550697,472322,1078375,,2642935,1446.31,4247.23,0.0942,11012,20.0,111493.95,0.75,0.5836
2610,Hudson and Sons,False,ZA,Lake Jane,IoT,2014,https://hudsonandsons.com,Idea a majority major pick plan mean teacher chair reduce.,29,hudson-and-sons,2023,USD,254461,50352,204109,65267,138842,0,138842,2544,5089,133753,5925,208207,98479,109728,,254461,901.21,818.39,0.0377,130,161.88,1369.01,4.33,0.8021
2611,Joyce-Marshall,False,AU,Wrightshire,Cybersecurity,2015,https://joyce-marshall.com,Lay ok spend right test suffer in notice price.,28,joyce-marshall,2023,USD,719297,221792,497505,472808,24697,3825,20872,7192,14385,6487,48526,497270,24863,472407,,719297,995.55,1387.53,0.001,393,152.26,20391.47,2.38,0.6917
2612,Gordon-Nguyen,False,CA,Theresaton,E-commerce,2016,https://gordon-nguyen.com,Everyone hair another region over church particular.,20,gordon-nguyen,2023,USD,1507337,757898,749439,1022403,-272964,0,-272964,15073,30146,-303110,70543,900267,265822,634445,,1507337,1403.55,6405.5,0.0215,2272,55.28,121300.11,0.58,0.4972
2613,Mayo Ayala and Johnson,False,NG,North Sarahbury,Marketplaces,2021,https://mayoayalaandjohnson.com,Ready challenge green large citizen face.,22,mayo-ayala-and-johnson,2023,USD,217315,72276,145039,122520,22519,11957,10562,2173,4346,6216,13050,136996,82828,54168,,217315,499.55,446.67,0.1018,153,117.85,19705.42,0.66,0.6674
2614,Smith PLC,False,IN,Emilystad,SaaS,2010,https://smithplc.com,Matter attack kind data necessary side rise small clearly.,20,smith-plc,2023,USD,345235,65555,279680,89903,189777,0,189777,3452,6904,182873,67216,286297,96170,190127,28769.58,345235,10.0,26.77,0.0329,698,41.19,36145.0,1.86,0.8101
2615,Stewart Davis and Suarez,False,CA,Lamberthaven,E-commerce,2022,https://stewartdavisandsuarez.com,Fight manager Republican share real southern hair score full.,25,stewart-davis-and-suarez,2023,USD,187539,96311,91228,115198,-23970,25786,-49756,1875,3750,-53506,1432,186742,50636,136106,,187539,20.0,91.7,0.0693,91,170.62,27232.72,0.05,0.4864
2616,Woods Kim and Robinson,False,EG,Arthurmouth,AI/ML,2024,https://woodskimandrobinson.com,Glass something system impact indeed.,20,woods-kim-and-robinson,2023,USD,613805,172043,441762,179656,262106,0,262106,6138,12276,249830,57812,483292,215119,268173,,613805,812.74,869.72,0.0697,829,61.7,13489.38,4.29,0.7197
2617,Brown and Sons,False,FR,West Paulbury,Mobility,2017,https://brownandsons.com,Last agreement use low want view difference notice sport side.,15,brown-and-sons,2023,EUR,1125799,399234,726565,270294,456271,0,456271,11257,22515,433756,10870,715155,213963,501192,,1125799,681.0,340.5,0.0099,1476,63.54,4778.0,2.28,0.6454
2618,Roberts Ltd,False,EG,West Christopher,IoT,2019,https://robertsltd.com,Billion drop that international court along whatever head democratic.,20,roberts-ltd,2023,USD,90668,33481,57187,30364,26823,0,26823,906,1813,25010,8869,143167,114086,29081,,90668,1990.56,4864.26,0.0956,146,51.54,50853.01,0.17,0.6307
2619,Hansen-Vega,False,AU,Port Ronald,Marketplaces,2010,https://hansen-vega.com,Up interest class movie international project animal human lose yet.,11,hansen-vega,2023,USD,1332266,308181,1024085,1019673,4412,0,4412,13322,26645,-22233,14252,709830,234554,475276,,1332266,1716.62,1427.33,0.0473,5551,20.0,58898.74,0.24,0.7687
2620,Elliott-Cole,False,DE,Lake Robin,Mobility,2010,https://elliott-cole.com,Fact specific five seat police thousand loss probably.,18,elliott-cole,2023,EUR,1019179,374431,644748,591199,53549,0,53549,10191,20383,33166,38351,744647,148083,596564,,1019179,20.0,112.85,0.1069,912,93.04,42806.15,0.9,0.6326
2621,Rowland-Carter,False,FR,West Haley,Energy,2013,https://rowland-carter.com,Prepare scene nature ago music floor foot language deep machine.,14,rowland-carter,2023,EUR,1915582,734781,1180801,1205321,-24520,10816,-35336,19155,38311,-73647,39358,1166185,239540,926645,,1915582,20.0,10.0,0.0344,1054,151.41,121885.4,0.32,0.6164
2622,Avila-Mueller,False,IN,North Alicia,Fintech,2011,https://avila-mueller.com,Explain box society beat arrive level.,21,avila-mueller,2023,USD,3641945,319851,3322094,2056952,1265142,12987,1252155,36419,72838,1179317,32477,2009056,674942,1334114,,3641945,20.0,108.83,0.0464,4136,73.37,175838.44,0.18,0.9122
2623,Riley-Wilson,False,GB,Smithville,AgriTech,2011,https://riley-wilson.com,Short state beat play picture wide become possible admit.,12,riley-wilson,2023,USD,358759,186106,172653,21656,150997,0,150997,3587,7175,143822,12912,259562,49954,209608,,358759,20.0,84.77,0.001,349,85.56,26307.02,0.49,0.4813
2624,Alexander-Pena,False,ZA,North Blakeport,HealthTech,2023,https://alexander-pena.com,Necessary almost political onto candidate local image through.,30,alexander-pena,2023,USD,497548,156951,340597,132046,208551,10728,197823,4975,9950,187873,224143,545026,287808,257218,41462.33,497548,10.0,61.75,0.001,588,70.45,21034.52,10.66,0.6846
2625,Maldonado Mcintosh and Cruz,False,GB,Cindymouth,EdTech,2024,https://maldonadomcintoshandcruz.com,Power school system power media American question small hour.,21,maldonado-mcintosh-and-cruz,2023,USD,142370,41946,100424,123375,-22951,13974,-36925,1423,2847,-39772,4836,121347,45388,75959,11864.17,142370,10.0,55.01,0.0164,2017,5.88,30521.87,0.16,0.7054
2626,Robinson Carter and Taylor,False,BR,West Michael,SaaS,2017,https://robinsoncarterandtaylor.com,Trouble best although role dog ask shake father poor contain.,18,robinson-carter-and-taylor,2023,USD,613205,322993,290212,302673,-12461,12995,-25456,6132,12264,-37720,11233,516124,25806,490318,51100.42,613205,10.0,28.13,0.065,727,70.21,39525.57,0.28,0.4733
2627,Lucas-Wiggins,False,TN,Moralesbury,Marketplaces,2012,https://lucas-wiggins.com,Along American alone ground option way nature event win total.,15,lucas-wiggins,2023,USD,699028,428509,270519,330931,-60412,26156,-86568,6990,13980,-100548,18684,514745,25737,489008,,699028,821.06,3542.22,0.1117,2912,20.0,52481.45,0.36,0.387
2628,Parrish Stephens and Doyle,False,EG,Chenmouth,E-commerce,2021,https://parrishstephensanddoyle.com,Feeling reach heavy school anything.,20,parrish-stephens-and-doyle,2023,USD,1151857,466444,685413,553159,132254,38255,93999,11518,23037,70962,210833,806860,309077,497783,,1151857,506.54,279.94,0.0382,954,100.61,17036.96,12.38,0.5951
2629,Shaw West and Jones,False,EG,New Walterville,Cybersecurity,2008,https://shawwestandjones.com,Wide where treat bill throw discover phone family.,15,shaw-west-and-jones,2023,USD,610250,136548,473702,315694,158008,0,158008,6102,12205,145803,20039,346187,23708,322479,,610250,2120.53,6793.68,0.001,2542,20.0,31850.84,0.63,0.7762
2630,Rodriguez White and Davis,False,IN,North Parkermouth,EdTech,2010,https://rodriguezwhiteanddavis.com,Until his child keep born tend despite.,24,rodriguez-white-and-davis,2023,USD,87034,23585,63449,48424,15025,15404,-379,870,1740,-2119,24476,194380,62149,132231,7252.83,87034,221.27,938.45,0.0379,1450,5.0,33842.88,0.72,0.729
2631,Martinez Group,False,US,Fosterburgh,EdTech,2024,https://martinezgroup.com,Great marriage seat once finally evidence also art nor measure.,23,martinez-group,2023,USD,540497,218703,321794,201278,120516,20270,100246,5404,10809,89437,13031,432731,110802,321929,45041.42,540497,155.02,607.07,0.0189,630,71.47,17978.78,0.72,0.5954
2632,Wilson-Mckee,False,BR,North Katherine,E-commerce,2021,https://wilson-mckee.com,Behind interest throw common visit step enter traditional education.,8,wilson-mckee,2023,USD,934857,425925,508932,613696,-104764,35008,-139772,9348,18697,-158469,92812,649992,105069,544923,,934857,20.0,57.77,0.1045,2147,36.27,65662.0,1.41,0.5444
2633,Mosley LLC,False,KE,Port Josephville,E-commerce,2018,https://mosleyllc.com,Continue end why radio matter plan outside social.,25,mosley-llc,2023,USD,391597,115593,276004,236411,39593,0,39593,3915,7831,31762,12867,239382,172949,66433,,391597,20.0,10.0,0.0769,155,209.34,38001.09,0.34,0.7048
2634,Carlson Chandler and Wood,False,EG,Lake Emilyshire,IoT,2024,https://carlsonchandlerandwood.com,Structure use stand newspaper effect.,18,carlson-chandler-and-wood,2023,USD,142883,28279,114604,80326,34278,2335,31943,1428,2857,29086,45019,123573,52267,71306,,142883,702.39,1320.62,0.0754,53,222.74,13675.62,3.29,0.8021
2635,Washington Patterson and Smith,False,NG,Port Amy,Mobility,2022,https://washingtonpattersonandsmith.com,Know order us save fine community.,19,washington-patterson-and-smith,2023,USD,585171,218371,366800,260396,106404,0,106404,5851,11703,94701,17361,419524,254956,164568,,585171,20.0,112.81,0.0933,1196,40.76,6951.92,2.5,0.6268
2636,Santiago-Smith,False,IN,Campbellville,IoT,2012,https://santiago-smith.com,Job suddenly throw about color really couple.,26,santiago-smith,2023,USD,2111362,1075235,1036127,811505,224622,16426,208196,21113,42227,165969,70287,1173363,310253,863110,,2111362,58.12,169.3,0.1785,860,204.5,97367.16,0.72,0.4907
2637,Campbell LLC,False,AU,Matthewland,AgriTech,2013,https://campbellllc.com,Culture stage involve check because mouth voice tell growth authority.,28,campbell-llc,2023,USD,1259606,511582,748024,223380,524644,11884,512760,12596,25192,487568,50178,751089,231906,519183,,1259606,577.36,2443.01,0.0789,5248,20.0,1000.0,50.18,0.5939
2638,Johnston LLC,False,AU,Sarahstad,AgriTech,2015,https://johnstonllc.com,Term fund happy total me article.,16,johnston-llc,2023,USD,214647,44570,170077,126850,43227,10983,32244,2146,4292,27952,13514,306211,113094,193117,,214647,20.0,24.04,0.0639,97,182.72,1000.0,13.51,0.7924
2639,Holland-Fox,False,EG,Lake Alexander,E-commerce,2017,https://holland-fox.com,Likely character could fill realize contain.,29,holland-fox,2023,USD,259017,81384,177633,130617,47016,1159,45857,2590,5180,40677,5372,144566,26569,117997,,259017,1366.66,1890.24,0.0758,62,346.49,1000.0,5.37,0.6858
2640,Lewis Moreno and Garcia,False,AU,East Richard,SaaS,2012,https://lewismorenoandgarcia.com,Later during there by language return.,25,lewis-moreno-and-garcia,2023,USD,1467815,237962,1229853,196104,1033749,3488,1030261,14678,29356,1000905,26137,791074,197218,593856,122317.92,1467815,10.0,44.9,0.0252,878,139.22,6456.06,4.05,0.8379
2641,Carter-Macias,False,CA,Rhondahaven,AgriTech,2022,https://carter-macias.com,Oil suddenly several Mr land relationship.,19,carter-macias,2023,USD,77383,8876,68507,14293,54214,17654,36560,773,1547,35013,8174,50571,28170,22401,,77383,45.45,51.31,0.1736,46,138.83,2075.95,3.94,0.8853
2642,Silva-Hernandez,False,GB,Josephborough,IoT,2013,https://silva-hernandez.com,Cut major PM manager write.,12,silva-hernandez,2023,USD,611792,227228,384564,79690,304874,19318,285556,6117,12235,273321,23676,490317,185306,305011,,611792,20.0,52.76,0.0427,277,183.66,30042.72,0.79,0.6286
2643,Christensen Powell and Wagner,False,ZA,Lake Markfurt,AI/ML,2017,https://christensenpowellandwagner.com,Today position decide cost course however top represent deal.,21,christensen-powell-and-wagner,2023,USD,3486021,1273436,2212585,4461135,-2248550,0,-2248550,34860,69720,-2318270,151941,2093471,500286,1593185,,3486021,1111.74,2156.43,0.1043,14525,20.0,387722.21,0.39,0.6347
2644,Webb PLC,False,GB,West Johnton,HealthTech,2012,https://webbplc.com,Never move country big five win.,26,webb-plc,2023,USD,552007,70295,481712,187416,294296,17408,276888,5520,11040,265848,20281,409163,105403,303760,46000.58,552007,42.87,42.87,0.0475,1339,34.34,28698.63,0.71,0.8727
2645,Davis Smith and Sanders,False,GB,Ambertown,EdTech,2011,https://davissmithandsanders.com,Economic career around budget others may.,19,davis-smith-and-sanders,2023,USD,672467,123879,548588,33623,514965,5186,509779,6724,13449,496330,24216,533635,141334,392301,56038.92,672467,288.81,1546.28,0.0705,792,70.71,1000.0,24.22,0.8158
2646,Rojas Mendez and Marks,False,US,North Daniel,E-commerce,2012,https://rojasmendezandmarks.com,Simple property drive low training growth early.,19,rojas-mendez-and-marks,2023,USD,708606,140557,568049,377837,190212,0,190212,7086,14172,176040,295278,841301,177579,663722,,708606,20.0,33.65,0.0558,744,79.31,51344.06,5.75,0.8016
2647,Dalton PLC,False,EG,North Emilychester,AgriTech,2019,https://daltonplc.com,Matter suffer dog herself.,24,dalton-plc,2023,USD,222483,52304,170179,63272,106907,24152,82755,2224,4449,78306,3938,238710,179324,59386,,222483,20.0,62.58,0.001,89,206.2,21488.49,0.18,0.7649
2648,Roberts Inc,False,GB,South Roberta,EdTech,2009,https://robertsinc.com,Special financial weight need painting certain.,21,roberts-inc,2023,USD,294920,90132,204788,225721,-20933,0,-20933,2949,5898,-26831,136173,316314,73512,242802,24576.67,294920,182.89,729.93,0.0537,672,36.55,35297.26,3.86,0.6944
2649,Garcia-Casey,False,BR,Port Susan,E-commerce,2019,https://garcia-casey.com,Which between society each amount indeed assume morning almost.,21,garcia-casey,2023,USD,3398677,1569280,1829397,2571794,-742397,36921,-779318,33986,67973,-847291,121224,1964471,655853,1308618,,3398677,1243.11,3865.35,0.0317,11640,24.33,227266.83,0.53,0.5383
2650,Delacruz-Richard,False,GB,Leblanctown,E-commerce,2022,https://delacruz-richard.com,Carry past model also your local government test.,14,delacruz-richard,2023,USD,583894,263124,320770,103355,217415,33658,183757,5838,11677,172080,37076,434487,220488,213999,,583894,20.0,21.18,0.0809,379,128.05,1000.0,37.08,0.5494
2651,Schmidt-Barnes,False,NG,Brandonside,HealthTech,2017,https://schmidt-barnes.com,Industry behavior hospital us purpose clearly.,18,schmidt-barnes,2023,USD,690326,316232,374094,223407,150687,21024,129663,6903,13806,115857,53577,472791,23639,449152,57527.17,690326,10.0,48.21,0.0319,1350,42.59,21709.18,2.47,0.5419
2652,Williams-Mckay,False,FR,Duketon,SaaS,2020,https://williams-mckay.com,Rather law type senior official crime act throw choice tree.,18,williams-mckay,2023,EUR,2387824,1311603,1076221,1399788,-323567,0,-323567,23878,47756,-371323,99684,1320128,329471,990657,198985.33,2387824,293.48,1691.29,0.005,5651,35.21,125900.49,0.79,0.4507
2653,Bruce-Stevenson,False,EG,Thompsonton,HealthTech,2022,https://bruce-stevenson.com,Account concern present expect experience stay throughout large model.,33,bruce-stevenson,2023,USD,1200837,279823,921014,382443,538571,14247,524324,12008,24016,500308,52188,820006,416930,403076,100069.75,1200837,10.0,64.44,0.0714,1747,57.27,17874.35,2.92,0.767
2654,Cameron Jensen and Brown,False,CA,South Jeremy,HealthTech,2008,https://cameronjensenandbrown.com,Threat vote check six debate career.,20,cameron-jensen-and-brown,2023,USD,12874285,4567800,8306485,2174814,6131671,8989,6122682,128742,257485,5865197,570498,7145855,1880507,5265348,1072857.08,12874285,321.32,783.91,0.0473,10885,98.56,178844.55,3.19,0.6452
2655,Lambert-Thompson,False,ZA,Jonathanville,AI/ML,2024,https://lambert-thompson.com,Or table eat range suffer fast side.,15,lambert-thompson,2023,USD,705568,333206,372362,565424,-193062,13808,-206870,7055,14111,-220981,27860,497346,119502,377844,,705568,513.32,1477.64,0.0513,487,120.67,78218.92,0.36,0.5277
2656,Carter-Davidson,False,CA,Cobbstad,Marketplaces,2017,https://carter-davidson.com,Environmental national arm sport story off say especially investment hundred.,29,carter-davidson,2023,USD,1070762,459480,611282,735077,-123795,0,-123795,10707,21415,-145210,33111,731371,144304,587067,,1070762,1347.0,5629.03,0.0978,4461,20.0,65346.38,0.51,0.5709
2657,Houston Allen and Kirby,False,EG,Tiffanystad,AgriTech,2012,https://houstonallenandkirby.com,Exactly truth name music.,16,houston-allen-and-kirby,2023,USD,788093,318032,470061,302294,167767,5427,162340,7880,15761,146579,106908,533759,246936,286823,,788093,638.38,2401.37,0.001,394,166.43,8678.17,12.32,0.5965
2658,Williams-Baxter,False,AU,Adkinston,IoT,2022,https://williams-baxter.com,Ok rule break smile believe these soldier she yard religious able.,23,williams-baxter,2023,USD,523495,116838,406657,363374,43283,0,43283,5234,10469,32814,32961,400145,28910,371235,,523495,1403.16,3962.56,0.0663,191,227.91,10507.14,3.14,0.7768
2659,Clark Inc,False,CA,Emilyshire,Cybersecurity,2011,https://clarkinc.com,Enough break bar if before peace customer TV decade.,29,clark-inc,2023,USD,1188092,317743,870349,331318,539031,0,539031,11880,23761,515270,38864,734600,238265,496335,,1188092,439.16,1710.52,0.0721,658,150.29,24016.37,1.62,0.7326
2660,Smith Group,False,ZA,East Lisa,Mobility,2009,https://smithgroup.com,Approach note back hold everybody set human view.,21,smith-group,2023,USD,898972,207936,691036,413920,277116,0,277116,8989,17979,259137,44018,550250,236678,313572,,898972,1188.26,4514.01,0.0614,443,169.07,14342.37,3.07,0.7687
2661,Wilson Inc,False,GB,Brianside,Marketplaces,2011,https://wilsoninc.com,Couple account little reality building soldier.,18,wilson-inc,2023,USD,752857,341489,411368,555547,-144179,21752,-165931,7528,15057,-180988,26074,426792,308071,118721,,752857,20.0,59.82,0.001,430,145.7,34001.43,0.77,0.5464
2662,Stewart-Morse,False,IN,Brandonville,SaaS,2020,https://stewart-morse.com,Program of ahead available to activity success serious four side.,14,stewart-morse,2023,USD,376228,68794,307434,38623,268811,0,268811,3762,7524,261287,52771,439769,125439,314330,31352.33,376228,281.91,281.91,0.0427,280,111.68,30613.05,1.72,0.8171
2663,Little and Sons,False,KE,Cuevasstad,EdTech,2022,https://littleandsons.com,Hard line it gun enough dream war change control up.,19,little-and-sons,2023,USD,338829,123531,215298,162122,53176,17635,35541,3388,6776,28765,14926,343386,204895,138491,28235.75,338829,10.0,75.65,0.0155,453,62.26,1000.0,14.93,0.6354
2664,Logan Bennett and Gamble,False,CA,South Robertchester,Fintech,2018,https://loganbennettandgamble.com,Collection ok whom hand.,16,logan-bennett-and-gamble,2023,USD,1212598,555672,656926,889642,-232716,6143,-238859,12125,24251,-263110,765567,1530330,534154,996176,,1212598,1444.73,5429.59,0.001,5052,20.0,65080.99,11.76,0.5418
2665,Alexander-Roberts,False,US,Bethanystad,IoT,2014,https://alexander-roberts.com,Be front character require tell perhaps peace structure really.,23,alexander-roberts,2023,USD,777065,340807,436258,669837,-233579,37009,-270588,7770,15541,-286129,50579,491091,236605,254486,,777065,46.6,173.95,0.001,415,155.97,72399.48,0.7,0.5614
2666,Mack Martin and Mercer,False,KE,Alisonhaven,AI/ML,2015,https://mackmartinandmercer.com,Reflect such model southern break staff network economic local black tend.,22,mack-martin-and-mercer,2023,USD,346667,60974,285693,151640,134053,0,134053,3466,6933,127120,3078,338829,243370,95459,,346667,428.55,1986.86,0.0167,1444,20.0,1000.0,3.08,0.8241
2667,Davis LLC,False,AU,Lake Jose,AgriTech,2014,https://davisllc.com,Fall south find hair figure indicate.,18,davis-llc,2023,USD,767575,183530,584045,284214,299831,20144,279687,7675,15351,264336,54675,501247,82057,419190,,767575,704.21,2773.71,0.001,1653,38.68,34057.03,1.61,0.7609
2668,Jones Ltd,False,US,South Charles,Fintech,2022,https://jonesltd.com,Time those enough of two radio I fly toward.,22,jones-ltd,2023,USD,1098764,593443,505321,524760,-19439,32946,-52385,10987,21975,-74360,124855,762442,58651,703791,,1098764,190.52,747.9,0.0754,443,206.48,46870.86,2.66,0.4599
2669,Pena-Daniels,False,BR,Yangtown,Marketplaces,2010,https://pena-daniels.com,Effect throughout power some value idea.,19,pena-daniels,2023,USD,815063,295682,519381,158299,361082,30824,330258,8150,16301,313957,3366,553787,166122,387665,,815063,90.2,258.97,0.0076,293,231.18,18537.15,0.18,0.6372
2670,Murray Group,False,NG,East Debraton,Energy,2014,https://murraygroup.com,Billion call degree develop bed.,27,murray-group,2023,USD,211748,89778,121970,141219,-19249,0,-19249,2117,4234,-23483,2932,251332,200206,51126,,211748,1358.24,1793.12,0.0175,226,77.95,45603.25,0.06,0.576
2671,Welch Santos and Gibson,False,EG,East Tamifort,E-commerce,2024,https://welchsantosandgibson.com,Herself western instead activity as as simple practice save first.,13,welch-santos-and-gibson,2023,USD,481365,155922,325443,137014,188429,27487,160942,4813,9627,151315,7182,419550,256554,162996,,481365,352.44,1557.68,0.001,2005,20.0,1000.0,7.18,0.6761
2672,Harrington Ltd,False,US,Lake Patriciamouth,Marketplaces,2019,https://harringtonltd.com,Star chance fact but thank day several common whether religious.,28,harrington-ltd,2023,USD,642340,434467,207873,214638,-6765,28595,-35360,6423,12846,-48206,11543,462178,275467,186711,,642340,20.0,10.0,0.0832,2676,20.0,3031.22,3.81,0.3236
2673,Huff LLC,False,TN,Stewartport,HealthTech,2021,https://huffllc.com,Wall certain travel month camera weight artist international.,20,huff-llc,2023,USD,880366,265631,614735,288577,326158,0,326158,8803,17607,308551,12236,535739,26786,508953,73363.83,880366,147.37,505.39,0.0209,888,82.58,39331.5,0.31,0.6983
2674,Martinez-Jones,False,CA,South Samanthaview,Energy,2019,https://martinez-jones.com,Area million we our girl physical full chance.,18,martinez-jones,2023,USD,1540974,727075,813899,961246,-147347,7250,-154597,15409,30819,-185416,152289,969779,393351,576428,,1540974,20.0,78.4,0.001,679,189.02,59120.73,2.58,0.5282
2675,Calhoun-Henderson,False,US,Dylanfort,AgriTech,2019,https://calhoun-henderson.com,Interesting foot seven do water sell establish.,24,calhoun-henderson,2023,USD,656003,236120,419883,388123,31760,1788,29972,6560,13120,16852,49164,556611,233989,322622,,656003,932.41,4210.88,0.001,486,112.36,56103.32,0.88,0.6401
2676,Smith-Johnson,False,CA,Debbieport,AgriTech,2022,https://smith-johnson.com,Benefit think live yourself president.,22,smith-johnson,2023,USD,669387,132862,536525,347645,188880,0,188880,6693,13387,175493,27946,458063,283772,174291,,669387,20.0,86.99,0.0056,524,106.26,15568.46,1.8,0.8015
2677,May LLC,False,NG,Newtonbury,Fintech,2014,https://mayllc.com,Black raise water myself summer animal low into structure see laugh.,18,may-llc,2023,USD,3841430,1645033,2196397,672237,1524160,35252,1488908,38414,76828,1412080,554994,2612798,1132174,1480624,,3841430,393.04,1033.56,0.001,8557,37.41,32468.54,17.09,0.5718
2678,Brown-Grant,False,ZA,North Joshua,Mobility,2021,https://brown-grant.com,Plant whom police major study drive environment development.,23,brown-grant,2023,USD,327348,95220,232128,183964,48164,0,48164,3273,6546,41618,21767,268264,39632,228632,,327348,633.27,1298.35,0.0435,1363,20.0,14471.2,1.5,0.7091
2679,Gallegos Gates and Harrison,False,AU,Blakefort,Mobility,2017,https://gallegosgatesandharrison.com,Behind interview sign choose week.,20,gallegos-gates-and-harrison,2023,USD,424879,139825,285054,276493,8561,26657,-18096,4248,8497,-26593,4270,296213,19721,276492,,424879,1560.61,4006.65,0.0133,210,168.37,20906.3,0.2,0.6709
2680,Jones Ltd,False,GB,Roblesmouth,Cybersecurity,2021,https://jonesltd.com,Effect about nor listen bar.,18,jones-ltd,2023,USD,2482667,903176,1579491,226999,1352492,22684,1329808,24826,49653,1280155,189377,1525013,944912,580101,,2482667,357.65,1751.39,0.0029,6855,30.18,1000.0,189.38,0.6362
2681,Wilson Murphy and Sanders,False,ZA,Adamstown,Energy,2012,https://wilsonmurphyandsanders.com,Grow north foreign skin visit allow glass TV check attack environment.,24,wilson-murphy-and-sanders,2023,USD,1702196,500529,1201667,1198233,3434,16069,-12635,17021,34043,-46678,39133,987856,308244,679612,,1702196,20.0,67.1,0.0241,582,243.39,88339.05,0.44,0.706
2682,Hernandez Sanders and Williams,False,KE,Lake Natasha,IoT,2010,https://hernandezsandersandwilliams.com,Play commercial baby vote believe others technology along ready rich.,15,hernandez-sanders-and-williams,2023,USD,181310,69749,111561,68250,43311,0,43311,1813,3626,39685,3210,118133,36117,82016,,181310,216.63,578.4,0.0412,78,191.26,36553.25,0.09,0.6153
2683,Calderon Mccormick and Thompson,False,GB,Hunttown,EdTech,2017,https://calderonmccormickandthompson.com,With you seat approach maybe cut several change property brother.,25,calderon-mccormick-and-thompson,2023,USD,203960,79950,124010,119634,4376,26685,-22309,2039,4079,-26388,6944,169640,21579,148061,16996.67,203960,10.0,67.42,0.001,344,49.38,28067.0,0.25,0.608
2684,Cook Taylor and Spencer,False,EG,East John,AI/ML,2018,https://cooktaylorandspencer.com,Control hope marriage get station.,17,cook-taylor-and-spencer,2023,USD,5543624,1415535,4128089,4215035,-86946,7590,-94536,55436,110872,-205408,63137,3022347,432398,2589949,,5543624,20.0,80.19,0.0696,3008,153.54,329262.32,0.19,0.7447
2685,Whitaker Stone and Cooper,False,FR,Martinezburgh,IoT,2020,https://whitakerstoneandcooper.com,Record when end country social market remain country cut.,22,whitaker-stone-and-cooper,2023,EUR,1114483,785286,329197,544206,-215009,16562,-231571,11144,22289,-253860,34613,780401,311581,468820,,1114483,20.0,135.97,0.0763,260,356.41,54679.07,0.63,0.2954
2686,Vasquez Lyons and Roy,False,FR,Port Craig,SaaS,2021,https://vasquezlyonsandroy.com,Reveal activity education alone order to end.,15,vasquez-lyons-and-roy,2023,EUR,1500672,520529,980143,632988,347155,9532,337623,15006,30013,307610,55379,935623,590240,345383,125056.0,1500672,326.3,1249.08,0.0236,7141,17.51,54578.58,1.01,0.6531
2687,Banks-Gibson,False,BR,Douglaston,AgriTech,2021,https://banks-gibson.com,You career where soldier difficult thank political trade.,18,banks-gibson,2023,USD,313138,78568,234570,82213,152357,9871,142486,3131,6262,136224,47036,274936,181519,93417,,313138,20.0,73.6,0.0597,1304,20.0,1000.0,47.04,0.7491
2688,Diaz Norris and Stevenson,False,GB,Snyderbury,AI/ML,2022,https://diaznorrisandstevenson.com,Far situation major least give chance minute phone.,15,diaz-norris-and-stevenson,2023,USD,771363,122502,648861,477431,171430,898,170532,7713,15427,155105,65356,551384,209476,341908,,771363,20.0,88.61,0.135,374,171.81,49267.32,1.33,0.8412
2689,Woodward-Glover,False,ZA,East Brandyland,IoT,2012,https://woodward-glover.com,Fly bill thousand available pretty anything ahead.,27,woodward-glover,2023,USD,1267440,464946,802494,272146,530348,0,530348,12674,25348,505000,44044,869027,83047,785980,,1267440,359.08,1382.61,0.0983,1088,97.07,1000.0,44.04,0.6332
2690,Lopez-Dougherty,False,DE,East Mirandafurt,HealthTech,2020,https://lopez-dougherty.com,Everything moment simply explain rule billion deep state call direction.,19,lopez-dougherty,2023,EUR,161208,59942,101266,113350,-12084,0,-12084,1612,3224,-15308,2624,235506,101349,134157,13434.0,161208,10.0,49.25,0.083,377,35.56,49645.06,0.05,0.6282
2691,Escobar PLC,False,IN,Floydhaven,AI/ML,2023,https://escobarplc.com,Though team listen wait series rest fight once.,22,escobar-plc,2023,USD,363894,130833,233061,124737,108324,0,108324,3638,7277,101047,4074,230123,151464,78659,,363894,666.44,333.22,0.0467,198,152.52,1000.0,4.07,0.6405
2692,Wright Inc,False,US,Annamouth,AgriTech,2017,https://wrightinc.com,Day peace buy wear born staff scientist control heart approach.,24,wright-inc,2023,USD,411553,135116,276437,105969,170468,28997,141471,4115,8231,133240,8604,362957,252476,110481,,411553,20.0,24.13,0.1413,933,36.74,1000.0,8.6,0.6717
2693,Williamson PLC,False,EG,South Carlos,AI/ML,2022,https://williamsonplc.com,Person avoid last myself establish.,12,williamson-plc,2023,USD,475442,214196,261246,348970,-87724,24479,-112203,4754,9508,-121711,8280,367989,165119,202870,,475442,708.3,2039.18,0.0598,998,39.66,5695.7,1.45,0.5495
2694,Stephens Buchanan and Brock,False,DE,East Seanview,SaaS,2008,https://stephensbuchananandbrock.com,Thousand sound myself believe society knowledge provide offer how.,17,stephens-buchanan-and-brock,2023,EUR,577031,110121,466910,215580,251330,0,251330,5770,11540,239790,62276,445528,22464,423064,48085.92,577031,333.36,1438.83,0.0408,669,71.84,16872.59,3.69,0.8092
2695,Kirby-Edwards,False,GB,South Melissatown,AgriTech,2017,https://kirby-edwards.com,Fly discussion green practice.,22,kirby-edwards,2023,USD,81194,19936,61258,60887,371,0,371,811,1623,-1252,8537,178808,127435,51373,,81194,537.92,3106.22,0.0905,47,141.23,1000.0,8.54,0.7545
2696,Stone Dickerson and Stark,False,BR,Lake Davidhaven,Marketplaces,2023,https://stonedickersonandstark.com,Property specific north second military.,29,stone-dickerson-and-stark,2023,USD,1864722,718810,1145912,739769,406143,0,406143,18647,37294,368849,114262,1051652,92510,959142,,1864722,401.02,2336.97,0.0023,7769,20.0,39070.13,2.92,0.6145
2697,Brown-Arias,False,FR,Travisshire,Marketplaces,2017,https://brown-arias.com,Shake which middle save despite audience he show beyond this.,9,brown-arias,2023,EUR,408117,159368,248749,308506,-59757,3269,-63026,4081,8162,-71188,4806,214905,22217,192688,,408117,1225.83,3429.47,0.0713,884,38.43,53724.45,0.09,0.6095
2698,Robinson Inc,False,TN,Ingramfurt,HealthTech,2023,https://robinsoninc.com,Indicate through article three recently defense town bed.,14,robinson-inc,2023,USD,688711,282376,406335,327115,79220,0,79220,6887,13774,65446,28933,424454,143947,280507,57392.58,688711,10.0,28.86,0.0272,1592,36.05,36264.53,0.8,0.59
2699,Mccormick Jones and Jordan,False,ZA,North Veronicashire,Marketplaces,2015,https://mccormickjonesandjordan.com,Front detail organization majority risk subject eight arm.,27,mccormick-jones-and-jordan,2023,USD,586079,296665,289414,293918,-4504,14459,-18963,5860,11721,-30684,39241,490289,125299,364990,,586079,1517.32,2637.46,0.001,154,316.57,45552.72,0.86,0.4938
2700,Vasquez-Jones,False,US,Smithborough,Fintech,2016,https://vasquez-jones.com,Occur present agree best Mrs case anything address world.,16,vasquez-jones,2023,USD,349810,122681,227129,285548,-58419,12498,-70917,3498,6996,-77913,48411,287451,14372,273079,,349810,1551.66,1118.19,0.001,114,255.03,44600.12,1.09,0.6493
2701,Holmes-Williams,False,EG,Port Colin,Fintech,2019,https://holmes-williams.com,Stock large realize camera it establish.,18,holmes-williams,2023,USD,973537,405799,567738,189419,378319,0,378319,9735,19470,358849,34601,585399,88260,497139,,973537,2533.84,4407.18,0.0304,991,81.81,7694.3,4.5,0.5832
2702,Sanchez-Ward,False,KE,Brucechester,Mobility,2021,https://sanchez-ward.com,Strong offer paper friend through his trip kid.,26,sanchez-ward,2023,USD,944035,217267,726768,455005,271763,0,271763,9440,18880,252883,50254,556032,154224,401808,,944035,20.0,22.87,0.001,1093,71.96,59962.43,0.84,0.7699
2703,Wilson Johnson and Cole,False,IN,Lake Jessica,Marketplaces,2023,https://wilsonjohnsonandcole.com,Generation nature product painting suggest finish wish fly turn Mr nothing.,16,wilson-johnson-and-cole,2023,USD,254420,47542,206878,54448,152430,9867,142563,2544,5088,137475,224883,353246,92537,260709,,254420,1269.31,634.66,0.0483,130,162.56,15738.4,14.29,0.8131
2704,Ryan-Owen,False,ZA,Joshuachester,Fintech,2019,https://ryan-owen.com,Week land you recent much bag role enjoy.,21,ryan-owen,2023,USD,1775905,519123,1256782,888571,368211,36077,332134,17759,35518,296616,87986,1055564,365133,690431,,1775905,20.0,67.85,0.0934,7399,20.0,85920.97,1.02,0.7077
2705,Johnson LLC,False,NG,Brianstad,Cybersecurity,2008,https://johnsonllc.com,Wind TV type program information.,29,johnson-llc,2023,USD,9296200,3574762,5721438,4549151,1172287,15892,1156395,92962,185924,970471,984313,5825107,482452,5342655,,9296200,2152.9,7708.48,0.0742,38734,20.0,409190.27,2.41,0.6155
2706,Smith-Cobb,False,IN,North Jessicafort,HealthTech,2009,https://smith-cobb.com,Over others drug under agency difference election physical.,19,smith-cobb,2023,USD,119327,24081,95246,71122,24124,0,24124,1193,2386,21738,3957,154469,56538,97931,9943.92,119327,16.61,16.61,0.0207,112,88.68,13872.55,0.29,0.7982
2707,Marks-Bailey,False,GB,South Crystaltown,E-commerce,2022,https://marks-bailey.com,Authority effort size well grow mind accept any American family.,17,marks-bailey,2023,USD,1465987,712790,753197,935025,-181828,0,-181828,14659,29319,-211147,37015,829351,362426,466925,,1465987,878.91,813.34,0.0449,6108,20.0,57569.08,0.64,0.5138
2708,Carter Group,False,ZA,Melindaview,HealthTech,2019,https://cartergroup.com,Left more decision rule movement key color image example time ok.,20,carter-group,2023,USD,427293,74533,352760,111056,241704,22022,219682,4272,8545,211137,60980,364233,222842,141391,35607.75,427293,72.35,259.27,0.0225,5752,6.19,43826.95,1.39,0.8256
2709,Heath Group,False,GB,Taylormouth,SaaS,2016,https://heathgroup.com,Art whom morning recent own school become medical color.,20,heath-group,2023,USD,2193133,834027,1359106,2162396,-803290,31339,-834629,21931,43862,-878491,54031,1209049,371318,837731,182761.08,2193133,353.57,1362.55,0.047,1841,99.27,193956.65,0.28,0.6197
2710,Sparks Group,False,CA,Gregorystad,Energy,2019,https://sparksgroup.com,News brother not own final.,25,sparks-group,2023,USD,1031206,417213,613993,398920,215073,10933,204140,10312,20624,183516,205406,754751,408078,346673,,1031206,741.56,3005.51,0.06,4296,20.0,53819.29,3.82,0.5954
2711,Morgan Inc,False,US,Parrishland,AgriTech,2017,https://morganinc.com,Either place raise loss sound task wife product there.,21,morgan-inc,2023,USD,133702,57400,76302,121070,-44768,777,-45545,1337,2674,-48219,4866,201199,102368,98831,,133702,20.0,66.88,0.0741,557,20.0,31780.76,0.15,0.5707
2712,Garrett Ltd,False,NG,Port Mackenzie,Marketplaces,2010,https://garrettltd.com,Business learn line class film heart including.,18,garrett-ltd,2023,USD,1413444,622423,791021,453295,337726,0,337726,14134,28268,309458,123465,998436,304130,694306,,1413444,327.35,522.5,0.0834,5889,20.0,41004.69,3.01,0.5596
2713,Knapp-Ramirez,False,NG,Campbellhaven,EdTech,2013,https://knapp-ramirez.com,Total conference raise base professor direction meet significant term task.,16,knapp-ramirez,2023,USD,466878,161206,305672,171290,134382,2612,131770,4668,9337,122433,35238,299190,14959,284231,38906.5,466878,300.03,653.8,0.0533,350,111.1,30868.93,1.14,0.6547
2714,Shields Ltd,False,AU,West Shelly,Fintech,2013,https://shieldsltd.com,Should value other report sit leader response.,23,shields-ltd,2023,USD,851414,384975,466439,239725,226714,0,226714,8514,17028,209686,7832,538631,178157,360474,,851414,1122.86,3407.73,0.1576,326,217.2,15781.68,0.5,0.5478
2715,Davis Villarreal and Sexton,False,NG,Teresashire,E-commerce,2018,https://davisvillarrealandsexton.com,After above produce his surface tell effort.,16,davis-villarreal-and-sexton,2023,USD,2523759,712957,1810802,350364,1460438,1011,1459427,25237,50475,1408952,23494,1339201,554699,784502,,2523759,20.0,10.0,0.1372,1128,186.36,32570.15,0.72,0.7175
2716,Young-Waller,False,BR,Lake Kaitlyn,AgriTech,2016,https://young-waller.com,Scientist song management adult whatever sell long program purpose local.,22,young-waller,2023,USD,416155,161664,254491,228785,25706,0,25706,4161,8323,17383,7437,265596,184417,81179,,416155,20.0,75.05,0.0378,1733,20.0,2074.73,3.58,0.6115
2717,Nash-Harrison,False,BR,South Amanda,Cybersecurity,2019,https://nash-harrison.com,Eat task go none talk lawyer interest suggest.,20,nash-harrison,2023,USD,214484,54916,159568,27226,132342,0,132342,2144,4289,128053,32958,189926,76214,113712,,214484,1329.59,5451.08,0.0022,168,105.9,1000.0,32.96,0.744
2718,Griffin Alexander and Roman,False,FR,Colemanfurt,AI/ML,2019,https://griffinalexanderandroman.com,Realize bank build couple half.,13,griffin-alexander-and-roman,2023,EUR,401365,169121,232244,164873,67371,9953,57418,4013,8027,49391,6241,392918,220372,172546,,401365,1161.79,1662.09,0.058,235,141.94,36826.41,0.17,0.5786
2719,Roberson-Martinez,False,GB,North Shane,SaaS,2012,https://roberson-martinez.com,Many up administration soldier inside tax five bring pick suffer.,19,roberson-martinez,2023,USD,1634161,384794,1249367,1014966,234401,23240,211161,16341,32683,178478,128400,1061516,355084,706432,136180.08,1634161,46.33,166.21,0.0525,27236,5.0,70965.24,1.81,0.7645
2720,Gross-Lewis,False,NG,Washingtonport,AgriTech,2019,https://gross-lewis.com,Size local loss station book alone source.,23,gross-lewis,2023,USD,3171923,358818,2813105,1329274,1483831,12344,1471487,31719,63438,1408049,51768,1734316,846138,888178,,3171923,20.0,78.07,0.1778,1220,216.62,93704.41,0.55,0.8869
2721,Duffy-Brown,False,AU,Wendytown,Mobility,2021,https://duffy-brown.com,Growth while eight example policy.,16,duffy-brown,2023,USD,390597,125071,265526,172775,92751,1620,91131,3905,7811,83320,18172,279683,221043,58640,,390597,20.0,92.84,0.0833,277,117.15,58221.81,0.31,0.6798
2722,Holt Humphrey and Flores,False,CA,Davidfurt,HealthTech,2011,https://holthumphreyandflores.com,Describe election trade value near ground run remember pressure hospital street.,27,holt-humphrey-and-flores,2023,USD,1038986,351539,687447,227661,459786,0,459786,10389,20779,439007,43194,666090,197363,468727,86582.17,1038986,50.79,50.79,0.039,1763,49.11,34288.46,1.26,0.6617
2723,Ortiz Allen and Morgan,False,DE,Teresatown,HealthTech,2024,https://ortizallenandmorgan.com,Ago north game democratic act last like safe.,18,ortiz-allen-and-morgan,2023,EUR,478218,219352,258866,43249,215617,18917,196700,4782,9564,187136,15316,432399,149715,282684,39851.5,478218,364.76,2019.39,0.0456,300,132.46,10638.56,1.44,0.5413
2724,Rice Ltd,False,DE,South Paul,EdTech,2024,https://riceltd.com,Public thing marriage water new yard success tell.,17,rice-ltd,2023,EUR,274333,117758,156575,93798,62777,30905,31872,2743,5486,26386,74670,393033,99467,293566,22861.08,274333,672.12,2009.59,0.089,335,68.05,14877.62,5.02,0.5707
2725,Keith Haas and Montoya,False,NG,East Robertchester,Cybersecurity,2011,https://keithhaasandmontoya.com,Music small cost let race fill must political show while sound.,17,keith-haas-and-montoya,2023,USD,579751,122592,457159,367517,89642,0,89642,5797,11595,78047,22079,421993,161374,260619,,579751,449.41,1020.2,0.0606,2415,20.0,24201.66,0.91,0.7885
2726,Gonzalez-Ward,False,TN,South Carriefurt,Mobility,2010,https://gonzalez-ward.com,It difference many sit race.,29,gonzalez-ward,2023,USD,766363,380783,385580,280299,105281,15909,89372,7663,15327,74045,232652,752199,89457,662742,,766363,20.0,40.28,0.0469,3193,20.0,27998.83,8.31,0.5031
2727,Taylor-Henry,False,FR,Chaneyshire,HealthTech,2008,https://taylor-henry.com,Only hope war into four.,9,taylor-henry,2023,EUR,1508562,483763,1024799,953840,70959,0,70959,15085,30171,40788,250907,1197414,505117,692297,125713.5,1508562,10.0,10.0,0.0566,2668,47.11,96973.91,2.59,0.6793
2728,Ruiz Thompson and Lawson,False,EG,Barryfurt,E-commerce,2017,https://ruizthompsonandlawson.com,Available interview live artist person center apply prove again as.,21,ruiz-thompson-and-lawson,2023,USD,718078,280445,437633,685316,-247683,0,-247683,7180,14361,-262044,34248,551846,303989,247857,,718078,20.0,137.19,0.0414,354,168.65,77896.19,0.44,0.6095
2729,Webster Ltd,False,ZA,Malloryshire,E-commerce,2012,https://websterltd.com,Center water lose discuss.,19,webster-ltd,2023,USD,828395,359321,469074,314783,154291,59743,94548,8283,16567,77981,54107,613134,290557,322577,,828395,132.07,457.2,0.0963,829,83.26,31556.13,1.71,0.5662
2730,Andrews-Moran,False,EG,Cindyville,IoT,2024,https://andrews-moran.com,About recent pull police traditional party brother reason occur feel.,24,andrews-moran,2023,USD,534428,204313,330115,292277,37838,17932,19906,5344,10688,9218,5163,276700,128920,147780,,534428,889.67,6761.78,0.0484,2226,20.0,26031.56,0.2,0.6177
2731,Williams-Jones,False,AU,New Ericmouth,E-commerce,2013,https://williams-jones.com,Town enjoy trip opportunity benefit bank certain special step none.,12,williams-jones,2023,USD,315330,122076,193254,97345,95909,0,95909,3153,6306,89603,7560,317377,139963,177414,,315330,1708.55,4688.8,0.0637,333,78.86,1000.0,7.56,0.6129
2732,Jarvis Haney and Morrison,False,ZA,Riggschester,AgriTech,2008,https://jarvishaneyandmorrison.com,Effect describe water face country put return ground technology second.,17,jarvis-haney-and-morrison,2023,USD,788889,211057,577832,543932,33900,483,33417,7888,15777,17640,20309,610841,249886,360955,,788889,1276.78,5435.06,0.001,3287,20.0,40111.65,0.51,0.7325
2733,Tanner-Moreno,False,ZA,Paulfort,Fintech,2015,https://tanner-moreno.com,Drop physical picture foot same act wonder conference large.,28,tanner-moreno,2023,USD,184743,84622,100121,177690,-77569,0,-77569,1847,3694,-81263,2400,158426,60750,97676,,184743,389.81,2383.79,0.0022,769,20.0,33095.93,0.07,0.5419
2734,Sutton Inc,False,GB,Johnstonland,Cybersecurity,2012,https://suttoninc.com,Citizen another success good citizen kitchen paper everyone.,19,sutton-inc,2023,USD,3577125,1353569,2223556,2977257,-753701,23993,-777694,35771,71542,-849236,182653,2056546,615089,1441457,,3577125,20.0,51.18,0.0869,2055,145.03,257801.52,0.71,0.6216
2735,Schultz Lowe and Warner,False,ZA,Lake Steven,EdTech,2017,https://schultzloweandwarner.com,West responsibility several maintain those safe they money.,19,schultz-lowe-and-warner,2023,USD,235633,88686,146947,51984,94963,0,94963,2356,4712,90251,849,123939,95090,28849,19636.08,235633,10.0,10.0,0.0276,249,78.68,42194.25,0.02,0.6236
2736,Valencia-Miller,False,GB,Port Alisha,EdTech,2012,https://valencia-miller.com,Kind media lose marriage Mrs try base far kitchen.,16,valencia-miller,2023,USD,726411,293325,433086,128224,304862,4676,300186,7264,14528,285658,27944,572401,244479,327922,60534.25,726411,362.44,1826.52,0.0229,1039,58.22,5834.55,4.79,0.5962
2737,Wiggins Mueller and Carlson,False,FR,Edwardsport,Energy,2011,https://wigginsmuellerandcarlson.com,Season magazine avoid message cell.,17,wiggins-mueller-and-carlson,2023,EUR,1425244,532533,892711,894621,-1910,17177,-19087,14252,28504,-47591,338134,1102503,171397,931106,,1425244,20.0,97.49,0.0419,1277,93.0,79850.4,4.23,0.6264
2738,Smith-Jones,False,FR,South Lindashire,SaaS,2023,https://smith-jones.com,Care simply evidence skill eat.,19,smith-jones,2023,EUR,10238991,1711821,8527170,7449562,1077608,0,1077608,102389,204779,872829,335807,5641174,2716282,2924892,853249.25,10238991,502.68,2353.43,0.022,14452,59.04,613818.73,0.55,0.8328
2739,Mcneil and Sons,False,AU,Diazhaven,Energy,2009,https://mcneilandsons.com,Fact how song fish bad.,16,mcneil-and-sons,2023,USD,955087,82806,872281,530393,341888,17901,323987,9550,19101,304886,22126,661186,86808,574378,,955087,1858.46,933.86,0.001,2208,36.04,79059.94,0.28,0.9133
2740,Wood Inc,False,DE,North Nicolemouth,Fintech,2009,https://woodinc.com,Few how successful west before despite arm animal recently assume.,18,wood-inc,2023,EUR,558536,130254,428282,376909,51373,0,51373,5585,11170,40203,8499,319036,140672,178364,,558536,258.66,598.94,0.001,317,146.43,33124.5,0.26,0.7668
2741,Steele Hill and Lee,False,AU,Wardtown,Marketplaces,2024,https://steelehillandlee.com,Your according want relationship record young wish defense defense.,24,steele-hill-and-lee,2023,USD,1089245,543455,545790,229949,315841,0,315841,10892,21784,294057,30677,767460,155703,611757,,1089245,626.93,1697.7,0.1109,1034,87.77,52493.04,0.58,0.5011
2742,Castillo Schultz and Williams,False,KE,North Donnaport,SaaS,2023,https://castilloschultzandwilliams.com,Commercial choose still woman pattern citizen ten we quality end.,12,castillo-schultz-and-williams,2023,USD,2076223,594115,1482108,1065092,417016,0,417016,20762,41524,375492,26816,1209865,521892,687973,173018.58,2076223,10.0,10.14,0.0562,2463,70.23,97679.01,0.27,0.7138
2743,Perry and Sons,False,FR,Cookshire,AgriTech,2009,https://perryandsons.com,Unit apply trip finish be wear economic my among.,20,perry-and-sons,2023,EUR,1108846,474437,634409,881320,-246911,0,-246911,11088,22176,-269087,30043,746075,532689,213386,,1108846,1964.42,3552.99,0.0157,484,190.69,36360.6,0.83,0.5721
2744,Poole-Miller,False,FR,Port Antonioport,AgriTech,2008,https://poole-miller.com,Apply thus second two remain occur foreign whom.,25,poole-miller,2023,EUR,544174,132518,411656,366197,45459,0,45459,5441,10883,34576,152855,553242,159397,393845,,544174,944.34,4227.65,0.0797,2267,20.0,32345.72,4.73,0.7565
2745,Russell Rivas and Hernandez,False,AU,Burkeborough,Fintech,2011,https://russellrivasandhernandez.com,Someone wonder manager machine join anyone force.,25,russell-rivas-and-hernandez,2023,USD,1835345,704539,1130806,154199,976607,0,976607,18353,36706,939901,938206,1916824,988226,928598,,1835345,20.0,10.0,0.0369,1918,79.74,1000.0,938.21,0.6161
2746,Kirby Cook and Hernandez,False,KE,Bellview,EdTech,2014,https://kirbycookandhernandez.com,Conference husband end arm opportunity enjoy.,18,kirby-cook-and-hernandez,2023,USD,1120740,625623,495117,793105,-297988,11926,-309914,11207,22414,-332328,69904,687165,80764,606401,93395.0,1120740,115.2,321.76,0.1032,1108,84.28,67583.78,1.03,0.4418
2747,Schwartz Perry and Rodriguez,False,GB,Morganview,Marketplaces,2019,https://schwartzperryandrodriguez.com,School city since body break.,17,schwartz-perry-and-rodriguez,2023,USD,800127,293655,506472,453454,53018,0,53018,8001,16002,37016,13107,561227,175379,385848,,800127,1485.71,6795.06,0.001,3333,20.0,35669.18,0.37,0.633
2748,Grant Kramer and Reyes,False,US,Tamaratown,Fintech,2012,https://grantkramerandreyes.com,Nothing provide television government majority.,22,grant-kramer-and-reyes,2023,USD,4488564,1509450,2979114,1284673,1694441,0,1694441,44885,89771,1604670,229797,2543816,1336383,1207433,,4488564,1274.63,2742.83,0.0488,3117,119.98,91635.22,2.51,0.6637
2749,Jackson Vasquez and Kelley,False,ZA,Paigeview,AgriTech,2019,https://jacksonvasquezandkelley.com,Safe before federal worker second person under.,16,jackson-vasquez-and-kelley,2023,USD,161097,60077,101020,106713,-5693,0,-5693,1610,3221,-8914,14808,96613,56486,40127,,161097,20.0,89.49,0.0937,127,105.01,22235.38,0.67,0.6271
2750,Goodman Group,False,CA,New Amberstad,HealthTech,2024,https://goodmangroup.com,Ask standard dinner protect price.,13,goodman-group,2023,USD,532090,157588,374502,320996,53506,9312,44194,5320,10641,33553,11932,462289,147064,315225,44340.83,532090,318.88,994.76,0.0717,401,110.48,2621.77,4.55,0.7038
2751,Jenkins LLC,False,AU,Williamsberg,Cybersecurity,2015,https://jenkinsllc.com,Artist rise professor bring change trade accept.,17,jenkins-llc,2023,USD,4568016,1716203,2851813,1815014,1036799,29784,1007015,45680,91360,915655,127898,2418858,630379,1788479,,4568016,1080.39,3423.38,0.0203,16157,23.56,128289.38,1.0,0.6243
2752,Keller-Miller,False,NG,North Rubenland,IoT,2010,https://keller-miller.com,Detail growth line public difficult security skill.,20,keller-miller,2023,USD,1278692,433494,845198,1391605,-546407,21776,-568183,12786,25573,-593756,192606,888609,444039,444570,,1278692,20.0,128.19,0.0278,5327,20.0,119910.24,1.61,0.661
2753,Jenkins-Garcia,False,FR,West Johnmouth,IoT,2008,https://jenkins-garcia.com,Follow ahead management add reach.,21,jenkins-garcia,2023,EUR,1599613,739520,860093,1251935,-391842,8471,-400313,15996,31992,-432305,53478,981545,85095,896450,,1599613,805.88,402.94,0.001,592,224.87,77374.2,0.69,0.5377
2754,Bailey-Nixon,False,NG,North Rachelfort,EdTech,2014,https://bailey-nixon.com,Economy medical wind guy join morning into low sometimes item.,22,bailey-nixon,2023,USD,1764686,391622,1373064,276232,1096832,22599,1074233,17646,35293,1038940,222631,1146736,303564,843172,147057.17,1764686,101.51,724.57,0.0218,1435,102.46,1000.0,222.63,0.7781
2755,Anderson-Davis,False,IN,Port Maria,HealthTech,2008,https://anderson-davis.com,Service federal ten else action play somebody book citizen weight.,20,anderson-davis,2023,USD,382081,106748,275333,161127,114206,9994,104212,3820,7641,96571,7087,363610,220219,143391,31840.08,382081,543.01,2098.33,0.025,447,71.23,1000.0,7.09,0.7206
2756,Cox Washington and Walker,False,ZA,Mckaymouth,Fintech,2014,https://coxwashingtonandwalker.com,Size approach model office color side generation.,15,cox-washington-and-walker,2023,USD,1251768,257580,994188,392013,602175,22550,579625,12517,25035,554590,173722,838392,504140,334252,,1251768,350.68,1137.39,0.0259,2145,48.63,48242.54,3.6,0.7942
2757,Stokes Morton and Watts,False,NG,Garzaside,Cybersecurity,2023,https://stokesmortonandwatts.com,Ahead computer similar garden if can mother increase sea teacher.,24,stokes-morton-and-watts,2023,USD,1953672,402794,1550878,804634,746244,36623,709621,19536,39073,670548,55268,1147887,742867,405020,,1953672,801.07,400.54,0.0382,1137,143.15,57335.31,0.96,0.7938
2758,Johnson Howard and Colon,False,CA,Port Chadfurt,Cybersecurity,2013,https://johnsonhowardandcolon.com,Response same huge drive artist top.,26,johnson-howard-and-colon,2023,USD,3812345,1605261,2207084,1541066,666018,9473,656545,38123,76246,580299,35277,2024102,101205,1922897,,3812345,1085.92,3944.17,0.0944,985,322.48,79255.38,0.45,0.5789
2759,Montgomery-Dyer,False,EG,West Davidmouth,Marketplaces,2011,https://montgomery-dyer.com,Send itself including work image source girl teacher.,21,montgomery-dyer,2023,USD,786625,214856,571769,387200,184569,0,184569,7866,15732,168837,190492,724610,188918,535692,,786625,1465.02,8691.51,0.0057,1743,37.6,66588.17,2.86,0.7269
2760,Lee Chase and Brown,False,GB,Johnfurt,E-commerce,2020,https://leechaseandbrown.com,Major unit speak peace concern their growth source yes trial.,22,lee-chase-and-brown,2023,USD,830218,274348,555870,427963,127907,19469,108438,8302,16604,91834,201594,791631,221804,569827,,830218,1104.76,3543.72,0.002,2446,28.28,23077.83,8.74,0.6695
2761,Mendez-Smith,False,TN,Hansenmouth,EdTech,2024,https://mendez-smith.com,State town television marriage best style.,20,mendez-smith,2023,USD,1471338,567213,904125,699953,204172,0,204172,14713,29426,174746,289149,1136453,408234,728219,122611.5,1471338,423.35,902.82,0.0235,2692,45.54,56919.67,5.08,0.6145
2762,Fields LLC,False,DE,Port Brianton,Energy,2011,https://fieldsllc.com,Join follow fall expert.,23,fields-llc,2023,EUR,4045728,865232,3180496,1532246,1648250,12867,1635383,40457,80914,1554469,228780,2303805,1016351,1287454,,4045728,587.7,1475.48,0.001,3355,100.49,99728.06,2.29,0.7861
2763,York PLC,False,AU,North Katherine,E-commerce,2011,https://yorkplc.com,Issue different speech student research ability move.,17,york-plc,2023,USD,1149758,397963,751795,385830,365965,0,365965,11497,22995,342970,28675,717106,84714,632392,,1149758,1011.8,1413.26,0.0478,948,101.01,24278.9,1.18,0.6539
2764,Phelps Fuller and Clay,False,EG,Hillbury,Fintech,2024,https://phelpsfullerandclay.com,Health someone expect level particular anything store fire never.,23,phelps-fuller-and-clay,2023,USD,874564,356943,517621,83352,434269,750,433519,8745,17491,416028,35179,593542,331809,261733,,874564,230.56,966.76,0.0761,212,343.08,1000.0,35.18,0.5919
2765,Brown Group,False,GB,East Tracyhaven,Mobility,2019,https://browngroup.com,Age support international happy young above want answer TV somebody.,14,brown-group,2023,USD,977355,152509,824846,247742,577104,0,577104,9773,19547,557557,222485,811570,391988,419582,,977355,899.25,1350.39,0.0638,4072,20.0,35603.3,6.25,0.844
2766,Jacobson PLC,False,ZA,Ruthmouth,AgriTech,2009,https://jacobsonplc.com,Lot total meet a executive machine agency.,25,jacobson-plc,2023,USD,860910,336702,524208,661198,-136990,20671,-157661,8609,17218,-174879,158475,599276,329812,269464,,860910,20.0,10.88,0.001,3587,20.0,58125.48,2.73,0.6089
2767,Dixon PLC,False,FR,Kristenmouth,E-commerce,2023,https://dixonplc.com,General difference actually really while guess.,28,dixon-plc,2023,EUR,680426,216868,463558,325330,138228,27517,110711,6804,13608,97103,5126,527499,157571,369928,,680426,1298.89,2803.55,0.121,2835,20.0,1000.0,5.13,0.6813
2768,Kirby-Villanueva,False,FR,East Markview,Energy,2017,https://kirby-villanueva.com,Ball song need listen set simple add guess decade.,19,kirby-villanueva,2023,EUR,1400507,409881,990626,782736,207890,0,207890,14005,28010,179880,367116,1104920,278469,826451,,1400507,2250.01,9720.77,0.0406,771,151.36,70339.29,5.22,0.7073
2769,Reese Martinez and Schmidt,False,EG,Christophertown,IoT,2017,https://reesemartinezandschmidt.com,Security start big against require station manage place.,13,reese-martinez-and-schmidt,2023,USD,449921,147547,302374,189897,112477,14505,97972,4499,8998,88974,55708,360906,278562,82344,,449921,499.28,1474.08,0.0811,623,60.14,10101.48,5.51,0.6721
2770,Madden Ltd,False,BR,Carloschester,Mobility,2015,https://maddenltd.com,Page study democratic sign list record certainly similar no throw.,26,madden-ltd,2023,USD,337094,86032,251062,138170,112892,0,112892,3370,6741,106151,16244,256910,63579,193331,,337094,255.7,382.86,0.1993,153,182.99,4782.31,3.4,0.7448
2771,Baker Perez and Owens,False,NG,North Ashley,Energy,2017,https://bakerperezandowens.com,Purpose condition data any without happen.,14,baker-perez-and-owens,2023,USD,345153,130942,214211,158386,55825,0,55825,3451,6903,48922,61358,394443,187340,207103,,345153,20.0,49.01,0.0246,161,178.25,47688.71,1.29,0.6206
2772,Jenkins Inc,False,TN,Millerport,EdTech,2010,https://jenkinsinc.com,Data day suddenly past carry fine.,22,jenkins-inc,2023,USD,911301,357460,553841,333545,220296,0,220296,9113,18226,202070,22637,584550,361366,223184,75941.75,911301,10.0,51.92,0.022,1583,47.97,64522.64,0.35,0.6077
2773,Bradley Group,False,AU,Laneborough,Mobility,2019,https://bradleygroup.com,Father whose glass really base fill school fire why.,21,bradley-group,2023,USD,74956,24192,50764,57514,-6750,21813,-28563,749,1499,-30062,3975,163617,53848,109769,,74956,20.0,41.32,0.0664,62,99.56,13619.92,0.29,0.6773
2774,Watson-Fisher,False,GB,West Anthonyside,SaaS,2023,https://watson-fisher.com,Floor board family red smile upon blue language nearly look.,23,watson-fisher,2023,USD,7167583,1768602,5398981,4100932,1298049,8557,1289492,71675,143351,1146141,315994,4025941,881184,3144757,597298.58,7167583,97.76,288.41,0.0237,119459,5.0,365623.37,0.86,0.7532
2775,Norman-Allen,False,BR,East Jamesview,Fintech,2020,https://norman-allen.com,Special decision spend reality modern serve.,22,norman-allen,2023,USD,1764735,724380,1040355,1101003,-60648,0,-60648,17647,35294,-95942,161549,1088609,378802,709807,,1764735,719.37,2151.62,0.001,2122,69.3,101420.26,1.59,0.5895
2776,Stanley Group,False,EG,Port Dustintown,AI/ML,2010,https://stanleygroup.com,Risk probably many else agency financial simple national itself here middle.,18,stanley-group,2023,USD,512400,296109,216291,154233,62058,14423,47635,5124,10248,37387,12563,294994,72147,222847,,512400,507.62,2410.27,0.0109,2135,20.0,1000.0,12.56,0.4221
2777,Williams-Porter,False,FR,South Brad,HealthTech,2020,https://williams-porter.com,Less live media industry interview including.,20,williams-porter,2023,EUR,584473,211478,372995,564249,-191254,27994,-219248,5844,11689,-230937,163830,550199,273534,276665,48706.08,584473,17.09,61.12,0.025,725,67.12,68027.01,2.41,0.6382
2778,Kelly Group,False,TN,New Brian,Cybersecurity,2011,https://kellygroup.com,Simple wish chair couple take nor ahead participant year my.,12,kelly-group,2023,USD,737736,96102,641634,292634,349000,23730,325270,7377,14754,310516,120873,560344,260673,299671,,737736,453.1,889.19,0.001,3073,20.0,53107.35,2.28,0.8697
2779,Marshall-Williams,False,ZA,Coxhaven,HealthTech,2010,https://marshall-williams.com,Catch about medical personal somebody stop increase could.,22,marshall-williams,2023,USD,15644478,3689056,11955422,4812448,7142974,43797,7099177,156444,312889,6786288,332278,8181698,1667657,6514041,1303706.5,15644478,10.0,26.2,0.0235,260741,5.0,379086.39,0.88,0.7642
2780,Rose-Galloway,False,CA,New Deborah,EdTech,2018,https://rose-galloway.com,These name off action her.,24,rose-galloway,2023,USD,600611,210008,390603,124165,266438,32765,233673,6006,12012,221661,123957,445943,271776,174167,50050.92,600611,128.8,167.97,0.0515,1655,30.23,9748.94,12.71,0.6503
2781,Castaneda-Gordon,False,DE,East Tomton,IoT,2020,https://castaneda-gordon.com,Risk clear commercial public help me age.,17,castaneda-gordon,2023,EUR,1560205,696638,863567,1112648,-249081,26291,-275372,15602,31204,-306576,52992,912030,316752,595278,,1560205,218.76,529.59,0.0571,1525,85.23,102892.99,0.52,0.5535
2782,Parsons Byrd and Carlson,False,FR,Lake Justin,EdTech,2021,https://parsonsbyrdandcarlson.com,Participant lead page across but newspaper most enough right pay trial.,15,parsons-byrd-and-carlson,2023,EUR,1404928,515503,889425,478386,411039,0,411039,14049,28098,382941,234186,1097345,501232,596113,117077.33,1404928,110.42,297.13,0.0379,11444,10.23,47635.26,4.92,0.6331
2783,Dyer-Green,False,ZA,Pierceton,Mobility,2016,https://dyer-green.com,Today move court indicate somebody much truth.,22,dyer-green,2023,USD,264728,162288,102440,85277,17163,25985,-8822,2647,5294,-14116,16185,332814,132579,200235,,264728,449.56,1722.65,0.0086,86,255.62,14345.8,1.13,0.387
2784,Moon-Walters,False,AU,Brownville,Cybersecurity,2016,https://moon-walters.com,Audience yet reach institution institution road.,20,moon-walters,2023,USD,951198,253387,697811,488850,208961,450,208511,9511,19023,189488,60375,618557,63365,555192,,951198,20.0,92.17,0.0957,338,233.97,49844.07,1.21,0.7336
2785,Brown-Weeks,False,AU,Reidport,Marketplaces,2020,https://brown-weeks.com,Policy most right across reflect knowledge common.,15,brown-weeks,2023,USD,207810,56306,151504,179382,-27878,32495,-60373,2078,4156,-64529,10784,311374,189587,121787,,207810,318.82,159.41,0.0702,865,20.0,26113.5,0.41,0.7291
2786,Parsons Mccarthy and Randall,False,CA,Rodriguezchester,Mobility,2020,https://parsonsmccarthyandrandall.com,Month age year bag skill floor music PM dog safe.,15,parsons-mccarthy-and-randall,2023,USD,156262,50265,105997,7813,98184,12716,85468,1562,3125,82343,45668,232418,62326,170092,,156262,626.21,3399.12,0.0233,203,64.11,1000.0,45.67,0.6783
2787,Klein LLC,False,EG,North Mary,AI/ML,2016,https://kleinllc.com,Hold case lose own whole edge cultural book.,20,klein-llc,2023,USD,632894,311802,321092,432534,-111442,14845,-126287,6328,12657,-138944,19639,397748,192297,205451,,632894,20.0,144.5,0.099,2637,20.0,38428.7,0.51,0.5073
2788,Moore Perez and Aguirre,False,GB,Debrafort,Mobility,2011,https://mooreperezandaguirre.com,Itself allow final add treat minute resource husband.,15,moore-perez-and-aguirre,2023,USD,3493503,850103,2643400,1953891,689509,5422,684087,34935,69870,614217,137748,2030645,442045,1588600,,3493503,20.0,71.13,0.071,1398,208.18,175482.71,0.78,0.7567
2789,Gallagher LLC,False,FR,Colechester,AgriTech,2023,https://gallagherllc.com,Catch outside recently memory first into piece firm.,18,gallagher-llc,2023,EUR,518475,220226,298249,92497,205752,10212,195540,5184,10369,185171,17040,414726,261440,153286,,518475,1201.17,3491.06,0.0583,257,167.77,1000.0,17.04,0.5752
2790,Beck-Turner,False,EG,Matthewchester,EdTech,2012,https://beck-turner.com,Lawyer particular occur area leg career responsibility line.,32,beck-turner,2023,USD,309791,96306,213485,100617,112868,42765,70103,3097,6195,63908,3903,349869,53907,295962,25815.92,309791,266.54,2233.66,0.0302,352,73.18,16042.75,0.24,0.6891
2791,Williams-Wade,False,US,West Veronicaview,Fintech,2009,https://williams-wade.com,Direction clear response until news.,23,williams-wade,2023,USD,1180065,351476,828589,583351,245238,17435,227803,11800,23601,204202,38787,715796,370148,345648,,1180065,278.25,710.75,0.001,2704,36.36,49515.61,0.78,0.7022
2792,Medina Robinson and Young,False,FR,Port James,Mobility,2008,https://medinarobinsonandyoung.com,Project paper hope choice positive education power science cost include.,20,medina-robinson-and-young,2023,EUR,948646,64662,883984,185438,698546,0,698546,9486,18972,679574,37617,619658,194573,425085,,948646,1496.81,8129.97,0.0777,3952,20.0,25875.74,1.45,0.9318
2793,Bird-Brown,False,GB,Richardfort,Energy,2018,https://bird-brown.com,Political appear trial customer prepare bad figure.,21,bird-brown,2023,USD,1001234,512661,488573,875432,-386859,166,-387025,10012,20024,-407049,5315,558857,221459,337398,,1001234,453.98,1757.96,0.0535,319,261.53,90782.44,0.06,0.488
2794,Martin Thomas and Hall,False,GB,Adamfurt,AgriTech,2011,https://martinthomasandhall.com,Appear baby state include experience.,18,martin-thomas-and-hall,2023,USD,476001,203157,272844,300980,-28136,0,-28136,4760,9520,-37656,7374,376099,93800,282299,,476001,1121.9,606.19,0.0632,139,284.86,49258.49,0.15,0.5732
2795,Fields-Johnson,False,AU,Joneston,Fintech,2024,https://fields-johnson.com,Trade base another blood hot strong or follow fund financial.,26,fields-johnson,2023,USD,620646,256604,364042,367826,-3784,0,-3784,6206,12412,-16196,14283,325370,79560,245810,,620646,20.0,65.3,0.0351,623,82.93,32861.71,0.43,0.5866
2796,Wright Brown and Wells,False,AU,Melissaberg,Mobility,2022,https://wrightbrownandwells.com,Road television practice choose state treat fire start candidate.,17,wright-brown-and-wells,2023,USD,1333251,349139,984112,364998,619114,0,619114,13332,26665,592449,49863,837332,143082,694250,,1333251,719.91,3008.26,0.0949,459,241.8,48511.7,1.03,0.7381
2797,Leonard Duncan and Peck,False,DE,Parksborough,AgriTech,2023,https://leonardduncanandpeck.com,Material when citizen in however.,26,leonard-duncan-and-peck,2023,EUR,259194,53262,205932,148933,56999,32107,24892,2591,5183,19709,6641,197153,9857,187296,,259194,365.18,1224.82,0.0842,130,166.03,30078.6,0.22,0.7945
2798,Hudson-Rodriguez,False,EG,Brownside,AI/ML,2016,https://hudson-rodriguez.com,Seem assume brother manager degree tree a chair.,23,hudson-rodriguez,2023,USD,433499,197615,235884,361588,-125704,0,-125704,4334,8669,-134373,39325,387688,293894,93794,,433499,2350.17,5843.23,0.0757,1005,35.91,40035.06,0.98,0.5441
2799,Sampson Group,False,NG,Gregorymouth,E-commerce,2008,https://sampsongroup.com,Traditional either financial offer fill provide full truth purpose.,25,sampson-group,2023,USD,2557815,921492,1636323,1318439,317884,21225,296659,25578,51156,245503,42123,1379203,505950,873253,,2557815,20.0,26.35,0.0891,10657,20.0,91870.21,0.46,0.6397
2800,Brown-Flores,False,AU,West Victor,SaaS,2021,https://brown-flores.com,Public enjoy bank in church hear of good response.,21,brown-flores,2023,USD,2468418,573143,1895275,1431343,463932,0,463932,24684,49368,414564,54059,1403601,501015,902586,205701.5,2468418,123.71,335.54,0.006,11621,17.7,153374.47,0.35,0.7678
2801,Medina Jimenez and Howard,False,FR,Leblancshire,Energy,2022,https://medinajimenezandhoward.com,Arrive rich pull think clear smile.,17,medina-jimenez-and-howard,2023,EUR,681971,308860,373111,472041,-98930,0,-98930,6819,13639,-112569,68570,587094,236602,350492,,681971,20.0,56.59,0.0357,241,235.44,22600.67,3.03,0.5471
2802,Rojas Pittman and Martin,False,CA,North Linda,Energy,2022,https://rojaspittmanandmartin.com,Human walk rock after probably.,15,rojas-pittman-and-martin,2023,USD,773797,259385,514412,442365,72047,40048,31999,7737,15475,16524,52192,507703,150536,357167,,773797,1166.67,9094.38,0.0377,451,142.76,8839.99,5.9,0.6648
2803,Burch Anderson and Moyer,False,EG,Bushport,SaaS,2009,https://burchandersonandmoyer.com,Dinner simply window or finally quickly moment.,19,burch-anderson-and-moyer,2023,USD,991181,420009,571172,1052471,-481299,17359,-498658,9911,19823,-518481,54021,597587,328853,268734,82598.42,991181,432.24,1412.2,0.0403,1186,69.62,94522.24,0.57,0.5763
2804,Steele-Simon,False,GB,West Wendyfort,AI/ML,2017,https://steele-simon.com,Can player share rest trial lose skin smile south.,22,steele-simon,2023,USD,1749172,514570,1234602,1425579,-190977,7341,-198318,17491,34983,-233301,29264,915317,240878,674439,,1749172,20.0,96.77,0.0274,4211,34.61,99142.21,0.3,0.7058
2805,Stanley LLC,False,ZA,New Laurachester,HealthTech,2023,https://stanleyllc.com,Physical society that against others kind factor worker party.,19,stanley-llc,2023,USD,1510383,485608,1024775,215722,809053,32743,776310,15103,30207,746103,79114,975316,48765,926551,125865.25,1510383,655.58,1182.93,0.0072,2566,49.05,17128.38,4.62,0.6785
2806,Riley and Sons,False,TN,South Cynthiaberg,HealthTech,2017,https://rileyandsons.com,Campaign call green give page wide.,20,riley-and-sons,2023,USD,316522,100838,215684,156838,58846,0,58846,3165,6330,52516,84316,432106,85509,346597,26376.83,316522,10.0,35.4,0.0257,719,36.68,22400.37,3.76,0.6814
2807,Ponce and Sons,False,ZA,Zacharyland,Energy,2023,https://ponceandsons.com,Garden hair nor nothing.,18,ponce-and-sons,2023,USD,870115,372648,497467,526098,-28631,11,-28642,8701,17402,-46044,460643,947922,627821,320101,,870115,929.35,2108.25,0.0129,507,142.74,50791.28,9.07,0.5717
2808,Wang-Calderon,False,AU,Jeremystad,Fintech,2023,https://wang-calderon.com,Go bring challenge side expert try every respond.,21,wang-calderon,2023,USD,713061,355111,357950,394185,-36235,10741,-46976,7130,14261,-61237,54026,482409,260754,221655,,713061,446.21,712.93,0.0392,2825,21.03,31464.07,1.72,0.502
2809,Holt-Palmer,False,BR,South Melissaborough,AI/ML,2023,https://holt-palmer.com,Vote dream forget possible draw.,15,holt-palmer,2023,USD,751837,208172,543665,166421,377244,0,377244,7518,15036,362208,33505,488594,59310,429284,,751837,1572.79,4929.0,0.0624,698,89.75,1000.0,33.51,0.7231
2810,Fernandez-Logan,False,EG,Melodytown,AI/ML,2013,https://fernandez-logan.com,Decide real strategy choose clear PM some consumer final.,13,fernandez-logan,2023,USD,1244349,496632,747717,789994,-42277,0,-42277,12443,24886,-67163,26850,719167,199422,519745,,1244349,20.0,61.8,0.0642,5184,20.0,62548.03,0.43,0.6009
2811,Davis Ltd,False,NG,West Jonathanfort,SaaS,2020,https://davisltd.com,Measure design less will appear around talk know perform water.,18,davis-ltd,2023,USD,3184147,1197315,1986832,1518944,467888,23650,444238,31841,63682,380556,85291,1837188,522054,1315134,265345.58,3184147,10.0,47.58,0.0069,6798,39.03,153549.38,0.56,0.624
2812,Smith Morales and Anderson,False,IN,East Scott,Mobility,2020,https://smithmoralesandanderson.com,Use research them theory dark into.,20,smith-morales-and-anderson,2023,USD,168665,52829,115836,99111,16725,34239,-17514,1686,3373,-20887,65937,239644,121380,118264,,168665,1471.62,4158.79,0.1564,52,268.47,1000.0,65.94,0.6868
2813,Hernandez-Rosario,False,KE,Obrienton,Marketplaces,2019,https://hernandez-rosario.com,School always message your score political kid.,18,hernandez-rosario,2023,USD,1517936,355718,1162218,917871,244347,0,244347,15179,30358,213989,26913,921330,144407,776923,,1517936,429.65,831.02,0.0063,979,129.2,103259.68,0.26,0.7657
2814,Jimenez Alvarado and Martin,False,AU,New Brianna,AgriTech,2018,https://jimenezalvaradoandmartin.com,Structure crime not board mind gun environment term southern.,23,jimenez-alvarado-and-martin,2023,USD,731562,159597,571965,379614,192351,0,192351,7315,14631,177720,24458,522678,272997,249681,,731562,20.0,66.81,0.0803,1324,46.04,12560.53,1.95,0.7818
2815,Nunez Holden and Rocha,False,US,Dudleyshire,SaaS,2009,https://nunezholdenandrocha.com,Month hundred chair painting beyond sort.,32,nunez-holden-and-rocha,2023,USD,787868,190437,597431,599576,-2145,0,-2145,7878,15757,-17902,19139,470596,159877,310719,65655.67,787868,342.39,979.71,0.044,2064,31.8,47366.33,0.4,0.7583
2816,Garcia-Morrison,False,GB,Gabrielport,E-commerce,2019,https://garcia-morrison.com,System myself scientist management better poor same cover daughter.,22,garcia-morrison,2023,USD,1789774,461233,1328541,130743,1197798,0,1197798,17897,35795,1162003,33808,1037216,197686,839530,,1789774,20.0,131.28,0.0863,1348,110.57,19917.86,1.7,0.7423
2817,Griffin Everett and Perez,False,AU,Lake Kent,Cybersecurity,2008,https://griffineverettandperez.com,Forget him as story see teacher here piece central.,28,griffin-everett-and-perez,2023,USD,1158753,267734,891019,620454,270565,0,270565,11587,23175,247390,88918,866561,354491,512070,,1158753,242.28,231.39,0.022,416,231.9,27249.64,3.26,0.7689
2818,Pham Inc,False,AU,South Allison,Marketplaces,2018,https://phaminc.com,Production side ground staff miss trip than.,20,pham-inc,2023,USD,402123,169074,233049,45497,187552,5340,182212,4021,8042,174170,8992,386876,139693,247183,,402123,20.0,37.84,0.0434,603,55.5,1000.0,8.99,0.5795
2819,Brown-Smith,False,TN,Lake Davidmouth,Fintech,2021,https://brown-smith.com,Mention prepare themselves size cover pass able.,16,brown-smith,2023,USD,546098,242221,303877,435158,-131281,3583,-134864,5460,10921,-145785,22104,450106,128833,321273,,546098,20.0,94.02,0.185,194,234.4,71268.37,0.31,0.5565
2820,Eaton Group,False,CA,East Jessica,E-commerce,2021,https://eatongroup.com,Plant trade raise remember understand marriage push soldier simple.,23,eaton-group,2023,USD,69090,17315,51775,29618,22157,0,22157,690,1381,20776,25978,221875,63962,157913,,69090,579.35,499.17,0.034,37,153.82,1000.0,25.98,0.7494
2821,Foster PLC,False,CA,Stewartland,SaaS,2015,https://fosterplc.com,Section girl property service deal.,25,foster-plc,2023,USD,198681,72605,126076,122609,3467,21327,-17860,1986,3973,-21833,4741,195775,25363,170412,16556.75,198681,10.0,19.13,0.0175,3311,5.0,32026.88,0.15,0.6346
2822,Anderson-Douglas,False,DE,Nguyenborough,EdTech,2017,https://anderson-douglas.com,Financial prepare economy participant speak.,20,anderson-douglas,2023,EUR,238892,74061,164831,86295,78536,0,78536,2388,4777,73759,8492,151454,33779,117675,19907.67,238892,325.87,325.87,0.0184,264,75.34,1000.0,8.49,0.69
2823,Wheeler PLC,False,KE,Kellermouth,Fintech,2010,https://wheelerplc.com,Will service prepare compare enjoy dark everyone whole way respond.,20,wheeler-plc,2023,USD,455038,116846,338192,161703,176489,12247,164242,4550,9100,155142,36950,406952,158750,248202,,455038,952.27,4520.56,0.0988,212,178.46,37489.07,0.99,0.7432
2824,Wang Group,False,IN,Port Michaelbury,Fintech,2018,https://wanggroup.com,Month accept know fly body must glass position.,21,wang-group,2023,USD,1774545,767611,1006934,595658,411276,0,411276,17745,35490,375786,378637,1270209,574431,695778,,1774545,974.52,1355.07,0.0747,7393,20.0,45309.59,8.36,0.5674
2825,Tyler and Sons,False,GB,Lake Amandamouth,SaaS,2018,https://tylerandsons.com,Young local often event stock health.,19,tyler-and-sons,2023,USD,1204537,429611,774926,804933,-30007,23611,-53618,12045,24090,-77708,62427,723066,36153,686913,100378.08,1204537,10.0,11.13,0.061,3296,30.45,104161.96,0.6,0.6433
2826,Bean-Jones,False,US,Shaffermouth,Mobility,2021,https://bean-jones.com,Someone why result area establish evening ability ball.,20,bean-jones,2023,USD,330703,130271,200432,16535,183897,0,183897,3307,6614,177283,62771,233691,121690,112001,,330703,744.2,2696.78,0.0343,214,128.5,23011.66,2.73,0.6061
2827,Myers LLC,False,KE,Shawnport,AI/ML,2021,https://myersllc.com,Have such suffer study house second think rise onto.,18,myers-llc,2023,USD,352501,182727,169774,132590,37184,10482,26702,3525,7050,19652,13401,201783,93290,108493,,352501,20.0,74.31,0.0749,232,126.18,13022.21,1.03,0.4816
2828,Castillo-Turner,False,IN,West Aaronhaven,SaaS,2023,https://castillo-turner.com,Pass society soon charge during partner father their.,29,castillo-turner,2023,USD,511025,230638,280387,284703,-4316,0,-4316,5110,10220,-14536,29846,465186,53774,411412,42585.42,511025,298.2,1233.67,0.015,8517,5.0,4389.42,6.8,0.5487
2829,Lopez Collins and Washington,False,KE,Port Robertville,SaaS,2018,https://lopezcollinsandwashington.com,Week free sure today detail structure actually data.,21,lopez-collins-and-washington,2023,USD,518693,280836,237857,251935,-14078,14890,-28968,5186,10373,-39341,102831,402812,71751,331061,43224.42,518693,410.97,1557.59,0.001,1660,26.03,11515.14,8.93,0.4586
2830,Martin-Carlson,False,TN,Fletcherland,IoT,2020,https://martin-carlson.com,Chance dark various sort help goal argue born success.,15,martin-carlson,2023,USD,1744235,535957,1208278,777362,430916,0,430916,17442,34884,396032,335711,1305503,387819,917684,,1744235,1518.42,3819.84,0.0529,7267,20.0,80697.17,4.16,0.6927
2831,Sanders-Sanders,False,CA,East Ryanmouth,IoT,2011,https://sanders-sanders.com,Forward around brother least style.,20,sanders-sanders,2023,USD,1224420,415128,809292,152029,657263,0,657263,12244,24488,632775,73956,743086,37154,705932,,1224420,544.41,2152.8,0.1945,4181,24.4,9683.6,7.64,0.661
2832,Bond Harrison and Lynch,False,AU,North Brooke,Mobility,2011,https://bondharrisonandlynch.com,Include allow us hold any leave pattern.,19,bond-harrison-and-lynch,2023,USD,735747,220329,515418,431635,83783,0,83783,7357,14714,69069,13270,485008,202467,282541,,735747,422.08,1976.75,0.0269,3065,20.0,49204.1,0.27,0.7005
2833,Roy and Sons,False,ZA,North William,Marketplaces,2014,https://royandsons.com,Must financial light support much trade check sing lay.,16,roy-and-sons,2023,USD,1018013,438442,579571,138969,440602,0,440602,10180,20360,420242,11078,704945,483108,221837,,1018013,20.0,63.36,0.0621,4241,20.0,1000.0,11.08,0.5693
2834,Powell Schmidt and Myers,False,CA,Daviesmouth,Mobility,2024,https://powellschmidtandmyers.com,Turn cost receive activity single along require.,18,powell-schmidt-and-myers,2023,USD,1118265,307063,811202,639551,171651,37698,133953,11182,22365,111588,121284,874223,532543,341680,,1118265,711.9,397.23,0.0096,523,178.03,79756.43,1.52,0.7254
2835,Lam LLC,False,AU,Olsenshire,Marketplaces,2018,https://lamllc.com,Administration speech create seven wait his teach risk.,15,lam-llc,2023,USD,590007,247357,342650,234896,107754,1440,106314,5900,11800,94514,3341,453072,152158,300914,,590007,20.0,42.07,0.0198,234,209.53,40538.67,0.08,0.5808
2836,Jones LLC,False,GB,Griffinhaven,IoT,2017,https://jonesllc.com,Everybody movie trade consumer family.,22,jones-llc,2023,USD,1334293,120315,1213978,66714,1147264,0,1147264,13342,26685,1120579,22149,856736,351341,505395,,1334293,622.12,2991.61,0.0623,1239,89.72,1566.23,14.14,0.9098
2837,Parker-Lynch,False,CA,Lake Johnland,Energy,2014,https://parker-lynch.com,Society argue everything policy professional site produce health now.,17,parker-lynch,2023,USD,1189789,507984,681805,491970,189835,9557,180278,11897,23795,156483,48693,765817,361065,404752,,1189789,75.78,359.41,0.0463,691,143.41,29896.11,1.63,0.573
2838,Young Lucero and Miller,False,EG,North Nicole,Marketplaces,2010,https://youngluceroandmiller.com,Artist blood road remember high oil age every key answer it.,13,young-lucero-and-miller,2023,USD,4857689,2363224,2494465,3010218,-515753,0,-515753,48576,97153,-612906,224468,2733876,953011,1780865,,4857689,237.2,995.09,0.0617,2033,199.11,257193.07,0.87,0.5135
2839,Campbell-Green,False,NG,Faithside,EdTech,2017,https://campbell-green.com,Forget painting development effort choose.,22,campbell-green,2023,USD,355064,105179,249885,206503,43382,30546,12836,3550,7101,5735,15210,256580,90236,166344,29588.67,355064,276.48,619.59,0.001,460,64.2,32557.18,0.47,0.7038
2840,Cunningham Davis and Grimes,False,IN,New Tiffanyburgh,SaaS,2017,https://cunninghamdavisandgrimes.com,Smile movement approach perhaps such international question policy step.,25,cunningham-davis-and-grimes,2023,USD,1044192,577468,466724,621995,-155271,0,-155271,10441,20883,-176154,55030,639938,150082,489856,87016.0,1044192,63.17,99.34,0.0468,3573,24.35,57866.96,0.95,0.447
2841,Jones Ali and Carter,False,KE,South Peggychester,Energy,2015,https://jonesaliandcarter.com,Benefit local level charge participant clear ability thousand.,25,jones-ali-and-carter,2023,USD,2619042,482488,2136554,994432,1142122,199,1141923,26190,52380,1089543,519096,1854107,1192231,661876,,2619042,1211.69,2364.15,0.0664,10912,20.0,102916.23,5.04,0.8158
2842,Williams-Costa,False,KE,Joystad,Cybersecurity,2010,https://williams-costa.com,Child your activity perhaps look Republican operation reduce reduce computer.,16,williams-costa,2023,USD,472299,86087,386212,183514,202698,1797,200901,4722,9445,191456,61959,401413,142438,258975,,472299,441.29,391.16,0.0559,235,167.38,37838.51,1.64,0.8177
2843,Johnson Inc,False,ZA,North Michael,IoT,2011,https://johnsoninc.com,Ten begin girl next itself significant rather particularly plant life.,23,johnson-inc,2023,USD,121823,48179,73644,35084,38560,0,38560,1218,2436,36124,37977,148748,44475,104273,,121823,357.71,1192.77,0.0841,34,293.23,6642.74,5.72,0.6045
2844,Brewer-Garcia,False,KE,Brittanystad,E-commerce,2016,https://brewer-garcia.com,Usually Congress guy out also act team special discussion.,17,brewer-garcia,2023,USD,884281,261610,622671,177895,444776,33261,411515,8842,17685,393830,77053,660710,269820,390890,,884281,20.0,57.94,0.0471,321,229.45,1000.0,77.05,0.7042
2845,Randolph-Conley,False,FR,South Samantha,IoT,2024,https://randolph-conley.com,Recently list mother officer sure close media doctor probably.,20,randolph-conley,2023,EUR,889723,468585,421138,257624,163514,0,163514,8897,17794,145720,50262,662147,205632,456515,,889723,87.32,184.06,0.0464,598,123.91,58393.67,0.86,0.4733
2846,Figueroa-Baker,False,EG,Jonathanburgh,Energy,2014,https://figueroa-baker.com,Drop plant bring finish tax.,20,figueroa-baker,2023,USD,2186846,617890,1568956,1514818,54138,2756,51382,21868,43736,7646,26366,1276214,226817,1049397,,2186846,132.2,744.03,0.1384,1718,106.07,106898.15,0.25,0.7175
2847,Sullivan-Hill,False,CA,Lake Tammyville,Fintech,2017,https://sullivan-hill.com,Performance several gun happy wish church.,15,sullivan-hill,2023,USD,3396113,1253455,2142658,1555700,586958,11249,575709,33961,67922,507787,124397,1860201,332429,1527772,,3396113,186.39,688.53,0.001,2666,106.13,133368.84,0.93,0.6309
2848,Ruiz Inc,False,NG,New Troy,AgriTech,2021,https://ruizinc.com,Leg today staff change wonder detail.,27,ruiz-inc,2023,USD,161331,45697,115634,120865,-5231,0,-5231,1613,3226,-8457,46824,151665,130697,20968,,161331,20.0,54.85,0.0456,142,94.03,1000.0,46.82,0.7168
2849,Young-Hale,False,BR,Lake Jamesstad,AI/ML,2018,https://young-hale.com,Social though for join necessary make though health activity.,24,young-hale,2023,USD,494679,122674,372005,152344,219661,6470,213191,4946,9893,203298,22550,282872,163306,119566,,494679,498.13,2062.22,0.0315,2061,20.0,29908.86,0.75,0.752
2850,Green Vazquez and Wise,False,DE,West Kimberlyburgh,Energy,2020,https://greenvazquezandwise.com,Throughout among teach must mind cost same miss security office test.,19,green-vazquez-and-wise,2023,EUR,693766,206268,487498,58823,428675,0,428675,6937,13875,414800,15406,524550,358473,166077,,693766,1671.81,2384.36,0.0123,454,127.28,38569.13,0.4,0.7027
2851,Hayes Miranda and Mcdowell,False,IN,Lake Danielle,IoT,2024,https://hayesmirandaandmcdowell.com,Weight rich herself model happen Mrs step career century.,13,hayes-miranda-and-mcdowell,2023,USD,611614,228052,383562,463901,-80339,0,-80339,6116,12232,-92571,64161,552370,386902,165468,,611614,20.0,142.12,0.0802,673,75.73,38863.28,1.65,0.6271
2852,Giles Ltd,False,EG,South Victoriastad,Marketplaces,2013,https://gilesltd.com,As have sure player.,21,giles-ltd,2023,USD,58526,19164,39362,14477,24885,8266,16619,585,1170,15449,2389,115879,40546,75333,,58526,74.08,100.31,0.0876,243,20.0,21158.44,0.11,0.6726
2853,Burgess-Mcneil,False,US,Port Kevin,Marketplaces,2024,https://burgess-mcneil.com,Stop themselves visit kitchen understand.,13,burgess-mcneil,2023,USD,342105,80853,261252,287469,-26217,0,-26217,3421,6842,-33059,37346,403639,144407,259232,,342105,912.57,3843.06,0.0385,1425,20.0,24554.79,1.52,0.7637
2854,Rosales-Gardner,False,GB,Lewisfort,IoT,2023,https://rosales-gardner.com,Door keep operation Mr account.,18,rosales-gardner,2023,USD,398767,112369,286398,140309,146089,28109,117980,3987,7975,110005,38904,263500,38082,225418,,398767,1107.8,4617.02,0.0629,314,105.79,33887.08,1.15,0.7182
2855,Hensley Ltd,False,DE,Johnburgh,Marketplaces,2022,https://hensleyltd.com,Various nearly you something relate pressure since worker than hospital.,22,hensley-ltd,2023,EUR,115535,53840,61695,47735,13960,7680,6280,1155,2310,3970,7758,212703,45554,167149,,115535,1096.35,5815.7,0.0919,331,29.0,30362.52,0.26,0.534
2856,Chavez-Adkins,False,IN,Port Deanna,Marketplaces,2021,https://chavez-adkins.com,Establish explain box phone unit choice college activity.,24,chavez-adkins,2023,USD,297821,90306,207515,85985,121530,7220,114310,2978,5956,108354,3057,316902,67060,249842,,297821,156.72,533.65,0.1331,579,42.84,5702.04,0.54,0.6968
2857,Harris Ramirez and Russell,False,KE,Ericaberg,Cybersecurity,2009,https://harrisramirezandrussell.com,Not safe business military language next think heavy trouble it.,20,harris-ramirez-and-russell,2023,USD,4808747,2270302,2538445,2580285,-41840,35371,-77211,48087,96174,-173385,1987530,4584282,1706843,2877439,,4808747,1967.75,1603.17,0.001,3484,115.01,227321.92,8.74,0.5279
2858,Salinas Harris and George,False,NG,Charlesfurt,EdTech,2019,https://salinasharrisandgeorge.com,Current result pattern audience certainly old yourself help fill control.,16,salinas-harris-and-george,2023,USD,326953,37922,289031,28082,260949,37298,223651,3269,6539,217112,16203,248304,146062,102242,27246.08,326953,69.67,69.67,0.001,588,46.3,19943.59,0.81,0.884
2859,Brooks Simpson and Lindsey,False,EG,East Robertborough,HealthTech,2015,https://brookssimpsonandlindsey.com,Growth out prepare practice.,22,brooks-simpson-and-lindsey,2023,USD,540907,188387,352520,319517,33003,26511,6492,5409,10818,-4326,6286,433407,32034,401373,45075.58,540907,132.02,132.02,0.0365,479,94.02,13668.7,0.46,0.6517
2860,Durham-Stewart,False,GB,Lake Bonnieport,Cybersecurity,2017,https://durham-stewart.com,Cell five natural national old.,20,durham-stewart,2023,USD,779122,208222,570900,248730,322170,26141,296029,7791,15582,280447,4736,563236,223876,339360,,779122,1107.38,3609.99,0.0124,279,232.69,11759.01,0.4,0.7327
2861,Byrd PLC,False,TN,Farmerhaven,Energy,2018,https://byrdplc.com,Begin time leave executive season.,18,byrd-plc,2023,USD,956116,471820,484296,336745,147551,21145,126406,9561,19122,107284,114402,757416,448618,308798,,956116,920.79,4712.16,0.0074,336,237.09,26692.44,4.29,0.5065
2862,Padilla Inc,False,FR,Port Teresa,Marketplaces,2014,https://padillainc.com,Ahead practice word production experience site evening soon maintain single.,22,padilla-inc,2023,EUR,169314,51767,117547,154813,-37266,8339,-45605,1693,3386,-48991,8019,219521,11902,207619,,169314,538.41,2960.51,0.0333,34,411.08,12273.92,0.65,0.6943
2863,Thompson Ltd,False,TN,Chaneychester,AgriTech,2017,https://thompsonltd.com,Tell sit difference wall resource away.,12,thompson-ltd,2023,USD,151477,92961,58516,81606,-23090,0,-23090,1514,3029,-26119,11070,275055,17121,257934,,151477,20.0,10.0,0.0837,160,78.7,26969.48,0.41,0.3863
2864,Brown Torres and Hunt,False,BR,Hollyton,HealthTech,2016,https://browntorresandhunt.com,Work now major when heart respond end bring business service.,19,brown-torres-and-hunt,2023,USD,1564820,637975,926845,1402674,-475829,3888,-479717,15648,31296,-511013,233063,1162693,790560,372133,130401.67,1564820,10.0,33.93,0.001,4904,26.59,98269.48,2.37,0.5923
2865,Jones PLC,False,BR,Ramirezburgh,IoT,2015,https://jonesplc.com,Before west three bit city hit people key hold describe.,16,jones-plc,2023,USD,1368820,614083,754737,603801,150936,0,150936,13688,27376,123560,8093,816422,199221,617201,,1368820,20.0,30.53,0.0597,595,191.42,21160.45,0.38,0.5514
2866,Parks Inc,False,TN,North Tracy,EdTech,2011,https://parksinc.com,Language seem final reflect than.,19,parks-inc,2023,USD,2937176,1108410,1828766,2189834,-361068,0,-361068,29371,58743,-419811,69375,1683542,680902,1002640,244764.67,2937176,149.57,978.76,0.088,3638,67.28,136617.64,0.51,0.6226
2867,Chase-Fox,False,GB,Port Christophermouth,EdTech,2008,https://chase-fox.com,Speech agency despite tax break general tend cold how network note.,16,chase-fox,2023,USD,38781,15979,22802,22485,317,18602,-18285,387,775,-19060,14492,87665,46024,41641,3231.75,38781,303.18,574.66,0.001,134,24.0,1000.0,14.49,0.588
2868,Andrews and Sons,False,DE,North Andrewland,AgriTech,2022,https://andrewsandsons.com,Own stuff serious ask however PM choose myself adult.,21,andrews-and-sons,2023,EUR,382217,128677,253540,244763,8777,3644,5133,3822,7644,-2511,55594,260625,75745,184880,,382217,20.0,12.74,0.0469,144,219.68,1000.0,55.59,0.6633
2869,Bates Inc,False,EG,North Melissa,AI/ML,2021,https://batesinc.com,Thought before others above tend sense hold hold tend door.,22,bates-inc,2023,USD,1253391,525326,728065,716172,11893,0,11893,12533,25067,-13174,440594,1229006,85075,1143931,,1253391,1277.95,2789.87,0.122,1568,66.6,56445.06,7.81,0.5809
2870,Johnson-Marshall,False,TN,South Eric,Marketplaces,2009,https://johnson-marshall.com,Sea hair receive number necessary its successful daughter rate those director.,26,johnson-marshall,2023,USD,385860,148786,237074,245813,-8739,0,-8739,3858,7717,-16456,4596,265495,37564,227931,,385860,20.0,79.19,0.1646,205,156.64,1000.0,4.6,0.6144
2871,Cox Inc,False,DE,Pagechester,HealthTech,2016,https://coxinc.com,For attention fine street evening voice.,26,cox-inc,2023,EUR,442271,155482,286789,22113,264676,4948,259728,4422,8845,250883,8178,250539,38456,212083,36855.92,442271,544.06,2441.08,0.0267,316,116.52,22850.09,0.36,0.6484
2872,Sanchez-Johns,False,GB,Elizabethmouth,SaaS,2016,https://sanchez-johns.com,Deal price ahead how data.,12,sanchez-johns,2023,USD,406017,256285,149732,44848,104884,0,104884,4060,8120,96764,5563,391119,128497,262622,33834.75,406017,642.7,642.7,0.0536,416,81.31,30969.87,0.18,0.3688
2873,Conley Wilcox and Hernandez,False,AU,South Kyleborough,AgriTech,2013,https://conleywilcoxandhernandez.com,Note quite increase draw nor develop himself produce.,14,conley-wilcox-and-hernandez,2023,USD,414597,136012,278585,550605,-272020,11682,-283702,4145,8291,-291993,12769,237423,13316,224107,,414597,654.5,2631.08,0.0779,1727,20.0,88444.09,0.14,0.6719
2874,Blanchard Cox and Ramirez,False,BR,New Craig,SaaS,2023,https://blanchardcoxandramirez.com,Them affect activity somebody fear hot race maintain.,24,blanchard-cox-and-ramirez,2023,USD,1043743,348290,695453,698270,-2817,8887,-11704,10437,20874,-32578,131080,802280,545579,256701,86978.58,1043743,326.41,971.09,0.001,2196,39.6,58999.49,2.22,0.6663
2875,Davis LLC,False,AU,Stoneville,SaaS,2009,https://davisllc.com,Hospital accept store adult officer shoulder tough.,22,davis-llc,2023,USD,3405745,1459264,1946481,2013615,-67134,0,-67134,34057,68114,-135248,184174,1916029,1054454,861575,283812.08,3405745,107.87,107.87,0.0405,56762,5.0,172747.45,1.07,0.5715
2876,Camacho-Ward,False,FR,Paulport,E-commerce,2017,https://camacho-ward.com,Around maybe several trip again degree.,23,camacho-ward,2023,EUR,1008186,462802,545384,512675,32709,0,32709,10081,20163,12546,35527,654212,445572,208640,,1008186,1315.42,4417.21,0.0654,1321,63.58,42950.86,0.83,0.541
2877,Davis LLC,False,FR,New Alexatown,Energy,2019,https://davisllc.com,Season successful born main give lead gas try.,14,davis-llc,2023,EUR,778270,216308,561962,38913,523049,0,523049,7782,15565,507484,35507,484668,113909,370759,,778270,1545.63,3496.15,0.0365,1538,42.16,4279.22,8.3,0.7221
2878,Lane Martin and Briggs,False,BR,Kennedystad,Marketplaces,2010,https://lanemartinandbriggs.com,Exactly behind hot city.,18,lane-martin-and-briggs,2023,USD,562522,145962,416560,85586,330974,42670,288304,5625,11250,277054,20331,481024,212807,268217,,562522,152.84,671.71,0.001,2343,20.0,1000.0,20.33,0.7405
2879,Nunez PLC,False,TN,Victoriachester,Cybersecurity,2012,https://nunezplc.com,Interesting they that newspaper serve material whatever act.,18,nunez-plc,2023,USD,6567567,3577515,2990052,3222088,-232036,36265,-268301,65675,131351,-399652,642160,4063035,1217022,2846013,,6567567,1419.51,3859.68,0.0441,9911,55.22,260502.47,2.47,0.4553
2880,Scott PLC,False,DE,Millertown,Fintech,2024,https://scottplc.com,Himself purpose dinner maintain sell because factor.,19,scott-plc,2023,EUR,919663,211086,708577,317375,391202,26847,364355,9196,18393,345962,232068,737124,308903,428221,,919663,20.0,129.28,0.0149,1304,58.77,65131.56,3.56,0.7705
2881,Sharp Ltd,False,FR,Wilsonshire,AI/ML,2024,https://sharpltd.com,Visit front ask fast oil great whatever which anyone.,18,sharp-ltd,2023,EUR,178901,64399,114502,109629,4873,0,4873,1789,3578,1295,10301,226057,60511,165546,,178901,476.79,1975.14,0.001,237,62.77,21393.02,0.48,0.64
2882,Williamson Smith and Simmons,False,IN,Kevinborough,Mobility,2010,https://williamsonsmithandsimmons.com,Interesting true career last catch effect include behavior.,22,williamson-smith-and-simmons,2023,USD,217830,80615,137215,62479,74736,7839,66897,2178,4356,62541,130947,369732,129127,240605,,217830,20.0,103.2,0.0957,87,208.28,3141.57,41.68,0.6299
2883,Johnson Meyer and Moore,False,DE,Brianhaven,IoT,2011,https://johnsonmeyerandmoore.com,Enough issue father among structure.,23,johnson-meyer-and-moore,2023,EUR,913755,288204,625551,189552,435999,31046,404953,9137,18275,386678,23949,565882,137167,428715,,913755,707.3,1876.8,0.0781,3807,20.0,55792.57,0.43,0.6846
2884,Smith-Phillips,False,AU,Brownchester,E-commerce,2018,https://smith-phillips.com,Cold guy friend traditional.,23,smith-phillips,2023,USD,1205387,493055,712332,281495,430837,0,430837,12053,24107,406730,87636,752619,205951,546668,,1205387,338.28,765.01,0.0238,5022,20.0,7865.3,11.14,0.591
2885,Guerrero Inc,False,KE,West Julia,Cybersecurity,2020,https://guerreroinc.com,Instead yes national traditional get unit man entire all.,16,guerrero-inc,2023,USD,4387185,219359,4167826,582534,3585292,52733,3532559,43871,87743,3444816,586864,2886162,1186728,1699434,,4387185,445.9,974.54,0.0136,2357,155.05,72170.69,8.13,0.95
2886,Wright-Levine,False,AU,West Kelseyview,Cybersecurity,2015,https://wright-levine.com,Clearly box could daughter sense particularly image piece billion set.,20,wright-levine,2023,USD,825001,418759,406242,431190,-24948,13914,-38862,8250,16500,-55362,26994,602432,49648,552784,,825001,1277.13,4755.75,0.056,286,239.65,25749.54,1.05,0.4924
2887,Martin Richards and Pearson,False,TN,Ryanville,EdTech,2012,https://martinrichardsandpearson.com,Speech sit wall expect everyone impact.,21,martin-richards-and-pearson,2023,USD,790009,467941,322068,277777,44291,10403,33888,7900,15800,18088,120387,515418,298378,217040,65834.08,790009,481.89,2327.91,0.026,13166,5.0,13550.17,8.88,0.4077
2888,Bennett-Ford,False,FR,Patrickmouth,HealthTech,2014,https://bennett-ford.com,Never TV around quite possible.,17,bennett-ford,2023,EUR,416054,201009,215045,166622,48423,6270,42153,4160,8321,33832,9905,270733,70085,200648,34671.17,416054,661.04,3426.53,0.001,2640,13.13,27996.02,0.35,0.5169
2889,Wright-Joyce,False,IN,West Taylor,Mobility,2021,https://wright-joyce.com,Thing often color it.,23,wright-joyce,2023,USD,1288249,477320,810929,279728,531201,31632,499569,12882,25764,473805,125462,943255,516697,426558,,1288249,1332.58,6385.18,0.1016,771,139.17,5352.82,23.44,0.6295
2890,Thomas LLC,False,IN,Kathyville,IoT,2009,https://thomasllc.com,Draw put check raise cell early voice.,22,thomas-llc,2023,USD,218765,98840,119925,116484,3441,5137,-1696,2187,4375,-6071,191127,463091,278704,184387,,218765,20.0,53.62,0.0235,911,20.0,20226.09,9.45,0.5482
2891,Melton Weaver and Ortiz,False,EG,New Kathrynville,AI/ML,2019,https://meltonweaverandortiz.com,Social more single control task speak sign think sure fund.,19,melton-weaver-and-ortiz,2023,USD,3719872,646513,3073359,2097835,975524,0,975524,37198,74397,901127,299795,2313484,115674,2197810,,3719872,2047.54,5383.82,0.0299,3046,101.75,170042.69,1.76,0.8262
2892,Arellano Group,False,ZA,North Jessica,Fintech,2018,https://arellanogroup.com,Different apply no month affect scene PM less I central.,27,arellano-group,2023,USD,1080848,353104,727744,984659,-256915,5656,-262571,10808,21616,-284187,172001,880174,170441,709733,,1080848,20.0,107.94,0.0399,411,218.73,46183.9,3.72,0.6733
2893,Pitts Perkins and Lucas,False,NG,West Alexanderfort,Energy,2023,https://pittsperkinsandlucas.com,Official alone government machine will.,18,pitts-perkins-and-lucas,2023,USD,2095653,576752,1518901,1587945,-69044,13913,-82957,20956,41913,-124870,914407,2104469,1035626,1068843,,2095653,20.0,10.0,0.0446,834,209.25,85761.13,10.66,0.7248
2894,Bailey-Mann,False,BR,Port Samuelville,EdTech,2016,https://bailey-mann.com,Easy lawyer its debate poor early sign.,26,bailey-mann,2023,USD,291710,65783,225927,219359,6568,25425,-18857,2917,5834,-24691,2591,171030,36183,134847,24309.17,291710,251.14,969.45,0.0145,586,41.42,1000.0,2.59,0.7745
2895,Stewart Owen and Gutierrez,False,AU,Franklinmouth,HealthTech,2019,https://stewartowenandgutierrez.com,Clear help say dinner respond despite white way major amount put.,24,stewart-owen-and-gutierrez,2023,USD,362440,52179,310261,67459,242802,3227,239575,3624,7248,232327,8481,258980,76148,182832,30203.33,362440,293.99,1759.48,0.0084,440,68.64,32370.19,0.26,0.856
2896,Gilbert Duncan and Mcneil,False,EG,Robertmouth,Cybersecurity,2019,https://gilbertduncanandmcneil.com,Under enter rate final again.,23,gilbert-duncan-and-mcneil,2023,USD,788076,319146,468930,545957,-77027,8032,-85059,7880,15761,-100820,4439,410534,96879,313655,,788076,2124.42,9774.37,0.059,3283,20.0,32011.3,0.14,0.595
2897,Sanders-Pearson,False,IN,East Stacy,SaaS,2009,https://sanders-pearson.com,Know specific natural political security almost government return beautiful.,23,sanders-pearson,2023,USD,476983,117388,359595,198550,161045,17765,143280,4769,9539,133741,139174,378959,150856,228103,39748.58,476983,448.82,1503.35,0.0583,341,116.53,1245.0,111.79,0.7539
2898,Ruiz Inc,False,ZA,Lake Joseph,Marketplaces,2009,https://ruizinc.com,Into drive economy product leg move attack.,22,ruiz-inc,2023,USD,1411798,301397,1110401,1175431,-65030,2441,-67471,14117,28235,-95706,10789,811817,117482,694335,,1411798,847.32,3189.52,0.0207,619,189.79,113256.38,0.1,0.7865
2899,Fox LLC,False,ZA,West Charles,Marketplaces,2015,https://foxllc.com,Teacher loss budget join no increase assume science.,24,fox-llc,2023,USD,357430,102570,254860,147310,107550,21946,85604,3574,7148,78456,17255,306330,109524,196806,,357430,20.0,41.9,0.0038,95,310.74,21077.6,0.82,0.713
2900,Murray-Schaefer,False,IN,North Sean,AI/ML,2020,https://murray-schaefer.com,Leave loss social director gas building station.,19,murray-schaefer,2023,USD,1246801,609387,637414,861578,-224164,0,-224164,12468,24936,-249100,29645,717835,309492,408343,,1246801,1178.03,2949.47,0.0944,1371,75.73,61432.7,0.48,0.5112
2901,Huynh-Leon,False,IN,Pittsmouth,Marketplaces,2019,https://huynh-leon.com,Ask best how move or identify.,19,huynh-leon,2023,USD,173251,59097,114154,125471,-11317,0,-11317,1732,3465,-14782,27059,292212,106691,185521,,173251,905.14,4060.09,0.001,46,308.07,1000.0,27.06,0.6589
2902,Kennedy Ltd,False,AU,North Amyhaven,Marketplaces,2011,https://kennedyltd.com,Environmental nature animal fear property listen save three identify top.,16,kennedy-ltd,2023,USD,373708,150821,222887,304442,-81555,0,-81555,3737,7474,-89029,7324,343381,175567,167814,,373708,808.94,3052.29,0.0209,1163,26.76,21666.73,0.34,0.5964
2903,Stone Inc,False,NG,Pennyhaven,EdTech,2022,https://stoneinc.com,Also wear candidate expect I resource new site it level energy.,19,stone-inc,2023,USD,187803,18404,169399,77609,91790,0,91790,1878,3756,88034,6139,232934,11646,221288,15650.25,187803,270.9,560.13,0.0208,434,36.06,6800.98,0.9,0.902
2904,Johnson-Ayers,False,TN,Robinsonchester,SaaS,2020,https://johnson-ayers.com,Back nor ready might couple treat.,17,johnson-ayers,2023,USD,250159,134632,115527,60618,54909,3884,51025,2501,5003,46022,4418,131527,40290,91237,20846.58,250159,743.5,6609.17,0.048,2236,9.32,1000.0,4.42,0.4618
2905,Lawrence and Sons,False,IN,West Matthewbury,AgriTech,2010,https://lawrenceandsons.com,Simply politics skin discover.,13,lawrence-and-sons,2023,USD,1143761,398714,745047,320374,424673,11787,412886,11437,22875,390011,207654,921984,172431,749553,,1143761,20.0,38.39,0.0508,342,278.62,53568.29,3.88,0.6514
2906,Rodriguez Miller and Mitchell,False,AU,Scottburgh,EdTech,2017,https://rodriguezmillerandmitchell.com,Culture real imagine special data doctor road power thousand.,20,rodriguez-miller-and-mitchell,2023,USD,79764,39192,40572,35573,4999,0,4999,797,1595,3404,55474,228438,167946,60492,6647.0,79764,10.0,36.56,0.0665,103,63.96,8357.47,6.64,0.5087
2907,Reid Ltd,False,DE,New Charlesstad,HealthTech,2022,https://reidltd.com,Process control read movement alone company.,18,reid-ltd,2023,EUR,740294,290744,449550,102759,346791,4881,341910,7402,14805,327105,56605,484189,47029,437160,61691.17,740294,10.0,54.32,0.0303,12338,5.0,11981.99,4.72,0.6073
2908,Sanders Inc,False,BR,Williamsbury,E-commerce,2021,https://sandersinc.com,Mean authority rise service lawyer actually memory.,11,sanders-inc,2023,USD,316206,67539,248667,114786,133881,1346,132535,3162,6324,126211,4621,197058,44619,152439,,316206,20.0,52.55,0.001,225,116.67,19231.81,0.24,0.7864
2909,Harper-Smith,False,AU,South Robin,SaaS,2016,https://harper-smith.com,Most audience full air onto individual Mr.,20,harper-smith,2023,USD,600267,158536,441731,435334,6397,0,6397,6002,12005,-5608,17441,416525,161778,254747,50022.25,600267,84.46,554.75,0.0542,643,77.71,14492.91,1.2,0.7359
2910,Schmidt Ltd,False,FR,South Chelsea,Mobility,2023,https://schmidtltd.com,Own music town note walk yet since.,19,schmidt-ltd,2023,EUR,486184,168662,317522,474024,-156502,26489,-182991,4861,9723,-192714,67796,479346,134572,344774,,486184,731.3,2609.87,0.0664,2025,20.0,39517.75,1.72,0.6531
2911,Sheppard and Sons,False,ZA,Lucashaven,Energy,2018,https://sheppardandsons.com,Event occur economic first still.,15,sheppard-and-sons,2023,USD,2791690,139584,2652106,139584,2512522,0,2512522,27916,55833,2456689,18611,1511937,485982,1025955,,2791690,20.0,10.0,0.0221,2201,105.67,1000.0,18.61,0.95
2912,Lawrence-Daniel,False,ZA,Port Grant,Energy,2011,https://lawrence-daniel.com,Cold feel memory between quickly future son public small.,25,lawrence-daniel,2023,USD,1006649,524438,482211,1014926,-532715,39166,-571881,10066,20132,-592013,94464,761751,130847,630904,,1006649,1277.37,5162.78,0.001,4194,20.0,75540.23,1.25,0.479
2913,Hall Inc,False,GB,Jimeneztown,Cybersecurity,2016,https://hallinc.com,Quickly evidence make yet everybody.,18,hall-inc,2023,USD,1885722,1107630,778092,997150,-219058,1331,-220389,18857,37714,-258103,20627,1131161,56558,1074603,,1885722,137.5,68.75,0.004,7857,20.0,59849.77,0.34,0.4126
2914,Allison PLC,False,NG,West Kennethville,Fintech,2019,https://allisonplc.com,Also no serious campaign nature film.,27,allison-plc,2023,USD,1917855,574387,1343468,917258,426210,0,426210,19178,38357,387853,238448,1363781,778228,585553,,1917855,974.94,4508.87,0.0454,581,274.63,68715.83,3.47,0.7005
2915,Powell-Lewis,False,TN,Stephensside,IoT,2018,https://powell-lewis.com,Reflect look determine song something learn imagine region wind.,24,powell-lewis,2023,USD,1422832,473757,949075,669923,279152,43758,235394,14228,28456,206938,6285,783897,428099,355798,,1422832,20.0,20.95,0.036,589,201.27,12345.59,0.51,0.667
2916,Carr Ltd,False,EG,Daniellebury,Cybersecurity,2008,https://carrltd.com,Newspaper teacher any growth listen avoid include nature.,23,carr-ltd,2023,USD,1061505,337762,723743,208205,515538,31217,484321,10615,21230,463091,57640,591609,189456,402153,,1061505,1764.77,9026.4,0.001,705,125.47,6460.62,8.92,0.6818
2917,Robinson Barron and Sullivan,False,AU,Lake John,SaaS,2013,https://robinsonbarronandsullivan.com,Indicate beat team evening develop loss loss many.,25,robinson-barron-and-sullivan,2023,USD,944192,271134,673058,285831,387227,0,387227,9441,18883,368344,17213,563103,291758,271345,78682.67,944192,10.0,40.72,0.0278,1255,62.67,7197.9,2.39,0.7128
2918,Cox Taylor and Lynch,False,BR,Williamchester,Mobility,2012,https://coxtaylorandlynch.com,Movie race source treatment court.,24,cox-taylor-and-lynch,2023,USD,3111810,155590,2956220,1618171,1338049,6564,1331485,31118,62236,1269249,58219,1756100,545682,1210418,,3111810,1129.55,564.78,0.018,1999,129.71,133486.09,0.44,0.95
2919,Collins-Walter,False,US,East Katherine,Energy,2014,https://collins-walter.com,Also candidate environment above goal suggest market artist.,15,collins-walter,2023,USD,2012079,712374,1299705,1744129,-444424,25005,-469429,20120,40241,-509670,76856,1169903,363589,806314,,2012079,1570.16,4958.52,0.0096,8383,20.0,126619.1,0.61,0.646
2920,Andersen PLC,False,BR,New Marvin,AgriTech,2018,https://andersenplc.com,New tree tree service rich while just in shake operation.,24,andersen-plc,2023,USD,563050,154773,408277,184754,223523,21127,202396,5630,11261,191135,12746,395607,35195,360412,,563050,512.05,3235.94,0.001,275,170.04,14889.22,0.86,0.7251
2921,Walker PLC,False,KE,West Jasonview,Fintech,2011,https://walkerplc.com,Personal join throughout near act.,23,walker-plc,2023,USD,534839,201078,333761,54652,279109,33954,245155,5348,10696,234459,167904,615646,129625,486021,,534839,1579.36,4021.97,0.0561,165,269.12,1000.0,167.9,0.624
2922,Bennett Flores and Wilson,False,GB,Frankville,EdTech,2024,https://bennettfloresandwilson.com,Stay leg wonder term summer second deal so question dog performance.,18,bennett-flores-and-wilson,2023,USD,243457,89871,153586,31888,121698,0,121698,2434,4869,116829,4045,182508,101010,81498,20288.08,243457,98.06,248.45,0.001,4057,5.0,22259.75,0.18,0.6309
2923,Jackson Group,False,ZA,Briannaburgh,Marketplaces,2012,https://jacksongroup.com,Top at wait health hair floor feeling her.,26,jackson-group,2023,USD,544904,255129,289775,255715,34060,0,34060,5449,10898,23162,14382,368019,18400,349619,,544904,20.0,95.14,0.0383,147,308.25,83604.66,0.17,0.5318
2924,Hernandez Jones and Smith,False,KE,Caldwelltown,Marketplaces,2021,https://hernandezjonesandsmith.com,Hour the front fire decision response several study.,20,hernandez-jones-and-smith,2023,USD,332305,145431,186874,150980,35894,36714,-820,3323,6646,-7466,18932,195466,63428,132038,,332305,92.03,46.02,0.001,97,284.29,1000.0,18.93,0.5624
2925,Williams Group,False,AU,Port Anthonychester,E-commerce,2022,https://williamsgroup.com,Stock impact wind purpose at garden work key.,16,williams-group,2023,USD,884823,319333,565490,226797,338693,8126,330567,8848,17696,312871,113365,647372,231209,416163,,884823,1519.9,6309.38,0.0194,1124,65.57,1000.0,113.36,0.6391
2926,Smith-Schwartz,False,EG,Kellystad,Cybersecurity,2012,https://smith-schwartz.com,Over reflect before be defense service to stage.,18,smith-schwartz,2023,USD,1785465,572437,1213028,1299576,-86548,0,-86548,17854,35709,-122257,59247,1039678,120443,919235,,1785465,1641.31,4360.46,0.0655,2582,57.61,68951.87,0.86,0.6794
2927,Hester Murphy and Cook,False,IN,Josetown,HealthTech,2018,https://hestermurphyandcook.com,News environmental yourself individual head dog modern church.,13,hester-murphy-and-cook,2023,USD,72141,27767,44374,3607,40767,0,40767,721,1442,39325,27032,216317,82522,133795,6011.75,72141,676.83,3754.57,0.0943,134,44.54,1000.0,27.03,0.6151
2928,Collins Bush and Cisneros,False,AU,Bennettton,AgriTech,2014,https://collinsbushandcisneros.com,Region talk rise rate message serious military already blue police.,26,collins-bush-and-cisneros,2023,USD,208659,78382,130277,55379,74898,20645,54253,2086,4173,50080,3030,207582,48955,158627,,208659,789.35,774.51,0.001,566,30.69,1000.0,3.03,0.6244
2929,Barnes and Sons,False,FR,Aliciaview,Energy,2019,https://barnesandsons.com,Black soon hospital traditional they term partner tend.,18,barnes-and-sons,2023,EUR,492097,134644,357453,24864,332589,35071,297518,4920,9841,287677,27133,325184,16259,308925,,492097,965.33,681.64,0.061,2050,20.0,30891.4,0.88,0.7264
2930,Pena PLC,False,GB,North Caroline,Energy,2020,https://penaplc.com,Family want audience clear social ever sure.,19,pena-plc,2023,USD,3605892,612956,2992936,1226818,1766118,479,1765639,36058,72117,1693522,133856,1975083,1144142,830941,,3605892,20.0,11.98,0.001,15024,20.0,95734.24,1.4,0.83
2931,Rivera-Gonzales,False,KE,North Thomasmouth,EdTech,2008,https://rivera-gonzales.com,Hold system sense magazine voice arm political wait.,26,rivera-gonzales,2023,USD,71722,20488,51234,36949,14285,0,14285,717,1434,12851,1915,149844,73600,76244,5976.83,71722,354.96,2253.87,0.0482,150,39.73,29817.52,0.06,0.7143
2932,Griffin-Rose,False,US,South Heidi,AI/ML,2015,https://griffin-rose.com,Board skin expect door magazine low here main.,17,griffin-rose,2023,USD,347826,100714,247112,133881,113231,0,113231,3478,6956,106275,5659,203618,96091,107527,,347826,474.6,1424.34,0.0039,591,49.03,16365.71,0.35,0.7104
2933,Ballard-Douglas,False,FR,Lake David,Mobility,2014,https://ballard-douglas.com,Even own look life operation likely.,11,ballard-douglas,2023,EUR,4010577,1166780,2843797,200528,2643269,19397,2623872,40105,80211,2543661,50902,2146832,328704,1818128,,4010577,20.0,45.92,0.0817,16710,20.0,17273.02,2.95,0.7091
2934,Chan-Aguilar,False,IN,Port Davidport,Cybersecurity,2013,https://chan-aguilar.com,Enough agency clear relate third everyone fear nice.,21,chan-aguilar,2023,USD,1421691,810504,611187,1090489,-479302,1027,-480329,14216,28433,-508762,58388,774566,391511,383055,,1421691,1367.92,4329.92,0.1202,745,158.95,111872.02,0.52,0.4299
2935,Rice Bennett and Chapman,False,US,Duncanville,Energy,2021,https://ricebennettandchapman.com,Push hit especially national interview media wrong.,24,rice-bennett-and-chapman,2023,USD,282122,139442,142680,121926,20754,0,20754,2821,5642,15112,2457,318776,102953,215823,,282122,1043.67,5050.0,0.001,124,189.39,1000.0,2.46,0.5057
2936,Morrison-Smith,False,KE,Holmesbury,AgriTech,2012,https://morrison-smith.com,Tree would father much dream once second tonight experience apply.,16,morrison-smith,2023,USD,746861,374031,372830,177595,195235,5267,189968,7468,14937,175031,16978,411389,143259,268130,,746861,2028.03,5122.27,0.0661,580,107.27,20008.22,0.85,0.4992
2937,Tyler-Green,False,FR,Jacobton,E-commerce,2013,https://tyler-green.com,Case feel gas character night as own education still.,21,tyler-green,2023,EUR,1011224,598502,412722,429173,-16451,19664,-36115,10112,20224,-56339,13958,636284,222981,413303,,1011224,20.0,86.16,0.0704,449,187.33,4141.08,3.37,0.4081
2938,Dunn LLC,False,KE,South Louisland,Fintech,2008,https://dunnllc.com,Early buy education something dream national word wait all fire model.,25,dunn-llc,2023,USD,1206040,398129,807911,656073,151838,0,151838,12060,24120,127718,53570,811694,230994,580700,,1206040,20.0,49.61,0.0608,1575,63.8,50369.53,1.06,0.6699
2939,Lynch Wilson and Strong,False,ZA,Amandafort,AI/ML,2021,https://lynchwilsonandstrong.com,A rest group blood office public democratic sort physical.,15,lynch-wilson-and-strong,2023,USD,786137,370996,415141,407543,7598,0,7598,7861,15722,-8124,36094,613123,148578,464545,,786137,564.91,2614.01,0.0527,305,214.62,21821.19,1.65,0.5281
2940,Long-Fry,False,AU,Holtport,Mobility,2023,https://long-fry.com,Sport begin word sing attack idea image room.,14,long-fry,2023,USD,979174,296314,682860,492685,190175,12109,178066,9791,19583,158483,200627,701720,206314,495406,,979174,412.91,1632.62,0.0116,1196,68.2,64005.12,3.13,0.6974
2941,Hubbard Rose and Jones,False,FR,Port Jeremy,EdTech,2014,https://hubbardroseandjones.com,Hot social budget action cup season improve field standard middle.,20,hubbard-rose-and-jones,2023,EUR,1272695,120361,1152334,63634,1088700,12789,1075911,12726,25453,1050458,64175,752597,487057,265540,106057.92,1272695,109.32,517.29,0.0326,1077,98.42,1000.0,64.18,0.9054
2942,Johnson-King,False,DE,Diazview,AgriTech,2017,https://johnson-king.com,Main air fine hour especially western eat either none from.,23,johnson-king,2023,EUR,195095,68875,126220,27345,98875,16515,82360,1950,3901,78459,42453,223848,132207,91641,,195095,277.2,763.13,0.06,109,148.58,1000.0,42.45,0.647
2943,Anderson Ltd,False,ZA,Jameston,Mobility,2020,https://andersonltd.com,Present summer red tell past to truth clear across age.,28,anderson-ltd,2023,USD,1081949,323615,758334,409219,349115,18043,331072,10819,21638,309434,18004,637578,119041,518537,,1081949,20.0,13.75,0.1344,462,195.08,23876.22,0.75,0.7009
2944,Lawrence Carson and Kelly,False,GB,Morrisport,Energy,2014,https://lawrencecarsonandkelly.com,Human international industry always until over theory could.,23,lawrence-carson-and-kelly,2023,USD,1935805,539804,1396001,956850,439151,2613,436538,19358,38716,397822,1065144,2130366,856418,1273948,,1935805,20.0,79.35,0.0669,8065,20.0,66000.13,16.14,0.7211
2945,Anderson-Turner,False,KE,Patriciaville,EdTech,2017,https://anderson-turner.com,Pm force ready receive certainly institution individual suffer.,20,anderson-turner,2023,USD,294202,164137,130065,107232,22833,4507,18326,2942,5884,12442,11891,327072,143091,183981,24516.83,294202,96.04,356.42,0.0196,203,120.41,30461.83,0.39,0.4421
2946,Cochran Castillo and Olsen,False,ZA,Port John,Marketplaces,2014,https://cochrancastilloandolsen.com,Stock job success financial choice behavior environment.,14,cochran-castillo-and-olsen,2023,USD,1456105,444944,1011161,272260,738901,28207,710694,14561,29122,681572,15075,924494,377056,547438,,1456105,124.73,163.24,0.1007,6067,20.0,19737.42,0.76,0.6944
2947,West-Mccarty,False,TN,South Mistyburgh,HealthTech,2021,https://west-mccarty.com,Subject trial side apply increase assume degree movement as practice.,27,west-mccarty,2023,USD,1468940,555410,913530,1044456,-130926,1888,-132814,14689,29378,-162192,30087,921565,349858,571707,122411.67,1468940,225.17,1365.35,0.0238,3031,40.38,91291.67,0.33,0.6219
2948,Barron-Barnett,False,AU,Richardsonberg,HealthTech,2008,https://barron-barnett.com,Eight yourself hard throw gun involve.,17,barron-barnett,2023,USD,847802,259739,588063,455974,132089,0,132089,8478,16956,115133,13606,553650,186664,366986,70650.17,847802,26.6,104.85,0.0555,4030,17.53,11463.22,1.19,0.6936
2949,Anderson Ltd,False,IN,East Kathleenside,AgriTech,2015,https://andersonltd.com,Scene in push itself few appear their.,22,anderson-ltd,2023,USD,592282,113480,478802,157353,321449,0,321449,5922,11845,309604,109682,528834,67939,460895,,592282,1577.75,10014.64,0.0839,2467,20.0,6130.08,17.89,0.8084
2950,Williamson Thornton and Dixon,False,KE,West Erinmouth,Mobility,2015,https://williamsonthorntonanddixon.com,Fund spring energy conference picture who.,24,williamson-thornton-and-dixon,2023,USD,1218720,384955,833765,846346,-12581,0,-12581,12187,24374,-36955,90943,821614,340095,481519,,1218720,20.0,134.53,0.0408,602,168.54,68630.88,1.33,0.6841
2951,Martinez-Duke,False,CA,Draketown,IoT,2022,https://martinez-duke.com,Really memory structure easy whatever medical why lawyer four.,24,martinez-duke,2023,USD,163826,47759,116067,8191,107876,0,107876,1638,3276,104600,11709,216050,100225,115825,,163826,20.0,90.57,0.0628,62,219.98,1000.0,11.71,0.7085
2952,Sanchez LLC,False,FR,South Emilyland,SaaS,2023,https://sanchezllc.com,Thank fish hear theory those catch employee serve public.,23,sanchez-llc,2023,EUR,6443725,3013933,3429792,926717,2503075,33085,2469990,64437,128874,2341116,477488,3714104,800168,2913936,536977.08,6443725,125.3,393.6,0.0426,9164,58.59,43685.21,10.93,0.5323
2953,Mack-Butler,False,GB,Christianton,E-commerce,2020,https://mack-butler.com,Pattern product popular board person site give option.,19,mack-butler,2023,USD,276135,135811,140324,174015,-33691,21552,-55243,2761,5522,-60765,23026,195422,9771,185651,,276135,1461.21,6310.75,0.001,109,210.88,23226.6,0.99,0.5082
2954,Fowler and Sons,False,BR,Johntown,EdTech,2020,https://fowlerandsons.com,Budget movement her direction shake site even.,22,fowler-and-sons,2023,USD,119214,44939,74275,59131,15144,4848,10296,1192,2384,7912,9738,227922,53997,173925,9934.5,119214,210.63,1309.23,0.001,1986,5.0,32969.93,0.3,0.623
2955,Payne Ltd,False,ZA,Jonathantown,Energy,2016,https://payneltd.com,Once close treat senior blue.,21,payne-ltd,2023,USD,2159779,707652,1452127,994587,457540,0,457540,21597,43195,414345,111460,1346650,508986,837664,,2159779,873.21,1430.39,0.034,2107,85.39,105329.15,1.06,0.6723
2956,Villa-Williams,False,FR,Castrobury,Fintech,2009,https://villa-williams.com,They garden country agree.,14,villa-williams,2023,EUR,287431,129909,157522,184247,-26725,4209,-30934,2874,5748,-36682,19260,261654,99046,162608,,287431,423.43,1454.3,0.0126,362,66.12,1000.0,19.26,0.548
2957,Allen LLC,False,US,East Julie,E-commerce,2015,https://allenllc.com,They central throw race shoulder happy.,22,allen-llc,2023,USD,1264481,582044,682437,1174185,-491748,0,-491748,12644,25289,-517037,20628,851724,410789,440935,,1264481,727.03,3407.56,0.001,1000,105.33,116909.24,0.18,0.5397
2958,Ayers-Hardy,False,EG,Fuenteshaven,E-commerce,2009,https://ayers-hardy.com,Parent he someone run kind reality strong.,19,ayers-hardy,2023,USD,1731818,620414,1111404,335352,776052,3761,772291,17318,34636,737655,63138,1015948,353269,662679,,1731818,724.06,3548.66,0.0415,6687,21.58,19356.29,3.26,0.6418
2959,Wheeler PLC,False,US,Jaredtown,AgriTech,2024,https://wheelerplc.com,Radio bag much meet seven natural most cost thing vote.,21,wheeler-plc,2023,USD,778821,406231,372590,396675,-24085,0,-24085,7788,15576,-39661,24337,578373,337829,240544,,778821,20.0,49.54,0.0981,531,122.22,25921.71,0.94,0.4784
2960,Shelton PLC,False,KE,Timothyhaven,Energy,2017,https://sheltonplc.com,Page million activity take night none sport.,21,shelton-plc,2023,USD,356099,187778,168321,91250,77071,22152,54919,3560,7121,47798,33429,266350,101399,164951,,356099,333.37,1621.7,0.1258,95,311.16,9570.75,3.49,0.4727
2961,Schneider Vincent and Becker,False,TN,Richardtown,Marketplaces,2019,https://schneidervincentandbecker.com,Send game information protect quickly help life time treatment.,25,schneider-vincent-and-becker,2023,USD,503464,127024,376440,394335,-17895,11135,-29030,5034,10069,-39099,15183,319418,117808,201610,,503464,20.0,34.62,0.025,278,150.59,8595.66,1.77,0.7477
2962,Garcia-Ferguson,False,GB,Kellymouth,AI/ML,2009,https://garcia-ferguson.com,Apply often that professor alone game word town.,24,garcia-ferguson,2023,USD,691850,264032,427818,113280,314538,0,314538,6918,13837,300701,8431,371820,208961,162859,,691850,20.0,30.21,0.1263,2882,20.0,1440.85,5.85,0.6184
2963,King PLC,False,KE,South Tinaborough,HealthTech,2016,https://kingplc.com,Again human employee mouth lose manager pass among fear some.,24,king-plc,2023,USD,646068,309451,336617,299010,37607,6831,30776,6460,12921,17855,11498,366842,203303,163539,53839.0,646068,10.0,51.06,0.0402,1002,53.69,1000.0,11.5,0.521
2964,Smith-Woods,False,GB,New Timothyside,AI/ML,2023,https://smith-woods.com,See a attack around cultural huge travel particular wife author house.,25,smith-woods,2023,USD,1360490,483737,876753,804329,72424,11286,61138,13604,27209,33929,27913,829794,432915,396879,,1360490,633.44,316.72,0.001,597,189.78,49723.84,0.56,0.6444
2965,King Martinez and Hamilton,False,CA,Perrychester,Mobility,2012,https://kingmartinezandhamilton.com,Low yard major of get kitchen inside.,16,king-martinez-and-hamilton,2023,USD,1969809,532639,1437170,98490,1338680,9383,1329297,19698,39396,1289901,60811,1071412,550402,521010,,1969809,20.0,33.28,0.0686,8207,20.0,1000.0,60.81,0.7296
2966,Hinton Ltd,False,FR,New Johnborough,E-commerce,2024,https://hintonltd.com,Prepare away hit player.,22,hinton-ltd,2023,EUR,319981,68621,251360,158991,92369,0,92369,3199,6399,85970,25354,378039,172487,205552,,319981,1138.82,6661.56,0.0794,120,221.43,17352.14,1.46,0.7855
2967,Walker Davis and Moore,False,TN,North Maryfort,HealthTech,2016,https://walkerdavisandmoore.com,Attorney scene then represent environmental we near.,15,walker-davis-and-moore,2023,USD,1769837,595857,1173980,194735,979245,0,979245,17698,35396,943849,757890,1689363,258156,1431207,147486.42,1769837,61.82,322.82,0.0268,14646,10.07,1000.0,757.89,0.6633
2968,Pratt and Sons,False,FR,North Raymond,E-commerce,2009,https://prattandsons.com,Defense surface feel student edge exactly.,18,pratt-and-sons,2023,EUR,3772055,1022967,2749088,3180424,-431336,14112,-445448,37720,75441,-520889,44581,2029780,159695,1870085,,3772055,563.49,2388.94,0.001,1152,272.86,294670.27,0.15,0.7288
2969,Johnson Inc,False,GB,Brownmouth,Mobility,2016,https://johnsoninc.com,Man laugh mother peace authority business brother.,23,johnson-inc,2023,USD,2649213,175201,2474012,1758050,715962,24821,691141,26492,52984,638157,267491,1699898,688527,1011371,,2649213,230.01,372.66,0.0841,1329,166.02,167539.53,1.6,0.9339
2970,Stevens PLC,False,ZA,New Donnafort,E-commerce,2021,https://stevensplc.com,Special story result risk pretty lay same should even point question.,23,stevens-plc,2023,USD,1407856,508601,899255,454930,444325,0,444325,14078,28157,416168,246412,968195,238256,729939,,1407856,81.24,300.11,0.0074,2800,41.9,23695.0,10.4,0.6387
2971,Rivera Soto and Gibson,False,IN,Shannontown,AgriTech,2016,https://riverasotoandgibson.com,South different pick that floor open road.,23,rivera-soto-and-gibson,2023,USD,283267,90941,192326,67850,124476,0,124476,2832,5665,118811,72398,284028,83008,201020,,283267,20.0,16.48,0.115,109,214.65,16904.98,4.28,0.679
2972,Tate-Huynh,False,NG,Port Teresashire,E-commerce,2021,https://tate-huynh.com,Respond once personal score walk more music table fire describe amount.,23,tate-huynh,2023,USD,929814,209858,719956,208204,511752,13034,498718,9298,18596,480122,125055,787970,91559,696411,,929814,1331.74,6482.39,0.0608,376,205.91,15479.04,8.08,0.7743
2973,Roberts and Sons,False,GB,West Natalie,E-commerce,2023,https://robertsandsons.com,Enough stand company skin support.,24,roberts-and-sons,2023,USD,3861779,1046317,2815462,686780,2128682,0,2128682,38617,77235,2051447,73728,2029857,844131,1185726,,3861779,801.42,3762.9,0.0345,16090,20.0,68362.11,1.08,0.7291
2974,Johnson Group,False,AU,Baileyview,HealthTech,2022,https://johnsongroup.com,Girl speech simply its fact represent way decision cause.,20,johnson-group,2023,USD,735492,251184,484308,239257,245051,20116,224935,7354,14709,210226,55764,482571,154408,328163,61291.0,735492,568.81,1207.89,0.0345,563,108.73,32736.13,1.7,0.6585
2975,Garcia and Sons,False,US,North James,EdTech,2012,https://garciaandsons.com,Medical bed soon compare home different easy ahead.,17,garcia-and-sons,2023,USD,196095,89573,106522,38671,67851,0,67851,1960,3921,63930,2403,274835,50525,224310,16341.25,196095,73.99,357.36,0.0503,2158,7.57,1000.0,2.4,0.5432
2976,Patton Ltd,False,US,Angelatown,EdTech,2013,https://pattonltd.com,Threat middle investment reason blue sign maybe few reduce discuss.,19,patton-ltd,2023,USD,994527,182600,811927,760017,51910,12501,39409,9945,19890,19519,333714,890479,172443,718036,82877.25,994527,658.62,3364.98,0.0523,16575,5.0,73981.69,4.51,0.8164
2977,Jarvis-Maldonado,False,US,Livingstonberg,Mobility,2016,https://jarvis-maldonado.com,Beyond knowledge reduce might a.,12,jarvis-maldonado,2023,USD,969346,509761,459585,441795,17790,43821,-26031,9693,19386,-45417,22285,552267,28714,523553,,969346,790.23,1324.77,0.0342,507,159.3,32835.77,0.68,0.4741
2978,Yoder Oconnell and Rosales,False,GB,Kiddchester,Cybersecurity,2022,https://yoderoconnellandrosales.com,Tree campaign free usually low stock later.,28,yoder-oconnell-and-rosales,2023,USD,4880264,2127295,2752969,3532679,-779710,22644,-802354,48802,97605,-899959,258187,2773790,1058338,1715452,,4880264,20.0,65.87,0.0602,2220,183.17,270150.6,0.96,0.5641
2979,Smith Inc,False,TN,Fergusonhaven,Fintech,2023,https://smithinc.com,Ever yeah story beyond line dog themselves style into.,14,smith-inc,2023,USD,441781,127705,314076,432161,-118085,5445,-123530,4417,8835,-132365,30186,291840,212206,79634,,441781,1498.98,749.49,0.0571,628,58.59,51190.47,0.59,0.7109
2980,Rogers Fields and Carter,False,US,West Gerald,Mobility,2019,https://rogersfieldsandcarter.com,Know here on now reason response specific determine stop.,24,rogers-fields-and-carter,2023,USD,907635,378671,528964,365668,163296,0,163296,9076,18152,145144,40436,687164,101220,585944,,907635,615.97,307.98,0.0213,1461,51.76,29215.74,1.38,0.5828
2981,Davis-Sims,False,ZA,Johnsonburgh,AI/ML,2023,https://davis-sims.com,Prevent science air enter right think good.,16,davis-sims,2023,USD,2111440,973789,1137651,1431059,-293408,16328,-309736,21114,42228,-351964,32152,1163803,401858,761945,,2111440,615.82,2784.03,0.0841,8797,20.0,125685.02,0.26,0.5388
2982,Burch Shelton and Flynn,False,EG,West Dawnville,Mobility,2011,https://burchsheltonandflynn.com,Particular here property scene cell around film treat character response industry.,29,burch-shelton-and-flynn,2023,USD,405479,165776,239703,119681,120022,11817,108205,4054,8109,100096,17945,368538,202240,166298,,405479,20.0,30.88,0.1182,414,81.49,28986.98,0.62,0.5912
2983,Davis Fowler and Day,False,ZA,Gloriabury,HealthTech,2011,https://davisfowlerandday.com,Source measure fact hour under write staff.,20,davis-fowler-and-day,2023,USD,273857,101075,172782,204382,-31600,0,-31600,2738,5477,-37077,17382,220617,121241,99376,22821.42,273857,70.95,408.82,0.0215,446,51.06,20726.6,0.84,0.6309
2984,Compton Valenzuela and Smith,False,CA,New Jill,Fintech,2014,https://comptonvalenzuelaandsmith.com,Beautiful rest role huge product social cover wife offer around.,19,compton-valenzuela-and-smith,2023,USD,5045070,1973348,3071722,3010774,60948,48547,12401,50450,100901,-88500,260499,2846958,2103926,743032,,5045070,262.07,131.04,0.0415,21021,20.0,249354.19,1.04,0.6089
2985,Fowler and Sons,False,IN,Sarahview,HealthTech,2013,https://fowlerandsons.com,Daughter economic itself article you mission kitchen pick serious TV.,27,fowler-and-sons,2023,USD,549893,77733,472160,322420,149740,0,149740,5498,10997,138743,5244,312103,93001,219102,45824.42,549893,285.71,1387.16,0.0726,900,50.88,1000.0,5.24,0.8586
2986,Freeman-Phillips,False,ZA,Clintonchester,AI/ML,2016,https://freeman-phillips.com,Hold behind Mr seat drop pay experience feeling owner.,32,freeman-phillips,2023,USD,222001,33589,188412,96412,92000,0,92000,2220,4440,87560,3045,259997,105177,154820,,222001,253.76,516.9,0.0543,925,20.0,28456.86,0.11,0.8487
2987,Taylor PLC,False,KE,Lake Kevin,Marketplaces,2014,https://taylorplc.com,Agency rest point on friend inside collection remember American.,19,taylor-plc,2023,USD,334095,85706,248389,81593,166796,6363,160433,3340,6681,153752,28187,258773,108597,150176,,334095,20.0,35.93,0.0985,1392,20.0,9153.71,3.08,0.7435
2988,Bailey-Fox,False,KE,South Donald,SaaS,2024,https://bailey-fox.com,Town development technology cost miss candidate shoulder subject treatment.,21,bailey-fox,2023,USD,2358703,532112,1826591,1540576,286015,0,286015,23587,47174,238841,69071,1388764,199208,1189556,196558.58,2358703,164.7,349.5,0.0036,2894,67.9,130464.86,0.53,0.7744
2989,Mcgrath-Walker,False,AU,West Laurenmouth,IoT,2013,https://mcgrath-walker.com,End would interesting resource sure can husband.,15,mcgrath-walker,2023,USD,440363,207105,233258,22018,211240,143,211097,4403,8807,202290,22723,441363,212858,228505,,440363,20.0,69.35,0.0317,231,158.74,1000.0,22.72,0.5297
2990,Morales Yates and Bentley,False,TN,South Brittanyland,Fintech,2015,https://moralesyatesandbentley.com,Have leave easy reach century network foreign politics ahead.,13,morales-yates-and-bentley,2023,USD,1793073,437186,1355887,896917,458970,0,458970,17930,35861,423109,17094,967339,319126,648213,,1793073,20.0,89.1,0.001,7471,20.0,60392.42,0.28,0.7562
2991,Flowers Smith and Johnson,False,AU,Greenmouth,Mobility,2011,https://flowerssmithandjohnson.com,Western machine information movement military boy nation economic condition job.,20,flowers-smith-and-johnson,2023,USD,139428,57966,81462,85611,-4149,0,-4149,1394,2788,-6937,12099,149393,67706,81687,,139428,1723.34,861.67,0.0109,44,259.93,1000.0,12.1,0.5843
2992,Nichols-Young,False,CA,Catherineside,SaaS,2017,https://nichols-young.com,Pm them camera eight camera step.,18,nichols-young,2023,USD,601438,208111,393327,244847,148480,0,148480,6014,12028,136452,9914,446747,22337,424410,50119.83,601438,245.94,1785.08,0.001,1094,45.78,47520.88,0.21,0.654
2993,Herrera Hughes and Smith,False,BR,West Lindsay,Marketplaces,2011,https://herrerahughesandsmith.com,Blue interest stop find blood energy billion.,22,herrera-hughes-and-smith,2023,USD,417796,168769,249027,282293,-33266,10883,-44149,4177,8355,-52504,29848,335694,150127,185567,,417796,20.0,10.0,0.0053,204,169.86,17357.54,1.72,0.596
2994,Rios Johnson and Garcia,False,TN,Linshire,E-commerce,2011,https://riosjohnsonandgarcia.com,Picture stock media present wait.,9,rios-johnson-and-garcia,2023,USD,1021744,287155,734589,547619,186970,0,186970,10217,20434,166536,113931,634713,272503,362210,,1021744,20.0,86.15,0.0536,4257,20.0,56875.98,2.0,0.719
2995,Meyer-Campbell,False,CA,Lake Corymouth,HealthTech,2008,https://meyer-campbell.com,Available though woman recently trip history maybe full still.,22,meyer-campbell,2023,USD,667061,263902,403159,216270,186889,11530,175359,6670,13341,162018,361465,893744,519722,374022,55588.42,667061,388.37,1531.19,0.001,781,71.13,12715.63,28.43,0.6044
2996,Smith Garza and Maldonado,False,FR,Josephshire,Mobility,2023,https://smithgarzaandmaldonado.com,Add moment prevent agreement soon there Mrs.,16,smith-garza-and-maldonado,2023,EUR,1070742,331169,739573,688360,51213,30115,21098,10707,21414,-316,63518,797441,139556,657885,,1070742,816.09,3393.53,0.0246,535,166.55,72668.25,0.87,0.6907
2997,Moore Knight and Williams,False,EG,Greenville,Marketplaces,2016,https://mooreknightandwilliams.com,Pay home new far choice north let edge camera indeed.,19,moore-knight-and-williams,2023,USD,383055,126240,256815,198726,58089,0,58089,3830,7661,50428,12158,345041,221222,123819,,383055,1825.84,5572.94,0.0393,580,55.03,1000.0,12.16,0.6704
2998,Peters-Burch,False,KE,East Johnfurt,Marketplaces,2008,https://peters-burch.com,Information wrong analysis actually account often agent than.,17,peters-burch,2023,USD,1119732,343754,775978,705392,70586,20235,50351,11197,22394,27957,22982,747352,315159,432193,,1119732,165.44,233.73,0.0184,887,105.19,86408.26,0.27,0.693
2999,Tate Dixon and Smith,False,CA,North Aaron,SaaS,2022,https://tatedixonandsmith.com,Lay child will tend save picture.,24,tate-dixon-and-smith,2023,USD,599819,248412,351407,545952,-194545,7775,-202320,5998,11996,-214316,66187,430927,107264,323663,49984.92,599819,146.26,810.3,0.0178,9996,5.0,67112.44,0.99,0.5859
3000,Rios Burton and Williams,False,CA,North Shawn,Cybersecurity,2012,https://riosburtonandwilliams.com,World my tonight interest scene.,30,rios-burton-and-williams,2023,USD,175768,37349,138419,114284,24135,0,24135,1757,3515,20620,50707,274913,154130,120783,,175768,898.36,3529.51,0.024,234,62.34,1286.29,39.42,0.7875
3001,Harris Ltd,False,DE,Grayfurt,SaaS,2017,https://harrisltd.com,Both especially give within attack official.,21,harris-ltd,2023,EUR,782316,236341,545975,306427,239548,38126,201422,7823,15646,185776,176082,573423,395249,178174,65193.0,782316,147.15,933.49,0.001,1226,53.15,26660.38,6.6,0.6979
3002,Brown Smith and Osborne,False,CA,South Jessica,SaaS,2010,https://brownsmithandosborne.com,Production story reason final start choice next describe Mrs system fill.,18,brown-smith-and-osborne,2023,USD,419936,187493,232443,269038,-36595,0,-36595,4199,8398,-44993,22436,259565,128332,131233,34994.67,419936,83.76,443.24,0.0612,339,103.15,4052.99,5.54,0.5535
3003,Warner Group,False,NG,New Brandi,IoT,2020,https://warnergroup.com,Maintain pretty past go because participant side second vote growth.,17,warner-group,2023,USD,3833311,1454507,2378804,2598272,-219468,0,-219468,38333,76666,-296134,116761,2233241,734491,1498750,,3833311,880.09,4086.24,0.0459,1580,202.17,199809.58,0.58,0.6206
3004,Gordon Gibson and Burch,False,FR,West Ricardo,Energy,2016,https://gordongibsonandburch.com,Positive staff best itself production ago.,25,gordon-gibson-and-burch,2023,EUR,4300670,2494109,1806561,598648,1207913,0,1207913,43006,86013,1121900,739466,2955823,978264,1977559,,4300670,20.0,85.99,0.085,1834,195.39,66741.63,11.08,0.4201
3005,Choi-Peters,False,GB,Jaredberg,EdTech,2020,https://choi-peters.com,Important even one protect arm smile put statement particular ask.,23,choi-peters,2023,USD,295641,94818,200823,184871,15952,0,15952,2956,5912,10040,3444,198220,46236,151984,24636.75,295641,294.88,1286.87,0.0439,943,26.11,1000.0,3.44,0.6793
3006,Knight-Burton,False,FR,Lake Bobby,SaaS,2014,https://knight-burton.com,Other trouble past room benefit foreign enjoy must special.,26,knight-burton,2023,EUR,870389,273332,597057,587742,9315,13546,-4231,8703,17407,-21638,40914,533397,306035,227362,72532.42,870389,10.0,42.08,0.0394,14506,5.0,78407.33,0.52,0.686
3007,Farley Mullen and Kennedy,False,GB,New Joshua,Energy,2020,https://farleymullenandkennedy.com,Feeling school establish either success office company contain treat might.,16,farley-mullen-and-kennedy,2023,USD,1179590,198245,981345,955792,25553,22735,2818,11795,23591,-20773,77777,671320,427342,243978,,1179590,1081.16,5235.55,0.1227,570,172.17,63261.76,1.23,0.8319
3008,Reed-Fernandez,False,IN,South Dianetown,Marketplaces,2012,https://reed-fernandez.com,Newspaper product green soon ball.,19,reed-fernandez,2023,USD,491752,167113,324639,239675,84964,1461,83503,4917,9835,73668,119484,371068,162393,208675,,491752,474.33,567.96,0.1152,201,203.14,12817.0,9.32,0.6602
3009,Mitchell-Clark,False,FR,Seanberg,AgriTech,2023,https://mitchell-clark.com,Can gas standard recently health player matter reduce natural interesting outside.,17,mitchell-clark,2023,EUR,163873,66531,97342,138209,-40867,18566,-59433,1638,3277,-62710,16263,128672,6433,122239,,163873,283.18,726.41,0.0784,97,139.85,42870.75,0.38,0.594
3010,Smith LLC,False,AU,East Kimberlyfurt,Energy,2017,https://smithllc.com,Event cost per wonder experience low.,25,smith-llc,2023,USD,1046608,474988,571620,465945,105675,15491,90184,10466,20932,69252,390318,1029087,51454,977633,,1046608,296.86,637.2,0.001,328,265.51,42705.74,9.14,0.5462
3011,Smith LLC,False,BR,New Heatherfurt,IoT,2012,https://smithllc.com,Tough final especially interesting perform growth which ready today.,24,smith-llc,2023,USD,838932,263141,575791,462603,113188,27189,85999,8389,16778,69221,102270,584718,277324,307394,,838932,20.0,58.8,0.0889,269,259.08,1000.0,102.27,0.6863
3012,Patel-Washington,False,CA,Hugheston,Marketplaces,2011,https://patel-washington.com,Defense keep protect owner war behind six arm respond stop.,13,patel-washington,2023,USD,3315748,1465930,1849818,850634,999184,31996,967188,33157,66314,900874,169208,1898788,676570,1222218,,3315748,456.17,2027.06,0.0637,1118,246.97,59477.65,2.84,0.5579
3013,Adams Group,False,CA,Courtneyland,AI/ML,2014,https://adamsgroup.com,Add enough simple animal child crime firm test live.,25,adams-group,2023,USD,1715399,473258,1242141,176912,1065229,9136,1056093,17153,34307,1021786,47932,1004405,315898,688507,,1715399,246.99,1369.35,0.0111,3138,45.55,11145.13,4.3,0.7241
3014,Bryant-Lewis,False,EG,Haneyburgh,Mobility,2020,https://bryant-lewis.com,Support her whatever growth ground catch meeting newspaper wait.,13,bryant-lewis,2023,USD,583025,295368,287657,318284,-30627,32413,-63040,5830,11660,-74700,2026,461449,223699,237750,,583025,20.0,67.6,0.0417,260,186.78,34442.73,0.06,0.4934
3015,Ward Hardy and Simmons,False,EG,Adamshaven,AgriTech,2021,https://wardhardyandsimmons.com,Modern price finally win list difference anything compare good.,21,ward-hardy-and-simmons,2023,USD,1731498,360716,1370782,584543,786239,0,786239,17314,34629,751610,50547,1073708,138199,935509,,1731498,1444.18,722.09,0.0505,7214,20.0,39044.62,1.29,0.7917
3016,Davidson-Peterson,False,FR,East Justin,Energy,2019,https://davidson-peterson.com,Meeting carry enter phone meet explain accept stand ready find along.,12,davidson-peterson,2023,EUR,842891,401930,440961,659202,-218241,13526,-231767,8428,16857,-248624,33282,602457,361031,241426,,842891,2902.99,18932.87,0.001,170,411.39,51095.81,0.65,0.5232
3017,Mcgee Lewis and Gonzalez,False,KE,South Carriemouth,HealthTech,2021,https://mcgeelewisandgonzalez.com,Table mission opportunity possible cup.,23,mcgee-lewis-and-gonzalez,2023,USD,687638,349919,337719,223881,113838,9486,104352,6876,13752,90600,37119,415660,185374,230286,57303.17,687638,10.0,40.89,0.0622,1524,37.6,1000.0,37.12,0.4911
3018,Alexander Baxter and Pena,False,BR,Markview,Energy,2010,https://alexanderbaxterandpena.com,Concern modern billion course this positive.,26,alexander-baxter-and-pena,2023,USD,8090263,2784121,5306142,1841177,3464965,15851,3449114,80902,161805,3287309,864823,5071913,1012566,4059347,,8090263,812.99,2969.49,0.0604,8910,75.66,149453.07,5.79,0.6559
3019,Jones-Contreras,False,US,Boonemouth,AI/ML,2018,https://jones-contreras.com,Ball accept blue really kid.,24,jones-contreras,2023,USD,4193046,2013027,2180019,3159524,-979505,6746,-986251,41930,83860,-1070111,2871094,5063123,313313,4749810,,4193046,774.62,2269.3,0.0359,4879,71.61,266402.11,10.78,0.5199
3020,Phillips-Meyers,False,EG,Williamsview,Marketplaces,2015,https://phillips-meyers.com,Perhaps able or forward choice between election range of even.,21,phillips-meyers,2023,USD,813594,465035,348559,166865,181694,0,181694,8135,16271,165423,655734,1190207,391170,799037,,813594,20.0,59.43,0.0459,3389,20.0,1000.0,655.73,0.4284
3021,Lutz-Harris,False,BR,Kimberlyfurt,Marketplaces,2012,https://lutz-harris.com,Mouth defense measure bank place before two program source him.,17,lutz-harris,2023,USD,310448,101307,209141,175840,33301,0,33301,3104,6208,27093,16322,299931,78957,220974,,310448,1470.47,2204.59,0.0148,1293,20.0,1000.0,16.32,0.6737
3022,Stewart Craig and Fernandez,False,EG,North Kristine,AI/ML,2024,https://stewartcraigandfernandez.com,Play class attack reason student save policy agree fly.,15,stewart-craig-and-fernandez,2023,USD,413570,107718,305852,270696,35156,28343,6813,4135,8271,-1458,5979,263793,87447,176346,,413570,103.61,458.7,0.0268,213,161.05,28067.79,0.21,0.7395
3023,Brown Haney and Smith,False,FR,Heidifort,AgriTech,2022,https://brownhaneyandsmith.com,Artist trade yet mother upon unit perform.,20,brown-haney-and-smith,2023,EUR,797763,366550,431213,39888,391325,3131,388194,7977,15955,372239,157084,638585,72193,566392,,797763,381.46,2478.03,0.0288,3324,20.0,1000.0,157.08,0.5405
3024,Farmer Dunlap and Henderson,False,TN,Nicholasville,Fintech,2023,https://farmerdunlapandhenderson.com,Indeed bed alone million late decide.,24,farmer-dunlap-and-henderson,2023,USD,1016150,399577,616573,254806,361767,32,361735,10161,20323,341412,207607,820219,181348,638871,,1016150,20.0,87.17,0.0466,607,139.5,29813.57,6.96,0.6068
3025,Neal Allen and Perkins,False,IN,Danielbury,HealthTech,2012,https://nealallenandperkins.com,Foreign response cut specific realize argue see.,9,neal-allen-and-perkins,2023,USD,1818497,630479,1188018,1096553,91465,25039,66426,18184,36369,30057,27585,1049313,221138,828175,151541.42,1818497,10.0,42.85,0.0327,2172,69.77,73337.47,0.38,0.6533
3026,Bailey-Copeland,False,BR,North Katieburgh,AgriTech,2015,https://bailey-copeland.com,Establish debate bill situation others method in card red.,16,bailey-copeland,2023,USD,250311,107868,142443,177339,-34896,15199,-50095,2503,5006,-55101,8075,240541,40492,200049,,250311,1754.18,1005.18,0.001,1042,20.0,39054.7,0.21,0.5691
3027,Harris Group,False,NG,Cynthiaton,Energy,2017,https://harrisgroup.com,Modern avoid while able place machine.,24,harris-group,2023,USD,3195687,1474661,1721026,1845712,-124686,0,-124686,31956,63913,-188599,43780,1790661,1271461,519200,,3195687,1393.28,4813.54,0.0038,13315,20.0,158088.17,0.28,0.5385
3028,Greer LLC,False,KE,East Joshua,SaaS,2010,https://greerllc.com,Able power whom section wife decade right huge available.,19,greer-llc,2023,USD,267828,58299,209529,206874,2655,0,2655,2678,5356,-2701,13041,252203,47919,204284,22319.0,267828,85.92,187.44,0.0695,4463,5.0,5572.63,2.34,0.7823
3029,Little-Vargas,False,US,Johnsonburgh,AI/ML,2011,https://little-vargas.com,Character growth reveal because question what direction go.,20,little-vargas,2023,USD,1861438,1015660,845778,730850,114928,0,114928,18614,37228,77700,91736,1131527,489963,641564,,1861438,216.13,108.06,0.001,1224,126.71,32281.89,2.84,0.4544
3030,Wells Ltd,False,NG,Lake Patrick,Energy,2021,https://wellsltd.com,Hand enjoy season probably movie college anything third center.,23,wells-ltd,2023,USD,1398975,265274,1133701,1059013,74688,0,74688,13989,27979,46709,865832,1721495,386886,1334609,,1398975,20.0,55.63,0.1203,395,294.8,90677.97,9.55,0.8104
3031,Frey Cook and Rios,False,FR,East Jonathan,Mobility,2016,https://freycookandrios.com,Until usually sort to animal if baby break.,19,frey-cook-and-rios,2023,EUR,1943687,898999,1044688,1650036,-605348,0,-605348,19436,38873,-644221,362998,1421137,668701,752436,,1943687,1588.8,3951.91,0.026,651,248.53,135748.08,2.67,0.5375
3032,Salazar Inc,False,CA,Michaelhaven,AgriTech,2010,https://salazarinc.com,Career hair play cultural appear man sell industry some woman.,18,salazar-inc,2023,USD,325871,157572,168299,101218,67081,6466,60615,3258,6517,54098,26229,324083,119969,204114,,325871,290.4,1134.92,0.1,235,115.5,8083.4,3.24,0.5165
3033,Perez Cook and Dodson,False,AU,Allenstad,AI/ML,2008,https://perezcookanddodson.com,Never moment child end decide nor keep morning hope night.,22,perez-cook-and-dodson,2023,USD,4641046,1771928,2869118,1000925,1868193,30235,1837958,46410,92820,1745138,440716,2874595,1279365,1595230,,4641046,58.19,29.1,0.1142,5971,64.77,52556.22,8.39,0.6182
3034,Sawyer Ltd,False,FR,Tracyborough,Cybersecurity,2022,https://sawyerltd.com,Traditional about perhaps same call picture.,26,sawyer-ltd,2023,EUR,682183,205509,476674,359246,117428,0,117428,6821,13643,103785,30851,469879,260504,209375,,682183,20.0,68.01,0.0076,2842,20.0,35383.87,0.87,0.6987
3035,Lane LLC,False,GB,West Johnathanstad,HealthTech,2020,https://lanellc.com,Bill southern administration include stuff.,20,lane-llc,2023,USD,3462064,1346448,2115616,2385251,-269635,0,-269635,34620,69241,-338876,327076,2128655,950556,1178099,288505.33,3462064,10.0,27.23,0.0235,6069,47.53,173064.79,1.89,0.6111
3036,Casey-Black,False,US,Lake Raymondside,Fintech,2021,https://casey-black.com,Test market smile Republican card dark face among.,14,casey-black,2023,USD,601884,288603,313281,249184,64097,0,64097,6018,12037,52060,23671,414351,157558,256793,,601884,575.55,287.77,0.001,331,151.1,33245.09,0.71,0.5205
3037,Smith Group,False,ZA,Lake Caleb,AgriTech,2018,https://smithgroup.com,Test step system light suffer.,13,smith-group,2023,USD,239272,76490,162782,11963,150819,39585,111234,2392,4785,106449,10688,270142,95335,174807,,239272,20.0,85.2,0.1666,996,20.0,3772.53,2.83,0.6803
3038,Abbott Reyes and Allen,False,KE,Port Emilyland,Cybersecurity,2022,https://abbottreyesandallen.com,Word chair any student natural board staff.,19,abbott-reyes-and-allen,2023,USD,290342,52822,237520,112231,125289,15315,109974,2903,5806,104168,18926,273654,87923,185731,,290342,1751.59,5689.02,0.001,1209,20.0,17456.62,1.08,0.8181
3039,Moore Group,False,AU,West Aaronberg,Marketplaces,2022,https://mooregroup.com,Upon fear certainly scene choose expert against.,22,moore-group,2023,USD,353276,76629,276647,285033,-8386,0,-8386,3532,7065,-15451,25595,270811,63991,206820,,353276,46.38,286.79,0.0226,1471,20.0,27955.34,0.92,0.7831
3040,Vazquez Ltd,False,KE,North Anthonyborough,AgriTech,2018,https://vazquezltd.com,Language voice commercial process claim production.,20,vazquez-ltd,2023,USD,27643,9962,17681,1382,16299,13044,3255,276,552,2703,5441,120515,49122,71393,,27643,1998.3,999.15,0.0787,115,20.0,27643.0,0.2,0.6396
3041,Brown-Willis,False,AU,Bradleybury,HealthTech,2014,https://brown-willis.com,Discover class follow herself player machine improve open.,20,brown-willis,2023,USD,1776179,859550,916629,1339602,-422973,23518,-446491,17761,35523,-482014,63466,1013250,447716,565534,148014.92,1776179,75.35,550.97,0.001,2557,57.87,79732.61,0.8,0.5161
3042,Horton Hill and Moss,False,GB,Mitchellside,Fintech,2016,https://hortonhillandmoss.com,Than learn value democratic attorney every necessary a let our.,14,horton-hill-and-moss,2023,USD,382513,86907,295606,172423,123183,40966,82217,3825,7650,74567,27933,253065,103738,149327,,382513,400.1,705.45,0.1259,1593,20.0,1000.0,27.93,0.7728
3043,Sanchez-Spears,False,BR,Brownfort,Fintech,2021,https://sanchez-spears.com,Travel return free like right instead.,24,sanchez-spears,2023,USD,726090,287008,439082,250827,188255,42039,146216,7260,14521,131695,5039,557263,265387,291876,,726090,386.89,193.44,0.1191,567,106.61,33401.72,0.15,0.6047
3044,Reese-Sloan,False,NG,South Jacob,SaaS,2008,https://reese-sloan.com,Factor speech protect occur remain ten.,17,reese-sloan,2023,USD,659666,32983,626683,352366,274317,0,274317,6596,13193,261124,8649,354542,66108,288434,54972.17,659666,211.61,463.59,0.0201,10994,5.0,37809.33,0.23,0.95
3045,Stephens Ltd,False,TN,Lake Kevin,Fintech,2008,https://stephensltd.com,Choose evidence coach civil control civil morning development miss.,11,stephens-ltd,2023,USD,1601567,792132,809435,80078,729357,911,728446,16015,32031,696415,220285,1069028,53451,1015577,,1601567,678.49,3267.7,0.0259,6673,20.0,9722.86,22.66,0.5054
3046,Gonzalez LLC,False,GB,Lake Frank,Marketplaces,2023,https://gonzalezllc.com,Over agreement certain race sign technology fact would.,19,gonzalez-llc,2023,USD,345181,251004,94177,309070,-214893,0,-214893,3451,6903,-221796,14847,269181,135178,134003,,345181,1411.27,2413.84,0.0214,1438,20.0,31130.78,0.48,0.2728
3047,Rich Ltd,False,EG,West Kevinburgh,Cybersecurity,2020,https://richltd.com,Full civil opportunity choice specific hold push.,25,rich-ltd,2023,USD,1800318,465236,1335082,727451,607631,1917,605714,18003,36006,569708,234688,1288346,331062,957284,,1800318,20.0,114.0,0.0047,7501,20.0,89570.8,2.62,0.7416
3048,Ortega Newman and Walker,False,BR,Port Heidi,Cybersecurity,2023,https://orteganewmanandwalker.com,Alone increase choose whole reality cultural west everything.,22,ortega-newman-and-walker,2023,USD,684455,382907,301548,208626,92922,26854,66068,6844,13689,52379,37939,452829,225061,227768,,684455,45.79,72.97,0.0555,2851,20.0,26408.73,1.44,0.4406
3049,Leblanc-Trevino,False,IN,East Jennifer,IoT,2019,https://leblanc-trevino.com,Meet wall half person rule southern participant future several.,27,leblanc-trevino,2023,USD,331691,24643,307048,167411,139637,0,139637,3316,6633,133004,18800,218930,110803,108127,,331691,20.0,128.88,0.001,180,153.08,21624.44,0.87,0.9257
3050,Fowler Adams and Hoffman,False,ZA,Ashleyton,Marketplaces,2020,https://fowleradamsandhoffman.com,Record continue speak local different scientist race add lot nice.,22,fowler-adams-and-hoffman,2023,USD,2848633,657653,2190980,2940048,-749068,0,-749068,28486,56972,-806040,31235,1502528,992530,509998,,2848633,115.14,412.05,0.0356,1023,231.87,258039.49,0.12,0.7691
3051,Grant PLC,False,AU,Wesleyport,AgriTech,2010,https://grantplc.com,Race expect rest send collection people especially economic.,17,grant-plc,2023,USD,838937,429601,409336,277950,131386,11214,120172,8389,16778,103394,124155,649311,584379,64932,,838937,415.29,1699.77,0.0039,226,308.44,1000.0,124.16,0.4879
3052,Finley-James,False,GB,Blakefurt,HealthTech,2008,https://finley-james.com,Carry stuff leader voice very a common standard quality hard.,22,finley-james,2023,USD,1477439,897877,579562,73871,505691,0,505691,14774,29548,476143,29485,802043,194335,607708,123119.92,1477439,23.07,28.25,0.0582,2902,42.42,1000.0,29.48,0.3923
3053,Contreras Baker and Garrett,False,DE,Lake Elizabethstad,Fintech,2008,https://contrerasbakerandgarrett.com,School concern field author institution impact inside population.,18,contreras-baker-and-garrett,2023,EUR,2418000,1094544,1323456,1228008,95448,0,95448,24180,48360,47088,119507,1368806,484113,884693,,2418000,964.55,1912.73,0.0691,1233,163.3,119453.45,1.0,0.5473
3054,Hartman PLC,False,ZA,Stephaniemouth,EdTech,2008,https://hartmanplc.com,I low eat interest entire subject success foot cup resource.,14,hartman-plc,2023,USD,49441,21232,28209,39278,-11069,0,-11069,494,988,-12057,3366,91172,15406,75766,4120.08,49441,252.38,1211.99,0.0339,304,13.52,19566.83,0.17,0.5706
3055,Jordan LLC,False,DE,East Tiffany,Mobility,2012,https://jordanllc.com,Far determine than receive town.,23,jordan-llc,2023,EUR,878293,373367,504926,374012,130914,5059,125855,8782,17565,108290,19944,553327,176065,377262,,878293,382.01,2106.05,0.0648,3659,20.0,47382.99,0.42,0.5749
3056,Mendoza LLC,False,BR,Port Jennifer,EdTech,2021,https://mendozallc.com,Some amount assume put very move.,25,mendoza-llc,2023,USD,253821,60257,193564,106561,87003,8738,78265,2538,5076,73189,8588,259945,132609,127336,21151.75,253821,10.0,42.46,0.0851,335,62.97,1000.0,8.59,0.7626
3057,Lozano Harvey and Barry,False,BR,Johnland,AI/ML,2014,https://lozanoharveyandbarry.com,Clear guy scene side every know.,18,lozano-harvey-and-barry,2023,USD,516441,103049,413392,250780,162612,21122,141490,5164,10328,131162,35225,339188,104005,235183,,516441,922.79,2619.0,0.001,140,306.34,24164.39,1.46,0.8005
3058,Dunn-Brown,False,FR,Santosfurt,AgriTech,2022,https://dunn-brown.com,Example media physical than already work say.,26,dunn-brown,2023,EUR,743946,292968,450978,388961,62017,0,62017,7439,14878,47139,8672,429261,172574,256687,,743946,719.33,2439.11,0.0752,332,186.37,31610.83,0.27,0.6062
3059,Warren-Navarro,False,GB,Lake Benjaminberg,Mobility,2021,https://warren-navarro.com,Yourself wide model across hot policy wall.,23,warren-navarro,2023,USD,1077968,345359,732609,253671,478938,0,478938,10779,21559,457379,56291,713778,198157,515621,,1077968,20.0,18.34,0.0419,675,132.97,1000.0,56.29,0.6796
3060,Rodriguez PLC,False,US,Parkershire,Fintech,2013,https://rodriguezplc.com,Agent eight attorney area.,18,rodriguez-plc,2023,USD,2420934,971352,1449582,953463,496119,0,496119,24209,48418,447701,545594,1843397,1360236,483161,,2420934,463.75,1690.92,0.001,10087,20.0,46348.4,11.77,0.5988
3061,Brown Jackson and Lee,False,GB,Lake Maryport,Cybersecurity,2022,https://brownjacksonandlee.com,Common air nothing debate require increase argue enter candidate arrive.,23,brown-jackson-and-lee,2023,USD,3853495,970229,2883266,2089651,793615,5777,787838,38534,77069,710769,174600,2111025,576889,1534136,,3853495,504.38,1536.29,0.0516,1103,290.9,172574.23,1.01,0.7482
3062,Lambert LLC,False,EG,North Anthony,Mobility,2008,https://lambertllc.com,Have act because road message near although indeed.,18,lambert-llc,2023,USD,254588,79586,175002,151325,23677,39993,-16316,2545,5091,-21407,11707,251605,33637,217968,,254588,198.16,446.85,0.0678,1060,20.0,14307.07,0.82,0.6874
3063,Wallace-Patrick,False,EG,West Darrenhaven,IoT,2015,https://wallace-patrick.com,Generation author idea note build rest use.,21,wallace-patrick,2023,USD,467464,177157,290307,467715,-177408,30728,-208136,4674,9349,-217485,28850,448493,33810,414683,,467464,796.26,2841.3,0.001,136,286.2,65471.26,0.44,0.621
3064,Williams-Moore,False,DE,Kimberlyside,AgriTech,2020,https://williams-moore.com,Boy who business bad remember company right suffer.,28,williams-moore,2023,EUR,1099328,192029,907299,202074,705225,0,705225,10993,21986,683239,34357,634566,246504,388062,,1099328,20.0,53.01,0.0429,1769,51.76,42339.51,0.81,0.8253
3065,Clark-Wood,False,US,West Daniel,E-commerce,2008,https://clark-wood.com,Bit tax white action effort recently material water.,21,clark-wood,2023,USD,656265,312347,343918,341127,2791,0,2791,6562,13125,-10334,7439,489614,139764,349850,,656265,1649.36,7155.71,0.0621,372,146.74,32387.4,0.23,0.5241
3066,Lewis-Atkinson,False,FR,South Jamesland,Marketplaces,2021,https://lewis-atkinson.com,Certainly just focus all possible fill.,23,lewis-atkinson,2023,EUR,275043,87732,187311,218257,-30946,0,-30946,2750,5500,-36446,24281,358908,17945,340963,,275043,20.0,107.46,0.1308,1146,20.0,4095.62,5.93,0.681
3067,Adkins Turner and Smith,False,TN,Ballton,Mobility,2017,https://adkinsturnerandsmith.com,Investment or fish war spend imagine between address us save party.,25,adkins-turner-and-smith,2023,USD,4498972,1655923,2843049,1531086,1311963,0,1311963,44989,89979,1221984,67868,2432199,1643589,788610,,4498972,833.69,416.84,0.0141,3448,108.71,139303.81,0.49,0.6319
3068,Casey PLC,False,US,Port Janetview,Mobility,2020,https://caseyplc.com,Agent organization raise box strong.,22,casey-plc,2023,USD,4836585,1200898,3635687,2537344,1098343,16710,1081633,48365,96731,984902,1435250,4006072,1590099,2415973,,4836585,20.0,52.11,0.0046,3815,105.63,205178.41,7.0,0.7517
3069,Hayes Zimmerman and Mcknight,False,EG,Lake Jaclyn,AI/ML,2023,https://hayeszimmermanandmcknight.com,Might language together run friend option.,21,hayes-zimmerman-and-mcknight,2023,USD,840176,222414,617762,107910,509852,17786,492066,8401,16803,475263,14762,515330,219587,295743,,840176,1001.33,983.07,0.001,3364,20.81,1000.0,14.76,0.7353
3070,Dean-Mcbride,False,DE,Cynthiaport,Cybersecurity,2009,https://dean-mcbride.com,Start chance interview population look mouth report personal.,17,dean-mcbride,2023,EUR,2436020,1027203,1408817,1066667,342150,0,342150,24360,48720,293430,95622,1429114,1000799,428315,,2436020,506.73,1875.67,0.0647,10150,20.0,101721.19,0.94,0.5783
3071,Larsen-Shannon,False,NG,North Benjaminland,SaaS,2021,https://larsen-shannon.com,Not role recognize life standard country.,12,larsen-shannon,2023,USD,347057,110302,236755,123107,113648,0,113648,3470,6941,106707,4084,297620,179512,118108,28921.42,347057,1023.46,3527.73,0.0157,1136,25.45,27597.19,0.15,0.6822
3072,Simmons Ruiz and Williamson,False,KE,Lake Paul,E-commerce,2010,https://simmonsruizandwilliamson.com,Medical activity able reality care whether me society plan.,21,simmons-ruiz-and-williamson,2023,USD,1873132,596178,1276954,976452,300502,0,300502,18731,37462,263040,11903,991166,277780,713386,,1873132,20.0,108.05,0.0158,956,163.24,108264.69,0.11,0.6817
3073,Baldwin and Sons,False,IN,Lake Kathleen,Marketplaces,2021,https://baldwinandsons.com,Lawyer condition no public social history stock hold.,16,baldwin-and-sons,2023,USD,873103,479144,393959,262385,131574,38166,93408,8731,17462,75946,64203,595071,367796,227275,,873103,20.0,88.61,0.001,267,271.53,1000.0,64.2,0.4512
3074,Smith Group,False,EG,New Lisa,Fintech,2023,https://smithgroup.com,Safe quickly high successful husband think no tell.,18,smith-group,2023,USD,585021,199923,385098,148120,236978,0,236978,5850,11700,225278,9312,443242,112841,330401,,585021,84.9,219.98,0.001,268,181.31,24817.91,0.38,0.6583
3075,Henderson Rodriguez and Miller,False,KE,New Josephbury,Marketplaces,2019,https://hendersonrodriguezandmiller.com,Agree nothing probably public yourself hospital low serious again more direction.,18,henderson-rodriguez-and-miller,2023,USD,197788,71816,125972,55018,70954,0,70954,1977,3955,66999,6490,171205,8560,162645,,197788,1131.47,5290.17,0.0212,132,124.25,17089.35,0.38,0.6369
3076,Robinson PLC,False,EG,Bradleyfurt,Cybersecurity,2021,https://robinsonplc.com,Poor manage across respond government moment ago already.,25,robinson-plc,2023,USD,1877744,837368,1040376,1186438,-146062,32305,-178367,18777,37554,-215921,96616,1154439,631869,522570,,1877744,814.31,4121.78,0.1445,7823,20.0,117419.29,0.82,0.5541
3077,Shelton Inc,False,US,North Robert,HealthTech,2017,https://sheltoninc.com,Cost answer report seven stop goal wish he issue far son.,19,shelton-inc,2023,USD,812445,205653,606792,242019,364773,23891,340882,8124,16248,324634,62728,648054,295196,352858,67703.75,812445,288.8,1006.36,0.0596,13540,5.0,49695.45,1.26,0.7469
3078,Berry Roberts and Jones,False,ZA,West Jason,EdTech,2023,https://berryrobertsandjones.com,Hotel head recognize other seem.,28,berry-roberts-and-jones,2023,USD,123154,38108,85046,109166,-24120,0,-24120,1231,2463,-26583,7406,219027,30873,188154,10262.83,123154,757.0,2034.26,0.0957,176,58.3,1000.0,7.41,0.6906
3079,Bishop Williams and Ross,False,CA,Port Crystalville,Mobility,2015,https://bishopwilliamsandross.com,Particularly Mr including miss particular down study.,27,bishop-williams-and-ross,2023,USD,1146773,123260,1023513,633362,390151,7709,382442,11467,22935,359507,33367,754214,225969,528245,,1146773,1655.9,6162.08,0.063,1500,63.67,36335.15,0.92,0.8925
3080,Cole LLC,False,NG,North Katiechester,EdTech,2018,https://colellc.com,Four age really property American could management politics current.,19,cole-llc,2023,USD,197042,95097,101945,129155,-27210,0,-27210,1970,3940,-31150,1234,205219,92223,112996,16420.17,197042,242.0,1322.31,0.0172,188,87.3,7194.09,0.17,0.5174
3081,Cook Group,False,KE,Deannaberg,Cybersecurity,2022,https://cookgroup.com,Per appear Mrs statement hour trade.,19,cook-group,2023,USD,249596,40794,208802,167416,41386,0,41386,2495,4991,36395,31836,288074,91697,196377,,249596,512.17,1126.57,0.0409,1039,20.0,32548.91,0.98,0.8366
3082,Brown Coleman and Carter,False,GB,Ramosstad,AgriTech,2020,https://browncolemanandcarter.com,Line happen data some wall thousand eat product.,18,brown-coleman-and-carter,2023,USD,287864,126363,161501,97675,63826,0,63826,2878,5757,58069,5182,281712,87232,194480,,287864,2031.09,1015.54,0.0522,100,239.77,15334.99,0.34,0.561
3083,Mitchell-George,False,TN,South Aaron,Marketplaces,2019,https://mitchell-george.com,Color leader and step ago.,19,mitchell-george,2023,USD,705170,211362,493808,87493,406315,23895,382420,7051,14103,368317,13632,372204,18610,353594,,705170,225.71,1417.84,0.0149,2938,20.0,72586.42,0.19,0.7003
3084,Fernandez-Chase,False,AU,North Johnberg,Mobility,2013,https://fernandez-chase.com,Me suggest either best.,19,fernandez-chase,2023,USD,1803332,479576,1323756,519616,804140,3473,800667,18033,36066,764601,178012,1197229,627105,570124,,1803332,1919.31,8571.35,0.1354,768,195.61,44539.92,4.0,0.7341
3085,Smith-Jennings,False,KE,New Stevenfort,EdTech,2017,https://smith-jennings.com,Movement someone box hundred base adult they end entire out.,23,smith-jennings,2023,USD,1409694,733734,675960,584101,91859,0,91859,14096,28193,63666,42212,855009,370240,484769,117474.5,1409694,10.0,79.67,0.0447,1462,80.33,53756.67,0.79,0.4795
3086,Walker-Lawrence,False,ZA,Robbinschester,Cybersecurity,2010,https://walker-lawrence.com,By college letter style know it.,31,walker-lawrence,2023,USD,659851,329193,330658,107859,222799,0,222799,6598,13197,209602,20799,475709,327591,148118,,659851,737.2,368.6,0.001,2749,20.0,50359.53,0.41,0.5011
3087,Peterson Ltd,False,BR,East Jennifertown,Mobility,2012,https://petersonltd.com,Model few somebody green former center.,16,peterson-ltd,2023,USD,823405,211033,612372,282622,329750,0,329750,8234,16468,313282,50849,486798,214125,272673,,823405,853.91,996.69,0.0915,194,353.38,2887.18,17.61,0.7437
3088,Zimmerman PLC,False,GB,Patrickhaven,EdTech,2013,https://zimmermanplc.com,Tough them person today sure protect last ever.,16,zimmerman-plc,2023,USD,196364,71641,124723,116757,7966,0,7966,1963,3927,4039,5799,232636,11631,221005,16363.67,196364,10.0,24.86,0.0163,363,44.98,1000.0,5.8,0.6352
3089,Mcdowell Inc,False,KE,East Jesusport,Mobility,2011,https://mcdowellinc.com,Kid base police field difference respond different put kid discussion.,18,mcdowell-inc,2023,USD,1164577,289156,875421,1101567,-226146,5453,-231599,11645,23291,-254890,6966,690902,317375,373527,,1164577,322.01,934.52,0.1147,497,195.2,92720.15,0.08,0.7517
3090,Brewer Oliver and Singleton,False,AU,Samuelbury,Energy,2023,https://breweroliverandsingleton.com,Owner kind send bit resource president conference occur actually.,21,brewer-oliver-and-singleton,2023,USD,402998,144533,258465,73716,184749,0,184749,4029,8059,176690,32020,249909,87752,162157,,402998,51.91,172.24,0.0192,1679,20.0,25280.78,1.27,0.6414
3091,Randolph-Martin,False,IN,Medinamouth,EdTech,2014,https://randolph-martin.com,Suggest far right probably fish smile.,23,randolph-martin,2023,USD,973174,583189,389985,526939,-136954,0,-136954,9731,19463,-156417,47917,639810,474758,165052,81097.83,973174,214.43,1604.46,0.001,1581,51.28,90268.02,0.53,0.4007
3092,Rodriguez Group,False,NG,Powelltown,SaaS,2008,https://rodriguezgroup.com,Use important become her throughout them media perform maybe civil.,26,rodriguez-group,2023,USD,2887662,774062,2113600,1529907,583693,47996,535697,28876,57753,477944,75654,1665687,83284,1582403,240638.5,2887662,293.64,1171.04,0.0812,48127,5.0,136134.67,0.56,0.7319
3093,Anderson-Wood,False,CA,Wardberg,AgriTech,2019,https://anderson-wood.com,Despite stand economy police among probably return personal adult discussion.,19,anderson-wood,2023,USD,356863,139097,217766,17843,199923,23039,176884,3568,7137,169747,7503,218977,39588,179389,,356863,276.55,803.5,0.1449,1486,20.0,5536.37,1.36,0.6102
3094,Pierce Lee and Stephenson,False,BR,Lake Jon,HealthTech,2013,https://pierceleeandstephenson.com,Owner age build election parent hospital analysis painting.,24,pierce-lee-and-stephenson,2023,USD,1856854,439433,1417421,1070007,347414,21807,325607,18568,37137,288470,185770,1231445,392553,838892,154737.83,1856854,612.44,4133.07,0.0668,30947,5.0,108400.73,1.71,0.7633
3095,Leon-Mcneil,False,NG,Lake Angela,SaaS,2010,https://leon-mcneil.com,Tend general very against admit throughout something.,20,leon-mcneil,2023,USD,4561530,1591138,2970392,2748629,221763,21469,200294,45615,91230,109064,37215,2378147,778745,1599402,380127.5,4561530,280.55,715.74,0.0935,21271,17.87,241816.23,0.15,0.6512
3096,Williamson LLC,False,CA,Blacktown,Energy,2011,https://williamsonllc.com,Grow middle share soon treatment.,20,williamson-llc,2023,USD,820315,265071,555244,500862,54382,3522,50860,8203,16406,34454,45241,556319,264367,291952,,820315,673.67,336.84,0.0387,1153,59.27,23664.55,1.91,0.6769
3097,Spears LLC,False,KE,Chadhaven,EdTech,2011,https://spearsllc.com,Owner population edge event beautiful decade.,26,spears-llc,2023,USD,155804,68084,87720,77892,9828,18677,-8849,1558,3116,-11965,7848,149140,73198,75942,12983.67,155804,10.0,42.67,0.0469,174,74.47,3269.92,2.4,0.563
3098,Castro-Rodriguez,False,NG,Mullinsport,EdTech,2023,https://castro-rodriguez.com,Third age sort final money card.,23,castro-rodriguez,2023,USD,1345228,575693,769535,970807,-201272,0,-201272,13452,26904,-228176,10882,746989,37349,709640,112102.33,1345228,10.0,70.81,0.001,2184,51.32,124123.06,0.09,0.572
3099,Larson Ltd,False,IN,Lake Jenniferton,E-commerce,2019,https://larsonltd.com,Meet language test free alone fly will five somebody.,20,larson-ltd,2023,USD,247244,72922,174322,153674,20648,7205,13443,2472,4944,8499,4121,308869,176520,132349,,247244,36.1,98.11,0.0417,132,155.9,26895.46,0.15,0.7051
3100,Chen Cardenas and Marquez,False,AU,South Michele,SaaS,2016,https://chencardenasandmarquez.com,Describe home especially will line be.,19,chen-cardenas-and-marquez,2023,USD,706373,442810,263563,289000,-25437,15014,-40451,7063,14127,-54578,32511,501526,311639,189887,58864.42,706373,13.97,34.5,0.0829,572,102.82,22030.09,1.48,0.3731
3101,Duran-Davis,False,GB,Navarroberg,Cybersecurity,2024,https://duran-davis.com,Firm indeed ask every thing some real whether enough drug feeling.,25,duran-davis,2023,USD,1103257,352744,750513,860984,-110471,47883,-158354,11032,22065,-180419,59161,802810,669177,133633,,1103257,33.21,100.89,0.0172,4596,20.0,61261.49,0.97,0.6803
3102,Jones-Rose,False,KE,Maldonadofort,Marketplaces,2011,https://jones-rose.com,Data several attention that hospital bag prove she other.,27,jones-rose,2023,USD,1009341,420362,588979,715530,-126551,0,-126551,10093,20186,-146737,683389,1287790,513379,774411,,1009341,589.71,294.86,0.0384,870,96.65,34494.33,19.81,0.5835
3103,Johnson-Swanson,False,ZA,Port Jessicaberg,SaaS,2022,https://johnson-swanson.com,Include member dark support form over TV stock.,15,johnson-swanson,2023,USD,433612,100507,333105,447199,-114094,3870,-117964,4336,8672,-126636,72299,461414,231690,229724,36134.33,433612,10.0,40.14,0.031,1032,35.01,43382.91,1.67,0.7682
3104,Meyer-Garrett,False,AU,Woodsfurt,Mobility,2011,https://meyer-garrett.com,End care fear young seven executive boy cover.,20,meyer-garrett,2023,USD,1068778,359958,708820,86749,622071,44173,577898,10687,21375,556523,97495,659446,48101,611345,,1068778,1073.19,2485.66,0.0101,2040,43.64,1000.0,97.5,0.6632
3105,Hopkins-Smith,False,FR,New Deborah,IoT,2011,https://hopkins-smith.com,Industry green spend sign who Congress.,14,hopkins-smith,2023,EUR,555125,226027,329098,210604,118494,8696,109798,5551,11102,98696,44498,450567,46876,403691,,555125,1691.5,5651.09,0.0777,370,124.84,1000.0,44.5,0.5928
3106,Gentry Group,False,NG,Coxburgh,SaaS,2024,https://gentrygroup.com,Have edge purpose election doctor figure plant member would.,16,gentry-group,2023,USD,1315569,272842,1042727,481544,561183,12660,548523,13155,26311,522212,101316,874388,257514,616874,109630.75,1315569,10.0,73.3,0.0607,1072,102.23,40876.54,2.48,0.7926
3107,Wright Cole and Oliver,False,FR,Joelport,HealthTech,2011,https://wrightcoleandoliver.com,Voice Congress any official just forward those manager huge mean remember.,20,wright-cole-and-oliver,2023,EUR,1237400,616385,621015,706523,-85508,10559,-96067,12374,24748,-120815,63529,705950,35297,670653,103116.67,1237400,10.0,68.11,0.0453,2956,34.88,76128.03,0.83,0.5019
3108,Bishop Ltd,False,DE,North Shirleymouth,E-commerce,2013,https://bishopltd.com,Significant them clearly land evening drive music toward.,21,bishop-ltd,2023,EUR,816332,415304,401028,604854,-203826,0,-203826,8163,16326,-220152,50162,580154,90913,489241,,816332,20.0,64.38,0.0696,527,128.93,24835.97,2.02,0.4913
3109,Cline PLC,False,ZA,Brownstad,AgriTech,2022,https://clineplc.com,Do prepare possible entire agency statement people production together drive.,21,cline-plc,2023,USD,138524,42812,95712,114081,-18369,13317,-31686,1385,2770,-34456,3810,182155,35210,146945,,138524,2250.04,6445.04,0.1206,56,204.65,1000.0,3.81,0.6909
3110,Collins-Salas,False,AU,Port Juan,AI/ML,2023,https://collins-salas.com,Past yet employee thought share feeling.,21,collins-salas,2023,USD,583356,87942,495414,97492,397922,9537,388385,5833,11667,376718,226525,549167,224307,324860,,583356,20.0,59.92,0.0481,1250,38.86,1000.0,226.52,0.8492
3111,Robertson-Cruz,False,ZA,New Jenniferfurt,Fintech,2012,https://robertson-cruz.com,Thousand subject visit company close keep.,19,robertson-cruz,2023,USD,1215970,579144,636826,824241,-187415,0,-187415,12159,24319,-211734,24306,749218,67136,682082,,1215970,673.28,919.35,0.0291,427,236.99,77812.8,0.31,0.5237
3112,Garcia-Bell,False,BR,Leeside,E-commerce,2018,https://garcia-bell.com,Game image stuff idea assume.,22,garcia-bell,2023,USD,1149162,402189,746973,546828,200145,1228,198917,11491,22983,175934,97369,856551,277296,579255,,1149162,1694.37,3979.42,0.037,4788,20.0,56262.54,1.73,0.65
3113,Lewis-Randolph,False,GB,East Judyfort,Fintech,2014,https://lewis-randolph.com,As after policy democratic away real.,19,lewis-randolph,2023,USD,215226,69191,146035,174605,-28570,0,-28570,2152,4304,-32874,7577,260912,13045,247867,,215226,393.71,925.96,0.0847,60,296.72,53500.03,0.14,0.6785
3114,Sanders Group,False,EG,South Genefurt,Energy,2008,https://sandersgroup.com,Right mission officer run look two common say maybe conference less.,14,sanders-group,2023,USD,499612,260936,238676,85663,153013,21216,131797,4996,9992,121805,11980,368032,118887,249145,,499612,20.0,18.61,0.0023,2081,20.0,22583.71,0.53,0.4777
3115,Soto Martinez and Snyder,False,DE,Gonzalesmouth,Mobility,2018,https://sotomartinezandsnyder.com,Hotel kitchen point million number.,22,soto-martinez-and-snyder,2023,EUR,821668,210103,611565,262057,349508,1912,347596,8216,16433,331163,56122,575873,155446,420427,,821668,322.25,1773.94,0.056,3423,20.0,30187.38,1.86,0.7443
3116,Lynch-Cook,False,IN,Heatherborough,AI/ML,2013,https://lynch-cook.com,You our area young size country serve development.,25,lynch-cook,2023,USD,358941,144692,214249,119816,94433,18386,76047,3589,7178,68869,20274,359602,86885,272717,,358941,196.68,268.94,0.1161,168,177.1,1000.0,20.27,0.5969
3117,Allen-Peterson,False,FR,West Timothy,AgriTech,2019,https://allen-peterson.com,Who generation fire yeah tax.,19,allen-peterson,2023,EUR,374483,146203,228280,66511,161769,17447,144322,3744,7489,136833,17945,364263,21806,342457,,374483,20.0,52.54,0.0926,609,51.21,1000.0,17.94,0.6096
3118,Grant PLC,False,ZA,Christopherland,Energy,2019,https://grantplc.com,Whose late ago lay president window paper step bring best.,20,grant-plc,2023,USD,2565881,421058,2144823,790529,1354294,34559,1319735,25658,51317,1268418,166479,1517637,276026,1241611,,2565881,198.23,1137.5,0.0208,10691,20.0,33665.6,4.95,0.8359
3119,Winters-Evans,False,BR,New James,Marketplaces,2015,https://winters-evans.com,Threat claim follow account development guess during truth.,19,winters-evans,2023,USD,5814943,750348,5064595,2045688,3018907,0,3018907,58149,116298,2902609,698687,3641444,1783442,1858002,,5814943,20.0,81.3,0.001,24228,20.0,172437.57,4.05,0.871
3120,Ramsey Thompson and Oconnor,False,GB,North Ethanport,AI/ML,2021,https://ramseythompsonandoconnor.com,Later shoulder other factor open painting support several.,19,ramsey-thompson-and-oconnor,2023,USD,1317626,453625,864001,1067600,-203599,29054,-232653,13176,26352,-259005,35851,706790,326982,379808,,1317626,20.0,27.34,0.0242,446,246.19,99241.76,0.36,0.6557
3121,Ruiz-Hall,False,AU,Smithchester,EdTech,2012,https://ruiz-hall.com,Price call necessary cost attack entire type form he source.,19,ruiz-hall,2023,USD,113004,52760,60244,82206,-21962,15228,-37190,1130,2260,-39450,41735,152550,7627,144923,9417.0,113004,10.0,32.95,0.0295,976,9.64,1000.0,41.74,0.5331
3122,Floyd Group,False,AU,South Vincent,Energy,2021,https://floydgroup.com,Information system feel protect rest today meet.,21,floyd-group,2023,USD,2510322,716177,1794145,2126833,-332688,23243,-355931,25103,50206,-406137,142404,1564098,1093358,470740,,2510322,20.0,10.0,0.0553,961,217.57,204906.04,0.69,0.7147
3123,Johnson Group,False,TN,Port David,Mobility,2024,https://johnsongroup.com,Teacher seven north plant help report age cell.,23,johnson-group,2023,USD,583633,196061,387572,249073,138499,9824,128675,5836,11672,117003,62864,408119,276081,132038,,583633,20.0,36.15,0.0565,333,145.84,28188.85,2.23,0.6641
3124,Phillips Gilbert and Shields,False,AU,North Christinaburgh,Marketplaces,2019,https://phillipsgilbertandshields.com,Land whatever politics social game issue professional.,21,phillips-gilbert-and-shields,2023,USD,120243,28758,91485,126754,-35269,13715,-48984,1202,2404,-51388,47062,229914,50267,179647,,120243,20.0,57.74,0.001,39,251.85,1000.0,47.06,0.7608
3125,Yoder Brown and Riley,False,US,New Timothy,Mobility,2012,https://yoderbrownandriley.com,Behind use democratic character option measure.,19,yoder-brown-and-riley,2023,USD,3504480,1676415,1828065,1605047,223018,11721,211297,35044,70089,141208,91798,1896179,1189142,707037,,3504480,20.0,10.0,0.0763,1690,172.75,164806.59,0.56,0.5216
3126,Sherman Stanton and Beard,False,AU,North Migueltown,SaaS,2024,https://shermanstantonandbeard.com,Perform vote majority international its would article physical.,22,sherman-stanton-and-beard,2023,USD,523469,330654,192815,206534,-13719,5313,-19032,5234,10469,-29501,31389,440152,155146,285006,43622.42,523469,94.35,311.03,0.016,526,82.86,13290.26,2.36,0.3683
3127,Hunt-Dodson,False,FR,West Jessicatown,Fintech,2018,https://hunt-dodson.com,Ten force work establish.,20,hunt-dodson,2023,EUR,5450060,1166262,4283798,2211637,2072161,3943,2068218,54500,109001,1959217,565206,3440765,722558,2718207,,5450060,287.58,852.45,0.1264,3172,143.14,167471.12,3.37,0.786
3128,Meyer-Miller,False,CA,North Lori,Energy,2013,https://meyer-miller.com,Deep drive a group energy control save.,20,meyer-miller,2023,USD,2281882,1052415,1229467,2291727,-1062260,3151,-1065411,22818,45637,-1111048,88439,1290593,590611,699982,,2281882,20.0,79.93,0.0023,1244,152.75,152657.88,0.58,0.5388
3129,Wilson LLC,False,TN,Autumnberg,SaaS,2020,https://wilsonllc.com,Bank raise organization why others successful year perform price own.,23,wilson-llc,2023,USD,281485,90607,190878,50298,140580,18051,122529,2814,5629,116900,43570,291103,51542,239561,23457.08,281485,320.8,1044.25,0.0618,335,69.86,16212.21,2.69,0.6781
3130,Young LLC,False,AU,South Dawnmouth,SaaS,2012,https://youngllc.com,Can training step within few play skill agent now agree.,10,young-llc,2023,USD,4121130,1339301,2781829,3068507,-286678,2026,-288704,41211,82422,-371126,188765,2437915,1156053,1281862,343427.5,4121130,192.96,717.51,0.0468,30526,11.25,251835.4,0.75,0.675
3131,Fisher PLC,False,KE,North Katelynmouth,SaaS,2024,https://fisherplc.com,Wrong indicate perhaps factor part hair.,21,fisher-plc,2023,USD,1701403,395923,1305480,460396,845084,0,845084,17014,34028,811056,85789,1055807,621054,434753,141783.58,1701403,588.94,2765.31,0.025,1931,73.39,2100.98,40.83,0.7673
3132,Rios PLC,False,IN,Clarkton,Energy,2020,https://riosplc.com,Sure increase watch he.,18,rios-plc,2023,USD,1411959,365886,1046073,425656,620417,0,620417,14119,28239,592178,56621,914643,74229,840414,,1411959,1920.68,6002.54,0.0451,777,151.27,53530.64,1.06,0.7409
3133,Harris-Mccoy,False,BR,West Jeffreystad,Cybersecurity,2017,https://harris-mccoy.com,Seat until quality young national teach positive read why.,22,harris-mccoy,2023,USD,1060027,411544,648483,751393,-102910,0,-102910,10600,21200,-124110,108290,746593,195873,550720,,1060027,20.0,70.36,0.1578,1694,52.14,52703.54,2.05,0.6118
3134,Lin LLC,False,ZA,Williamschester,Cybersecurity,2018,https://linllc.com,Necessary red follow word best identify rule.,17,lin-llc,2023,USD,3533917,1655638,1878279,1396944,481335,30424,450911,35339,70678,380233,769178,2542689,127134,2415555,,3533917,20.0,12.17,0.1046,5991,49.15,123982.15,6.2,0.5315
3135,Robbins Inc,False,CA,Patriciamouth,SaaS,2016,https://robbinsinc.com,Between treatment not hard note phone doctor.,20,robbins-inc,2023,USD,550456,253874,296582,156769,139813,11337,128476,5504,11009,117467,37366,406513,75538,330975,45871.33,550456,236.47,1639.97,0.0697,962,47.68,19898.44,1.88,0.5388
3136,Parsons Jones and Sanders,False,NG,Jimeneztown,IoT,2012,https://parsonsjonesandsanders.com,Test worker choice word trial forward mean wish most respond end.,20,parsons-jones-and-sanders,2023,USD,326852,168016,158836,127604,31232,0,31232,3268,6537,24695,27186,361332,263431,97901,,326852,20.0,10.0,0.1311,146,185.48,10386.1,2.62,0.486
3137,Obrien and Sons,False,ZA,North Wendyhaven,Energy,2022,https://obrienandsons.com,Only central similar skin stock foot method customer resource whether.,20,obrien-and-sons,2023,USD,3100477,1074713,2025764,2207104,-181340,18756,-200096,31004,62009,-262105,382342,2012931,778259,1234672,,3100477,1934.84,8809.18,0.0199,4726,54.67,207230.69,1.85,0.6534
3138,Lee Inc,False,BR,South Thomas,EdTech,2022,https://leeinc.com,Check happy necessary never note.,14,lee-inc,2023,USD,96317,32927,63390,57912,5478,23504,-18026,963,1926,-19952,11185,102819,7305,95514,8026.42,96317,10.0,57.4,0.0372,136,58.82,1000.0,11.18,0.6581
3139,Torres Kelly and Holt,False,ZA,Kingmouth,E-commerce,2020,https://torreskellyandholt.com,Back country window reveal give president under add arm author.,27,torres-kelly-and-holt,2023,USD,617846,105102,512744,433671,79073,0,79073,6178,12356,66717,50948,400736,63163,337573,,617846,1241.61,2367.68,0.1379,2574,20.0,52490.84,0.97,0.8299
3140,Sanchez Ltd,False,AU,Joneston,EdTech,2017,https://sanchezltd.com,Also everybody standard fight.,18,sanchez-ltd,2023,USD,293092,99851,193241,135971,57270,26055,31215,2930,5861,25354,7122,350809,82429,268380,24424.33,293092,172.71,1125.43,0.0092,349,69.86,26392.05,0.27,0.6593
3141,Rodriguez Jefferson and Sheppard,False,FR,Lake James,SaaS,2018,https://rodriguezjeffersonandsheppard.com,Media billion themselves old question close force.,18,rodriguez-jefferson-and-sheppard,2023,EUR,795016,324754,470262,220176,250086,0,250086,7950,15900,234186,10781,579757,97503,482254,66251.33,795016,10.0,10.0,0.001,2423,27.34,21738.45,0.5,0.5915
3142,Lyons Group,False,TN,West Meagan,Cybersecurity,2012,https://lyonsgroup.com,Bad especially view production respond realize safe nor knowledge.,23,lyons-group,2023,USD,1651063,501701,1149362,682422,466940,0,466940,16510,33021,433919,287217,1305971,388060,917911,,1651063,1073.85,5288.48,0.0043,504,272.97,46602.7,6.16,0.6961
3143,Pruitt Inc,False,NG,Lake David,AI/ML,2017,https://pruittinc.com,Certainly eight many issue book those film wide.,22,pruitt-inc,2023,USD,251936,98313,153623,173703,-20080,0,-20080,2519,5038,-25118,34609,299123,107767,191356,,251936,20.0,19.01,0.0944,690,30.41,1000.0,34.61,0.6098
3144,King Ltd,False,DE,New Richardmouth,Fintech,2024,https://kingltd.com,Use in baby but stand include.,14,king-ltd,2023,EUR,1053618,340026,713592,363863,349729,36702,313027,10536,21072,291955,81930,721009,36050,684959,,1053618,1258.34,2152.5,0.1263,354,247.76,33647.6,2.43,0.6773
3145,Elliott Black and Rangel,False,NG,North Chaseburgh,AgriTech,2024,https://elliottblackandrangel.com,Despite receive but lawyer stay front.,19,elliott-black-and-rangel,2023,USD,397279,122793,274486,344717,-70231,1740,-71971,3972,7945,-79916,18224,234850,11742,223108,,397279,874.65,2850.73,0.001,1655,20.0,45205.23,0.4,0.6909
3146,Garrett-Price,False,CA,Bullockburgh,Marketplaces,2013,https://garrett-price.com,Nature positive worker court measure between drive.,12,garrett-price,2023,USD,1086175,701484,384691,329082,55609,0,55609,10861,21723,33886,91106,666094,211277,454817,,1086175,20.0,125.47,0.0595,877,103.14,50988.72,1.79,0.3542
3147,Long-Jackson,False,US,Lake Tommyton,SaaS,2016,https://long-jackson.com,Wonder mention yet room single add role happen.,25,long-jackson,2023,USD,2150725,970492,1180233,1217846,-37613,0,-37613,21507,43014,-80627,22657,1256234,182062,1074172,179227.08,2150725,252.63,451.34,0.0176,4006,44.73,81664.26,0.28,0.5488
3148,Hines Mora and Cordova,False,DE,New Danielle,AgriTech,2021,https://hinesmoraandcordova.com,Myself however former knowledge condition ago maybe continue expert.,18,hines-mora-and-cordova,2023,EUR,118155,42413,75742,103328,-27586,29123,-56709,1181,2363,-59072,15301,210319,103913,106406,,118155,1609.51,4662.34,0.0987,107,91.38,12326.48,1.24,0.641
3149,Ashley LLC,False,NG,West Joyceshire,Fintech,2009,https://ashleyllc.com,Security see base fund before find ground window happy performance.,19,ashley-llc,2023,USD,3371819,1136314,2235505,812416,1423089,3975,1419114,33718,67436,1351678,17802,1853082,995045,858037,,3371819,20.0,42.66,0.0699,14049,20.0,55695.05,0.32,0.663
3150,Wright-Stewart,False,CA,North Timothy,AgriTech,2024,https://wright-stewart.com,Necessary center since look poor commercial.,15,wright-stewart,2023,USD,188675,107961,80714,96817,-16103,0,-16103,1886,3773,-19876,1212,246233,18314,227919,,188675,1147.25,1831.47,0.001,47,328.09,1000.0,1.21,0.4278
3151,Brown Martin and Vance,False,CA,Lake Sarahburgh,Fintech,2009,https://brownmartinandvance.com,Fire blood possible rest certainly fine friend make.,15,brown-martin-and-vance,2023,USD,958799,141040,817759,561200,256559,16574,239985,9587,19175,220810,39860,689926,268182,421744,,958799,20.0,56.46,0.0396,937,85.19,28447.94,1.4,0.8529
3152,Huerta and Sons,False,AU,West Michaelfurt,Marketplaces,2011,https://huertaandsons.com,Return dinner despite this exactly assume.,11,huerta-and-sons,2023,USD,614755,128351,486404,269123,217281,3523,213758,6147,12295,201463,221017,597869,44794,553075,,614755,2062.49,1031.24,0.0389,116,438.58,13790.56,16.03,0.7912
3153,Smith Inc,False,EG,North Juan,AgriTech,2008,https://smithinc.com,Strategy continue example let long question quality.,9,smith-inc,2023,USD,961995,412280,549715,342058,207657,16248,191409,9619,19239,172170,104213,613829,30691,583138,,961995,375.56,1337.67,0.0096,1445,55.46,26622.87,3.91,0.5714
3154,Rogers-Odonnell,False,EG,Lake Dean,E-commerce,2015,https://rogers-odonnell.com,Whole age produce into scientist nor human various list.,11,rogers-odonnell,2023,USD,357114,139441,217673,204418,13255,3286,9969,3571,7142,2827,62728,312488,103268,209220,,357114,20.0,49.3,0.0664,608,48.88,48657.59,1.29,0.6095
3155,Fitzgerald Holmes and Cole,False,AU,West Richard,Cybersecurity,2015,https://fitzgeraldholmesandcole.com,Job sister back deep address language its face performance later.,16,fitzgerald-holmes-and-cole,2023,USD,429812,179758,250054,290378,-40324,29549,-69873,4298,8596,-78469,16425,310408,137790,172618,,429812,650.94,2288.26,0.0532,177,201.9,36235.57,0.45,0.5818
3156,West Powell and Robinson,False,CA,Hunterton,AgriTech,2017,https://westpowellandrobinson.com,Both black tell material answer we green contain animal.,28,west-powell-and-robinson,2023,USD,189272,67081,122191,49718,72473,0,72473,1892,3785,68688,10458,282954,14147,268807,,189272,854.04,427.02,0.0581,172,91.65,4695.73,2.23,0.6456
3157,Thomas Group,False,BR,Lake Julianberg,Cybersecurity,2012,https://thomasgroup.com,Use right dog response catch shake beat fight.,20,thomas-group,2023,USD,750956,274223,476733,397775,78958,0,78958,7509,15019,63939,52982,508394,126303,382091,,750956,20.0,81.57,0.0615,3128,20.0,30071.33,1.76,0.6348
3158,Rodriguez Inc,False,ZA,Mercerfort,Energy,2024,https://rodriguezinc.com,Question treat including main maintain born you.,17,rodriguez-inc,2023,USD,1535644,757546,778098,290901,487197,0,487197,15356,30712,456485,156254,990526,371267,619259,,1535644,606.99,2186.74,0.0328,1525,83.9,1000.0,156.25,0.5067
3159,Carpenter Merritt and Conner,False,ZA,West Troymouth,EdTech,2011,https://carpentermerrittandconner.com,Dream art culture brother positive very.,15,carpenter-merritt-and-conner,2023,USD,548244,278083,270161,489651,-219490,12603,-232093,5482,10964,-243057,20117,376247,96033,280214,45687.0,548244,357.34,1721.62,0.0312,454,100.5,43819.54,0.46,0.4928
3160,Morales White and Turner,False,CA,South Molly,AI/ML,2014,https://moraleswhiteandturner.com,Fund meeting return experience heavy oil deal.,16,morales-white-and-turner,2023,USD,826253,74536,751717,216695,535022,25644,509378,8262,16525,492853,74799,687201,333655,353546,,826253,1000.56,3723.5,0.001,3442,20.0,12175.93,6.14,0.9098
3161,Burnett Group,False,AU,Reedtown,E-commerce,2022,https://burnettgroup.com,Prove ground really phone attack window suddenly more place everything.,23,burnett-group,2023,USD,539647,243912,295735,251603,44132,0,44132,5396,10792,33340,44541,462200,243499,218701,,539647,746.01,1349.09,0.0685,216,208.15,25772.7,1.73,0.548
3162,Moore Group,False,FR,Kimview,HealthTech,2021,https://mooregroup.com,Everybody visit kid stay image into.,16,moore-group,2023,EUR,843677,90079,753598,630648,122950,2372,120578,8436,16873,103705,63941,596577,56710,539867,70306.42,843677,149.78,693.9,0.001,5246,13.4,56400.88,1.13,0.8932
3163,Mitchell PLC,False,TN,Floydmouth,Fintech,2010,https://mitchellplc.com,Build model imagine moment science.,21,mitchell-plc,2023,USD,1874081,747203,1126878,93704,1033174,0,1033174,18740,37481,995693,170416,1286823,633176,653647,,1874081,20.0,24.77,0.1073,1798,86.85,21132.28,8.06,0.6013
3164,Alexander Robinson and Colon,False,US,Robertschester,Energy,2012,https://alexanderrobinsonandcolon.com,Win scientist heart by time reality drug plant bill.,20,alexander-robinson-and-colon,2023,USD,1060230,390430,669800,860989,-191189,11495,-202684,10602,21204,-223888,38689,628732,217291,411441,,1060230,1617.11,8926.92,0.0915,307,287.3,78096.38,0.5,0.6317
3165,Gallegos Berger and Garcia,False,EG,Simpsonport,EdTech,2022,https://gallegosbergerandgarcia.com,Standard social everyone should plan gas.,15,gallegos-berger-and-garcia,2023,USD,1128034,122610,1005424,786743,218681,0,218681,11280,22560,196121,22641,682939,334073,348866,94002.83,1128034,10.0,10.0,0.0334,1098,85.56,67820.08,0.33,0.8913
3166,Harper-Walsh,False,FR,Lake Steventon,E-commerce,2024,https://harper-walsh.com,Throw politics strategy piece health why agree after machine.,23,harper-walsh,2023,EUR,2083201,795667,1287534,2089246,-801712,28423,-830135,20832,41664,-871799,116412,1355685,174612,1181073,,2083201,888.61,4799.91,0.001,8680,20.0,165687.52,0.7,0.6181
3167,Parsons LLC,False,TN,East Thomasstad,IoT,2024,https://parsonsllc.com,Compare point offer never high real election happen garden position.,20,parsons-llc,2023,USD,1946541,1061943,884598,640297,244301,51823,192478,19465,38930,153548,17117,1137172,513750,623422,,1946541,498.36,1006.79,0.001,4325,37.5,35869.33,0.48,0.4544
3168,Martin York and Garcia,False,AU,Robertsside,Energy,2016,https://martinyorkandgarcia.com,Issue choose practice final choose these especially just.,16,martin-york-and-garcia,2023,USD,1151525,561156,590369,352565,237804,21199,216605,11515,23030,193575,15360,627909,219637,408272,,1151525,20.0,53.17,0.0179,1544,62.15,48610.63,0.32,0.5127
3169,Wagner and Sons,False,KE,North Jack,Mobility,2021,https://wagnerandsons.com,Every about fall number among.,16,wagner-and-sons,2023,USD,447534,108616,338918,173833,165085,25978,139107,4475,8950,130157,72846,487245,24362,462883,,447534,743.72,1618.55,0.0177,191,194.58,12953.09,5.62,0.7573
3170,Bennett and Sons,False,EG,Port Nancyville,Cybersecurity,2023,https://bennettandsons.com,Message information performance later discussion color almost.,21,bennett-and-sons,2023,USD,2737866,801932,1935934,136893,1799041,14013,1785028,27378,54757,1730271,267542,1818000,674423,1143577,,2737866,1620.9,2796.57,0.1669,1134,201.02,10432.56,25.64,0.7071
3171,Allen Martin and Wilson,False,ZA,Peterborough,Energy,2013,https://allenmartinandwilson.com,Arrive run institution girl however nothing.,25,allen-martin-and-wilson,2023,USD,1225991,511737,714254,646952,67302,10097,57205,12259,24519,32686,451210,1122579,448441,674138,,1225991,427.11,213.56,0.0621,372,274.53,26328.28,17.14,0.5826
3172,Wilson Le and Pollard,False,GB,Josephstad,AI/ML,2012,https://wilsonleandpollard.com,Design economic trade authority town agree.,20,wilson-le-and-pollard,2023,USD,275443,55213,220230,211432,8798,27439,-18641,2754,5508,-24149,186142,372688,265416,107272,,275443,1331.99,3006.88,0.001,1147,20.0,43804.17,4.25,0.7995
3173,Norton Ltd,False,EG,North Amanda,Cybersecurity,2022,https://nortonltd.com,Man section father way in each cost student.,24,norton-ltd,2023,USD,2904804,1694102,1210702,2204287,-993585,31066,-1024651,29048,58096,-1082747,472505,2049633,809874,1239759,,2904804,1321.76,2821.09,0.0211,2835,85.37,177602.46,2.66,0.4168
3174,Horton Group,False,GB,Davidfurt,Cybersecurity,2024,https://hortongroup.com,Opportunity condition office agree mission government ball establish someone.,15,horton-group,2023,USD,7200382,4031570,3168812,3478389,-309577,0,-309577,72003,144007,-453584,220935,3900453,310595,3589858,,7200382,20.0,69.26,0.0321,15878,37.79,283904.71,0.78,0.4401
3175,Roach-White,False,NG,Serranoport,Fintech,2014,https://roach-white.com,Bad range use leader coach no.,17,roach-white,2023,USD,2511699,1179488,1332211,712123,620088,14977,605111,25116,50233,554878,51407,1440319,730263,710056,,2511699,728.91,865.65,0.0214,10465,20.0,57391.41,0.9,0.5304
3176,Williamson-Avery,False,EG,Ritashire,Mobility,2009,https://williamson-avery.com,Safe main fall must however bank.,19,williamson-avery,2023,USD,330759,137568,193191,222160,-28969,0,-28969,3307,6615,-35584,11608,294442,101016,193426,,330759,619.98,1610.75,0.0283,317,86.77,34077.78,0.34,0.5841
3177,Rollins-Vazquez,False,ZA,Contrerashaven,HealthTech,2019,https://rollins-vazquez.com,Western town several middle brother as deal present common.,20,rollins-vazquez,2023,USD,691979,236496,455483,339954,115529,0,115529,6919,13839,101690,5313,387509,157442,230067,57664.92,691979,582.33,4140.04,0.0528,5162,11.17,1757.15,3.02,0.6582
3178,Hernandez Clark and Walker,False,FR,East Jason,IoT,2021,https://hernandezclarkandwalker.com,Friend especially somebody soon huge drug cost everything race.,26,hernandez-clark-and-walker,2023,EUR,457481,179277,278204,244926,33278,43733,-10455,4574,9149,-19604,66155,491908,25874,466034,,457481,20.0,139.19,0.0099,331,114.99,46387.83,1.43,0.6081
3179,Dunn-Ortiz,False,FR,Meganburgh,Fintech,2019,https://dunn-ortiz.com,Bit rich hand piece candidate one cultural onto light.,30,dunn-ortiz,2023,EUR,385531,162385,223146,187406,35740,44329,-8589,3855,7710,-16299,5463,314796,27843,286953,,385531,62.75,262.43,0.0681,162,197.45,1000.0,5.46,0.5788
3180,Martinez LLC,False,KE,Jonesfurt,AgriTech,2009,https://martinezllc.com,Stop serious find protect authority chance particularly interview serious power happen.,21,martinez-llc,2023,USD,121904,8543,113361,114215,-854,0,-854,1219,2438,-3292,26068,103864,39769,64095,,121904,1114.39,2715.01,0.0144,457,22.21,1000.0,26.07,0.9299
3181,Miller-Goodman,False,NG,Jamesmouth,HealthTech,2011,https://miller-goodman.com,Cold produce learn these form.,18,miller-goodman,2023,USD,1225139,660452,564687,927938,-363251,0,-363251,12251,24502,-387753,120941,795194,249403,545791,102094.92,1225139,10.0,20.25,0.0482,6191,16.49,71271.12,1.7,0.4609
3182,Morris and Sons,False,CA,South Lisa,AgriTech,2019,https://morrisandsons.com,However environmental for yard however family service.,20,morris-and-sons,2023,USD,516888,197292,319596,362428,-42832,0,-42832,5168,10337,-53169,43734,308094,124159,183935,,516888,20.0,10.0,0.0141,184,233.42,36778.41,1.19,0.6183
3183,Brennan-Miller,False,IN,South Lukefurt,AgriTech,2023,https://brennan-miller.com,Compare control identify painting set baby man.,19,brennan-miller,2023,USD,433676,106142,327534,335174,-7640,18560,-26200,4336,8673,-34873,7932,284567,139210,145357,,433676,1409.99,5691.32,0.0637,262,137.86,30238.57,0.26,0.7553
3184,Wilson-Bailey,False,US,Lake Shawn,HealthTech,2012,https://wilson-bailey.com,Baby others want several candidate summer center give national audience.,18,wilson-bailey,2023,USD,754904,281895,473009,37745,435264,30722,404542,7549,15098,389444,22708,454748,128306,326442,62908.67,754904,637.2,5990.61,0.0198,12581,5.0,1000.0,22.71,0.6266
3185,Rivera-Callahan,False,AU,Millerfurt,IoT,2021,https://rivera-callahan.com,Quickly class prove television upon subject together minute.,18,rivera-callahan,2023,USD,352986,174746,178240,440615,-262375,0,-262375,3529,7059,-269434,7160,309523,36028,273495,,352986,668.29,1653.34,0.0351,1470,20.0,46269.53,0.15,0.5049
3186,Graham Inc,False,US,Richardsborough,AgriTech,2017,https://grahaminc.com,Young executive message run sort line design.,20,graham-inc,2023,USD,217013,30911,186102,10850,175252,15676,159576,2170,4340,155236,20459,221214,22405,198809,,217013,767.25,3374.44,0.0787,129,139.87,1000.0,20.46,0.8576
3187,Rodriguez Whitaker and Johnston,False,DE,Perryfurt,HealthTech,2023,https://rodriguezwhitakerandjohnston.com,Popular age war loss hard from anything anyone.,20,rodriguez-whitaker-and-johnston,2023,EUR,7228456,1696208,5532248,2670685,2861563,10958,2850605,72284,144569,2706036,210846,3949994,1900229,2049765,602371.33,7228456,367.01,367.01,0.001,120474,5.0,228083.57,0.92,0.7653
3188,Washington LLC,False,US,New Jameschester,Fintech,2019,https://washingtonllc.com,Exactly them peace night.,19,washington-llc,2023,USD,2463673,735170,1728503,1431093,297410,4694,292716,24636,49273,243443,87695,1412887,631910,780977,,2463673,1296.7,648.35,0.0717,4782,42.93,136083.65,0.64,0.7016
3189,Jacobson Group,False,FR,West Douglasville,SaaS,2021,https://jacobsongroup.com,Source eye station material notice official.,11,jacobson-group,2023,EUR,967196,250589,716607,559585,157022,23914,133108,9671,19343,113765,75592,577616,246888,330728,80599.67,967196,31.18,67.99,0.0601,1195,67.43,23114.67,3.27,0.7409
3190,Thomas Russell and Cummings,False,EG,Morganmouth,IoT,2017,https://thomasrussellandcummings.com,Citizen statement scientist call east rock east.,27,thomas-russell-and-cummings,2023,USD,422109,160212,261897,444772,-182875,19353,-202228,4221,8442,-210670,10887,334455,42275,292180,,422109,75.88,405.61,0.001,158,222.27,26844.85,0.41,0.6204
3191,Simon-Brennan,False,KE,East Karen,Mobility,2018,https://simon-brennan.com,Quickly community trouble be yeah.,19,simon-brennan,2023,USD,1170107,351422,818685,469450,349235,63,349172,11701,23402,325770,27617,777210,587413,189797,,1170107,20.0,10.0,0.0623,2716,35.89,15400.58,1.79,0.6997
3192,Carr-Garcia,False,AU,Morahaven,Energy,2023,https://carr-garcia.com,Operation media seem outside no.,15,carr-garcia,2023,USD,1391908,635928,755980,528417,227563,6085,221478,13919,27838,193640,125098,854373,188272,666101,,1391908,20.0,48.13,0.006,631,183.68,56491.52,2.21,0.5431
3193,Baker PLC,False,ZA,East Phillip,IoT,2012,https://bakerplc.com,Join yet sing forget camera low.,18,baker-plc,2023,USD,61518,18512,43006,21521,21485,21426,59,615,1230,-1171,1050,133526,53938,79588,,61518,1352.8,3059.36,0.0124,18,271.21,20244.45,0.05,0.6991
3194,Green Price and Hall,False,AU,Lake Jane,HealthTech,2024,https://greenpriceandhall.com,Conference time big firm give certainly anyone benefit peace.,13,green-price-and-hall,2023,USD,2487981,710594,1777387,1252924,524463,3669,520794,24879,49759,471035,126227,1540522,532731,1007791,207331.75,2487981,299.92,1943.62,0.0146,1724,120.25,109663.15,1.15,0.7144
3195,Lopez Russo and Knight,False,BR,Kingville,Mobility,2022,https://lopezrussoandknight.com,Relate house spring writer sit.,23,lopez-russo-and-knight,2023,USD,3018710,651099,2367611,2227696,139915,38720,101195,30187,60374,40821,84941,1712780,293067,1419713,,3018710,318.51,159.26,0.0161,12577,20.0,183567.71,0.46,0.7843
3196,Smith-Ross,False,BR,Marthamouth,Mobility,2012,https://smith-ross.com,Different ok international return we.,23,smith-ross,2023,USD,1426304,478834,947470,474167,473303,11983,461320,14263,28526,432794,96783,1001541,274572,726969,,1426304,20.0,31.09,0.0641,392,303.04,41950.94,2.31,0.6643
3197,Clayton-Morris,False,ZA,Lake Bailey,E-commerce,2010,https://clayton-morris.com,Season trade look wish behavior beat tree care.,16,clayton-morris,2023,USD,1683468,616299,1067169,1274780,-207611,21343,-228954,16834,33669,-262623,43700,1024669,117920,906749,,1683468,1742.16,3981.52,0.0724,7014,20.0,117463.55,0.37,0.6339
3198,Chavez and Sons,False,AU,New Jenniferside,IoT,2021,https://chavezandsons.com,Wind form half approach improve design oil.,22,chavez-and-sons,2023,USD,966813,225870,740943,48340,692603,38979,653624,9668,19336,634288,37725,646899,97263,549636,,966813,2905.95,19507.31,0.001,858,93.89,6318.89,5.97,0.7664
3199,Hodge Peterson and Bullock,False,TN,South Stephenchester,EdTech,2020,https://hodgepetersonandbullock.com,Great peace sell away when here station one.,33,hodge-peterson-and-bullock,2023,USD,301532,110675,190857,204763,-13906,2413,-16319,3015,6030,-22349,7395,232027,134876,97151,25127.67,301532,171.41,467.73,0.016,224,112.01,28912.21,0.26,0.633
3200,Brown-White,False,CA,South Joshua,AI/ML,2009,https://brown-white.com,Occur of sometimes rather suggest doctor project.,21,brown-white,2023,USD,284630,127048,157582,53638,103944,36666,67278,2846,5692,61586,57118,352501,99187,253314,,284630,1312.35,2350.75,0.0834,583,40.66,1000.0,57.12,0.5536
3201,Adams Clay and King,False,BR,West Catherine,Mobility,2016,https://adamsclayandking.com,Choice culture marriage light even too challenge certain tax.,11,adams-clay-and-king,2023,USD,1511424,763067,748357,451386,296971,0,296971,15114,30228,266743,56088,842877,520478,322399,,1511424,873.93,1711.6,0.001,1027,122.57,12087.33,4.64,0.4951
3202,Turner Rasmussen and Rodriguez,False,BR,Leehaven,Fintech,2013,https://turnerrasmussenandrodriguez.com,Property them radio agreement discussion.,20,turner-rasmussen-and-rodriguez,2023,USD,1659058,842047,817011,308188,508823,0,508823,16590,33181,475642,7988,904353,162268,742085,,1659058,937.42,6119.87,0.0259,3961,34.9,32796.18,0.24,0.4925
3203,Harris-Chavez,False,ZA,North Dorothyshire,SaaS,2017,https://harris-chavez.com,Music rock force media day collection big fear.,26,harris-chavez,2023,USD,710471,328196,382275,35523,346752,20620,326132,7104,14209,311923,31592,501128,240327,260801,59205.92,710471,575.07,2229.34,0.0512,1210,48.92,4261.31,7.41,0.5381
3204,Fitzgerald LLC,False,NG,East Louischester,Marketplaces,2011,https://fitzgeraldllc.com,World remember you assume keep back.,18,fitzgerald-llc,2023,USD,739136,537323,201813,204332,-2519,16015,-18534,7391,14782,-33316,62742,450845,49694,401151,,739136,114.28,260.48,0.0329,351,175.43,10294.92,6.09,0.273
3205,Stuart Burch and English,False,BR,Hallborough,AI/ML,2010,https://stuartburchandenglish.com,End physical reduce the tend deep view plant.,18,stuart-burch-and-english,2023,USD,954583,364416,590167,466630,123537,0,123537,9545,19091,104446,17096,511464,146360,365104,,954583,20.0,43.55,0.0969,745,106.75,19219.44,0.89,0.6182
3206,Morris Inc,False,DE,Owenside,IoT,2009,https://morrisinc.com,White ready chair huge much now population total effort significant.,22,morris-inc,2023,EUR,570235,262738,307497,189875,117622,9320,108302,5702,11404,96898,22828,383838,19191,364647,,570235,20.0,80.64,0.001,1101,43.14,16769.82,1.36,0.5392
3207,Williams Noble and Velazquez,False,KE,Stevenside,AI/ML,2014,https://williamsnobleandvelazquez.com,Of rather beyond nor popular will interview compare walk.,33,williams-noble-and-velazquez,2023,USD,239411,81346,158065,117900,40165,0,40165,2394,4788,35377,11441,293958,14697,279261,,239411,262.2,131.1,0.001,462,43.12,11429.1,1.0,0.6602
3208,Jacobs Rodriguez and Turner,False,AU,Lake Robert,Mobility,2024,https://jacobsrodriguezandturner.com,Customer turn whom book development.,17,jacobs-rodriguez-and-turner,2023,USD,640371,106058,534313,406710,127603,0,127603,6403,12807,114796,33262,389044,139847,249197,,640371,1018.73,4423.16,0.0433,920,57.95,37946.07,0.88,0.8344
3209,Schwartz-Allison,False,US,South Craigtown,Fintech,2013,https://schwartz-allison.com,Evening difficult radio machine property reason down like.,23,schwartz-allison,2023,USD,910600,446089,464511,606490,-141979,47224,-189203,9106,18212,-207415,9476,494464,242483,251981,,910600,20.0,10.0,0.001,3794,20.0,14433.83,0.66,0.5101
3210,Jimenez LLC,False,US,Smithstad,AgriTech,2014,https://jimenezllc.com,Source company law more she few a.,25,jimenez-llc,2023,USD,39278,15420,23858,24505,-647,6080,-6727,392,785,-7512,11548,56749,24991,31758,,39278,20.0,80.99,0.001,43,75.91,19895.28,0.58,0.6074
3211,Hughes Hammond and Taylor,False,DE,Griffinberg,Cybersecurity,2022,https://hugheshammondandtaylor.com,Evening never college crime pattern.,18,hughes-hammond-and-taylor,2023,EUR,1422327,448015,974312,614879,359433,0,359433,14223,28446,330987,2386,828395,269087,559308,,1422327,857.64,4814.03,0.001,5926,20.0,23323.02,0.1,0.685
3212,Newman Group,False,FR,Edwardsside,AI/ML,2018,https://newmangroup.com,Real man election thousand third parent century hair.,19,newman-group,2023,EUR,548144,216686,331458,346673,-15215,15802,-31017,5481,10962,-41979,23596,437022,274596,162426,,548144,695.0,2953.38,0.0795,379,120.39,28463.75,0.83,0.6047
3213,Wiley Group,False,TN,Marktown,IoT,2009,https://wileygroup.com,Hospital bill born relationship must run us.,21,wiley-group,2023,USD,461073,179691,281382,258216,23166,0,23166,4610,9221,13945,15061,323776,209692,114084,,461073,1163.5,5018.2,0.0472,535,71.76,17609.69,0.86,0.6103
3214,Perez Group,False,EG,Port Nicholas,SaaS,2018,https://perezgroup.com,Example key stand place ok become can value.,20,perez-group,2023,USD,636762,267488,369274,345379,23895,3352,20543,6367,12735,7808,43777,485427,190819,294608,53063.5,636762,46.74,146.16,0.0352,10612,5.0,11238.94,3.9,0.5799
3215,Jensen Group,False,TN,South Erica,HealthTech,2021,https://jensengroup.com,Design form focus medical mission.,30,jensen-group,2023,USD,4765524,1681962,3083562,3194142,-110580,4822,-115402,47655,95310,-210712,645934,3113173,155658,2957515,397127.0,4765524,57.24,200.95,0.001,5883,67.5,268644.64,2.4,0.6471
3216,Wilson and Sons,False,US,New Christine,AI/ML,2018,https://wilsonandsons.com,Main democratic statement final value movie raise half often.,20,wilson-and-sons,2023,USD,1407972,785146,622826,686578,-63752,14837,-78589,14079,28159,-106748,202931,1052314,101731,950583,,1407972,1183.6,6312.91,0.001,1260,93.07,59680.32,3.4,0.4424
3217,Ford Rowe and Ortiz,False,TN,Williamfurt,AgriTech,2010,https://fordroweandortiz.com,Challenge free positive write dinner realize cultural if me best.,24,ford-rowe-and-ortiz,2023,USD,932028,316247,615781,322646,293135,11750,281385,9320,18640,262745,75170,694740,250122,444618,,932028,853.61,4301.28,0.0966,199,389.43,29836.25,2.52,0.6607
3218,Burnett-Hanna,False,FR,Watsonborough,Fintech,2013,https://burnett-hanna.com,Others four with painting understand southern interesting nothing.,17,burnett-hanna,2023,EUR,1295217,604554,690663,639821,50842,16834,34008,12952,25904,8104,77398,820784,220901,599883,,1295217,275.11,287.86,0.0214,709,152.1,38186.78,2.03,0.5332
3219,Rogers Osborne and Anderson,False,IN,Amandabury,HealthTech,2013,https://rogersosborneandanderson.com,Parent room region minute foot.,21,rogers-osborne-and-anderson,2023,USD,579453,236035,343418,100481,242937,5926,237011,5794,11589,225422,48079,372745,136951,235794,48287.75,579453,10.0,51.45,0.0149,844,57.2,15433.27,3.12,0.5927
3220,Hill Griffin and Harris,False,IN,Ritaland,Fintech,2012,https://hillgriffinandharris.com,Today relate enjoy treat green financial their.,18,hill-griffin-and-harris,2023,USD,3450335,1724771,1725564,2040983,-315419,3427,-318846,34503,69006,-387852,750472,2661196,445374,2215822,,3450335,2038.17,1019.08,0.0038,1237,232.26,149994.71,5.0,0.5001
3221,Riley Group,False,IN,Thomasberg,Energy,2013,https://rileygroup.com,West guess energy finally way have seat reality PM let.,25,riley-group,2023,USD,2411788,799598,1612190,1095170,517020,0,517020,24117,48235,468785,252405,1547126,807703,739423,,2411788,20.0,80.83,0.1007,2611,76.95,103708.17,2.43,0.6685
3222,Harris LLC,False,US,Jordanbury,IoT,2018,https://harrisllc.com,Who smile probably kid speech.,21,harris-llc,2023,USD,356467,96937,259530,357881,-98351,18053,-116404,3564,7129,-123533,26799,216090,108583,107507,,356467,1222.97,4260.39,0.0846,374,79.31,14878.67,1.8,0.7281
3223,Flores-Estrada,False,GB,New Anthonystad,SaaS,2009,https://flores-estrada.com,Perform executive maintain step whom.,24,flores-estrada,2023,USD,181628,68096,113532,22972,90560,0,90560,1816,3632,86928,26804,148299,19281,129018,15135.67,181628,10.0,21.55,0.0106,199,75.73,1000.0,26.8,0.6251
3224,Sampson-Russell,False,IN,Jessicaview,Energy,2011,https://sampson-russell.com,Republican artist anyone check charge apply.,21,sampson-russell,2023,USD,4923370,970514,3952856,2826043,1126813,0,1126813,49233,98467,1028346,80163,2639703,771025,1868678,,4923370,1926.52,11570.21,0.0458,1444,283.99,252432.72,0.32,0.8029
3225,Morrow Inc,False,CA,New Anthony,HealthTech,2021,https://morrowinc.com,One green ask save fight either.,19,morrow-inc,2023,USD,362107,145107,217000,70918,146082,0,146082,3621,7242,138840,10374,303439,54906,248533,30175.58,362107,12.05,24.76,0.001,572,52.68,12693.15,0.82,0.5993
3226,Calderon Griffin and Jensen,False,CA,Lake Michaelstad,AgriTech,2020,https://calderongriffinandjensen.com,Call loss could peace education whether manager lose.,22,calderon-griffin-and-jensen,2023,USD,14143,3406,10737,11980,-1243,46215,-47458,141,282,-47740,7608,72087,22275,49812,,14143,20.0,63.83,0.0186,58,20.0,14143.0,0.54,0.7592
3227,Edwards-Hebert,False,FR,Justinfurt,SaaS,2014,https://edwards-hebert.com,Crime statement early together play name film.,21,edwards-hebert,2023,EUR,1232215,197721,1034494,612819,421675,0,421675,12322,24644,397031,126235,761611,267357,494254,102684.58,1232215,53.82,213.92,0.0277,2530,40.58,43716.7,2.89,0.8395
3228,Delacruz Cooper and Duncan,False,DE,East Jenniferside,IoT,2015,https://delacruzcooperandduncan.com,Society next far decade brother some.,11,delacruz-cooper-and-duncan,2023,EUR,3885034,1380453,2504581,482693,2021888,0,2021888,38850,77700,1944188,606912,2669419,1385242,1284177,,3885034,1425.16,4714.46,0.0203,3903,82.94,78858.51,7.7,0.6447
3229,Stanley-Clarke,False,EG,Lindaton,AI/ML,2024,https://stanley-clarke.com,Hand season during yet until budget.,18,stanley-clarke,2023,USD,1210829,208303,1002526,605675,396851,0,396851,12108,24216,372635,581993,1285968,388095,897873,,1210829,20.0,32.62,0.0724,562,179.31,37169.98,15.66,0.828
3230,Vega-Stevenson,False,TN,East Justin,Fintech,2016,https://vega-stevenson.com,Very remember amount serve strong trouble book.,14,vega-stevenson,2023,USD,835874,320401,515473,504149,11324,5767,5557,8358,16717,-11160,173838,765034,277533,487501,,835874,20.0,40.81,0.0767,226,307.08,1000.0,173.84,0.6167
3231,Meyers Collier and Garcia,False,US,North Lauren,E-commerce,2022,https://meyerscollierandgarcia.com,This professor notice which.,10,meyers-collier-and-garcia,2023,USD,8302377,2771536,5530841,1595274,3935567,0,3935567,83023,166047,3769520,28102,4203822,2888805,1315017,,8302377,1497.87,2049.12,0.0739,4791,144.38,159789.81,0.18,0.6662
3232,Rice Group,False,NG,Esparzahaven,Energy,2010,https://ricegroup.com,Push product station name way.,23,rice-group,2023,USD,4354063,2321942,2032121,217703,1814418,0,1814418,43540,87081,1727337,38120,2245704,1750650,495054,,4354063,20.0,10.0,0.0573,5738,63.23,1000.0,38.12,0.4667
3233,Moore and Sons,False,EG,South Wendy,SaaS,2021,https://mooreandsons.com,Travel side cell style soldier last third dream group.,17,moore-and-sons,2023,USD,2574250,851132,1723118,2036083,-312965,9325,-322290,25742,51485,-373775,81876,1543407,731380,812027,214520.83,2574250,10.0,16.39,0.0224,20067,10.69,170718.13,0.48,0.6694
3234,Nelson-Brown,False,BR,New Dianaborough,EdTech,2008,https://nelson-brown.com,Factor sister really model eat woman reduce class.,22,nelson-brown,2023,USD,407845,139872,267973,187702,80271,6710,73561,4078,8156,65405,19246,326805,86121,240684,33987.08,407845,497.51,3986.78,0.1038,769,44.14,18317.65,1.05,0.657
3235,Alvarado and Sons,False,IN,Tammyberg,AI/ML,2011,https://alvaradoandsons.com,Different little general away fly.,19,alvarado-and-sons,2023,USD,1026164,492419,533745,277715,256030,2519,253511,10261,20523,232988,18670,676737,462389,214348,,1026164,747.71,373.86,0.1413,2493,34.29,40354.94,0.46,0.5201
3236,Williams Day and Pena,False,DE,Katieberg,AI/ML,2012,https://williamsdayandpena.com,Time past past dog week site there bed him responsibility.,24,williams-day-and-pena,2023,EUR,4197592,1533892,2663700,1590724,1072976,0,1072976,41975,83951,989025,272222,2436883,407968,2028915,,4197592,685.07,580.28,0.0557,8921,39.21,121646.78,2.24,0.6346
3237,Robinson PLC,False,IN,South Patrick,IoT,2021,https://robinsonplc.com,Star way far prove teacher realize office hospital.,24,robinson-plc,2023,USD,367515,162046,205469,183812,21657,0,21657,3675,7350,14307,18498,252846,154132,98714,,367515,244.18,122.09,0.0433,1531,20.0,1000.0,18.5,0.5591
3238,Andrews Jackson and Mccarty,False,EG,Amymouth,Fintech,2024,https://andrewsjacksonandmccarty.com,Agree ability type word record tough.,14,andrews-jackson-and-mccarty,2023,USD,1103510,536336,567174,574376,-7202,0,-7202,11035,22070,-29272,63018,796189,394365,401824,,1103510,897.93,778.85,0.0254,1400,65.66,54072.12,1.17,0.514
3239,Diaz Collins and Ayala,False,DE,Travisberg,HealthTech,2019,https://diazcollinsandayala.com,Land arm bit road.,21,diaz-collins-and-ayala,2023,EUR,832542,369511,463031,383958,79073,2737,76336,8325,16650,59686,57878,532725,243478,289247,69378.5,832542,10.0,69.33,0.0283,4616,15.03,38551.46,1.5,0.5562
3240,Dunn Waller and Smith,False,NG,Lake Dennis,HealthTech,2015,https://dunnwallerandsmith.com,Reveal later foreign partner care.,23,dunn-waller-and-smith,2023,USD,1815843,775035,1040808,1484462,-443654,34051,-477705,18158,36316,-514021,96738,1172335,178493,993842,151320.25,1815843,220.49,220.49,0.0615,30264,5.0,133170.24,0.73,0.5732
3241,Goodman-Burton,False,NG,New Charles,Energy,2022,https://goodman-burton.com,Compare reality black appear policy capital.,21,goodman-burton,2023,USD,8193923,1917541,6276382,2448086,3828296,10849,3817447,81939,163878,3653569,361297,4558413,1727825,2830588,,8193923,2398.09,12651.01,0.1116,5961,114.53,238280.3,1.52,0.766
3242,Brown and Sons,False,US,Jacksonmouth,SaaS,2022,https://brownandsons.com,Force ground why choose Democrat argue argue several international.,10,brown-and-sons,2023,USD,1168659,602933,565726,372001,193725,0,193725,11686,23373,170352,15540,632164,345896,286268,97388.25,1168659,10.0,38.37,0.0034,950,102.42,1744.68,8.91,0.4841
3243,Garner Clark and Johnson,False,KE,East Michael,AgriTech,2013,https://garnerclarkandjohnson.com,Hit join mouth particularly brother clearly experience civil table.,17,garner-clark-and-johnson,2023,USD,843430,421769,421661,338098,83563,0,83563,8434,16868,66695,28928,521347,26067,495280,,843430,1032.93,9604.5,0.1073,540,130.11,50054.79,0.58,0.4999
3244,Turner PLC,False,US,Annastad,SaaS,2023,https://turnerplc.com,View huge ask west our rise suddenly allow.,19,turner-plc,2023,USD,726343,353167,373176,396222,-23046,0,-23046,7263,14526,-37572,32603,424227,178749,245478,60528.58,726343,66.3,185.7,0.0438,792,76.33,10521.59,3.1,0.5138
3245,Knight Golden and Jones,False,IN,Vernonborough,IoT,2016,https://knightgoldenandjones.com,Into cultural later new report statement give individual factor.,19,knight-golden-and-jones,2023,USD,1166844,348512,818332,689396,128936,28320,100616,11668,23336,77280,35159,801466,721319,80147,,1166844,236.85,685.58,0.0022,1197,81.19,48652.07,0.72,0.7013
3246,Gomez Patterson and Collins,False,BR,Kimshire,Energy,2019,https://gomezpattersonandcollins.com,Together follow market reveal focus night technology wait.,22,gomez-patterson-and-collins,2023,USD,4634554,2050390,2584164,3878682,-1294518,0,-1294518,46345,92691,-1387209,3528704,5988026,2348630,3639396,,4634554,20.0,96.83,0.001,4865,79.37,282050.36,12.51,0.5576
3247,Foster PLC,False,BR,Mcleanmouth,EdTech,2024,https://fosterplc.com,Between one accept pattern them.,18,foster-plc,2023,USD,767602,232947,534655,633704,-99049,40,-99089,7676,15352,-114441,22334,427550,225541,202009,63966.83,767602,258.1,793.92,0.0289,520,122.8,27847.27,0.8,0.6965
3248,Gutierrez-Bryant,False,IN,Moniquechester,SaaS,2013,https://gutierrez-bryant.com,Help particular pay another role another since.,17,gutierrez-bryant,2023,USD,732621,317544,415077,229153,185924,506,185418,7326,14652,170766,17683,440413,108095,332318,61051.75,732621,111.37,406.6,0.0659,12210,5.0,1000.0,17.68,0.5666
3249,Sanders Combs and Schwartz,False,ZA,Robinsonburgh,AI/ML,2010,https://sanderscombsandschwartz.com,He respond bill central let a sometimes police agree.,19,sanders-combs-and-schwartz,2023,USD,452070,249526,202544,265108,-62564,7893,-70457,4520,9041,-79498,308,312395,15619,296776,,452070,635.65,1536.14,0.0665,164,229.7,23921.65,0.01,0.448
3250,Moore Cook and Rodriguez,False,IN,New Alexander,Fintech,2020,https://moorecookandrodriguez.com,Stage return enter star without these care manage during what.,17,moore-cook-and-rodriguez,2023,USD,1583842,698850,884992,490386,394606,27341,367265,15838,31676,335589,18203,981586,343901,637685,,1583842,1005.78,4317.63,0.0545,624,211.21,44612.8,0.41,0.5588
3251,Eaton LLC,False,ZA,Bakerfort,Fintech,2012,https://eatonllc.com,Before prove capital our forget hard south our role national difference.,27,eaton-llc,2023,USD,1030148,143003,887145,447100,440045,6077,433968,10301,20602,413366,21065,608694,154697,453997,,1030148,20.0,73.27,0.0589,569,150.7,28710.57,0.73,0.8612
3252,Fritz Perez and Mason,False,ZA,Ashleyland,AI/ML,2016,https://fritzperezandmason.com,Opportunity development give seven positive Republican century nearly list.,17,fritz-perez-and-mason,2023,USD,256305,58826,197479,144509,52970,47583,5387,2563,5126,261,7687,230885,69428,161457,,256305,1169.31,7207.24,0.0535,1067,20.0,11057.66,0.7,0.7705
3253,Morris Anderson and Smith,False,TN,North Amyfort,EdTech,2024,https://morrisandersonandsmith.com,Senior leader she business expert parent draw.,24,morris-anderson-and-smith,2023,USD,1688177,372331,1315846,632635,683211,0,683211,16881,33763,649448,86856,1098453,612116,486337,140681.42,1688177,274.4,571.88,0.0119,2263,62.14,66582.17,1.3,0.7794
3254,Jefferson-Cunningham,False,AU,Port Briantown,E-commerce,2018,https://jefferson-cunningham.com,Pull seem painting hope support peace laugh.,20,jefferson-cunningham,2023,USD,323003,110828,212175,124989,87186,20764,66422,3230,6460,59962,10703,230483,154065,76418,,323003,620.25,2911.67,0.1207,110,244.65,12696.19,0.84,0.6569
3255,Hayden Brown and Bradford,False,BR,Christinastad,AgriTech,2022,https://haydenbrownandbradford.com,Debate treat yeah group save collection admit federal admit meeting.,17,hayden-brown-and-bradford,2023,USD,114976,40480,74496,73002,1494,30198,-28704,1149,2299,-31003,9064,257759,47615,210144,,114976,100.76,573.36,0.0852,479,20.0,14553.1,0.62,0.6479
3256,Cervantes-Walter,False,IN,New Courtney,EdTech,2018,https://cervantes-walter.com,Fly now strategy natural company forget relationship financial.,19,cervantes-walter,2023,USD,446138,107138,339000,156243,182757,29134,153623,4461,8922,144701,23040,373931,242128,131803,37178.17,446138,797.76,1558.46,0.0266,682,54.44,39820.9,0.58,0.7599
3257,Riddle-Martinez,False,CA,New Jamiestad,EdTech,2022,https://riddle-martinez.com,Service wonder word talk stock often here total would.,19,riddle-martinez,2023,USD,619171,256288,362883,179671,183212,34140,149072,6191,12383,136689,11413,497619,196137,301482,51597.58,619171,111.5,402.49,0.0271,1209,42.66,8544.94,1.34,0.5861
3258,Morales Odonnell and Coleman,False,KE,Danielstad,E-commerce,2008,https://moralesodonnellandcoleman.com,Commercial my small news here.,22,morales-odonnell-and-coleman,2023,USD,551032,271664,279368,701845,-422477,12378,-434855,5510,11020,-445875,85194,390280,149932,240348,,551032,330.14,917.26,0.0785,339,135.44,48576.96,1.75,0.507
3259,Edwards Frank and Ward,False,ZA,Amandaburgh,HealthTech,2008,https://edwardsfrankandward.com,Leg article important people capital carry out prevent star.,28,edwards-frank-and-ward,2023,USD,104404,13307,91097,55137,35960,0,35960,1044,2088,33872,142376,216547,114850,101697,8700.33,104404,151.01,581.71,0.0187,94,91.81,30663.54,4.64,0.8725
3260,Elliott-Powers,False,KE,Carlychester,Mobility,2008,https://elliott-powers.com,Surface population market buy.,18,elliott-powers,2023,USD,428718,90983,337735,129548,208187,27721,180466,4287,8574,171892,41119,449319,22662,426657,,428718,20.0,10.0,0.0362,532,67.13,29970.12,1.37,0.7878
3261,Jackson and Sons,False,US,Lisaberg,Marketplaces,2013,https://jacksonandsons.com,Type several else yeah remain.,18,jackson-and-sons,2023,USD,477020,137184,339836,150112,189724,21111,168613,4770,9540,159073,92469,343913,172203,171710,,477020,20.0,75.74,0.1206,224,176.93,1000.0,92.47,0.7124
3262,Silva-Cook,False,TN,Harrisview,AI/ML,2023,https://silva-cook.com,End crime get play institution daughter grow term reason environmental.,22,silva-cook,2023,USD,3998227,1367880,2630347,266884,2363463,6004,2357459,39982,79964,2277495,44405,2127278,910090,1217188,,3998227,220.87,110.44,0.001,4650,71.64,30920.88,1.44,0.6579
3263,Miller Oconnor and Moss,False,AU,Harrellville,Energy,2010,https://milleroconnorandmoss.com,Middle picture production talk race build discover someone particular theory.,21,miller-oconnor-and-moss,2023,USD,1199872,302002,897870,746094,151776,8613,143163,11998,23997,119166,26365,753950,297965,455985,,1199872,540.86,534.45,0.001,4999,20.0,53439.24,0.49,0.7483
3264,Clark Inc,False,AU,Joeview,Marketplaces,2010,https://clarkinc.com,Picture kind protect there seven.,14,clark-inc,2023,USD,337637,138136,199501,199903,-402,0,-402,3376,6752,-7154,54821,395885,270034,125851,,337637,76.77,343.02,0.001,1406,20.0,32138.91,1.71,0.5909
3265,Burns Group,False,NG,Allenhaven,SaaS,2022,https://burnsgroup.com,Service pattern American mention attention push common say store.,22,burns-group,2023,USD,476103,104871,371232,283871,87361,18979,68382,4761,9522,58860,7876,442750,125277,317473,39675.25,476103,105.22,105.22,0.0678,340,116.53,1000.0,7.88,0.7797
3266,White Inc,False,BR,Julianport,Fintech,2019,https://whiteinc.com,Technology born make simply sing better thing.,16,white-inc,2023,USD,777831,357276,420555,485920,-65365,0,-65365,7778,15556,-80921,134152,591490,320192,271298,,777831,652.71,326.36,0.1103,391,165.53,44172.72,3.04,0.5407
3267,Gomez Rodriguez and Blake,False,TN,Teresamouth,IoT,2019,https://gomezrodriguezandblake.com,Option address site place memory clearly every best analysis buy song.,13,gomez-rodriguez-and-blake,2023,USD,339443,82515,256928,16972,239956,0,239956,3394,6788,233168,3429,239601,80962,158639,,339443,20.0,46.16,0.0646,924,30.6,6132.27,0.56,0.7569
3268,Calderon Rollins and Christian,False,TN,East Troyview,HealthTech,2008,https://calderonrollinsandchristian.com,Either difference threat arrive game property.,13,calderon-rollins-and-christian,2023,USD,484248,253978,230270,215727,14543,0,14543,4842,9684,4859,4933,267729,89985,177744,40354.0,484248,10.0,21.96,0.0195,8070,5.0,19968.21,0.25,0.4755
3269,Jackson Mann and Fowler,False,FR,Walkerbury,Mobility,2019,https://jacksonmannandfowler.com,Minute discussion may set another physical free choose.,29,jackson-mann-and-fowler,2023,EUR,1818135,545676,1272459,1153605,118854,27763,91091,18181,36362,54729,137686,1108556,267266,841290,,1818135,987.73,6102.06,0.0846,938,161.36,84739.11,1.62,0.6999
3270,Tucker Barnes and Richardson,False,DE,Richardland,Mobility,2008,https://tuckerbarnesandrichardson.com,History later plant indicate analysis.,18,tucker-barnes-and-richardson,2023,EUR,1117815,471159,646656,970746,-324090,26460,-350550,11178,22356,-372906,78656,803277,427291,375986,,1117815,590.73,351.49,0.0747,577,161.26,67848.79,1.16,0.5785
3271,Landry and Sons,False,DE,Alejandrofurt,Cybersecurity,2008,https://landryandsons.com,Expect PM full stage home stock campaign series early.,17,landry-and-sons,2023,EUR,1858918,753211,1105707,843559,262148,0,262148,18589,37178,224970,272901,1363174,708828,654346,,1858918,20.0,38.19,0.0872,1136,136.25,33844.27,8.06,0.5948
3272,Cook Schultz and Garcia,False,AU,West Jonathan,AgriTech,2019,https://cookschultzandgarcia.com,Help try without think oil agree car nor success money.,26,cook-schultz-and-garcia,2023,USD,84230,27289,56941,47609,9332,5096,4236,842,1684,2552,8686,246702,64766,181936,,84230,20.0,21.16,0.029,350,20.0,35386.03,0.25,0.676
3273,Shepard Arias and Scott,False,DE,Elizabethshire,Fintech,2017,https://shepardariasandscott.com,Same keep goal letter chair tonight area.,19,shepard-arias-and-scott,2023,EUR,646346,271043,375303,471611,-96308,0,-96308,6463,12926,-109234,243813,589830,142686,447144,,646346,20.0,64.37,0.0974,2693,20.0,68733.77,3.55,0.5807
3274,King-Flowers,False,AU,Lake Daniel,Cybersecurity,2015,https://king-flowers.com,In notice only walk spend for their feeling.,20,king-flowers,2023,USD,2685564,739629,1945935,2003488,-57553,32270,-89823,26855,53711,-143534,340609,1868822,887841,980981,,2685564,20.0,38.01,0.001,1327,168.54,155931.59,2.18,0.7246
3275,Fisher-Owen,False,DE,Collinsland,Mobility,2019,https://fisher-owen.com,School civil care thought series move something.,24,fisher-owen,2023,EUR,7340822,3266351,4074471,4051810,22661,41683,-19022,73408,146816,-165838,1734602,5441777,1297361,4144416,,7340822,20.0,77.35,0.0322,1939,315.43,319361.47,5.43,0.555
3276,Gray-Hancock,False,US,North John,AgriTech,2023,https://gray-hancock.com,Little newspaper choice down other.,17,gray-hancock,2023,USD,1005580,387806,617774,753261,-135487,0,-135487,10055,20111,-155598,113044,685861,588337,97524,,1005580,1724.69,9124.96,0.001,1003,83.54,92631.22,1.22,0.6143
3277,Frank Ltd,False,ZA,Petersonhaven,Cybersecurity,2014,https://frankltd.com,Past maintain low yourself security you scene.,20,frank-ltd,2023,USD,1533106,627247,905859,1217021,-311162,0,-311162,15331,30662,-341824,374398,1335621,177889,1157732,,1533106,736.3,4394.98,0.0784,6387,20.0,93986.14,3.98,0.5909
3278,King-Hernandez,False,US,Darrellmouth,EdTech,2020,https://king-hernandez.com,Respond system quality every.,14,king-hernandez,2023,USD,327365,67001,260364,156153,104211,0,104211,3273,6547,97664,35683,234029,140560,93469,27280.42,327365,180.33,682.41,0.0114,347,78.52,38885.94,0.92,0.7953
3279,Lopez Group,False,FR,East Jerome,AgriTech,2024,https://lopezgroup.com,Trial analysis father attention low describe local wall appear.,27,lopez-group,2023,EUR,49700,18271,31429,25916,5513,0,5513,497,994,4519,4765,159587,79881,79706,,49700,1297.39,1668.56,0.0543,31,131.83,1000.0,4.76,0.6324
3280,Young-Young,False,EG,Hurleyborough,HealthTech,2014,https://young-young.com,What city yeah most trouble country policy.,20,young-young,2023,USD,1187085,471019,716066,663272,52794,7983,44811,11870,23741,21070,44290,817407,102185,715222,98923.75,1187085,10.0,12.06,0.0523,1476,67.02,68826.12,0.64,0.6032
3281,Kelly-Mcfarland,False,BR,South Sherry,Cybersecurity,2013,https://kelly-mcfarland.com,Way month exactly write she these.,26,kelly-mcfarland,2023,USD,532497,162583,369914,293849,76065,25676,50389,5324,10649,39740,18163,349474,80664,268810,,532497,20.0,10.0,0.0607,2218,20.0,29548.05,0.61,0.6947
3282,Brown Mills and Hubbard,False,FR,New Davidville,IoT,2012,https://brownmillsandhubbard.com,Per consider build stand represent dog care politics in couple.,24,brown-mills-and-hubbard,2023,EUR,620691,244346,376345,72569,303776,0,303776,6206,12413,291363,61554,464390,173648,290742,,620691,20.0,48.55,0.001,490,105.55,33921.43,1.81,0.6063
3283,Hull Mcgee and Barry,False,ZA,Matthewport,Fintech,2012,https://hullmcgeeandbarry.com,Could nor law better other camera.,24,hull-mcgee-and-barry,2023,USD,1076155,131016,945139,363096,582043,4947,577096,10761,21523,555573,57441,650527,315744,334783,,1076155,707.45,1075.47,0.0249,4483,20.0,14861.49,3.87,0.8783
3284,Nelson PLC,False,IN,East Kelly,IoT,2015,https://nelsonplc.com,Simple still wife student allow agency population.,22,nelson-plc,2023,USD,152383,20478,131905,83326,48579,0,48579,1523,3047,45532,22455,214251,65201,149050,,152383,20.0,99.4,0.0735,85,147.92,1000.0,22.46,0.8656
3285,Yang Hines and Walker,False,NG,Leeberg,Cybersecurity,2016,https://yanghinesandwalker.com,Possible about middle someone marriage whether figure.,17,yang-hines-and-walker,2023,USD,229001,110321,118680,99145,19535,10731,8804,2290,4580,4224,21938,262206,13110,249096,,229001,661.07,1449.17,0.001,108,176.48,11512.3,1.91,0.5183
3286,Shaw-Combs,False,DE,South Davidberg,Marketplaces,2008,https://shaw-combs.com,Treat cold many specific wall.,22,shaw-combs,2023,EUR,145889,65815,80074,30290,49784,12121,37663,1458,2917,34746,5134,271543,116640,154903,,145889,20.0,10.0,0.0186,41,295.52,3005.56,1.71,0.5489
3287,Michael-Rollins,False,ZA,East Kevinville,Marketplaces,2016,https://michael-rollins.com,Writer structure probably likely clear exactly prepare growth yourself key.,20,michael-rollins,2023,USD,1172241,265023,907218,440924,466294,18541,447753,11722,23444,424309,56777,793378,302567,490811,,1172241,270.79,486.11,0.0691,775,125.94,16593.93,3.42,0.7739
3288,Aguilar Briggs and Kelly,False,BR,North Christopher,AI/ML,2022,https://aguilarbriggsandkelly.com,Less medical ground international group trial use these answer head.,20,aguilar-briggs-and-kelly,2023,USD,2249406,816294,1433112,918660,514452,0,514452,22494,44988,469464,210939,1396166,326415,1069751,,2249406,20.0,51.25,0.001,644,290.84,55401.82,3.81,0.6371
3289,Beltran-Walton,False,US,Kimton,Energy,2009,https://beltran-walton.com,Program call best case such.,22,beltran-walton,2023,USD,1492590,491166,1001424,548282,453142,0,453142,14925,29851,423291,215703,1128853,56442,1072411,,1492590,386.08,797.26,0.001,667,186.37,34816.73,6.2,0.6709
3290,Davis-Bird,False,CA,East Paulchester,Energy,2021,https://davis-bird.com,Give team dream single worry year door establish something will.,26,davis-bird,2023,USD,1454434,349873,1104561,338200,766361,3549,762812,14544,29088,733724,51699,885199,244614,640585,,1454434,1360.28,1921.02,0.1447,465,260.52,12255.3,4.22,0.7594
3291,Mcgee PLC,False,IN,Lauriestad,Fintech,2024,https://mcgeeplc.com,Avoid home technology unit blue or back city imagine.,33,mcgee-plc,2023,USD,1730935,881811,849124,433959,415165,0,415165,17309,34618,380547,141351,1159217,389167,770050,,1730935,510.67,916.38,0.0414,7212,20.0,16974.8,8.33,0.4906
3292,Stanton-Rivera,False,EG,North Donaldhaven,Mobility,2019,https://stanton-rivera.com,Season day senior beat child.,16,stanton-rivera,2023,USD,1059312,531234,528078,92144,435934,0,435934,10593,21186,414748,77321,667563,326209,341354,,1059312,261.77,130.88,0.001,4413,20.0,1000.0,77.32,0.4985
3293,Hall Inc,False,NG,Benjaminmouth,SaaS,2015,https://hallinc.com,News usually put civil you office for.,27,hall-inc,2023,USD,202203,89578,112625,55254,57371,14787,42584,2022,4044,38540,5124,239846,60075,179771,16850.25,202203,643.44,1591.05,0.0026,237,70.89,25795.62,0.2,0.557
3294,Rogers-Montoya,False,US,Troybury,AgriTech,2021,https://rogers-montoya.com,It begin have tonight weight.,19,rogers-montoya,2023,USD,157832,68990,88842,10391,78451,0,78451,1578,3156,75295,3753,121447,16826,104621,,157832,326.32,1691.0,0.1021,657,20.0,16449.38,0.23,0.5629
3295,Clark LLC,False,NG,West Yolanda,Mobility,2018,https://clarkllc.com,Citizen use kid write eight interest term.,19,clark-llc,2023,USD,1001845,379803,622042,768738,-146696,0,-146696,10018,20036,-166732,166002,738032,491369,246663,,1001845,21.48,19.81,0.001,4174,20.0,52457.04,3.16,0.6209
3296,Kirk Jackson and Buck,False,US,Pricefort,Energy,2014,https://kirkjacksonandbuck.com,Popular onto everyone green seem vote series.,16,kirk-jackson-and-buck,2023,USD,1532046,432516,1099530,1084159,15371,0,15371,15320,30640,-15269,65062,1003891,226169,777722,,1532046,1574.1,3120.38,0.0113,525,242.92,35261.4,1.85,0.7177
3297,Ramsey-Jackson,False,CA,West Carlachester,Fintech,2008,https://ramsey-jackson.com,Wide challenge eye last apply even lot.,19,ramsey-jackson,2023,USD,3158804,1276874,1881930,2257007,-375077,18885,-393962,31588,63176,-457138,158061,1746884,644632,1102252,,3158804,379.99,1195.73,0.1105,10525,25.01,183329.65,0.86,0.5958
3298,Wilkinson Moyer and Mcintosh,False,ZA,Lake Deborahport,EdTech,2021,https://wilkinsonmoyerandmcintosh.com,Performance tree develop board another girl suffer doctor this owner.,14,wilkinson-moyer-and-mcintosh,2023,USD,669391,177047,492344,33469,458875,5483,453392,6693,13387,440005,21756,381074,159300,221774,55782.58,669391,292.99,1229.23,0.0142,655,85.08,32717.56,0.66,0.7355
3299,Mcintosh Inc,False,FR,Joshuaburgh,EdTech,2014,https://mcintoshinc.com,Above girl put end subject let wish.,19,mcintosh-inc,2023,EUR,252976,33076,219900,136215,83685,934,82751,2529,5059,77692,13058,146749,46113,100636,21081.33,252976,24.17,52.24,0.0223,282,74.72,11098.18,1.18,0.8693
3300,Padilla Group,False,GB,New Lindabury,E-commerce,2017,https://padillagroup.com,Month security throughout worry population wear interview fly.,25,padilla-group,2023,USD,269673,53957,215716,181955,33761,0,33761,2696,5393,28368,6505,261537,34193,227344,,269673,587.65,950.56,0.105,315,71.17,20306.99,0.32,0.7999
3301,Hoffman Watson and Austin,False,FR,Greenstad,Marketplaces,2011,https://hoffmanwatsonandaustin.com,Two place possible around shoulder field his.,26,hoffman-watson-and-austin,2023,EUR,802272,211945,590327,614673,-24346,4483,-28829,8022,16045,-44874,1445,552504,224378,328126,,802272,32.45,217.78,0.0941,341,195.56,82080.75,0.02,0.7358
3302,Robles LLC,False,US,Robertsonshire,Mobility,2021,https://roblesllc.com,Though month article realize two mission political issue soon.,15,robles-llc,2023,USD,4929968,650205,4279763,4037389,242374,0,242374,49299,98599,143775,324483,2860342,1449649,1410693,,4929968,1110.58,3907.42,0.001,1214,338.39,377269.66,0.86,0.8681
3303,Hines and Sons,False,AU,Port Williammouth,SaaS,2018,https://hinesandsons.com,Accept teach white mission sing though end board suffer time.,17,hines-and-sons,2023,USD,4015508,1434894,2580614,1528244,1052370,0,1052370,40155,80310,972060,238256,2399794,1227717,1172077,334625.67,4015508,115.73,414.96,0.0443,7207,46.43,181001.05,1.32,0.6427
3304,Shelton and Sons,False,IN,Robertland,EdTech,2011,https://sheltonandsons.com,Pay child from describe tonight after across chair someone which.,21,shelton-and-sons,2023,USD,427499,225392,202107,251203,-49096,7745,-56841,4274,8549,-65390,31736,289654,186694,102960,35624.92,427499,681.8,3742.1,0.0973,7124,5.0,1000.0,31.74,0.4728
3305,Oneill-Davidson,False,EG,West Charles,EdTech,2018,https://oneill-davidson.com,Suggest go area data Congress none early baby range after.,24,oneill-davidson,2023,USD,299713,156720,142993,65161,77832,0,77832,2997,5994,71838,7107,269542,125253,144289,24976.08,299713,108.27,145.69,0.001,305,81.81,19543.58,0.36,0.4771
3306,Collins-Russell,False,US,New Susanburgh,E-commerce,2024,https://collins-russell.com,Story prevent audience arm interview foreign well hold sit develop.,18,collins-russell,2023,USD,1750484,753561,996923,591024,405899,40998,364901,17504,35009,329892,118142,1114123,705041,409082,,1750484,167.05,974.29,0.0591,7293,20.0,46924.32,2.52,0.5695
3307,Blair Mejia and Warren,False,AU,Billland,EdTech,2010,https://blairmejiaandwarren.com,Back couple almost eat religious agreement least more include.,24,blair-mejia-and-warren,2023,USD,389564,123339,266225,19478,246747,5941,240806,3895,7791,233015,13305,303291,45097,258194,32463.67,389564,391.92,1386.96,0.001,6492,5.0,1000.0,13.3,0.6834
3308,Garza-Arnold,False,AU,Marshbury,IoT,2022,https://garza-arnold.com,Democratic PM window soon some language participant make including.,23,garza-arnold,2023,USD,197185,82925,114260,117229,-2969,0,-2969,1971,3943,-6912,138506,266801,186888,79913,,197185,20.0,99.1,0.0087,70,231.6,16254.9,8.52,0.5795
3309,Miller Inc,False,AU,Walshmouth,Fintech,2022,https://millerinc.com,Factor ability ready area message car picture ready huge.,23,miller-inc,2023,USD,1486035,496217,989818,685111,304707,26336,278371,14860,29720,248651,163451,1013673,351474,662199,,1486035,897.39,5706.8,0.1486,6191,20.0,77806.3,2.1,0.6661
3310,Delacruz Stephens and Gray,False,KE,New Reneebury,Fintech,2010,https://delacruzstephensandgray.com,American matter stop beyond try seek car bring reduce.,17,delacruz-stephens-and-gray,2023,USD,439928,182095,257833,278783,-20950,0,-20950,4399,8798,-29748,76850,448696,265289,183407,,439928,1413.01,892.58,0.0828,233,156.7,35088.16,2.19,0.5861
3311,Poole Sawyer and Raymond,False,US,West Codyton,SaaS,2020,https://poolesawyerandraymond.com,Two strategy seven throw training safe.,20,poole-sawyer-and-raymond,2023,USD,994998,232606,762392,565758,196634,9555,187079,9949,19899,167180,26000,591036,143934,447102,82916.5,994998,689.36,2181.34,0.0084,6796,12.2,21707.78,1.2,0.7662
3312,Gonzalez Adams and Chapman,False,CA,Port Patrickmouth,Cybersecurity,2010,https://gonzalezadamsandchapman.com,Pattern too successful always wonder example figure bank sort.,21,gonzalez-adams-and-chapman,2023,USD,320410,135373,185037,74959,110078,0,110078,3204,6408,103670,12964,322267,210640,111627,,320410,1092.4,4658.45,0.1294,162,164.42,7431.32,1.74,0.5775
3313,Perez-White,False,AU,Lake Edward,HealthTech,2009,https://perez-white.com,Note either career wide operation.,14,perez-white,2023,USD,1786688,520311,1266377,1129454,136923,8848,128075,17866,35733,92342,28329,1012053,373801,638252,148890.67,1786688,543.3,2490.45,0.0122,1348,110.41,137479.08,0.21,0.7088
3314,Hunter-Hughes,False,AU,Griffinville,Mobility,2009,https://hunter-hughes.com,Together machine test choose force.,23,hunter-hughes,2023,USD,2623646,970306,1653340,2046566,-393226,36880,-430106,26236,52472,-482578,67663,1411128,613241,797887,,2623646,445.41,912.29,0.0863,1291,169.24,205175.88,0.33,0.6302
3315,Buchanan-Larson,False,IN,Markburgh,IoT,2021,https://buchanan-larson.com,Type church respond such professional society trouble.,22,buchanan-larson,2023,USD,786197,161905,624292,387984,236308,4549,231759,7861,15723,216036,29445,499710,328943,170767,,786197,20.0,76.23,0.0273,3275,20.0,62634.54,0.47,0.7941
3316,Fields-Williams,False,FR,Mezamouth,Fintech,2009,https://fields-williams.com,Work color center edge.,17,fields-williams,2023,EUR,516284,196943,319341,125466,193875,16177,177698,5162,10325,167373,75462,375894,132135,243759,,516284,2082.14,8009.11,0.001,393,109.22,15110.1,4.99,0.6185
3317,Barnes and Sons,False,NG,Harryville,SaaS,2017,https://barnesandsons.com,Picture explain kind wall such which child choice husband.,17,barnes-and-sons,2023,USD,1047737,422673,625064,571766,53298,0,53298,10477,20954,32344,11289,654960,212286,442674,87311.42,1047737,10.0,31.08,0.0408,773,112.81,36259.19,0.31,0.5966
3318,Clark Pham and Anderson,False,TN,North Kimberly,Energy,2011,https://clarkphamandanderson.com,Last story skill left film this concern seat never.,14,clark-pham-and-anderson,2023,USD,5957406,2354184,3603222,757960,2845262,18030,2827232,59574,119148,2708084,1277909,4450879,222543,4228336,,5957406,1745.5,5452.86,0.0938,12227,40.6,16504.52,77.43,0.6048
3319,Barr-Mendez,False,KE,Port Rachelchester,Energy,2015,https://barr-mendez.com,All official hit hot last student company.,17,barr-mendez,2023,USD,881684,281236,600448,478845,121603,32795,88808,8816,17633,71175,97992,702702,344585,358117,,881684,252.9,126.45,0.0321,3673,20.0,50802.91,1.93,0.681
3320,Johnson-Moore,False,KE,Doughertyport,Marketplaces,2008,https://johnson-moore.com,Our trade PM either resource but increase start other ten would.,23,johnson-moore,2023,USD,601499,262338,339161,569995,-230834,25703,-256537,6014,12029,-268566,31151,502019,117503,384516,,601499,257.97,654.3,0.001,797,62.84,36293.69,0.86,0.5639
3321,Little-Allison,False,EG,Reginastad,Energy,2022,https://little-allison.com,Left water early spring plan born culture cold maybe.,25,little-allison,2023,USD,491654,105187,386467,107215,279252,15349,263903,4916,9833,254070,10115,274806,23108,251698,,491654,97.73,601.97,0.057,823,49.78,1000.0,10.12,0.7861
3322,Lewis Kirby and Boyd,False,AU,Carrilloberg,Energy,2011,https://lewiskirbyandboyd.com,South should international fly series move.,20,lewis-kirby-and-boyd,2023,USD,1830624,495131,1335493,881961,453532,14227,439305,18306,36612,402693,52701,1147057,695033,452024,,1830624,869.44,434.72,0.0306,687,221.81,87233.45,0.6,0.7295
3323,Anderson-Callahan,False,CA,Tinaport,Marketplaces,2008,https://anderson-callahan.com,Physical positive country role result choice beyond feel.,21,anderson-callahan,2023,USD,221200,123202,97998,107489,-9491,16384,-25875,2212,4424,-30299,21275,248447,57687,190760,,221200,20.0,29.57,0.0037,301,61.16,18804.12,1.13,0.443
3324,Perry-Sherman,False,EG,Michaelborough,AI/ML,2018,https://perry-sherman.com,Wrong common without carry eat smile four each give individual.,29,perry-sherman,2023,USD,871997,354108,517889,425775,92114,0,92114,8719,17439,74675,18199,641052,355415,285637,,871997,571.48,2378.28,0.0246,755,96.24,54519.67,0.33,0.5939
3325,Odom PLC,False,KE,Cabrerafort,EdTech,2011,https://odomplc.com,Field top chance accept skin determine record natural.,17,odom-plc,2023,USD,24443,9215,15228,5746,9482,0,9482,244,488,8994,4976,161711,36093,125618,2036.92,24443,10.0,24.55,0.0539,25,78.83,1000.0,4.98,0.623
3326,Harris Ltd,False,FR,Fowlerland,SaaS,2010,https://harrisltd.com,Back half lead wife between financial become understand green sign blue.,16,harris-ltd,2023,EUR,336131,90189,245942,188754,57188,0,57188,3361,6722,50466,8140,215915,68668,147247,28010.92,336131,457.54,747.46,0.0326,1158,24.18,1000.0,8.14,0.7317
3327,Monroe-Lewis,False,KE,Johnview,EdTech,2012,https://monroe-lewis.com,Nature both nation themselves try full.,23,monroe-lewis,2023,USD,410894,286731,124163,108652,15511,13946,1565,4108,8217,-6652,35769,300515,119529,180986,34241.17,410894,475.64,978.48,0.0217,1191,28.73,34397.26,1.04,0.3022
3328,Parsons Bennett and Villanueva,False,BR,Gilmorestad,AI/ML,2016,https://parsonsbennettandvillanueva.com,Hard keep score send.,20,parsons-bennett-and-villanueva,2023,USD,855872,78160,777712,155314,622398,6553,615845,8558,17117,598728,31654,471202,179988,291214,,855872,20.0,61.14,0.1059,580,122.76,1000.0,31.65,0.9087
3329,Martinez LLC,False,CA,North Dianaside,Energy,2023,https://martinezllc.com,Artist popular talk far address.,22,martinez-llc,2023,USD,2587669,853715,1733954,1066329,667625,0,667625,25876,51753,615872,91907,1513410,626257,887153,,2587669,20.0,129.74,0.0999,3502,61.57,93950.76,0.98,0.6701
3330,Stevens and Sons,False,ZA,Port Alexis,IoT,2022,https://stevensandsons.com,From not certainly poor pick network strong moment.,16,stevens-and-sons,2023,USD,1249343,532732,716611,958791,-242180,0,-242180,12493,24986,-267166,13476,686909,291395,395514,,1249343,547.45,1768.82,0.09,372,279.24,42706.93,0.32,0.5736
3331,Boyer-Villa,False,GB,Pachecochester,EdTech,2012,https://boyer-villa.com,Reason beyond finally bad article fund teacher.,21,boyer-villa,2023,USD,607037,258996,348041,414815,-66774,58098,-124872,6070,12140,-137012,21290,361633,210326,151307,50586.42,607037,465.24,1749.33,0.001,799,63.24,79446.15,0.27,0.5733
3332,Hancock Hobbs and Alvarez,False,AU,West Danielburgh,SaaS,2009,https://hancockhobbsandalvarez.com,Return factor option air heavy yes either high born.,22,hancock-hobbs-and-alvarez,2023,USD,581363,137539,443824,204581,239243,7491,231752,5813,11627,220125,25186,427640,73365,354275,48446.92,581363,10.0,31.22,0.0229,1078,44.94,20300.86,1.24,0.7634
3333,Hunter and Sons,False,GB,South Tylerberg,AgriTech,2021,https://hunterandsons.com,Risk strategy traditional the green expect listen early so fall.,19,hunter-and-sons,2023,USD,1159527,324893,834634,323741,510893,25887,485006,11595,23190,461816,28843,717484,123290,594194,,1159527,20.0,66.68,0.0799,4831,20.0,15832.78,1.82,0.7198
3334,Anderson-Romero,False,NG,Owenburgh,Marketplaces,2019,https://anderson-romero.com,Free parent tree new operation condition understand.,19,anderson-romero,2023,USD,562450,237385,325065,194850,130215,30028,100187,5624,11249,88938,43412,426109,80350,345759,,562450,187.05,504.33,0.0634,1326,35.33,1000.0,43.41,0.5779
3335,Morgan-Holt,False,IN,Lake Deniseview,IoT,2012,https://morgan-holt.com,Business act feel option human body.,29,morgan-holt,2023,USD,555843,175240,380603,177004,203599,25885,177714,5558,11116,166598,44082,355062,107988,247074,,555843,1132.32,566.16,0.0747,287,160.85,1000.0,44.08,0.6847
3336,Griffin-Morris,False,GB,Nathanshire,Mobility,2017,https://griffin-morris.com,Return key people herself value.,20,griffin-morris,2023,USD,3172270,1211702,1960568,158613,1801955,0,1801955,31722,63445,1738510,103436,1715894,161127,1554767,,3172270,1516.91,8494.18,0.0842,13217,20.0,1000.0,103.44,0.618
3337,Jordan Thompson and Glover,False,KE,New Matthew,E-commerce,2017,https://jordanthompsonandglover.com,Unit room across second pick campaign get.,19,jordan-thompson-and-glover,2023,USD,2387664,119383,2268281,1124045,1144236,4037,1140199,23876,47753,1092446,53881,1289407,453246,836161,,2387664,627.34,3228.66,0.0504,2115,94.07,77429.31,0.7,0.95
3338,Dunlap-Larson,False,CA,Port Danielle,SaaS,2024,https://dunlap-larson.com,Really lawyer state property design compare grow find.,17,dunlap-larson,2023,USD,581214,94074,487140,217346,269794,3493,266301,5812,11624,254677,68709,520065,193564,326501,48434.5,581214,10.0,32.34,0.0394,834,58.03,22645.2,3.03,0.8381
3339,Ball Burns and Johnson,False,KE,North Joann,Marketplaces,2012,https://ballburnsandjohnson.com,Artist go make project half.,19,ball-burns-and-johnson,2023,USD,242928,71508,171420,45794,125626,36573,89053,2429,4858,84195,27180,288729,121816,166913,,242928,1243.1,6475.73,0.0767,117,172.41,1492.75,18.21,0.7056
3340,Jenkins LLC,False,US,North Matthew,EdTech,2024,https://jenkinsllc.com,Investment finally detail many natural attorney use discuss.,22,jenkins-llc,2023,USD,737316,196147,541169,135461,405708,0,405708,7373,14746,390962,14373,514932,111184,403748,61443.0,737316,149.47,848.48,0.0122,12288,5.0,15582.35,0.92,0.734
3341,Henson Lewis and Kemp,False,NG,North Robinview,SaaS,2021,https://hensonlewisandkemp.com,To simply company item return low particularly skill current single.,17,henson-lewis-and-kemp,2023,USD,3660221,370660,3289561,966373,2323188,0,2323188,36602,73204,2249984,82877,1929002,988849,940153,305018.42,3660221,63.63,325.13,0.0614,3427,89.0,72943.54,1.14,0.8987
3342,Jordan and Sons,False,CA,Lake Carolberg,EdTech,2014,https://jordanandsons.com,Inside move reveal little fall project line form fire however.,17,jordan-and-sons,2023,USD,401709,123741,277968,89963,188005,3741,184264,4017,8034,176230,27961,344361,92236,252125,33475.75,401709,10.0,38.76,0.0145,394,84.8,1000.0,27.96,0.692
3343,Tyler-Williams,False,BR,Callahanstad,EdTech,2010,https://tyler-williams.com,Step heart or range politics.,15,tyler-williams,2023,USD,352966,160165,192801,133479,59322,30006,29316,3529,7059,22257,7934,381513,19075,362438,29413.83,352966,207.28,440.16,0.001,939,31.31,1000.0,7.93,0.5462
3344,Payne Church and Rojas,False,CA,Annetteview,EdTech,2023,https://paynechurchandrojas.com,Bad experience occur day she base floor.,15,payne-church-and-rojas,2023,USD,696154,236868,459286,433372,25914,2048,23866,6961,13923,9943,8098,436212,21810,414402,58012.83,696154,349.2,1202.2,0.0473,736,78.77,19421.34,0.42,0.6597
3345,Zimmerman Stewart and Brandt,False,ZA,South Kaitlyn,Cybersecurity,2022,https://zimmermanstewartandbrandt.com,Between among respond prevent act early.,25,zimmerman-stewart-and-brandt,2023,USD,1501551,528796,972755,617955,354800,33516,321284,15015,30031,291253,43437,852876,315624,537252,,1501551,351.1,1654.49,0.0116,512,243.93,12159.35,3.57,0.6478
3346,Wright-Hall,False,KE,Jodiside,Cybersecurity,2018,https://wright-hall.com,Term certain process into government behavior receive artist.,26,wright-hall,2023,USD,249419,162209,87210,74954,12256,26923,-14667,2494,4988,-19655,3406,301857,77229,224628,,249419,2222.65,3190.44,0.0409,376,55.27,1000.0,3.41,0.3497
3347,Navarro-Allen,False,KE,Millerport,IoT,2018,https://navarro-allen.com,Eye fly even type current about position site spring shake.,29,navarro-allen,2023,USD,1791952,508706,1283246,692978,590268,9902,580366,17919,35839,544527,14878,1027410,599354,428056,,1791952,20.0,89.06,0.0013,1068,139.82,51226.53,0.29,0.7161
3348,Rojas-Harrison,False,KE,Davidport,AgriTech,2021,https://rojas-harrison.com,Start security social test may best each serious those.,18,rojas-harrison,2023,USD,148154,41482,106672,90600,16072,0,16072,1481,2963,13109,8824,188061,90958,97103,,148154,868.45,571.18,0.0707,76,160.74,1000.0,8.82,0.72
3349,Villarreal and Sons,False,CA,Gonzalezmouth,HealthTech,2011,https://villarrealandsons.com,Same leg measure here themselves law around still term.,33,villarreal-and-sons,2023,USD,1145888,574349,571539,201672,369867,0,369867,11458,22917,346950,301826,913470,212512,700958,95490.67,1145888,520.2,3727.81,0.0835,1102,86.58,1000.0,301.83,0.4988
3350,Bryant Group,False,EG,Simmonsfurt,SaaS,2023,https://bryantgroup.com,Political ground middle guess challenge bank another message important get.,22,bryant-group,2023,USD,3048298,734095,2314203,1508998,805205,28149,777056,30482,60965,716091,209145,1889873,583553,1306320,254024.83,3048298,10.0,12.86,0.0094,50804,5.0,102976.87,2.03,0.7592
3351,Clark Cruz and Spence,False,DE,Nelsonville,SaaS,2015,https://clarkcruzandspence.com,Ask public add sell employee notice minute.,20,clark-cruz-and-spence,2023,EUR,940482,368157,572325,290953,281372,0,281372,9404,18809,262563,19078,524927,247577,277350,78373.5,940482,375.51,1423.82,0.001,1136,68.97,22985.41,0.83,0.6085
3352,Anthony Flores and Cobb,False,ZA,Williamstown,EdTech,2022,https://anthonyfloresandcobb.com,Need rather account message black.,23,anthony-flores-and-cobb,2023,USD,273458,86974,186484,13672,172812,5015,167797,2734,5469,162328,13939,220999,86517,134482,22788.17,273458,538.64,2699.1,0.0442,382,59.6,12394.32,1.12,0.6819
3353,Robinson Clay and Martinez,False,KE,Lake Erica,EdTech,2015,https://robinsonclayandmartinez.com,Political live not media office detail subject black particular long page.,25,robinson-clay-and-martinez,2023,USD,163796,81651,82145,65848,16297,0,16297,1637,3275,13022,8140,248173,77650,170523,13649.67,163796,142.49,653.07,0.0547,2729,5.0,1000.0,8.14,0.5015
3354,Gutierrez Inc,False,EG,Port Alicialand,Cybersecurity,2018,https://gutierrezinc.com,Say lead season bill allow mind require raise floor.,24,gutierrez-inc,2023,USD,898146,452567,445579,843867,-398288,12030,-410318,8981,17962,-428280,290004,912853,104572,808281,,898146,20.0,41.99,0.0887,1470,50.9,98074.92,2.96,0.4961
3355,Martinez and Sons,False,AU,Carlaland,Cybersecurity,2020,https://martinezandsons.com,Campaign million different member trade would idea job.,33,martinez-and-sons,2023,USD,797700,305002,492698,97622,395076,54391,340685,7977,15954,324731,65797,638487,330705,307782,,797700,1269.88,3396.7,0.0286,1067,62.3,9859.01,6.67,0.6176
3356,Miller Vaughan and Harris,False,DE,North Megan,Energy,2013,https://millervaughanandharris.com,Too notice break for require soldier major wear son.,18,miller-vaughan-and-harris,2023,EUR,421872,181846,240026,53361,186665,4870,181795,4218,8437,173358,93067,309359,62937,246422,,421872,95.48,618.58,0.0543,346,101.54,11335.17,8.21,0.569
3357,Cooper-Wright,False,US,Hendersonstad,E-commerce,2008,https://cooper-wright.com,Behavior million camera join theory.,25,cooper-wright,2023,USD,865006,352000,513006,342350,170656,20470,150186,8650,17300,132886,29226,615120,384628,230492,,865006,826.4,698.16,0.1006,3604,20.0,18363.65,1.59,0.5931
3358,Schroeder Rodriguez and Lewis,False,FR,South Gavinville,E-commerce,2008,https://schroederrodriguezandlewis.com,Edge really including movement than would crime building.,18,schroeder-rodriguez-and-lewis,2023,EUR,1129435,214881,914554,961963,-47409,5985,-53394,11294,22588,-75982,25482,599072,177305,421767,,1129435,938.41,1717.81,0.085,626,150.3,79891.05,0.32,0.8097
3359,Johnson-Harris,False,NG,Smithfort,Fintech,2012,https://johnson-harris.com,Yard indeed play measure for feeling seat.,18,johnson-harris,2023,USD,682375,392629,289746,327107,-37361,19844,-57205,6823,13647,-70852,113304,623979,229711,394268,,682375,48.77,101.51,0.001,252,224.92,50177.14,2.26,0.4246
3360,Graves-Torres,False,IN,Amberville,Mobility,2014,https://graves-torres.com,Suggest talk major pass newspaper computer serve thus town member.,22,graves-torres,2023,USD,447390,129017,318373,384458,-66085,43994,-110079,4473,8947,-119026,9316,420874,143251,277623,,447390,408.57,1048.23,0.0605,142,260.91,8726.76,1.07,0.7116
3361,Mullen-Ramirez,False,BR,Port Michaelborough,IoT,2019,https://mullen-ramirez.com,Future debate shake here approach.,23,mullen-ramirez,2023,USD,289795,110715,179080,128705,50375,4018,46357,2897,5795,40562,13549,326244,160793,165451,,289795,2000.68,6167.58,0.1413,143,168.86,1000.0,13.55,0.618
3362,Bates Morris and Barnes,False,US,Norrisbury,SaaS,2014,https://batesmorrisandbarnes.com,Make entire look man direction beautiful fund draw soon structure.,25,bates-morris-and-barnes,2023,USD,451477,128898,322579,216447,106132,11977,94155,4514,9029,85126,143804,417541,174249,243292,37623.08,451477,651.4,2097.68,0.001,475,79.07,1000.0,143.8,0.7145
3363,Wright Shields and Miller,False,DE,Woodmouth,AgriTech,2013,https://wrightshieldsandmiller.com,Particularly right window want instead him.,21,wright-shields-and-miller,2023,EUR,16521,3794,12727,7483,5244,0,5244,165,330,4914,4230,103731,53507,50224,,16521,2559.27,6113.0,0.0352,68,20.0,2283.57,1.85,0.7704
3364,Duran-Avery,False,DE,South Lisaton,AgriTech,2013,https://duran-avery.com,Throughout do without key quite law find.,14,duran-avery,2023,EUR,332030,176643,155387,94935,60452,0,60452,3320,6640,53812,4188,258096,62679,195417,,332030,347.98,1066.16,0.001,1283,21.55,10731.02,0.39,0.468
3365,Johnson Ltd,False,CA,Jamesfort,AI/ML,2015,https://johnsonltd.com,See seven mind worry area activity.,23,johnson-ltd,2023,USD,3252783,1661410,1591373,2104399,-513026,0,-513026,32527,65055,-578081,163338,1915777,1216022,699755,,3252783,20.0,19.31,0.0338,1327,204.17,186328.23,0.88,0.4892
3366,Stark Hill and Dean,False,GB,West Jillian,EdTech,2008,https://starkhillanddean.com,Consumer save box third cup role career where apply bag.,13,stark-hill-and-dean,2023,USD,136326,22617,113709,7490,106219,34817,71402,1363,2726,68676,22554,271348,13567,257781,11360.5,136326,368.77,1423.16,0.001,1600,7.1,5175.23,4.36,0.8341
3367,Kim Group,False,GB,Rachelstad,AgriTech,2011,https://kimgroup.com,Successful maybe environment meeting meet.,17,kim-group,2023,USD,1444712,604992,839720,864285,-24565,4973,-29538,14447,28894,-58432,414495,1331983,722553,609430,,1444712,20.0,75.56,0.0548,1357,88.67,102186.06,4.06,0.5812
3368,Bullock Dean and Fox,False,US,Michaelhaven,Marketplaces,2012,https://bullockdeanandfox.com,Relate man run green red local between them beautiful true own.,13,bullock-dean-and-fox,2023,USD,670583,357616,312967,315656,-2689,9803,-12492,6705,13411,-25903,185499,587025,274351,312674,,670583,1288.61,8801.09,0.0312,523,106.71,47612.97,3.9,0.4667
3369,Butler-Holland,False,TN,South Briannaburgh,Marketplaces,2011,https://butler-holland.com,Police number great again team while reveal.,17,butler-holland,2023,USD,197834,79314,118520,138995,-20475,17181,-37656,1978,3956,-41612,21578,230155,199756,30399,,197834,514.68,1284.4,0.0654,75,219.68,1000.0,21.58,0.5991
3370,Buck Vaughan and Gill,False,CA,Longchester,EdTech,2017,https://buckvaughanandgill.com,Will work number feeling adult director walk vote former political.,27,buck-vaughan-and-gill,2023,USD,364578,108123,256455,38434,218021,0,218021,3645,7291,210730,4981,213742,68356,145386,30381.5,364578,10.0,23.53,0.0402,384,79.04,6220.9,0.8,0.7034
3371,Humphrey and Sons,False,EG,Claytonview,EdTech,2019,https://humphreyandsons.com,Always kitchen imagine such your development.,18,humphrey-and-sons,2023,USD,656835,32841,623994,175036,448958,5669,443289,6568,13136,430153,29444,466675,176892,289783,54736.25,656835,157.43,968.76,0.0084,1182,46.29,1000.0,29.44,0.95
3372,Thompson-Hart,False,AU,Thomaston,E-commerce,2013,https://thompson-hart.com,Republican piece now television audience air establish.,15,thompson-hart,2023,USD,734822,210863,523959,263755,260204,4508,255696,7348,14696,241000,10030,511016,273490,237526,,734822,282.36,1021.51,0.0267,265,230.96,6461.39,1.55,0.713
3373,Frazier Martin and Higgins,False,NG,Brownmouth,IoT,2021,https://fraziermartinandhiggins.com,Miss interest know attorney reason nothing.,30,frazier-martin-and-higgins,2023,USD,333152,93175,239977,270067,-30090,3520,-33610,3331,6663,-40273,7355,297552,89771,207781,,333152,20.0,61.31,0.0356,1388,20.0,43938.55,0.17,0.7203
3374,Henry-Hernandez,False,ZA,West Kevin,Fintech,2011,https://henry-hernandez.com,Identify attention exactly dinner surface general culture professor.,20,henry-hernandez,2023,USD,1648753,637729,1011024,646938,364086,22813,341273,16487,32975,308298,46881,915832,295397,620435,,1648753,814.9,2796.99,0.0183,1309,104.91,19849.38,2.36,0.6132
3375,Sims Sutton and Torres,False,GB,Johnland,HealthTech,2014,https://simssuttonandtorres.com,Thank treatment all she officer amount.,19,sims-sutton-and-torres,2023,USD,782863,409810,373053,759593,-386540,2635,-389175,7828,15657,-404832,60479,567725,146298,421427,65238.58,782863,143.76,580.83,0.0176,1331,49.0,98904.11,0.61,0.4765
3376,Compton Inc,False,DE,West Dalton,AI/ML,2020,https://comptoninc.com,Allow identify edge this sometimes reveal design daughter stage.,23,compton-inc,2023,EUR,286777,143834,142943,105388,37555,31238,6317,2867,5735,582,43868,239903,97793,142110,,286777,189.11,670.56,0.0179,275,86.73,69305.96,0.63,0.4984
3377,Collins LLC,False,ZA,Martinezhaven,E-commerce,2018,https://collinsllc.com,Together that hour suddenly service situation light table process safe.,19,collins-llc,2023,USD,1170048,422038,748010,682652,65358,0,65358,11700,23400,41958,9352,651901,170118,481783,,1170048,1089.73,4566.95,0.001,4875,20.0,35679.95,0.26,0.6393
3378,Luna-Nixon,False,KE,North Austin,Energy,2015,https://luna-nixon.com,Manager many environment short ball.,20,luna-nixon,2023,USD,3382627,912450,2470177,470485,1999692,18620,1981072,33826,67652,1913420,176773,1913144,95657,1817487,,3382627,90.35,45.18,0.1056,3870,72.83,26405.76,6.69,0.7303
3379,Barry-Leach,False,US,Traceyfort,IoT,2014,https://barry-leach.com,Instead bag century reach production risk ever hope bag too.,23,barry-leach,2023,USD,693835,307768,386067,34691,351376,0,351376,6938,13876,337500,279468,743106,387016,356090,,693835,964.85,3824.3,0.0796,314,183.89,38608.62,7.24,0.5564
3380,Schneider Schultz and Davis,False,NG,Myersfort,AgriTech,2012,https://schneiderschultzanddavis.com,Everybody machine writer first real.,21,schneider-schultz-and-davis,2023,USD,271080,109594,161486,157812,3674,0,3674,2710,5421,-1747,2573,314873,65897,248976,,271080,390.66,807.8,0.0258,1129,20.0,16433.5,0.16,0.5957
3381,Hamilton Romero and Martin,False,CA,South William,EdTech,2009,https://hamiltonromeroandmartin.com,Leg put win but assume opportunity whose take pretty.,25,hamilton-romero-and-martin,2023,USD,205976,51767,154209,53652,100557,8540,92017,2059,4119,87898,12107,273652,65140,208512,17164.67,205976,10.0,48.75,0.001,393,43.57,1000.0,12.11,0.7487
3382,French Vasquez and Griffith,False,BR,Smithfort,AgriTech,2012,https://frenchvasquezandgriffith.com,Ability commercial just technology.,26,french-vasquez-and-griffith,2023,USD,233901,105072,128829,87163,41666,13838,27828,2339,4678,23150,96266,391067,95574,295493,,233901,1317.22,7339.06,0.053,157,124.11,1000.0,96.27,0.5508
3383,Doyle LLC,False,NG,Isaachaven,IoT,2023,https://doylellc.com,We a wide detail nation may senior.,21,doyle-llc,2023,USD,462216,199371,262845,230735,32110,0,32110,4622,9244,22866,13495,301786,22143,279643,,462216,1248.81,2321.26,0.0726,550,69.91,1000.0,13.5,0.5687
3384,Huerta-Rasmussen,False,DE,Villanuevamouth,Cybersecurity,2010,https://huerta-rasmussen.com,Film others probably talk increase population statement fight prepare main.,30,huerta-rasmussen,2023,EUR,844176,215570,628606,347635,280971,9060,271911,8441,16883,255028,84232,607349,391725,215624,,844176,1372.8,1431.98,0.0672,3517,20.0,6060.81,13.9,0.7446
3385,Guzman-Lee,False,AU,North Jason,Mobility,2010,https://guzman-lee.com,Center her teacher I likely possible debate happen wide scene.,19,guzman-lee,2023,USD,546881,198371,348510,486101,-137591,0,-137591,5468,10937,-148528,27281,500061,123140,376921,,546881,216.49,570.26,0.0628,407,111.9,43919.56,0.62,0.6373
3386,Schmidt-Hartman,False,GB,Markfurt,AI/ML,2020,https://schmidt-hartman.com,Democrat oil end well explain adult measure development.,20,schmidt-hartman,2023,USD,372159,31429,340730,50978,289752,0,289752,3721,7443,282309,22960,365810,213735,152075,,372159,1054.63,4302.28,0.047,556,55.72,32376.32,0.71,0.9155
3387,Thompson Group,False,AU,Andrewland,Marketplaces,2024,https://thompsongroup.com,Clear hotel sell realize health set.,18,thompson-group,2023,USD,367170,117856,249314,137892,111422,25788,85634,3671,7343,78291,26277,221626,37700,183926,,367170,645.09,322.54,0.0701,673,45.42,1000.0,26.28,0.679
3388,Campbell Bullock and Wood,False,CA,Hallport,Mobility,2024,https://campbellbullockandwood.com,Character whatever instead certainly price man investment cut new south.,24,campbell-bullock-and-wood,2023,USD,1375019,729477,645542,883470,-237928,3546,-241474,13750,27500,-268974,67906,909614,237548,672066,,1375019,197.9,201.38,0.1339,1724,66.45,62636.12,1.08,0.4695
3389,Brown Nixon and Brown,False,EG,West Leslie,HealthTech,2018,https://brownnixonandbrown.com,Quality investment both least onto our study partner owner price.,16,brown-nixon-and-brown,2023,USD,1311839,485803,826036,598537,227499,8498,219001,13118,26236,192765,99425,830619,253022,577597,109319.92,1311839,482.97,1930.06,0.0151,5623,19.44,48665.94,2.04,0.6297
3390,Walker Pope and Cannon,False,ZA,New James,E-commerce,2024,https://walkerpopeandcannon.com,Money standard network decision rest huge.,15,walker-pope-and-cannon,2023,USD,971582,223201,748381,786533,-38152,0,-38152,9715,19431,-57583,14380,559668,204915,354753,,971582,20.0,127.56,0.0055,673,120.18,84127.96,0.17,0.7703
3391,Gibbs Hernandez and Hunt,False,ZA,Clarkchester,Mobility,2023,https://gibbshernandezandhunt.com,Bill young give sea economic also space play street place.,21,gibbs-hernandez-and-hunt,2023,USD,9037500,3915797,5121703,4148468,973235,12146,961089,90375,180750,780339,835491,5387852,269392,5118460,,9037500,900.21,1837.24,0.001,37656,20.0,337978.8,2.47,0.5667
3392,Castillo Group,False,EG,Lake Crystal,AgriTech,2020,https://castillogroup.com,Box page agent walk eight trip.,23,castillo-group,2023,USD,745321,152248,593073,287864,305209,0,305209,7453,14906,290303,13194,494568,107212,387356,,745321,20.0,80.56,0.063,659,94.21,1000.0,13.19,0.7957
3393,Johnson-Gonzalez,False,BR,West Gregory,IoT,2009,https://johnson-gonzalez.com,Right arm house child rest impact piece continue because argue identify.,18,johnson-gonzalez,2023,USD,1749325,681416,1067909,1224773,-156864,8523,-165387,17493,34986,-200373,154175,1185156,649371,535785,,1749325,121.86,249.55,0.001,6889,21.16,120598.39,1.28,0.6105
3394,Figueroa-Wallace,False,DE,Nixonbury,EdTech,2014,https://figueroa-wallace.com,Lot mouth attack participant grow office enter involve wear off.,12,figueroa-wallace,2023,EUR,1655452,457571,1197881,325118,872763,0,872763,16554,33109,839654,31180,937329,455588,481741,137954.33,1655452,222.39,1455.99,0.019,3991,34.56,1000.0,31.18,0.7236
3395,Perez Johnson and Lewis,False,EG,Ramirezchester,EdTech,2020,https://perezjohnsonandlewis.com,Window cell bring remember drop evidence.,23,perez-johnson-and-lewis,2023,USD,1665917,439891,1226026,85934,1140092,0,1140092,16659,33318,1106774,218882,1095574,335428,760146,138826.42,1665917,469.28,1308.09,0.0149,1310,105.91,11751.07,18.63,0.7359
3396,Schwartz Jimenez and Price,False,DE,New Amandaville,AgriTech,2021,https://schwartzjimenezandprice.com,Movie important hour deep oil again draw hair line enough idea.,17,schwartz-jimenez-and-price,2023,EUR,222620,74235,148385,79267,69118,0,69118,2226,4452,64666,10810,127203,39253,87950,,222620,708.08,3375.73,0.0197,927,20.0,17320.22,0.62,0.6665
3397,Greene LLC,False,TN,Cannonfurt,IoT,2013,https://greenellc.com,Follow action cause up religious such meet Republican great simple.,17,greene-llc,2023,USD,905563,542365,363198,136763,226435,8587,217848,9055,18111,199737,167767,622281,205105,417176,,905563,173.66,303.76,0.0551,601,125.42,20621.76,8.14,0.4011
3398,Johnson PLC,False,CA,Hamiltonshire,AgriTech,2010,https://johnsonplc.com,Six wish population theory fine administration.,17,johnson-plc,2023,USD,565453,181554,383899,254779,129120,37320,91800,5654,11309,80491,2671,420011,76238,343773,,565453,638.41,2830.06,0.0129,188,250.12,19435.06,0.14,0.6789
3399,Brown-Adams,False,GB,West Wesleymouth,Fintech,2017,https://brown-adams.com,General parent hear difficult expert some dog.,23,brown-adams,2023,USD,452940,103733,349207,211515,137692,0,137692,4529,9058,128634,92988,333344,22676,310668,,452940,145.49,205.42,0.0648,1038,36.33,1000.0,92.99,0.771
3400,Randall-Montgomery,False,EG,Garciaton,AI/ML,2019,https://randall-montgomery.com,Material truth painting know central claim recently film traditional.,29,randall-montgomery,2023,USD,1194190,522388,671802,442572,229230,12320,216910,11941,23883,193027,38137,692917,386948,305969,,1194190,1899.57,949.78,0.0465,832,119.5,36496.63,1.04,0.5626
3401,Leonard Avila and Morris,False,DE,East Stephanie,IoT,2009,https://leonardavilaandmorris.com,Challenge action least guy.,22,leonard-avila-and-morris,2023,EUR,603798,241833,361965,30189,331776,10735,321041,6037,12075,308966,40573,363919,85870,278049,,603798,20.0,121.09,0.0886,545,92.26,1000.0,40.57,0.5995
3402,Chase Group,False,EG,Ballardfort,AI/ML,2018,https://chasegroup.com,Really during Mr although five edge drive never power.,27,chase-group,2023,USD,1452255,474011,978244,401471,576773,0,576773,14522,29045,547728,51451,923236,257895,665341,,1452255,908.06,4835.94,0.0168,6051,20.0,42275.52,1.22,0.6736
3403,Smith Arias and Black,False,TN,East Kathleenton,Mobility,2022,https://smithariasandblack.com,Garden according agent partner show pay ball girl morning.,16,smith-arias-and-black,2023,USD,261606,24727,236879,115404,121475,39161,82314,2616,5232,77082,4932,166610,38761,127849,,261606,316.53,2441.06,0.1366,57,380.76,25065.51,0.2,0.9055
3404,Reilly-Robinson,False,TN,Port Douglas,Energy,2019,https://reilly-robinson.com,Eight green job consumer consider benefit sea.,17,reilly-robinson,2023,USD,1101566,508588,592978,55078,537900,0,537900,11015,22031,515869,257750,1004613,286252,718361,,1101566,20.0,55.38,0.0958,559,164.15,1409.7,182.84,0.5383
3405,Duke Parker and Wang,False,AU,New Laurie,Mobility,2018,https://dukeparkerandwang.com,Off pretty travel I outside decade appear necessary first on.,23,duke-parker-and-wang,2023,USD,722603,219783,502820,121193,381627,35949,345678,7226,14452,331226,104732,644683,192923,451760,,722603,101.03,573.46,0.0078,3010,20.0,31908.31,3.28,0.6958
3406,Barr Olson and Bailey,False,IN,Harperland,Energy,2008,https://barrolsonandbailey.com,Style state decade tough.,22,barr-olson-and-bailey,2023,USD,868405,209482,658923,529280,129643,27190,102453,8684,17368,85085,28171,629622,236688,392934,,868405,709.82,354.91,0.1874,659,109.74,58450.29,0.48,0.7588
3407,Glover Morton and Stone,False,GB,Carterhaven,Mobility,2015,https://glovermortonandstone.com,As still word rather official.,23,glover-morton-and-stone,2023,USD,1371309,796848,574461,1344072,-769611,32272,-801883,13713,27426,-829309,68273,918160,308851,609309,,1371309,1225.88,4512.97,0.0139,5713,20.0,109923.99,0.62,0.4189
3408,Perez Moreno and Jones,False,IN,Davidmouth,Marketplaces,2010,https://perezmorenoandjones.com,On serious threat however measure which doctor sit cost expert.,16,perez-moreno-and-jones,2023,USD,274922,127780,147142,118840,28302,0,28302,2749,5498,22804,23060,285382,17163,268219,,274922,20.0,64.89,0.1085,228,100.32,1000.0,23.06,0.5352
3409,Thomas-Shaw,False,CA,West Patrickton,Fintech,2017,https://thomas-shaw.com,Very season number change impact enjoy role government your note.,22,thomas-shaw,2023,USD,613768,145913,467855,275391,192464,53330,139134,6137,12275,126859,39538,387376,84611,302765,,613768,881.97,1987.73,0.1322,269,189.88,9531.07,4.15,0.7623
3410,Baker-Walls,False,NG,New Teresaview,AI/ML,2010,https://baker-walls.com,Organization drop want stop.,20,baker-walls,2023,USD,73834,22904,50930,23324,27606,8004,19602,738,1476,18126,33215,239594,66462,173132,,73834,527.18,1339.94,0.1299,37,162.67,3184.43,10.43,0.6898
3411,Branch-Stevens,False,AU,South Darlene,AgriTech,2015,https://branch-stevens.com,Reach head member fill line.,27,branch-stevens,2023,USD,857897,391982,465915,257841,208074,12348,195726,8578,17157,178569,46694,484966,150945,334021,,857897,20.0,74.68,0.0841,238,299.81,31181.81,1.5,0.5431
3412,Ross-Hernandez,False,FR,Port Kristiton,Fintech,2010,https://ross-hernandez.com,Hotel according possible final personal the guess teacher.,24,ross-hernandez,2023,EUR,496940,186369,310571,55576,254995,17667,237328,4969,9938,227390,27859,329476,198885,130591,,496940,1433.91,5911.44,0.0823,190,216.83,1000.0,27.86,0.625
3413,Larsen Ltd,False,CA,West Brian,SaaS,2014,https://larsenltd.com,Pick teacher item area world growth worker pay.,22,larsen-ltd,2023,USD,599809,225676,374133,503490,-129357,22493,-151850,5998,11996,-163846,11421,361697,41663,320034,49984.08,599809,317.57,936.78,0.0413,639,78.11,22972.16,0.5,0.6238
3414,Phelps Schneider and Horton,False,CA,Riveraside,EdTech,2018,https://phelpsschneiderandhorton.com,Defense source of whose on unit final entire left then.,24,phelps-schneider-and-horton,2023,USD,276431,86387,190044,91479,98565,0,98565,2764,5528,93037,29195,242341,64109,178232,23035.92,276431,10.0,55.9,0.0583,1263,18.23,2592.25,11.26,0.6875
3415,Williams Lee and Kane,False,IN,Lake Krystalshire,AgriTech,2016,https://williamsleeandkane.com,Space adult by catch institution site market training.,20,williams-lee-and-kane,2023,USD,280441,84841,195600,117975,77625,4228,73397,2804,5608,67789,25057,299612,93209,206403,,280441,2259.69,1129.84,0.1003,304,76.83,1912.27,13.1,0.6975
3416,Lopez-Lowe,False,DE,East Christopher,Cybersecurity,2012,https://lopez-lowe.com,Spend ok candidate possible seven.,16,lopez-lowe,2023,EUR,770975,352282,418693,220472,198221,5064,193157,7709,15419,177738,115076,581966,203133,378833,,770975,20.0,90.19,0.001,1564,41.07,28858.38,3.99,0.5431
3417,Young Group,False,AU,Lake Sarah,Cybersecurity,2016,https://younggroup.com,Situation way small account town.,16,young-group,2023,USD,2780632,790253,1990379,826434,1163945,0,1163945,27806,55612,1108333,137862,1538892,243558,1295334,,2780632,20.0,104.28,0.1004,2765,83.8,90976.59,1.52,0.7158
3418,Sanchez Barajas and Wood,False,US,East Travis,AgriTech,2017,https://sanchezbarajasandwood.com,Debate history son scene.,22,sanchez-barajas-and-wood,2023,USD,1210946,556431,654515,1232555,-578040,34932,-612972,12109,24218,-637190,46852,718155,335638,382517,,1210946,269.92,1060.12,0.001,5045,20.0,94906.06,0.49,0.5405
3419,Robertson LLC,False,CA,Port Michael,Energy,2020,https://robertsonllc.com,Idea together need including mother security when turn.,22,robertson-llc,2023,USD,720656,290540,430116,175038,255078,0,255078,7206,14413,240665,30718,558136,207385,350751,,720656,412.6,1456.45,0.0852,3002,20.0,26799.85,1.15,0.5968
3420,Johnson Ltd,False,KE,Rebeccashire,Marketplaces,2008,https://johnsonltd.com,Tv record Democrat break light head throughout tree.,11,johnson-ltd,2023,USD,1335553,183659,1151894,593406,558488,0,558488,13355,26711,531777,67447,873989,355771,518218,,1335553,20.0,10.0,0.0927,397,280.08,93340.69,0.72,0.8625
3421,Adams-Cohen,False,EG,Shawnville,Marketplaces,2024,https://adams-cohen.com,Player which law whom Republican event unit turn sometimes they.,20,adams-cohen,2023,USD,1286590,643850,642740,127349,515391,0,515391,12865,25731,489660,53466,807105,142218,664887,,1286590,460.26,1580.51,0.001,358,298.87,1000.0,53.47,0.4996
3422,Savage Wilson and Santiago,False,AU,West Josephchester,HealthTech,2020,https://savagewilsonandsantiago.com,Thousand price game book behavior.,18,savage-wilson-and-santiago,2023,USD,190974,103892,87082,38826,48256,0,48256,1909,3819,44437,9461,194583,9729,184854,15914.5,190974,353.95,1736.46,0.0125,3182,5.0,28437.37,0.33,0.456
3423,Dillon Group,False,DE,Robertberg,EdTech,2014,https://dillongroup.com,Hospital movie gun task finish forward since plant.,16,dillon-group,2023,EUR,170355,88485,81870,112498,-30628,1648,-32276,1703,3407,-35683,7635,197232,46677,150555,14196.25,170355,252.72,1289.89,0.001,417,34.03,12522.91,0.61,0.4806
3424,Robinson-Velazquez,False,EG,Colemanstad,EdTech,2024,https://robinson-velazquez.com,Per goal outside collection director example similar car thus night.,18,robinson-velazquez,2023,USD,494773,169536,325237,243671,81566,0,81566,4947,9895,71671,14487,303959,105282,198677,41231.08,494773,267.92,1996.84,0.0288,1757,23.46,29945.38,0.48,0.6573
3425,White-James,False,KE,Williamport,AI/ML,2022,https://white-james.com,Position money hot fine though nature do design friend wait process.,28,white-james,2023,USD,1736908,412234,1324674,1214482,110192,0,110192,17369,34738,75454,334424,1285617,355500,930117,,1736908,806.81,3369.98,0.092,360,400.99,126815.12,2.64,0.7627
3426,Gonzalez Ltd,False,ZA,Christopherborough,Mobility,2018,https://gonzalezltd.com,Quality culture issue spring watch.,17,gonzalez-ltd,2023,USD,2454134,476799,1977335,1458223,519112,24441,494671,24541,49082,445589,342786,1571397,547976,1023421,,2454134,473.61,1441.17,0.1249,949,215.49,123884.45,2.77,0.8057
3427,Martin PLC,False,AU,Thomasport,Fintech,2018,https://martinplc.com,Lead store small knowledge security dinner per.,19,martin-plc,2023,USD,1382918,69145,1313773,792102,521671,32178,489493,13829,27658,461835,65840,948783,252232,696551,,1382918,114.66,480.89,0.0532,944,122.04,78745.45,0.84,0.95
3428,Rodriguez Gallagher and Jones,False,DE,Grantburgh,Energy,2021,https://rodriguezgallagherandjones.com,Mission game water writer usually event culture democratic.,28,rodriguez-gallagher-and-jones,2023,EUR,3612705,1722480,1890225,1280575,609650,0,609650,36127,72254,537396,898705,2865187,1189189,1675998,,3612705,1364.58,4160.51,0.02,5692,52.89,113086.7,7.95,0.5232
3429,Potter Horton and Becker,False,DE,Alexismouth,Mobility,2022,https://potterhortonandbecker.com,Language agree later particular charge pick bit.,26,potter-horton-and-becker,2023,EUR,335143,80229,254914,171087,83827,0,83827,3351,6702,77125,19488,228636,91236,137400,,335143,478.22,2410.28,0.1327,157,177.83,31988.69,0.61,0.7606
3430,Reed-Peterson,False,NG,Lawrenceton,SaaS,2019,https://reed-peterson.com,By together scientist energy forget beat also first.,26,reed-peterson,2023,USD,239077,80247,158830,11953,146877,0,146877,2390,4781,142096,1231,234651,50549,184102,19923.08,239077,481.39,2739.97,0.0102,244,81.63,2189.41,0.56,0.6643
3431,Edwards-Richards,False,GB,West Dan,IoT,2012,https://edwards-richards.com,Message it find economy at international.,12,edwards-richards,2023,USD,2367183,546843,1820340,2098864,-278524,0,-278524,23671,47343,-325867,857636,2070434,1108454,961980,,2367183,20.0,43.73,0.0645,1985,99.35,220063.81,3.9,0.769
3432,Lambert Inc,False,IN,Kingville,Cybersecurity,2008,https://lambertinc.com,Fill defense early ready glass conference benefit.,24,lambert-inc,2023,USD,420532,80452,340080,207543,132537,0,132537,4205,8410,124127,65200,379380,66284,313096,,420532,1112.33,5600.52,0.001,710,49.32,29665.3,2.2,0.8087
3433,James-Davis,False,EG,Everettville,Marketplaces,2019,https://james-davis.com,Rate federal baby thing direction little time military.,25,james-davis,2023,USD,3966702,997320,2969382,2275524,693858,26258,667600,39667,79334,588266,215409,2282529,516299,1766230,,3966702,20.0,41.51,0.0565,16527,20.0,183974.77,1.17,0.7486
3434,Cummings Inc,False,CA,West Charles,EdTech,2021,https://cummingsinc.com,Medical administration accept born hear politics prevent federal general.,31,cummings-inc,2023,USD,121237,33873,87364,71380,15984,36660,-20676,1212,2424,-23100,10476,202152,96524,105628,10103.08,121237,10.0,11.69,0.0549,139,72.42,6519.7,1.61,0.7206
3435,Aguilar-Garcia,False,TN,Markborough,Marketplaces,2020,https://aguilar-garcia.com,Main defense near western level organization international back than anyone.,26,aguilar-garcia,2023,USD,882207,377218,504989,375946,129043,0,129043,8822,17644,111399,87803,620092,288658,331434,,882207,1133.28,4966.51,0.001,3675,20.0,49023.94,1.79,0.5724
3436,Allen-Meyer,False,AU,South Mariaport,Cybersecurity,2017,https://allen-meyer.com,Cause life college crime those statement page lay admit find.,27,allen-meyer,2023,USD,6247544,2269195,3978349,4816048,-837699,584,-838283,62475,124950,-963233,924772,4163807,732986,3430821,,6247544,446.1,297.12,0.001,6515,79.91,445642.28,2.08,0.6368
3437,Hill-Peterson,False,CA,North Elizabeth,IoT,2008,https://hill-peterson.com,Public energy require buy particular answer base message.,14,hill-peterson,2023,USD,1603695,469060,1134635,431009,703626,0,703626,16036,32073,671553,40870,856227,106799,749428,,1603695,1613.6,9660.71,0.0928,2409,55.47,36505.82,1.12,0.7075
3438,Clark Inc,False,KE,South Danielle,SaaS,2012,https://clarkinc.com,Dream yes space lead coach site develop interview.,34,clark-inc,2023,USD,9399665,4857215,4542450,2718905,1823545,19897,1803648,93996,187993,1615655,178409,5013091,645427,4367664,783305.42,9399665,847.22,4113.22,0.0742,18535,42.26,200509.5,0.89,0.4833
3439,Brown-Guerra,False,GB,Lake Paul,E-commerce,2020,https://brown-guerra.com,Forward answer less ground force.,27,brown-guerra,2023,USD,1677727,536252,1141475,1168801,-27326,14836,-42162,16777,33554,-75716,91614,968511,255997,712514,,1677727,38.71,116.34,0.001,500,279.61,85812.01,1.07,0.6804
3440,Martin Ltd,False,TN,Jorgeborough,EdTech,2020,https://martinltd.com,Whole staff general decide when.,18,martin-ltd,2023,USD,100238,35064,65174,84784,-19610,7285,-26895,1002,2004,-28899,9017,251457,85567,165890,8353.17,100238,224.05,709.42,0.0532,97,85.39,1000.0,9.02,0.6502
3441,Oneal-Mack,False,FR,Colinstad,AI/ML,2020,https://oneal-mack.com,Onto fast inside plant station resource particular performance learn level think.,20,oneal-mack,2023,EUR,660650,262262,398388,33032,365356,4767,360589,6606,13213,347376,23171,359903,135824,224079,,660650,1021.16,4483.29,0.0665,384,143.18,2749.73,8.43,0.603
3442,Edwards Green and Lyons,False,DE,Port Paulland,Mobility,2011,https://edwardsgreenandlyons.com,Part take red its information.,29,edwards-green-and-lyons,2023,EUR,576585,169682,406903,455844,-48941,0,-48941,5765,11531,-60472,51976,446187,26564,419623,,576585,1048.74,1336.25,0.074,219,218.47,61549.54,0.84,0.7057
3443,Williams Davidson and Juarez,False,CA,Sandraburgh,IoT,2022,https://williamsdavidsonandjuarez.com,American include music position probably cold minute data surface.,24,williams-davidson-and-juarez,2023,USD,698459,186691,511768,458520,53248,0,53248,6984,13969,39279,139646,530442,63414,467028,,698459,596.54,1731.52,0.001,1447,40.21,15025.85,9.29,0.7327
3444,Gentry Lopez and Lucas,False,BR,Sandraport,AgriTech,2010,https://gentrylopezandlucas.com,Then no cold for political everything main compare.,22,gentry-lopez-and-lucas,2023,USD,334007,106221,227786,199724,28062,0,28062,3340,6680,21382,4305,267903,176429,91474,,334007,20.0,109.47,0.0316,659,42.21,8379.3,0.51,0.682
3445,Dean-Ellis,False,GB,Diazville,Fintech,2013,https://dean-ellis.com,Method since message thought provide yet.,13,dean-ellis,2023,USD,4089464,1357386,2732078,1265537,1466541,0,1466541,40894,81789,1384752,291592,2507780,1610638,897142,,4089464,609.49,304.74,0.001,1135,300.18,97859.42,2.98,0.6681
3446,Herrera Group,False,US,Russellstad,Cybersecurity,2023,https://herreragroup.com,Around bag about cold physical early popular usually whole.,28,herrera-group,2023,USD,579675,245069,334606,102184,232422,28799,203623,5796,11593,192030,20552,329642,208755,120887,,579675,151.65,776.31,0.109,430,112.31,17753.45,1.16,0.5772
3447,Kelly-Clark,False,US,Gregoryport,HealthTech,2014,https://kelly-clark.com,Say Democrat society eye simply former six.,21,kelly-clark,2023,USD,899451,344093,555358,270862,284496,20380,264116,8994,17989,246127,35549,639724,261055,378669,74954.25,899451,10.0,34.47,0.0439,681,110.0,8730.8,4.07,0.6174
3448,Elliott-Fox,False,FR,New Roger,Energy,2017,https://elliott-fox.com,Wife no camera character test Democrat perhaps court game eat.,19,elliott-fox,2023,EUR,472170,191851,280319,172591,107728,0,107728,4721,9443,98285,37785,309925,69644,240281,,472170,811.64,4743.16,0.001,157,249.89,37840.49,1.0,0.5937
3449,Thompson-Brown,False,DE,South Jamesport,EdTech,2017,https://thompson-brown.com,Information sure wait item mouth off north require.,16,thompson-brown,2023,EUR,379301,94133,285168,211387,73781,21821,51960,3793,7586,44374,31077,233600,79128,154472,31608.42,379301,10.0,31.23,0.0428,535,59.08,10056.51,3.09,0.7518
3450,Stanton LLC,False,BR,Garciastad,AI/ML,2010,https://stantonllc.com,Single indeed black nation professor baby song standard class.,24,stanton-llc,2023,USD,531436,150723,380713,302882,77831,0,77831,5314,10628,67203,8961,458078,247623,210455,,531436,20.0,95.57,0.0178,169,261.62,1000.0,8.96,0.7164
3451,Baldwin and Sons,False,EG,Susanville,SaaS,2019,https://baldwinandsons.com,Benefit spend others difference course new.,28,baldwin-and-sons,2023,USD,946613,536776,409837,602312,-192475,3727,-196202,9466,18932,-215134,55998,646663,581996,64667,78884.42,946613,10.0,20.67,0.001,1497,52.69,70681.61,0.79,0.433
3452,Garcia-Cherry,False,NG,South Lori,SaaS,2013,https://garcia-cherry.com,Card season second box enough data little from already focus strong.,19,garcia-cherry,2023,USD,1816903,701234,1115669,879431,236238,12427,223811,18169,36338,187473,167129,1124690,426327,698363,151408.58,1816903,10.0,15.67,0.0922,1841,82.23,50242.86,3.33,0.614
3453,Freeman-Atkins,False,CA,Pierceton,Energy,2020,https://freeman-atkins.com,Quickly police seven beyond condition.,24,freeman-atkins,2023,USD,1943541,908680,1034861,97177,937684,29338,908346,19435,38870,869476,9133,1111363,580539,530824,,1943541,830.19,1736.83,0.1296,8098,20.0,1000.0,9.13,0.5325
3454,Evans Gonzalez and Thompson,False,GB,Leestad,Fintech,2012,https://evansgonzalezandthompson.com,Increase quite debate response state none could.,25,evans-gonzalez-and-thompson,2023,USD,1990472,819460,1171012,99523,1071489,9680,1061809,19904,39809,1022000,295730,1330631,540709,789922,,1990472,678.76,339.38,0.1094,733,226.25,31383.96,9.42,0.5883
3455,Walter LLC,False,NG,Millermouth,Energy,2023,https://walterllc.com,Compare reflect beyond fall full law write.,25,walter-llc,2023,USD,5171474,2149582,3021892,3166798,-144906,9275,-154181,51714,103429,-257610,2905045,5642745,282137,5360608,,5171474,20.0,22.82,0.1048,3316,129.96,306127.83,9.49,0.5843
3456,Blair Kim and Osborne,False,ZA,Smithburgh,Fintech,2020,https://blairkimandosborne.com,Form exist would on address partner.,19,blair-kim-and-osborne,2023,USD,1947505,391628,1555877,627707,928170,0,928170,19475,38950,889220,78313,1242562,460167,782395,,1947505,20.0,85.17,0.001,8114,20.0,40671.05,1.93,0.7989
3457,Ferguson Hicks and Spence,False,DE,Alexanderside,HealthTech,2014,https://fergusonhicksandspence.com,Many notice hot number not property week your your.,26,ferguson-hicks-and-spence,2023,EUR,1269294,345069,924225,1022029,-97804,0,-97804,12692,25385,-123189,2368,748920,145556,603364,105774.5,1269294,398.88,1972.81,0.009,21154,5.0,62240.48,0.04,0.7281
3458,Eaton Ltd,False,IN,Annamouth,Energy,2023,https://eatonltd.com,Home community white base receive across center.,14,eaton-ltd,2023,USD,1482259,519369,962890,1109897,-147007,0,-147007,14822,29645,-176652,493289,1293275,64663,1228612,,1482259,191.37,380.51,0.1199,836,147.68,65686.71,7.51,0.6496
3459,Cox Inc,False,GB,Charlesmouth,IoT,2017,https://coxinc.com,Set town together TV decision daughter coach list candidate simple.,18,cox-inc,2023,USD,264329,48371,215958,178990,36968,0,36968,2643,5286,31682,16140,204968,45416,159552,,264329,2282.6,10914.98,0.17,121,181.81,15304.05,1.05,0.817
3460,Munoz Ortiz and Hamilton,False,KE,Lambside,EdTech,2024,https://munozortizandhamilton.com,Spend street environmental attorney history trial arrive provide.,16,munoz-ortiz-and-hamilton,2023,USD,564945,207703,357242,171954,185288,0,185288,5649,11298,173990,14500,321965,202424,119541,47078.75,564945,10.0,62.91,0.0304,3569,13.19,29337.36,0.49,0.6323
3461,Gomez-Charles,False,ZA,West Jaclynview,Marketplaces,2022,https://gomez-charles.com,Deal party I hair so see back future keep.,17,gomez-charles,2023,USD,747648,191544,556104,37382,518722,3006,515716,7476,14952,500764,18848,558916,262669,296247,,747648,20.0,40.25,0.0951,3115,20.0,22559.03,0.84,0.7438
3462,Alvarado and Sons,False,IN,Lake Kendramouth,EdTech,2008,https://alvaradoandsons.com,Of among turn nation official former him later.,22,alvarado-and-sons,2023,USD,543544,192457,351087,232774,118313,0,118313,5435,10870,107443,248233,605920,454898,151022,45295.33,543544,256.77,1197.06,0.029,664,68.19,9392.86,26.43,0.6459
3463,Hinton PLC,False,GB,Jamesburgh,Mobility,2010,https://hintonplc.com,Between note shoulder cold big generation.,22,hinton-plc,2023,USD,2900563,836881,2063682,1344243,719439,0,719439,29005,58011,661428,254088,1839852,855200,984652,,2900563,20.0,25.74,0.0508,816,296.1,106610.09,2.38,0.7115
3464,Hamilton Coleman and Day,False,TN,Port Claudiahaven,IoT,2015,https://hamiltoncolemanandday.com,Necessary radio answer off than.,29,hamilton-coleman-and-day,2023,USD,211261,94981,116280,235468,-119188,29490,-148678,2112,4225,-152903,3661,283820,21062,262758,,211261,956.22,3524.27,0.1049,121,144.69,6974.89,0.52,0.5504
3465,Chandler Montgomery and Wilson,False,NG,Port Tamaraville,E-commerce,2023,https://chandlermontgomeryandwilson.com,Able skin next add bad drug entire.,18,chandler-montgomery-and-wilson,2023,USD,309454,84967,224487,57012,167475,0,167475,3094,6189,161286,11076,185724,31149,154575,,309454,672.04,3929.73,0.0486,83,310.63,1000.0,11.08,0.7254
3466,Nelson Martin and Guzman,False,EG,Stoutchester,Mobility,2009,https://nelsonmartinandguzman.com,Authority consumer sound field career realize ready.,18,nelson-martin-and-guzman,2023,USD,1883633,101978,1781655,1552157,229498,0,229498,18836,37672,191826,78214,1104130,55206,1048924,,1883633,20.0,10.0,0.0226,722,217.15,141125.77,0.55,0.9459
3467,Andrews Roy and Mitchell,False,ZA,New Sarah,Fintech,2017,https://andrewsroyandmitchell.com,Actually eye effect Mr base executive pick catch.,26,andrews-roy-and-mitchell,2023,USD,2123725,823839,1299886,624730,675156,13666,661490,21237,42474,619016,9534,1076652,352905,723747,,2123725,535.81,2576.38,0.0189,638,277.36,37557.94,0.25,0.6121
3468,Young Duncan and Miles,False,BR,Ricemouth,Mobility,2019,https://youngduncanandmiles.com,Control soldier water it task affect better positive bill charge situation.,20,young-duncan-and-miles,2023,USD,719761,292334,427427,35988,391439,0,391439,7197,14395,377044,4176,555125,182185,372940,,719761,20.0,76.71,0.1431,2999,20.0,21450.92,0.19,0.5938
3469,Price-Walls,False,ZA,Port Katie,Cybersecurity,2017,https://price-walls.com,Painting major claim part success.,18,price-walls,2023,USD,838715,476686,362029,586747,-224718,0,-224718,8387,16774,-241492,47013,607913,331892,276021,,838715,20.0,58.76,0.1092,3494,20.0,59155.91,0.79,0.4316
3470,Mccarthy Lawson and Craig,False,TN,Michelleville,IoT,2013,https://mccarthylawsonandcraig.com,Performance avoid game degree bring area provide go.,19,mccarthy-lawson-and-craig,2023,USD,183617,57840,125777,60910,64867,15277,49590,1836,3672,45918,5038,157585,75824,81761,,183617,20.0,16.16,0.0125,70,216.16,13696.9,0.37,0.685
3471,Allen PLC,False,TN,Smithfurt,EdTech,2013,https://allenplc.com,Final positive life long generation.,18,allen-plc,2023,USD,290514,92161,198353,74586,123767,16937,106830,2905,5810,101020,39429,304967,256352,48615,24209.5,290514,322.5,1553.92,0.001,274,88.26,1000.0,39.43,0.6828
3472,White-Richardson,False,KE,Millerberg,Cybersecurity,2021,https://white-richardson.com,Range follow drive agent current.,16,white-richardson,2023,USD,396427,187586,208841,97086,111755,0,111755,3964,7928,103827,48531,359943,55144,304799,,396427,20.0,93.61,0.0518,1520,21.73,1000.0,48.53,0.5268
3473,Rogers Group,False,EG,Nelsonview,Energy,2013,https://rogersgroup.com,Course town attorney beyond before.,26,rogers-group,2023,USD,537938,159976,377962,29624,348338,0,348338,5379,10758,337580,20929,311830,176760,135070,,537938,20.0,10.0,0.0752,312,143.54,4171.3,5.02,0.7026
3474,Gordon-Bishop,False,ZA,Ericchester,IoT,2011,https://gordon-bishop.com,Culture happy third adult they past you politics president.,14,gordon-bishop,2023,USD,1186511,378334,808177,399268,408909,0,408909,11865,23730,385179,17055,768621,262975,505646,,1186511,20.0,80.77,0.001,4241,23.31,58887.94,0.29,0.6811
3475,Holt-Wilson,False,TN,West Lorimouth,Cybersecurity,2009,https://holt-wilson.com,Teach remember it because husband industry.,18,holt-wilson,2023,USD,1027267,398687,628580,671556,-42976,45575,-88551,10272,20545,-109096,30349,621249,386907,234342,,1027267,1311.45,2016.77,0.1261,515,166.17,50240.38,0.6,0.6119
3476,Gonzalez Miller and Reilly,False,DE,Garyhaven,HealthTech,2016,https://gonzalezmillerandreilly.com,Defense thing reach store memory fly.,15,gonzalez-miller-and-reilly,2023,EUR,2275581,558260,1717321,957049,760272,26024,734248,22755,45511,688737,196835,1412975,330501,1082474,189631.75,2275581,119.18,221.74,0.0924,2325,81.56,80736.08,2.44,0.7547
3477,Colon PLC,False,BR,Farmershire,AI/ML,2017,https://colonplc.com,Republican other image wind lay near.,24,colon-plc,2023,USD,844472,215535,628937,422066,206871,0,206871,8444,16889,189982,61224,636324,201811,434513,,844472,1515.98,7301.11,0.0871,3518,20.0,32012.22,1.91,0.7448
3478,Walker Thompson and Caldwell,False,BR,Smithfurt,Fintech,2014,https://walkerthompsonandcaldwell.com,According item because cultural realize skill political.,13,walker-thompson-and-caldwell,2023,USD,2644923,1041445,1603478,1074197,529281,12625,516656,26449,52898,463758,653329,2151523,1181719,969804,,2644923,1005.97,1044.14,0.0842,1071,205.64,59363.88,11.01,0.6062
3479,Campbell-Moore,False,EG,Tinahaven,Energy,2011,https://campbell-moore.com,Across water three address hundred center.,14,campbell-moore,2023,USD,3619720,1310177,2309543,180986,2128557,0,2128557,36197,72394,2056163,42734,1866081,444507,1421574,,3619720,1036.69,2558.74,0.0786,2578,116.99,1000.0,42.73,0.638
3480,Smith Lopez and Adams,False,CA,West Curtistown,Fintech,2011,https://smithlopezandadams.com,By we pick cut up various cold usually.,15,smith-lopez-and-adams,2023,USD,2672805,1063885,1608920,1505391,103529,2753,100776,26728,53456,47320,54946,1441116,548027,893089,,2672805,1399.1,4832.36,0.001,830,268.34,84845.69,0.65,0.602
3481,Jones Pruitt and Sullivan,False,NG,Gabrielleport,E-commerce,2021,https://jonespruittandsullivan.com,Hold industry possible should particularly item.,22,jones-pruitt-and-sullivan,2023,USD,249934,100179,149755,119230,30525,2370,28155,2499,4998,23157,13232,233688,11684,222004,,249934,734.25,2122.77,0.0332,1041,20.0,26865.16,0.49,0.5992
3482,Torres Mendoza and Foley,False,EG,South Caitlin,HealthTech,2016,https://torresmendozaandfoley.com,Remember above small real deal car past night.,16,torres-mendoza-and-foley,2023,USD,604230,142428,461802,342394,119408,0,119408,6042,12084,107324,94702,529170,253778,275392,50352.5,604230,10.0,29.8,0.001,1319,38.16,22781.69,4.16,0.7643
3483,Pierce Taylor and Davis,False,DE,Smithchester,AI/ML,2009,https://piercetayloranddavis.com,Building note audience task executive behind music build same.,25,pierce-taylor-and-davis,2023,EUR,391330,104593,286737,327989,-41252,0,-41252,3913,7826,-49078,75242,387389,235685,151704,,391330,592.35,2074.71,0.0205,292,111.39,13020.75,5.78,0.7327
3484,Henderson-Martinez,False,EG,Stevensonborough,SaaS,2010,https://henderson-martinez.com,Executive we window change ahead industry thing subject wife learn.,16,henderson-martinez,2023,USD,1084353,291823,792530,809962,-17432,34921,-52353,10843,21687,-74040,54406,626689,511471,115218,90362.75,1084353,196.11,422.64,0.001,789,114.43,79159.01,0.69,0.7309
3485,Page-Jones,False,BR,Port Alexfurt,Cybersecurity,2022,https://page-jones.com,Attorney very past per couple rule well later.,14,page-jones,2023,USD,486712,99911,386801,52992,333809,7238,326571,4867,9734,316837,31162,304376,225322,79054,,486712,700.92,658.08,0.0925,1325,30.61,16751.44,1.86,0.7947
3486,Williams Payne and Rogers,False,TN,South Ashleyborough,E-commerce,2020,https://williamspayneandrogers.com,Sport there development save western.,31,williams-payne-and-rogers,2023,USD,477010,140217,336793,147993,188800,6144,182656,4770,9540,173116,181558,613123,117912,495211,,477010,274.0,1647.42,0.0866,934,42.53,1000.0,181.56,0.7061
3487,Hood Daniel and Juarez,False,DE,North Jackberg,Energy,2009,https://hooddanielandjuarez.com,Defense story practice tough their personal where point strategy.,16,hood-daniel-and-juarez,2023,EUR,2556643,677978,1878665,759812,1118853,0,1118853,25566,51132,1067721,272472,1744128,1032058,712070,,2556643,848.19,1529.44,0.0714,985,216.08,73096.09,3.73,0.7348
3488,Brennan Davis and Mcdaniel,False,US,North Steven,AgriTech,2011,https://brennandavisandmcdaniel.com,Culture smile drug save change difference.,13,brennan-davis-and-mcdaniel,2023,USD,450734,112984,337750,390875,-53125,6485,-59610,4507,9014,-68624,60791,442017,375068,66949,,450734,321.99,1331.12,0.0341,172,217.56,46443.88,1.31,0.7493
3489,Williamson Howard and Garcia,False,ZA,East Courtneyshire,HealthTech,2018,https://williamsonhowardandgarcia.com,Several light somebody must product own keep yard hope.,19,williamson-howard-and-garcia,2023,USD,1022748,405069,617679,363422,254257,0,254257,10227,20454,233803,61130,678033,151276,526757,85229.0,1022748,141.64,722.25,0.0344,1595,53.41,6230.73,9.81,0.6039
3490,Dunlap-Underwood,False,BR,South Adrian,Cybersecurity,2022,https://dunlap-underwood.com,Research consumer or himself their summer impact bit eight employee.,12,dunlap-underwood,2023,USD,162840,36355,126485,104370,22115,19822,2293,1628,3256,-963,26769,146805,28004,118801,,162840,1985.21,1013.85,0.0285,104,130.1,19702.53,1.36,0.7767
3491,Bennett Stevens and Gonzalez,False,EG,Mooretown,Mobility,2010,https://bennettstevensandgonzalez.com,Month finally put such player special pass but.,20,bennett-stevens-and-gonzalez,2023,USD,2874292,747630,2126662,1926037,200625,12651,187974,28742,57485,130489,54703,1624951,426625,1198326,,2874292,20.0,53.35,0.018,752,318.16,168261.43,0.33,0.7399
3492,Warner Thomas and Thompson,False,FR,North Jasontown,AI/ML,2015,https://warnerthomasandthompson.com,Even two despite build face base relate break wrong red.,19,warner-thomas-and-thompson,2023,EUR,2132070,991265,1140805,506878,633927,0,633927,21320,42641,591286,69142,1300425,879468,420957,,2132070,111.9,543.04,0.0606,3798,46.78,52142.08,1.33,0.5351
3493,Kim Ortiz and Orozco,False,ZA,Lake Matthewtown,Mobility,2012,https://kimortizandorozco.com,Send evidence where apply executive dream their kid stay.,26,kim-ortiz-and-orozco,2023,USD,930173,266807,663366,341154,322212,28879,293333,9301,18603,274730,34605,660733,287910,372823,,930173,204.59,1274.85,0.0423,349,221.69,42079.89,0.82,0.7132
3494,Martin Hansen and Santos,False,EG,East Jasminview,AgriTech,2013,https://martinhansenandsantos.com,Several born six beat help defense range.,28,martin-hansen-and-santos,2023,USD,588272,280739,307533,448913,-141380,0,-141380,5882,11765,-153145,12937,410212,301478,108734,,588272,133.64,307.67,0.0015,2451,20.0,29647.22,0.44,0.5228
3495,Lamb-Nelson,False,GB,New Joycemouth,SaaS,2011,https://lamb-nelson.com,War pressure into car media.,28,lamb-nelson,2023,USD,875356,236001,639355,472114,167241,36634,130607,8753,17507,113100,41651,541809,115233,426576,72946.33,875356,713.15,3152.69,0.0633,14589,5.0,30623.14,1.36,0.7304
3496,Burns Ltd,False,GB,Timothyport,AgriTech,2011,https://burnsltd.com,Also live until compare table.,21,burns-ltd,2023,USD,545031,238772,306259,473600,-167341,45719,-213060,5450,10900,-223960,61850,492004,267285,224719,,545031,525.29,474.37,0.0832,2270,20.0,55775.04,1.11,0.5619
3497,Burke-Martinez,False,NG,Davidside,Cybersecurity,2020,https://burke-martinez.com,Money base it fire military year.,29,burke-martinez,2023,USD,344895,60923,283972,180081,103891,43816,60075,3448,6897,53178,41740,247673,76167,171506,,344895,533.08,3080.55,0.0875,396,72.45,15737.35,2.65,0.8234
3498,Jenkins LLC,False,GB,Jenkinshaven,Fintech,2008,https://jenkinsllc.com,South blood couple range people society beyond.,21,jenkins-llc,2023,USD,949421,342609,606812,637800,-30988,27059,-58047,9494,18988,-77035,23150,598461,168108,430353,,949421,20.0,73.76,0.0676,3955,20.0,60019.18,0.39,0.6391
3499,Clay PLC,False,BR,West Adriennemouth,AgriTech,2012,https://clayplc.com,Stuff nearly moment trouble step apply.,20,clay-plc,2023,USD,124644,43653,80991,32165,48826,26408,22418,1246,2492,19926,14013,268101,86155,181946,,124644,20.0,115.37,0.0905,233,44.49,12916.91,1.08,0.6498
3500,Cruz-Anderson,False,EG,Johnmouth,E-commerce,2013,https://cruz-anderson.com,Will meeting member address six which Mrs support really from.,21,cruz-anderson,2023,USD,982481,492284,490197,433888,56309,28476,27833,9824,19649,8184,20732,665197,201219,463978,,982481,402.27,682.58,0.0868,527,155.13,31610.37,0.66,0.4989
3501,Burnett Group,False,DE,Montoyafurt,Cybersecurity,2009,https://burnettgroup.com,Central believe night conference more.,19,burnett-group,2023,EUR,145319,98014,47305,112591,-65286,0,-65286,1453,2906,-68192,5544,151768,59948,91820,,145319,419.79,987.1,0.0386,51,234.58,44381.59,0.12,0.3255
3502,Peters Hill and Mcdonald,False,BR,Mullenside,AI/ML,2014,https://petershillandmcdonald.com,Take cup west director material.,22,peters-hill-and-mcdonald,2023,USD,850657,378089,472568,429618,42950,0,42950,8506,17013,25937,22380,497954,125866,372088,,850657,20.0,91.85,0.0097,401,176.66,41234.48,0.54,0.5555
3503,Burgess-Bailey,False,EG,North Deborahview,Cybersecurity,2009,https://burgess-bailey.com,Discussion ability phone air young clearly behind box bad.,22,burgess-bailey,2023,USD,837014,339780,497234,262571,234663,16121,218542,8370,16740,201802,97612,701444,262301,439143,,837014,482.61,2464.89,0.0649,3487,20.0,29848.59,3.27,0.5941
3504,Roberson-Thompson,False,BR,Port Jodibury,AI/ML,2011,https://roberson-thompson.com,Ever far high less.,21,roberson-thompson,2023,USD,627021,108823,518198,89757,428441,0,428441,6270,12540,415901,17787,417463,209406,208057,,627021,20.0,35.04,0.0769,2611,20.01,1000.0,17.79,0.8264
3505,Chapman Thomas and Murphy,False,TN,Walkershire,Cybersecurity,2017,https://chapmanthomasandmurphy.com,Set upon opportunity information.,18,chapman-thomas-and-murphy,2023,USD,777853,199908,577945,38892,539053,0,539053,7778,15557,523496,35282,505765,213251,292514,,777853,20.0,81.65,0.0672,372,173.92,1000.0,35.28,0.743
3506,Cross Perez and Hill,False,EG,North Jonathanstad,SaaS,2008,https://crossperezandhill.com,Project cup analysis ago simply.,17,cross-perez-and-hill,2023,USD,751807,213334,538473,857258,-318785,11517,-330302,7518,15036,-345338,29042,467576,167196,300380,62650.58,751807,428.93,2005.68,0.0631,1083,57.8,94459.84,0.31,0.7162
3507,Jones-Smith,False,US,South Ginafurt,Energy,2014,https://jones-smith.com,Safe talk financial real purpose career political all out major.,13,jones-smith,2023,USD,3787389,1589200,2198189,767185,1431004,437,1430567,37873,75747,1354820,68698,2101513,105075,1996438,,3787389,20.0,15.53,0.0349,15780,20.0,59571.39,1.15,0.5804
3508,Collins Mills and Whitaker,False,DE,New Danielfurt,E-commerce,2015,https://collinsmillsandwhitaker.com,Hotel cause sit effort eight force key sure finally series.,20,collins-mills-and-whitaker,2023,EUR,744717,289914,454803,346699,108104,0,108104,7447,14894,93210,31186,590481,333559,256922,,744717,67.93,67.31,0.1013,2252,27.55,25385.26,1.23,0.6107
3509,Miller and Sons,False,DE,Castanedafurt,Fintech,2008,https://millerandsons.com,Agent will avoid account produce evening.,20,miller-and-sons,2023,EUR,2499813,518811,1981002,670886,1310116,4937,1305179,24998,49996,1255183,243682,1669135,1502221,166914,,2499813,20.0,70.79,0.1035,959,217.21,37983.95,6.42,0.7925
3510,Morse Crane and Woods,False,TN,Port James,SaaS,2008,https://morsecraneandwoods.com,Agreement keep recognize hospital write money heart stand care recently soldier.,24,morse-crane-and-woods,2023,USD,161015,37940,123075,53734,69341,0,69341,1610,3220,66121,8266,139264,10524,128740,13417.92,161015,215.45,453.55,0.0184,621,21.6,22193.93,0.37,0.7644
3511,Johnston Kirby and Palmer,False,CA,Jessicaton,EdTech,2010,https://johnstonkirbyandpalmer.com,Loss single up really because to city.,16,johnston-kirby-and-palmer,2023,USD,432471,209936,222535,237785,-15250,0,-15250,4324,8649,-23899,10651,299915,73706,226209,36039.25,432471,110.01,320.51,0.0353,7207,5.0,22911.43,0.46,0.5146
3512,Stewart-Ali,False,DE,Vincentview,Fintech,2013,https://stewart-ali.com,Quite firm hope leader friend.,19,stewart-ali,2023,EUR,1872435,557247,1315188,353705,961483,8839,952644,18724,37448,915196,100036,1085117,387033,698084,,1872435,807.44,3517.37,0.0684,7801,20.0,35409.76,2.83,0.7024
3513,Maddox Inc,False,ZA,North Sharon,HealthTech,2009,https://maddoxinc.com,Bit read adult front.,20,maddox-inc,2023,USD,734686,192151,542535,36734,505801,12458,493343,7346,14693,478650,19580,408097,20404,387693,61223.83,734686,631.43,2865.45,0.0742,4357,14.05,1000.0,19.58,0.7385
3514,Tate Lee and Richardson,False,TN,Henryshire,AI/ML,2011,https://tateleeandrichardson.com,Sound this consumer return fund generation.,16,tate-lee-and-richardson,2023,USD,354725,137453,217272,134134,83138,0,83138,3547,7094,76044,305134,682015,359532,322483,,354725,430.45,851.33,0.0222,493,59.87,1000.0,305.13,0.6125
3515,Miller-Johnson,False,CA,East Michael,E-commerce,2014,https://miller-johnson.com,Something message election another middle assume issue service reality might.,16,miller-johnson,2023,USD,3085087,933489,2151598,1492085,659513,14821,644692,30850,61701,582991,599107,2296249,546998,1749251,,3085087,20.0,115.17,0.1017,1500,171.33,99226.33,6.04,0.6974
3516,Walton LLC,False,KE,West Stephanie,EdTech,2020,https://waltonllc.com,Or them subject music describe step.,22,walton-llc,2023,USD,1766425,565097,1201328,737327,464001,26857,437144,17664,35328,401816,126824,1147511,455170,692341,147202.08,1766425,483.45,2884.72,0.0487,1561,94.25,88485.85,1.43,0.6801
3517,Vazquez Inc,False,TN,Lake Johnshire,Fintech,2015,https://vazquezinc.com,North describe north exactly answer majority spend inside never street.,21,vazquez-inc,2023,USD,3116295,1030755,2085540,2266882,-181342,0,-181342,31162,62325,-243667,250508,2000829,937178,1063651,,3116295,20.0,74.8,0.001,12984,20.0,194988.6,1.28,0.6692
3518,Bradley Wall and Rodriguez,False,DE,Bobbymouth,Fintech,2019,https://bradleywallandrodriguez.com,Four a street late major pull stage our particular.,21,bradley-wall-and-rodriguez,2023,EUR,540287,208397,331890,389446,-57556,0,-57556,5402,10805,-68361,8910,378890,112404,266486,,540287,20.0,56.53,0.0353,1496,30.09,42130.19,0.21,0.6143
3519,Brown Fleming and Murray,False,CA,West Peterfurt,HealthTech,2008,https://brownflemingandmurray.com,Teach sing several travel might cover miss thing most must.,29,brown-fleming-and-murray,2023,USD,550674,184290,366384,130547,235837,0,235837,5506,11013,224824,28913,394865,282833,112032,45889.5,550674,580.36,1303.6,0.0079,663,69.13,15011.14,1.93,0.6653
3520,Anderson-Willis,False,TN,Millerborough,Marketplaces,2018,https://anderson-willis.com,Well public little at true leader continue in.,24,anderson-willis,2023,USD,1245846,346238,899608,597813,301795,0,301795,12458,24916,276879,94733,826804,166442,660362,,1245846,20.0,48.39,0.0704,598,173.49,35712.53,2.65,0.7221
3521,Duncan Evans and Nunez,False,US,Lake Paul,Energy,2014,https://duncanevansandnunez.com,Group evening music pass understand.,20,duncan-evans-and-nunez,2023,USD,655808,304936,350872,562839,-211967,0,-211967,6558,13116,-225083,117908,533739,52091,481648,,655808,20.0,140.76,0.0984,1204,45.39,38950.89,3.03,0.535
3522,Daniel Powers and Baker,False,EG,West Mark,EdTech,2010,https://danielpowersandbaker.com,Some sell line gun society source.,14,daniel-powers-and-baker,2023,USD,1356061,386382,969679,268632,701047,11827,689220,13560,27121,662099,584707,1379595,460567,919028,113005.08,1356061,361.67,923.42,0.001,3345,33.78,6441.36,90.77,0.7151
3523,Morgan-Morgan,False,BR,Russellview,AgriTech,2019,https://morgan-morgan.com,Successful move myself weight than themselves woman.,18,morgan-morgan,2023,USD,512960,71419,441541,187270,254271,24152,230119,5129,10259,219860,74901,445139,95079,350060,,512960,284.08,912.36,0.0862,602,70.93,13410.03,5.59,0.8608
3524,Hopkins Melendez and Ramos,False,US,Michelleville,Fintech,2014,https://hopkinsmelendezandramos.com,Thought both officer moment artist TV study.,23,hopkins-melendez-and-ramos,2023,USD,199853,77720,122133,75818,46315,10070,36245,1998,3997,32248,31974,254141,56772,197369,,199853,2535.19,8242.73,0.001,832,20.0,1000.0,31.97,0.6111
3525,Evans and Sons,False,TN,North Johnside,AgriTech,2023,https://evansandsons.com,Deep world section nation share avoid today.,27,evans-and-sons,2023,USD,639426,311572,327854,440442,-112588,42513,-155101,6394,12788,-167889,20597,390331,36299,354032,,639426,180.3,663.97,0.095,545,97.69,14110.35,1.46,0.5127
3526,Carter and Sons,False,FR,Thomaschester,Cybersecurity,2013,https://carterandsons.com,Somebody subject until continue improve class.,19,carter-and-sons,2023,EUR,5160818,3026912,2133906,406451,1727455,0,1727455,51608,103216,1624239,118498,2711632,1038523,1673109,,5160818,20.0,24.56,0.0609,4925,87.32,30160.53,3.93,0.4135
3527,Hall PLC,False,IN,East Kevinport,Fintech,2018,https://hallplc.com,However matter sound eat seven strong with.,14,hall-plc,2023,USD,474367,134327,340040,242790,97250,793,96457,4743,9487,86970,15452,314877,152799,162078,,474367,44.98,238.5,0.0288,231,170.64,1000.0,15.45,0.7168
3528,Grimes PLC,False,BR,Kennethfurt,Cybersecurity,2020,https://grimesplc.com,Industry maintain soon program arm total not able per reason.,20,grimes-plc,2023,USD,1036756,216976,819780,362054,457726,28926,428800,10367,20735,408065,68165,654769,149942,504827,,1036756,563.7,3215.66,0.0196,419,205.98,14195.16,4.8,0.7907
3529,Duncan Davidson and Mata,False,BR,Randychester,Cybersecurity,2012,https://duncandavidsonandmata.com,Let others head begin always.,22,duncan-davidson-and-mata,2023,USD,2877995,1248895,1629100,584717,1044383,0,1044383,28779,57559,986824,353430,1860317,742444,1117873,,2877995,835.78,1074.72,0.0179,1107,216.49,37236.77,9.49,0.5661
3530,Larsen Powell and Montes,False,CA,Timothyfurt,HealthTech,2018,https://larsenpowellandmontes.com,Attention without risk organization central ago.,18,larsen-powell-and-montes,2023,USD,206564,68638,137926,28522,109404,0,109404,2065,4131,105273,22729,293611,62385,231226,17213.67,206564,223.42,1010.34,0.0557,179,95.71,26376.42,0.86,0.6677
3531,Chang-Valencia,False,BR,Nathanieltown,Mobility,2010,https://chang-valencia.com,Share fear available interview successful.,16,chang-valencia,2023,USD,766251,325051,441200,45009,396191,0,396191,7662,15325,380866,25454,465243,184858,280385,,766251,1095.17,8115.21,0.0558,3192,20.0,7713.77,3.3,0.5758
3532,Frazier-Williams,False,CA,Jessicaburgh,SaaS,2022,https://frazier-williams.com,Health choice this that against box floor nothing state.,20,frazier-williams,2023,USD,370962,195793,175169,291553,-116384,3691,-120075,3709,7419,-127494,28516,287668,205179,82489,30913.5,370962,65.53,223.56,0.0594,256,120.66,25382.68,1.12,0.4722
3533,Lewis Graves and Flores,False,TN,Johnsonbury,AI/ML,2015,https://lewisgravesandflores.com,Remember reflect ahead wall lead above street check rule.,16,lewis-graves-and-flores,2023,USD,1335290,227444,1107846,66764,1041082,0,1041082,13352,26705,1014377,172966,896990,381565,515425,,1335290,1207.39,4665.28,0.005,455,244.42,1000.0,172.97,0.8297
3534,Baird Lee and Parsons,False,NG,Lake Steven,IoT,2008,https://bairdleeandparsons.com,Trouble inside live under very hold nation daughter control.,22,baird-lee-and-parsons,2023,USD,475233,147752,327481,192252,135229,0,135229,4752,9504,125725,23336,308880,44743,264137,,475233,830.73,1537.23,0.0726,170,232.17,1000.0,23.34,0.6891
3535,Ponce LLC,False,DE,Ericside,SaaS,2011,https://poncellc.com,Meet nearly along main grow than very join general full.,14,ponce-llc,2023,EUR,3961212,1537423,2423789,1796791,626998,0,626998,39612,79224,547774,269117,2267614,1181635,1085979,330101.0,3961212,89.2,433.77,0.001,3119,105.81,193667.35,1.39,0.6119
3536,Gonzales Watson and Underwood,False,IN,Christophershire,EdTech,2021,https://gonzaleswatsonandunderwood.com,Everyone large drug history race suggest.,15,gonzales-watson-and-underwood,2023,USD,427109,91259,335850,240365,95485,43325,52160,4271,8542,43618,12438,351910,179664,172246,35592.42,427109,363.57,1169.61,0.0643,533,66.72,49068.83,0.25,0.7863
3537,Barnett Cisneros and Davis,False,AU,Drewhaven,EdTech,2010,https://barnettcisnerosanddavis.com,Wish debate blue nearly lose hotel employee phone event.,24,barnett-cisneros-and-davis,2023,USD,223903,94662,129241,100314,28927,0,28927,2239,4478,24449,8153,212243,80204,132039,18658.58,223903,457.64,1093.16,0.1043,223,83.54,9609.5,0.85,0.5772
3538,Barrera Ortega and Alexander,False,US,Everettborough,HealthTech,2019,https://barreraortegaandalexander.com,Knowledge return west young cover model keep simply yourself star.,25,barrera-ortega-and-alexander,2023,USD,960832,562119,398713,590821,-192108,0,-192108,9608,19216,-211324,262551,851924,223302,628622,80069.33,960832,81.42,102.4,0.001,16013,5.0,54066.73,4.86,0.415
3539,Tucker-Carroll,False,EG,Schmittchester,AgriTech,2014,https://tucker-carroll.com,Measure miss high property situation room company across rather air.,19,tucker-carroll,2023,USD,100468,28741,71727,41513,30214,0,30214,1004,2009,28205,4970,215448,41303,174145,,100468,272.15,662.24,0.0742,46,179.29,1000.0,4.97,0.7139
3540,Ruiz-Faulkner,False,GB,Thompsonland,Energy,2014,https://ruiz-faulkner.com,Decide sign form most identify fish box discussion.,17,ruiz-faulkner,2023,USD,4026428,1216725,2809703,2369804,439899,25272,414627,40264,80528,334099,318242,2401423,120071,2281352,,4026428,933.39,3311.49,0.0451,2084,160.96,182633.86,1.74,0.6978
3541,Brown Inc,False,BR,Lake Adriana,SaaS,2015,https://browninc.com,Past politics machine another see rule produce interview skin TV effect.,21,brown-inc,2023,USD,859531,265486,594045,352707,241338,1924,239414,8595,17190,222224,39758,567763,52016,515747,71627.58,859531,294.71,1146.49,0.0319,9206,7.78,12556.14,3.17,0.6911
3542,Morton-Logan,False,ZA,South Alexisstad,IoT,2022,https://morton-logan.com,Down increase already yet spring friend reality close hold back.,19,morton-logan,2023,USD,538506,308175,230331,167301,63030,9378,53652,5385,10770,42882,7260,355501,259008,96493,,538506,1006.04,503.02,0.001,409,109.64,1000.0,7.26,0.4277
3543,Baker Group,False,ZA,Matthewstad,E-commerce,2012,https://bakergroup.com,Night whole why crime first here draw accept staff.,19,baker-group,2023,USD,308099,77110,230989,28221,202768,34766,168002,3080,6161,161841,29140,310677,63026,247651,,308099,1186.7,5192.08,0.0292,219,116.78,23190.24,1.26,0.7497
3544,Yates Group,False,IN,North Jasonland,E-commerce,2009,https://yatesgroup.com,Anyone central section over appear rest wish effect wind.,15,yates-group,2023,USD,283336,104022,179314,213817,-34503,9263,-43766,2833,5666,-49432,13989,263100,123393,139707,,283336,898.69,6492.52,0.001,331,71.3,39678.23,0.35,0.6329
3545,Ochoa-Cook,False,NG,Cohenbury,Energy,2017,https://ochoa-cook.com,Rather describe night director paper could yes.,12,ochoa-cook,2023,USD,1189643,117789,1071854,678248,393606,0,393606,11896,23792,369814,35269,749943,187072,562871,,1189643,113.03,402.5,0.0407,554,178.65,73918.67,0.48,0.901
3546,Cooke Pierce and Morrow,False,AU,South Peter,SaaS,2015,https://cookepierceandmorrow.com,Perhaps eat onto political modern hope middle.,14,cooke-pierce-and-morrow,2023,USD,1167903,499652,668251,425949,242302,24631,217671,11679,23358,194313,10066,618195,152461,465734,97325.25,1167903,212.43,277.64,0.0836,3293,29.55,38711.31,0.26,0.5722
3547,Clark-Lane,False,ZA,Staffordhaven,E-commerce,2018,https://clark-lane.com,Series interview listen too couple apply century.,16,clark-lane,2023,USD,751106,450861,300245,131163,169082,35723,133359,7511,15022,118337,84699,512931,294117,218814,,751106,20.0,97.98,0.1277,416,150.18,21270.86,3.98,0.3997
3548,Long-Bishop,False,DE,Michaelside,EdTech,2009,https://long-bishop.com,Risk own here us agreement father modern wind staff chair suddenly.,21,long-bishop,2023,EUR,298634,118212,180422,125165,55257,27248,28009,2986,5972,22037,6218,267583,72372,195211,24886.17,298634,183.53,627.93,0.1087,2737,9.09,1000.0,6.22,0.6042
3549,Sullivan-Mercer,False,BR,Thompsonview,EdTech,2015,https://sullivan-mercer.com,Service home where drug central morning exactly.,15,sullivan-mercer,2023,USD,316759,130709,186050,67604,118446,12056,106390,3167,6335,100055,4712,165562,88820,76742,26396.58,316759,10.0,33.48,0.1114,440,59.94,12098.61,0.39,0.5874
3550,Mcdaniel Inc,False,KE,South Kevin,Energy,2024,https://mcdanielinc.com,Rate still open begin bag catch consider.,18,mcdaniel-inc,2023,USD,1598322,402447,1195875,485061,710814,0,710814,15983,31966,678848,40150,989804,225332,764472,,1598322,1398.68,7716.96,0.0399,2514,52.96,50226.78,0.8,0.7482
3551,Peterson Inc,False,CA,Lake Gail,HealthTech,2022,https://petersoninc.com,Back himself everything foot style resource protect close.,18,peterson-inc,2023,USD,246976,106870,140106,166485,-26379,19985,-46364,2469,4939,-51303,8494,241519,158103,83416,20581.33,246976,271.75,271.75,0.0237,4116,5.0,29473.35,0.29,0.5673
3552,Freeman Inc,False,BR,Jimenezstad,SaaS,2010,https://freemaninc.com,Pass seem day citizen rise.,18,freeman-inc,2023,USD,3527545,765603,2761942,1369266,1392676,10249,1382427,35275,70550,1311877,212228,2131222,987284,1143938,293962.08,3527545,10.0,31.61,0.1093,4177,70.37,130545.69,1.63,0.783
3553,Alvarez LLC,False,EG,Hicksport,Fintech,2014,https://alvarezllc.com,Claim life either mother instead you despite.,20,alvarez-llc,2023,USD,632092,253124,378968,196902,182066,7907,174159,6320,12641,161518,12593,460279,150246,310033,,632092,20.0,76.07,0.001,270,195.05,51564.13,0.24,0.5995
3554,Montoya and Sons,False,US,East Tracey,Marketplaces,2012,https://montoyaandsons.com,Use space specific drug resource when loss area green garden.,17,montoya-and-sons,2023,USD,499820,85281,414539,128279,286260,22010,264250,4998,9996,254254,48308,439936,182546,257390,,499820,20.0,71.28,0.0826,218,190.21,1000.0,48.31,0.8294
3555,Jones Group,False,DE,Kathleenchester,HealthTech,2010,https://jonesgroup.com,Chance even behavior carry program bag green wonder walk maybe.,28,jones-group,2023,EUR,1905448,267971,1637477,905260,732217,23571,708646,19054,38108,670538,131723,1101608,548939,552669,158787.33,1905448,423.17,1537.88,0.001,31757,5.0,89463.19,1.47,0.8594
3556,Gonzalez Jensen and Norris,False,GB,South Amyview,IoT,2014,https://gonzalezjensenandnorris.com,Camera simply form again include.,15,gonzalez-jensen-and-norris,2023,USD,1245097,414225,830872,933775,-102903,29281,-132184,12450,24901,-157085,27269,841622,303126,538496,,1245097,104.75,503.47,0.1213,656,158.05,93178.58,0.29,0.6673
3557,Ellis PLC,False,DE,Port Meagan,AI/ML,2010,https://ellisplc.com,Today stand feel stay light pressure white.,31,ellis-plc,2023,EUR,2120980,749393,1371587,1378917,-7330,12406,-19736,21209,42419,-62155,438455,1502873,736449,766424,,2120980,91.64,152.84,0.0256,1380,127.99,103323.12,4.24,0.6467
3558,Garcia Inc,False,TN,Lindseychester,Cybersecurity,2022,https://garciainc.com,Street decision purpose candidate church source fish rise investment discuss.,17,garcia-inc,2023,USD,463209,259804,203405,230752,-27347,2868,-30215,4632,9264,-39479,63498,457699,38801,418898,,463209,20.0,48.74,0.001,147,261.38,11068.99,5.74,0.4391
3559,Burch-Rice,False,IN,Williamville,HealthTech,2014,https://burch-rice.com,Song address tax never.,15,burch-rice,2023,USD,88266,20659,67607,9846,57761,0,57761,882,1765,55996,7536,220459,144249,76210,7355.5,88266,10.0,37.44,0.0059,94,77.8,40740.33,0.18,0.7659
3560,Gordon-Alvarez,False,DE,Leeburgh,Energy,2013,https://gordon-alvarez.com,Glass stuff make audience choice figure book according dog.,15,gordon-alvarez,2023,EUR,801076,200623,600453,282686,317767,0,317767,8010,16021,301746,46495,615107,88048,527059,,801076,20.0,131.68,0.0277,3337,20.0,35398.36,1.31,0.7496
3561,Olsen-Noble,False,KE,South Johnchester,EdTech,2017,https://olsen-noble.com,Notice management her person fine report able.,27,olsen-noble,2023,USD,377428,71954,305474,71983,233491,0,233491,3774,7548,225943,3866,333128,59674,273454,31452.33,377428,10.0,37.58,0.0153,480,65.44,2294.99,1.68,0.8094
3562,Vega Wilson and Underwood,False,IN,Jeffreybury,IoT,2022,https://vegawilsonandunderwood.com,Increase country four ago available back building value.,19,vega-wilson-and-underwood,2023,USD,1361314,580692,780622,665019,115603,0,115603,13613,27226,88377,14440,795329,254946,540383,,1361314,20.0,55.89,0.1106,1363,83.19,53722.39,0.27,0.5734
3563,Ruiz Parks and Yu,False,BR,New Monicaburgh,EdTech,2016,https://ruizparksandyu.com,Write grow capital coach my dog.,20,ruiz-parks-and-yu,2023,USD,187626,45460,142166,135357,6809,10778,-3969,1876,3752,-7721,2449,141235,53528,87707,15635.5,187626,123.27,123.27,0.0261,227,68.87,25292.04,0.1,0.7577
3564,Howard Odom and Williams,False,AU,West Rogerland,Mobility,2010,https://howardodomandwilliams.com,Bring support ten experience tell consider speak station to.,19,howard-odom-and-williams,2023,USD,3031306,1034689,1996617,2181907,-185290,0,-185290,30313,60626,-245916,42460,1709131,268220,1440911,,3031306,455.81,700.51,0.001,3495,72.26,178246.96,0.24,0.6587
3565,Le Mack and Conway,False,CA,New Bradley,Energy,2020,https://lemackandconway.com,Industry around idea most road half response single.,13,le-mack-and-conway,2023,USD,957925,117149,840776,576568,264208,0,264208,9579,19158,245050,36583,703606,215325,488281,,957925,241.01,606.48,0.0677,3991,20.0,40770.78,0.9,0.8777
3566,Marshall and Sons,False,GB,South Andrewstad,Mobility,2022,https://marshallandsons.com,Child figure that administration state.,29,marshall-and-sons,2023,USD,1425459,568707,856752,510692,346060,34511,311549,14254,28509,283040,35622,783144,307338,475806,,1425459,685.76,1693.42,0.1025,1032,115.0,48723.45,0.73,0.601
3567,Martinez Group,False,TN,Lake Heatherstad,AI/ML,2021,https://martinezgroup.com,Such every because wife into sport.,25,martinez-group,2023,USD,1252690,460469,792221,413320,378901,44569,334332,12526,25053,309279,23250,724362,201991,522371,,1252690,1082.66,541.33,0.001,5219,20.0,74007.79,0.31,0.6324
3568,Paul Reynolds and Evans,False,AU,Grayfurt,HealthTech,2023,https://paulreynoldsandevans.com,In tax build coach measure across above.,24,paul-reynolds-and-evans,2023,USD,534597,236776,297821,260558,37263,4254,33009,5345,10691,22318,45758,505478,124038,381440,44549.75,534597,258.56,1102.96,0.0484,4190,10.63,8056.39,5.68,0.5571
3569,Hood Inc,False,US,Port Shelley,Energy,2021,https://hoodinc.com,Enjoy language even rule admit listen medical condition where.,18,hood-inc,2023,USD,258524,129613,128911,35480,93431,0,93431,2585,5170,88261,60486,309992,74569,235423,,258524,544.74,2776.84,0.001,1077,20.0,1000.0,60.49,0.4986
3570,Nguyen Ltd,False,FR,East Timothy,AgriTech,2012,https://nguyenltd.com,Politics center you result environmental and.,20,nguyen-ltd,2023,EUR,40155,7703,32452,25755,6697,0,6697,401,803,5894,17992,178733,43530,135203,,40155,20.0,101.19,0.1054,12,260.28,26056.67,0.69,0.8082
3571,Hill-Ruiz,False,NG,Woodside,Cybersecurity,2013,https://hill-ruiz.com,Your join amount prepare along thought out system but.,21,hill-ruiz,2023,USD,1211561,283333,928228,262600,665628,15059,650569,12115,24231,626338,42402,832383,413797,418586,,1211561,20.0,67.25,0.0928,377,267.68,23627.92,1.79,0.7661
3572,Martin-Dennis,False,IN,Franklinbury,Energy,2022,https://martin-dennis.com,Democratic west whatever meet official expect campaign wife politics home try.,24,martin-dennis,2023,USD,1815254,532360,1282894,1575092,-292198,0,-292198,18152,36305,-328503,236577,1331745,718362,613383,,1815254,1149.44,7309.31,0.0901,1416,106.77,123002.75,1.92,0.7067
3573,Miller LLC,False,IN,Cynthiahaven,Mobility,2017,https://millerllc.com,Possible me have sign leave.,22,miller-llc,2023,USD,773102,332149,440953,249955,190998,0,190998,7731,15462,175536,30354,596494,268535,327959,,773102,213.53,887.15,0.0743,289,222.38,1000.0,30.35,0.5704
3574,Arroyo and Sons,False,TN,New Sarahbury,AI/ML,2023,https://arroyoandsons.com,Career court approach score exactly eight movie point admit property.,16,arroyo-and-sons,2023,USD,2983916,1403990,1579926,1474951,104975,48599,56376,29839,59678,-3302,48536,1696382,755176,941206,,2983916,635.66,3371.97,0.0974,1882,132.11,155415.87,0.31,0.5295
3575,Weaver Sanchez and Richardson,False,FR,Melissaside,E-commerce,2012,https://weaversanchezandrichardson.com,Computer difficult week science yard law assume.,26,weaver-sanchez-and-richardson,2023,EUR,758308,282879,475429,451383,24046,0,24046,7583,15166,8880,40329,563481,52805,510676,,758308,1075.12,750.33,0.0365,1169,54.05,42958.2,0.94,0.627
3576,Wright-Randall,False,ZA,Guerreroland,Mobility,2014,https://wright-randall.com,Instead cover analysis family right.,26,wright-randall,2023,USD,923570,395325,528245,669393,-141148,51928,-193076,9235,18471,-211547,115198,663904,247207,416697,,923570,559.72,3570.58,0.0306,248,310.07,68100.64,1.69,0.572
3577,Tucker White and Lane,False,GB,Lake Benjaminberg,EdTech,2008,https://tuckerwhiteandlane.com,Close possible life industry simple road painting pass.,24,tucker-white-and-lane,2023,USD,316084,74053,242031,105286,136745,0,136745,3160,6321,130424,8274,174829,37108,137721,26340.33,316084,211.79,629.11,0.0534,314,83.88,16372.57,0.51,0.7657
3578,Hamilton Inc,False,US,Darrellchester,AI/ML,2019,https://hamiltoninc.com,Star action wide his tell beyond star teacher cost officer tell.,14,hamilton-inc,2023,USD,159178,49076,110102,84423,25679,0,25679,1591,3183,22496,26307,119439,5971,113468,,159178,806.3,453.12,0.0239,44,299.92,1000.0,26.31,0.6917
3579,Smith Castillo and Shaw,False,EG,Jeffreyside,Energy,2021,https://smithcastilloandshaw.com,Against manage development cup help both energy.,13,smith-castillo-and-shaw,2023,USD,744800,250457,494343,639937,-145594,54834,-200428,7448,14896,-215324,63469,544459,27222,517237,,744800,1113.55,8036.48,0.115,1536,40.39,76598.62,0.83,0.6637
3580,Mason PLC,False,TN,Hintonville,Cybersecurity,2019,https://masonplc.com,Rather build little positive nation design top process sometimes where.,17,mason-plc,2023,USD,521535,152932,368603,515354,-146751,0,-146751,5215,10430,-157181,42204,469273,102285,366988,,521535,193.88,96.94,0.0198,2173,20.0,34425.7,1.23,0.7068
3581,Contreras-Jackson,False,TN,South Lisashire,Mobility,2017,https://contreras-jackson.com,Professor full gas similar approach cup strategy movement professional remain.,26,contreras-jackson,2023,USD,859691,150729,708962,396359,312603,0,312603,8596,17193,295410,11066,563857,262646,301211,,859691,20.0,10.0,0.001,330,216.94,21150.01,0.52,0.8247
3582,Richardson-Sims,False,BR,West Julie,IoT,2010,https://richardson-sims.com,Best task always military successful face newspaper national TV throw street.,22,richardson-sims,2023,USD,446475,186895,259580,133372,126208,0,126208,4464,8929,117279,11391,307070,19147,287923,,446475,20.0,89.52,0.0517,1860,20.0,21253.54,0.54,0.5814
3583,Alexander and Sons,False,TN,Singletonmouth,SaaS,2011,https://alexanderandsons.com,Situation eye market structure phone could vote maybe voice.,21,alexander-and-sons,2023,USD,4359217,1651585,2707632,4126558,-1418926,22415,-1441341,43592,87184,-1528525,1327742,3605651,1096197,2509454,363268.08,4359217,187.66,1469.38,0.0579,17566,20.68,361520.45,3.67,0.6211
3584,Hughes Group,False,TN,South Shannonville,IoT,2013,https://hughesgroup.com,According expect company who man despite.,23,hughes-group,2023,USD,569676,212331,357345,258679,98666,14636,84030,5696,11393,72637,8287,393985,82360,311625,,569676,384.14,853.55,0.0643,760,62.41,1000.0,8.29,0.6273
3585,Jimenez LLC,False,DE,Shermanview,Energy,2016,https://jimenezllc.com,List party maybe police accept.,15,jimenez-llc,2023,EUR,515692,117011,398681,204725,193956,41150,152806,5156,10313,142493,46012,425514,21275,404239,,515692,1173.79,3242.48,0.061,255,167.9,10780.38,4.27,0.7731
3586,Johnson Inc,False,AU,East Johnburgh,Cybersecurity,2019,https://johnsoninc.com,Everybody natural adult trouble bag risk.,17,johnson-inc,2023,USD,300927,125549,175378,15046,160332,16530,143802,3009,6018,137784,26930,182298,23551,158747,,300927,441.3,1989.1,0.0451,595,42.08,11160.31,2.41,0.5828
3587,Davenport Ltd,False,NG,North Michael,Cybersecurity,2023,https://davenportltd.com,Ten they oil letter man chair eye population represent week.,21,davenport-ltd,2023,USD,503084,270827,232257,454632,-222375,35849,-258224,5030,10061,-268285,10015,321066,154522,166544,,503084,216.68,1284.21,0.0186,1133,36.99,51496.52,0.19,0.4617
3588,Bennett-Holmes,False,BR,Ronaldshire,Cybersecurity,2019,https://bennett-holmes.com,Health read nation stock deal.,20,bennett-holmes,2023,USD,550398,135432,414966,206928,208038,21814,186224,5503,11007,175217,11080,345077,96488,248589,,550398,20.0,96.31,0.1936,776,59.1,1000.0,11.08,0.7539
3589,Raymond-Oliver,False,ZA,Collinston,SaaS,2020,https://raymond-oliver.com,While bit middle score reach owner recently participant address memory difference.,24,raymond-oliver,2023,USD,1399288,131035,1268253,127046,1141207,0,1141207,13992,27985,1113222,33096,793774,255661,538113,116607.33,1399288,106.6,402.37,0.0327,6720,17.35,24655.93,1.34,0.9064
3590,Barron Cameron and Bennett,False,TN,Martinezfort,Cybersecurity,2015,https://barroncameronandbennett.com,Play single her thought career idea raise oil his suffer.,17,barron-cameron-and-bennett,2023,USD,2803593,967103,1836490,1502920,333570,0,333570,28035,56071,277499,122167,1619112,495043,1124069,,2803593,171.8,102.24,0.0985,1859,125.64,114320.59,1.07,0.655
3591,Brennan Chandler and Spence,False,DE,Craighaven,Mobility,2009,https://brennanchandlerandspence.com,Receive heavy lay toward fast much interest style last.,24,brennan-chandler-and-spence,2023,EUR,306730,136988,169742,145540,24202,0,24202,3067,6134,18068,23430,324504,120318,204186,,306730,386.42,331.57,0.0299,216,117.87,1000.0,23.43,0.5534
3592,Ashley Burke and Browning,False,CA,Hamiltonborough,Marketplaces,2008,https://ashleyburkeandbrowning.com,Medical always left alone spring modern court room sister dog too.,28,ashley-burke-and-browning,2023,USD,1344005,264861,1079144,1082622,-3478,30954,-34432,13440,26880,-61312,13918,751602,200847,550755,,1344005,20.0,22.0,0.0512,420,266.45,112629.33,0.12,0.8029
3593,Allen Mcdonald and Campbell,False,ZA,Lake Jenniferchester,Marketplaces,2012,https://allenmcdonaldandcampbell.com,None identify full appear early standard toward happy style.,14,allen-mcdonald-and-campbell,2023,USD,750838,323209,427629,453159,-25530,0,-25530,7508,15016,-40546,69336,562139,146562,415577,,750838,935.99,4602.15,0.0347,3128,20.0,23627.39,2.93,0.5695
3594,Manning LLC,False,IN,North Teresa,IoT,2022,https://manningllc.com,Career eat able forward sometimes quite.,20,manning-llc,2023,USD,943534,196877,746657,514333,232324,0,232324,9435,18870,213454,38315,651755,314478,337277,,943534,1114.45,3411.0,0.0351,275,285.56,67030.63,0.57,0.7913
3595,Jackson Fuller and Fox,False,BR,East Tonyaburgh,HealthTech,2016,https://jacksonfullerandfox.com,Prevent get since that matter peace design mention Mr marriage.,10,jackson-fuller-and-fox,2023,USD,343052,119394,223658,54469,169189,28381,140808,3430,6861,133947,68815,332230,30183,302047,28587.67,343052,84.04,395.96,0.0082,288,99.13,10632.25,6.47,0.652
3596,Johnson George and Perkins,False,DE,Port Heathertown,IoT,2013,https://johnsongeorgeandperkins.com,Camera rate power generation example significant family bad step.,20,johnson-george-and-perkins,2023,EUR,1297742,534829,762913,535772,227141,9521,217620,12977,25954,191666,136209,922775,205743,717032,,1297742,20.0,83.39,0.082,407,265.34,32026.61,4.25,0.5879
3597,Orozco-Gibson,False,US,Amberfurt,Fintech,2010,https://orozco-gibson.com,Buy reflect senior citizen participant piece stock help eight.,21,orozco-gibson,2023,USD,478660,179079,299581,324830,-25249,0,-25249,4786,9573,-34822,24569,385908,19295,366613,,478660,20.0,41.3,0.1442,298,133.72,47178.29,0.52,0.6259
3598,Brooks-Cobb,False,BR,New Johnchester,Cybersecurity,2020,https://brooks-cobb.com,Piece single sign white condition action.,15,brooks-cobb,2023,USD,1928657,451510,1477147,1161038,316109,23861,292248,19286,38573,253675,255544,1331822,756437,575385,,1928657,160.94,301.29,0.001,741,216.68,73458.78,3.48,0.7659
3599,Gray Castro and Vasquez,False,TN,Lake Johnville,Cybersecurity,2010,https://graycastroandvasquez.com,Themselves huge large as tend baby let let.,22,gray-castro-and-vasquez,2023,USD,1318577,737278,581299,424620,156679,0,156679,13185,26371,130308,60062,769774,128388,641386,,1318577,20.0,15.73,0.001,1147,95.73,39018.73,1.54,0.4409
3600,Adams LLC,False,NG,Lake Pamela,EdTech,2021,https://adamsllc.com,Special travel term nearly property against common drug yeah.,19,adams-llc,2023,USD,390967,139522,251445,19548,231897,13003,218894,3909,7819,211075,9023,309508,15475,294033,32580.58,390967,176.01,176.01,0.1106,6516,5.0,30954.83,0.29,0.6431
3601,Holland Johnson and Johnson,False,GB,Paulland,Energy,2016,https://hollandjohnsonandjohnson.com,Draw bed with tonight either because imagine want hair.,23,holland-johnson-and-johnson,2023,USD,2741485,840248,1901237,1907329,-6092,0,-6092,27414,54829,-60921,97387,1518586,372779,1145807,,2741485,20.0,109.51,0.0159,11422,20.0,153349.91,0.64,0.6935
3602,Miller-Andersen,False,ZA,Port Jamie,AgriTech,2024,https://miller-andersen.com,Hair avoid soldier sense second beautiful pretty image.,24,miller-andersen,2023,USD,849318,212727,636591,195063,441528,16016,425512,8493,16986,408526,42415,597346,29867,567479,,849318,825.73,2323.15,0.001,852,83.02,34864.68,1.22,0.7495
3603,Vaughn Group,False,NG,East William,Marketplaces,2020,https://vaughngroup.com,Meeting four approach visit energy for tonight.,22,vaughn-group,2023,USD,603804,247188,356616,440266,-83650,10398,-94048,6038,12076,-106124,28408,481755,239065,242690,,603804,20.0,36.69,0.1272,2515,20.0,12974.35,2.19,0.5906
3604,Boone-Smith,False,KE,South Michaelfurt,AgriTech,2021,https://boone-smith.com,Leave southern prepare party such personal question.,26,boone-smith,2023,USD,370073,100082,269991,20477,249514,7141,242373,3700,7401,234972,18825,280434,157587,122847,,370073,419.84,1397.61,0.001,1541,20.0,1000.0,18.82,0.7296
3605,Hunter-Garcia,False,AU,West Caleb,Cybersecurity,2010,https://hunter-garcia.com,Change way every view ever once rate first.,17,hunter-garcia,2023,USD,276387,90315,186072,172347,13725,0,13725,2763,5527,8198,70788,386612,234493,152119,,276387,2463.52,9101.94,0.0778,189,121.44,1000.0,70.79,0.6732
3606,Lowery-Duncan,False,FR,Jamesstad,Marketplaces,2019,https://lowery-duncan.com,Street everyone way her decade.,20,lowery-duncan,2023,EUR,1453982,645670,808312,1057502,-249190,41042,-290232,14539,29079,-319311,133710,905578,388008,517570,,1453982,20.0,46.33,0.0274,1008,120.14,92740.24,1.44,0.5559
3607,Burke LLC,False,GB,Coxborough,AgriTech,2014,https://burkellc.com,True beat alone peace old tend.,23,burke-llc,2023,USD,230548,72775,157773,144318,13455,15644,-2189,2305,4610,-6799,35876,154193,83396,70797,,230548,480.18,1171.6,0.0634,394,48.69,20640.23,1.74,0.6843
3608,Cannon-Kaiser,False,ZA,Tiffanybury,Energy,2017,https://cannon-kaiser.com,Enter line ago particular better song positive gun upon believe.,15,cannon-kaiser,2023,USD,4694383,2832273,1862110,1296274,565836,0,565836,46943,93887,471949,426616,2793308,787759,2005549,,4694383,1150.69,575.34,0.1261,2590,151.0,101020.86,4.22,0.3967
3609,Trevino-Allen,False,US,Lake John,HealthTech,2023,https://trevino-allen.com,Camera old detail that investment majority size book.,21,trevino-allen,2023,USD,1091959,604224,487735,584477,-96742,30341,-127083,10919,21839,-148922,117972,710157,184295,525862,90996.58,1091959,18.91,18.91,0.0576,1818,50.03,51933.13,2.27,0.4467
3610,Roy Lawson and Erickson,False,US,East Williamborough,Fintech,2010,https://roylawsonanderickson.com,This into that serve.,19,roy-lawson-and-erickson,2023,USD,976395,416751,559644,940526,-380882,13377,-394259,9763,19527,-413786,15302,509889,227151,282738,,976395,84.76,243.21,0.0909,4068,20.0,66810.91,0.23,0.5732
3611,Hunt Ltd,False,AU,West Michael,Cybersecurity,2021,https://huntltd.com,Management become late business resource join man special believe.,15,hunt-ltd,2023,USD,2210775,548242,1662533,295794,1366739,26718,1340021,22107,44215,1295806,466264,1770692,1032150,738542,,2210775,2133.16,6081.77,0.092,1143,161.15,1213.34,384.28,0.752
3612,Austin and Sons,False,NG,East Sonya,Energy,2017,https://austinandsons.com,North eat decide deal town easy it Republican.,19,austin-and-sons,2023,USD,6893884,2835770,4058114,1758088,2300026,26618,2273408,68938,137877,2135531,177833,3640741,1133427,2507314,,6893884,20.0,95.61,0.0729,28724,20.0,140708.04,1.26,0.5887
3613,Garrison Ball and Higgins,False,ZA,Helentown,Energy,2013,https://garrisonballandhiggins.com,Responsibility young reality off billion soldier professor.,16,garrison-ball-and-higgins,2023,USD,1305412,553475,751937,397057,354880,28554,326326,13054,26108,300218,14820,801042,40052,760990,,1305412,1125.25,3119.04,0.0234,3879,28.04,12720.33,1.17,0.576
3614,Avila Group,False,GB,New Elizabeth,E-commerce,2013,https://avilagroup.com,Community movie campaign experience natural spend benefit create candidate major.,21,avila-group,2023,USD,240733,111054,129679,12036,117643,42279,75364,2407,4814,70550,5576,278859,59796,219063,,240733,1218.33,6111.15,0.0933,1003,20.0,1000.0,5.58,0.5387
3615,Mills Ltd,False,ZA,Dawnmouth,HealthTech,2014,https://millsltd.com,Center respond design cause catch city item.,24,mills-ltd,2023,USD,102013,41919,60094,69005,-8911,18503,-27414,1020,2040,-29454,4383,100009,17684,82325,8501.08,102013,459.97,459.97,0.0022,536,15.84,27178.26,0.16,0.5891
3616,Mercer-Hawkins,False,EG,South William,HealthTech,2024,https://mercer-hawkins.com,Citizen edge family yourself value.,13,mercer-hawkins,2023,USD,350565,52242,298323,92497,205826,0,205826,3505,7011,198815,10074,240262,75522,164740,29213.75,350565,297.03,529.52,0.0673,206,141.8,34564.07,0.29,0.851
3617,Pugh-Weaver,False,FR,Reedtown,Mobility,2014,https://pugh-weaver.com,Election executive bed interest Democrat especially about.,15,pugh-weaver,2023,EUR,3636579,1064809,2571770,1535243,1036527,0,1036527,36365,72731,963796,864693,2849152,1067934,1781218,,3636579,20.0,44.25,0.0135,15152,20.0,111820.64,7.73,0.7072
3618,Willis-Contreras,False,GB,South Heatherburgh,EdTech,2009,https://willis-contreras.com,Describe often place environmental structure production senior everyone.,23,willis-contreras,2023,USD,285486,144546,140940,199397,-58457,41642,-100099,2854,5709,-105808,108830,263342,13167,250175,23790.5,285486,362.53,645.92,0.001,505,47.06,3782.03,28.78,0.4937
3619,Wilson-Sampson,False,ZA,Luistown,HealthTech,2014,https://wilson-sampson.com,Present page lot two enough carry myself building focus late.,23,wilson-sampson,2023,USD,1201689,510303,691386,1034727,-343341,44597,-387938,12016,24033,-411971,141603,934958,490319,444639,100140.75,1201689,63.09,408.63,0.042,1223,81.87,81526.5,1.74,0.5753
3620,Henderson-Reed,False,IN,North Janiceburgh,Energy,2022,https://henderson-reed.com,Ago crime strategy kitchen by partner.,16,henderson-reed,2023,USD,4725069,881000,3844069,2412963,1431106,41407,1389699,47250,94501,1295198,204855,2673837,1778107,895730,,4725069,190.11,326.11,0.0489,1962,200.61,200913.81,1.02,0.8135
3621,Kelley-Alvarez,False,BR,Aprilshire,IoT,2011,https://kelley-alvarez.com,Involve give understand the range question.,23,kelley-alvarez,2023,USD,476000,170736,305264,310513,-5249,36526,-41775,4760,9520,-51295,26603,345704,22465,323239,,476000,20.0,52.98,0.001,327,121.06,4966.68,5.36,0.6413
3622,Morris Group,False,BR,Lake Brett,HealthTech,2010,https://morrisgroup.com,Talk meet again listen maybe above may today commercial along.,22,morris-group,2023,USD,738463,266461,472002,262755,209247,0,209247,7384,14769,194478,136267,625416,177777,447639,61538.58,738463,10.0,10.0,0.0328,2913,21.12,35871.06,3.8,0.6392
3623,Kelly Ltd,False,IN,North Deborahshire,Fintech,2020,https://kellyltd.com,Should crime generation else north deep role.,22,kelly-ltd,2023,USD,291389,131860,159529,69531,89998,26580,63418,2913,5827,57591,31246,372785,328032,44753,,291389,20.0,52.31,0.0863,307,79.0,1000.0,31.25,0.5475
3624,Grimes-Carpenter,False,FR,East Leslietown,AgriTech,2010,https://grimes-carpenter.com,Somebody trial college our.,34,grimes-carpenter,2023,EUR,75566,37457,38109,41122,-3013,43519,-46532,755,1511,-48043,11360,150534,39345,111189,,75566,20.0,10.0,0.055,17,355.9,1000.0,11.36,0.5043
3625,Anthony Group,False,CA,West Kristina,SaaS,2015,https://anthonygroup.com,Up collection smile discussion subject federal nearly.,17,anthony-group,2023,USD,861880,212115,649765,561872,87893,7871,80022,8618,17237,62785,32726,650172,208056,442116,71823.33,861880,263.75,1816.12,0.0214,1357,52.92,74960.6,0.44,0.7539
3626,Mcdonald May and Smith,False,EG,Bartonville,Mobility,2011,https://mcdonaldmayandsmith.com,Black girl to my chance high media three no.,19,mcdonald-may-and-smith,2023,USD,3165364,631399,2533965,2677431,-143466,4065,-147531,31653,63307,-210838,103596,1857171,838913,1018258,,3165364,620.01,1649.7,0.1295,1898,138.95,245492.58,0.42,0.8005
3627,Wood Johnston and Moses,False,US,New Markstad,SaaS,2016,https://woodjohnstonandmoses.com,Sit cell team indicate himself.,27,wood-johnston-and-moses,2023,USD,6202909,1498611,4704298,1708848,2995450,6719,2988731,62029,124058,2864673,424290,3574947,869262,2705685,516909.08,6202909,10.0,37.84,0.019,4268,121.1,114751.64,3.7,0.7584
3628,Smith PLC,False,AU,Levyport,SaaS,2009,https://smithplc.com,Exactly body single body yeah together doctor fast TV result.,17,smith-plc,2023,USD,512348,247928,264420,189584,74836,3448,71388,5123,10246,61142,62124,408345,44819,363526,42695.67,512348,10.0,62.0,0.0572,670,63.72,21229.07,2.93,0.5161
3629,Ruiz Ltd,False,FR,Christinatown,EdTech,2024,https://ruizltd.com,Certainly own international evidence ready.,20,ruiz-ltd,2023,EUR,304216,136789,167427,68259,99168,28101,71067,3042,6084,64983,40020,193826,14560,179266,25351.33,304216,367.99,1890.41,0.0629,1938,13.08,48394.78,0.83,0.5504
3630,Wolf-Hale,False,AU,Weaverchester,SaaS,2020,https://wolf-hale.com,Make friend within yes team speak rule note several fund per.,13,wolf-hale,2023,USD,1622806,719760,903046,81140,821906,0,821906,16228,32456,789450,10298,864700,474888,389812,135233.83,1622806,10.0,47.64,0.0293,2500,54.08,38547.11,0.27,0.5565
3631,Blake Nguyen and Washington,False,KE,Scottfort,AI/ML,2016,https://blakenguyenandwashington.com,And world outside base popular.,22,blake-nguyen-and-washington,2023,USD,2617720,1061163,1556557,1075193,481364,0,481364,26177,52354,429010,95799,1412801,351155,1061646,,2617720,868.23,2285.7,0.0055,1661,131.26,115204.52,0.83,0.5946
3632,Morse Hall and Lopez,False,EG,Briggsstad,Mobility,2018,https://morsehallandlopez.com,Chance personal like dark action full place health mouth return myself.,26,morse-hall-and-lopez,2023,USD,2440502,499015,1941487,481456,1460031,16024,1444007,24405,48810,1395197,32981,1350185,419332,930853,,2440502,1850.19,925.1,0.001,1367,148.68,52859.59,0.62,0.7955
3633,Fisher-Meyers,False,KE,Lake Deborahbury,Energy,2018,https://fisher-meyers.com,Letter heart ask fight teach your both tonight miss matter.,17,fisher-meyers,2023,USD,2425365,556560,1868805,2024607,-155802,8129,-163931,24253,48507,-212438,99027,1354809,251566,1103243,,2425365,2223.18,1111.59,0.0241,10105,20.0,165843.29,0.6,0.7705
3634,Carr-Harper,False,CA,New Earlfurt,Marketplaces,2018,https://carr-harper.com,Provide from live do pressure institution nature everything.,16,carr-harper,2023,USD,3438250,1078847,2359403,1599618,759785,0,759785,34382,68765,691020,81833,1922434,459920,1462514,,3438250,185.51,904.5,0.0134,2366,121.05,144097.87,0.57,0.6862
3635,Robinson Group,False,CA,Andrewtown,EdTech,2019,https://robinsongroup.com,Note around bring blue today.,26,robinson-group,2023,USD,545719,100169,445550,107482,338068,0,338068,5457,10914,327154,21449,345598,98549,247049,45476.58,545719,158.87,557.14,0.0355,9095,5.0,1000.0,21.45,0.8164
3636,Peters and Sons,False,BR,Marybury,Energy,2020,https://petersandsons.com,His significant whole notice safe bag.,19,peters-and-sons,2023,USD,1683891,859167,824724,1189396,-364672,0,-364672,16838,33677,-398349,18305,1033567,289768,743799,,1683891,233.16,224.13,0.1041,7016,20.0,70359.25,0.26,0.4898
3637,Franklin Douglas and Martinez,False,KE,Masonmouth,SaaS,2019,https://franklindouglasandmartinez.com,Assume late both expect draw often total American.,26,franklin-douglas-and-martinez,2023,USD,633422,133197,500225,31671,468554,8112,460442,6334,12668,447774,18384,406915,237695,169220,52785.17,633422,76.08,240.07,0.0334,632,83.46,15756.52,1.17,0.7897
3638,Villanueva Nelson and Morrison,False,CA,Amandaborough,Fintech,2008,https://villanuevanelsonandmorrison.com,Window exist evening modern part.,22,villanueva-nelson-and-morrison,2023,USD,1534693,317378,1217315,816913,400402,5495,394907,15346,30693,364214,960652,1876770,131969,1744801,,1534693,900.38,1707.75,0.0383,1184,107.97,70949.93,13.54,0.7932
3639,Johnson Inc,False,EG,Willisfurt,Cybersecurity,2020,https://johnsoninc.com,Must owner reduce could will time beat like where collection son.,20,johnson-inc,2023,USD,1481540,537657,943883,1167312,-223429,19378,-242807,14815,29630,-272437,49075,823966,273596,550370,,1481540,20.0,156.57,0.0182,712,173.35,108153.17,0.45,0.6371
3640,Smith-Sexton,False,ZA,Lake Brandon,HealthTech,2008,https://smith-sexton.com,Able nor off agree watch everything middle art.,24,smith-sexton,2023,USD,1842136,1085802,756334,317947,438387,7322,431065,18421,36842,394223,230125,1161055,58052,1103003,153511.33,1842136,374.15,1735.14,0.0073,1613,95.14,48939.89,4.7,0.4106
3641,Rodriguez-Johnston,False,KE,Hansonstad,Fintech,2024,https://rodriguez-johnston.com,Adult source for class stuff.,20,rodriguez-johnston,2023,USD,918688,363741,554947,473758,81189,0,81189,9186,18373,62816,9433,486147,193679,292468,,918688,20.0,65.04,0.1043,436,175.45,64416.83,0.15,0.6041
3642,Reyes Lewis and Porter,False,IN,Michaelstad,Cybersecurity,2015,https://reyeslewisandporter.com,Cultural could modern test room history response eight north early.,26,reyes-lewis-and-porter,2023,USD,3082997,830169,2252828,2038645,214183,0,214183,30829,61659,152524,304545,1893611,94680,1798931,,3082997,354.65,1649.9,0.0733,2593,99.07,198016.35,1.54,0.7307
3643,Moses-Rodriguez,False,CA,Port Vicki,Mobility,2023,https://moses-rodriguez.com,Nature rule account physical something scientist their year relate public.,14,moses-rodriguez,2023,USD,665849,313071,352778,436087,-83309,19731,-103040,6658,13316,-116356,76962,607299,250684,356615,,665849,79.35,235.77,0.0023,2774,20.0,43616.23,1.76,0.5298
3644,Brown PLC,False,NG,Williamsborough,Energy,2014,https://brownplc.com,Make simply building school.,19,brown-plc,2023,USD,1025790,358299,667491,320168,347323,24438,322885,10257,20515,302370,88540,791298,236028,555270,,1025790,20.0,90.59,0.0256,1042,82.01,46711.84,1.9,0.6507
3645,Wright Ltd,False,US,West Matthew,Marketplaces,2018,https://wrightltd.com,Name be scientist strong practice close key industry third surface.,21,wright-ltd,2023,USD,526599,270184,256415,400358,-143943,51584,-195527,5265,10531,-206058,68343,510241,99441,410800,,526599,702.96,3054.98,0.001,328,133.58,45633.84,1.5,0.4869
3646,Johnson Bright and Heath,False,US,Davidfurt,Marketplaces,2019,https://johnsonbrightandheath.com,Itself record will article thank wall source generation kitchen.,16,johnson-bright-and-heath,2023,USD,702298,238899,463399,459381,4018,26736,-22718,7022,14045,-36763,30952,511065,303929,207136,,702298,735.75,2350.55,0.0295,694,84.27,56514.62,0.55,0.6598
3647,Stewart-Davis,False,US,Jonathanstad,Cybersecurity,2018,https://stewart-davis.com,Feeling world nothing within good organization as off top adult.,33,stewart-davis,2023,USD,117124,52517,64607,47712,16895,20098,-3203,1171,2342,-5545,51808,260571,134108,126463,,117124,2437.61,3747.07,0.0581,60,160.47,1000.0,51.81,0.5516
3648,Downs Ltd,False,BR,Anthonyshire,Mobility,2015,https://downsltd.com,Friend us feel task.,19,downs-ltd,2023,USD,2244529,518993,1725536,1505043,220493,1416,219077,22445,44890,174187,59485,1266490,508457,758033,,2244529,20.0,10.0,0.0142,1158,161.46,130293.65,0.46,0.7688
3649,Jackson-Paul,False,KE,Duaneville,Mobility,2020,https://jackson-paul.com,Glass necessary stay lead simply speech describe old those.,16,jackson-paul,2023,USD,857709,288511,569198,208039,361159,51033,310126,8577,17154,292972,4943,577671,345525,232146,,857709,1133.31,566.66,0.0489,284,251.45,1000.0,4.94,0.6636
3650,Williams Lester and Myers,False,ZA,Tuckerberg,IoT,2010,https://williamslesterandmyers.com,Popular consider whose drive study short lose.,11,williams-lester-and-myers,2023,USD,464118,114621,349497,100079,249418,8075,241343,4641,9282,232061,44675,465882,165669,300213,,464118,2059.18,10293.57,0.0836,172,223.73,29996.46,1.49,0.753
3651,Snyder Sullivan and Barrera,False,CA,North Whitneyview,Energy,2023,https://snydersullivanandbarrera.com,Serious somebody join doctor difference amount something instead.,15,snyder-sullivan-and-barrera,2023,USD,1551797,606880,944917,1159337,-214420,3872,-218292,15517,31035,-249327,57550,995414,412723,582691,,1551797,1896.33,5183.55,0.2,471,273.98,122597.32,0.47,0.6089
3652,Williams Garcia and Taylor,False,BR,South David,Cybersecurity,2011,https://williamsgarciaandtaylor.com,Indeed deal traditional position group tough ability leave pick.,18,williams-garcia-and-taylor,2023,USD,436773,180297,256476,318765,-62289,22344,-84633,4367,8735,-93368,11592,303751,66226,237525,,436773,989.34,3952.54,0.001,1819,20.0,1000.0,11.59,0.5872
3653,Thompson-Butler,False,ZA,Williamborough,Energy,2017,https://thompson-butler.com,Society its couple pretty employee carry.,24,thompson-butler,2023,USD,4878688,1282548,3596140,1729106,1867034,15495,1851539,48786,97573,1753966,442622,2999077,1199849,1799228,,4878688,1822.85,10840.5,0.0556,4210,96.56,156919.31,2.82,0.7371
3654,Knapp-Khan,False,KE,Lake Vanessaside,EdTech,2012,https://knapp-khan.com,Degree position summer poor trade appear.,19,knapp-khan,2023,USD,1057420,498467,558953,125085,433868,17926,415942,10574,21148,394794,91823,763942,74662,689280,88118.33,1057420,66.02,226.73,0.001,3100,28.42,1000.0,91.82,0.5286
3655,Atkins-Sutton,False,NG,West Mariafurt,IoT,2024,https://atkins-sutton.com,Safe admit law name side responsibility head discussion set.,24,atkins-sutton,2023,USD,854103,310688,543415,571396,-27981,33481,-61462,8541,17082,-78544,21707,635526,320338,315188,,854103,389.22,1104.42,0.0748,466,152.64,6161.45,3.52,0.6362
3656,Powell-Terry,False,US,West Melissa,HealthTech,2023,https://powell-terry.com,Week voice new leave cover blood.,24,powell-terry,2023,USD,310269,121667,188602,88545,100057,11198,88859,3102,6205,82654,10376,227478,75692,151786,25855.75,310269,10.0,20.58,0.0245,575,44.9,1000.0,10.38,0.6079
3657,Green Peck and Allison,False,AU,South Keith,Fintech,2017,https://greenpeckandallison.com,Book change region various increase hair.,26,green-peck-and-allison,2023,USD,1189901,578723,611178,847246,-236068,15666,-251734,11899,23798,-275532,72061,832737,277709,555028,,1189901,550.76,317.05,0.001,4957,20.0,68250.88,1.06,0.5136
3658,Owens Brown and Cruz,False,BR,Lake Brandon,AI/ML,2022,https://owensbrownandcruz.com,Claim its word require message letter.,20,owens-brown-and-cruz,2023,USD,1907775,634482,1273293,1154805,118488,0,118488,19077,38155,80333,218681,1337132,375358,961774,,1907775,20.0,94.99,0.1275,937,169.59,98740.74,2.21,0.6674
3659,Hunt Inc,False,GB,Matthewview,Mobility,2011,https://huntinc.com,Today way send beyond billion.,18,hunt-inc,2023,USD,5021497,2105749,2915748,2014661,901087,26883,874204,50214,100429,773775,185568,2756010,1458754,1297256,,5021497,20.0,28.39,0.0338,2169,192.92,185078.17,1.0,0.5807
3660,Lee Clay and Lee,False,EG,Port Denisefort,Marketplaces,2015,https://leeclayandlee.com,Require or fight year remember picture third time say up.,15,lee-clay-and-lee,2023,USD,872236,342001,530235,540930,-10695,1141,-11836,8722,17444,-29280,110719,693549,205434,488115,,872236,65.62,140.18,0.0957,603,120.38,49471.77,2.24,0.6079
3661,Bennett Cooper and Jenkins,False,DE,North Toddberg,EdTech,2013,https://bennettcooperandjenkins.com,Direction window ready look environmental.,23,bennett-cooper-and-jenkins,2023,EUR,587868,268526,319342,292696,26646,6578,20068,5878,11757,8311,25726,456137,207535,248602,48989.0,587868,358.75,2257.61,0.0622,9797,5.0,6391.95,4.02,0.5432
3662,Petty Wallace and James,False,AU,East Virginia,Marketplaces,2010,https://pettywallaceandjames.com,Various continue within can whose.,27,petty-wallace-and-james,2023,USD,229195,50570,178625,120429,58196,0,58196,2291,4583,53613,33105,239760,58657,181103,,229195,971.14,4153.14,0.001,700,27.28,1000.0,33.1,0.7794
3663,Davis-Esparza,False,FR,Jeremyborough,Energy,2008,https://davis-esparza.com,Save system really trouble specific performance.,23,davis-esparza,2023,EUR,1156145,356736,799409,661218,138191,0,138191,11561,23122,115069,69468,744496,204258,540238,,1156145,496.33,1268.5,0.1583,509,188.94,85825.54,0.81,0.6914
3664,Sims-Moore,False,GB,North Caseyberg,E-commerce,2020,https://sims-moore.com,Class sell across soldier past race defense area speech investment either.,20,sims-moore,2023,USD,252956,122973,129983,239186,-109203,21200,-130403,2529,5059,-135462,123824,275033,74323,200710,,252956,451.69,1674.89,0.001,80,261.28,9996.3,12.39,0.5139
3665,Walters Ltd,False,AU,Lake Kendrafort,AgriTech,2015,https://waltersltd.com,Avoid back partner boy what she hot.,19,walters-ltd,2023,USD,270233,59497,210736,181202,29534,0,29534,2702,5404,24130,17089,277165,172941,104224,,270233,20.0,80.21,0.001,322,69.75,16775.45,1.02,0.7798
3666,Hoover and Sons,False,ZA,West Brendafurt,AgriTech,2023,https://hooverandsons.com,Movement hundred get again nature others decision rate consider.,21,hoover-and-sons,2023,USD,169602,59351,110251,29424,80827,0,80827,1696,3392,77435,16418,274834,90319,184515,,169602,284.54,522.01,0.03,126,112.11,1000.0,16.42,0.6501
3667,Barton-Maxwell,False,BR,Port Ashley,Fintech,2012,https://barton-maxwell.com,Scene account future Democrat film more.,23,barton-maxwell,2023,USD,2262033,704397,1557636,743689,813947,7593,806354,22620,45240,761114,60896,1244967,809902,435065,,2262033,20.0,38.92,0.1008,9425,20.0,88101.5,0.69,0.6886
3668,Camacho Johnson and Mejia,False,NG,Georgechester,Marketplaces,2023,https://camachojohnsonandmejia.com,Leg some fire degree good other clearly note.,21,camacho-johnson-and-mejia,2023,USD,1342760,597261,745499,859363,-113864,0,-113864,13427,26855,-140719,16641,827200,348683,478517,,1342760,20.0,47.39,0.0564,1484,75.37,53248.86,0.31,0.5552
3669,Henderson-Farmer,False,FR,Port Diana,Cybersecurity,2018,https://henderson-farmer.com,Garden door law old quite that assume.,17,henderson-farmer,2023,EUR,1477602,257254,1220348,73880,1146468,32450,1114018,14776,29552,1084466,26821,897025,279152,617873,,1477602,1401.36,4689.22,0.0833,6156,20.0,1000.0,26.82,0.8259
3670,Sullivan Ltd,False,DE,Erikamouth,IoT,2010,https://sullivanltd.com,Quite building citizen clear poor entire even of face law.,21,sullivan-ltd,2023,EUR,207887,40595,167292,68467,98825,0,98825,2078,4157,94668,41198,225995,174589,51406,,207887,20.0,115.01,0.001,80,214.0,8424.33,4.89,0.8047
3671,Hogan Herrera and Fox,False,BR,Osborneport,E-commerce,2020,https://hoganherreraandfox.com,Wife ball energy brother happy cell sea.,15,hogan-herrera-and-fox,2023,USD,1108813,469652,639161,716948,-77787,3370,-81157,11088,22176,-103333,44936,781143,406839,374304,,1108813,340.07,564.02,0.0934,379,243.35,61218.34,0.73,0.5764
3672,Scott Group,False,ZA,South Calebborough,Cybersecurity,2020,https://scottgroup.com,Be doctor movement key size production boy she deep over.,12,scott-group,2023,USD,315016,139424,175592,15750,159842,2671,157171,3150,6300,150871,48093,356251,54144,302107,,315016,20.0,52.6,0.0684,74,354.72,1000.0,48.09,0.5574
3673,Baker-Singh,False,BR,West Jennifer,Marketplaces,2021,https://baker-singh.com,Structure kid stuff action including.,12,baker-singh,2023,USD,9219097,2789702,6429395,2216013,4213382,0,4213382,92190,184381,4029001,661859,5414747,2210142,3204605,,9219097,20.0,31.35,0.001,2514,305.52,188525.8,3.51,0.6974
3674,Alexander-Valencia,False,AU,North Sherry,EdTech,2015,https://alexander-valencia.com,No drop particularly right effort nice claim research gas.,18,alexander-valencia,2023,USD,252906,57384,195522,164726,30796,0,30796,2529,5058,25738,52676,222395,109574,112821,21075.5,252906,10.0,14.59,0.0498,349,60.25,30306.01,1.74,0.7731
3675,Hart PLC,False,IN,Port Donnashire,Fintech,2017,https://hartplc.com,Near citizen various north base subject.,19,hart-plc,2023,USD,1105283,494462,610821,500620,110201,0,110201,11052,22105,88096,23879,593910,293197,300713,,1105283,1771.72,6799.41,0.001,1674,55.01,17744.11,1.35,0.5526
3676,Ware Ltd,False,FR,Alexanderbury,Fintech,2010,https://wareltd.com,Matter mother vote fund guy hospital budget behind beautiful increase leave.,29,ware-ltd,2023,EUR,2744300,1075079,1669221,1190435,478786,52720,426066,27443,54886,371180,88378,1534797,348020,1186777,,2744300,20.0,71.66,0.0438,1068,214.13,102438.62,0.86,0.6083
3677,Cook Hammond and Walters,False,CA,North Terrance,Cybersecurity,2014,https://cookhammondandwalters.com,Unit push then concern discover measure but too.,15,cook-hammond-and-walters,2023,USD,1461842,520890,940952,404894,536058,11867,524191,14618,29236,494955,46024,860143,568630,291513,,1461842,1132.18,860.8,0.0739,2022,60.22,46400.41,0.99,0.6437
3678,Wiggins-Ortiz,False,ZA,Christopherview,Fintech,2019,https://wiggins-ortiz.com,Owner gas practice attorney employee see each energy food four.,24,wiggins-ortiz,2023,USD,1396902,638041,758861,1337951,-579090,24064,-603154,13969,27938,-631092,44579,831932,337091,494841,,1396902,490.25,790.04,0.0251,671,173.38,129966.13,0.34,0.5432
3679,Davis Ltd,False,GB,East Charles,E-commerce,2020,https://davisltd.com,Wind son positive me nice daughter campaign approach group parent argue.,19,davis-ltd,2023,USD,919118,276443,642675,64746,577929,23699,554230,9191,18382,535848,147204,772705,117880,654825,,919118,1451.2,725.6,0.0171,752,101.85,1000.0,147.2,0.6992
3680,Meyer Marquez and Johnson,False,KE,Lake Sandra,Cybersecurity,2008,https://meyermarquezandjohnson.com,Republican close west final attorney matter.,22,meyer-marquez-and-johnson,2023,USD,556399,225028,331371,238568,92803,36786,56017,5563,11127,44890,18391,488740,201233,287507,,556399,20.0,54.42,0.051,408,113.63,44526.15,0.41,0.5956
3681,Sexton-Vargas,False,IN,Port Laurenfurt,SaaS,2014,https://sexton-vargas.com,Cut natural need her impact face raise adult according war.,28,sexton-vargas,2023,USD,5848851,1232862,4615989,2064487,2551502,0,2551502,58488,116977,2434525,1457951,4417902,3026124,1391778,487404.25,5848851,286.82,724.86,0.0052,15591,31.26,149403.0,9.76,0.7892
3682,Castillo Walker and Vazquez,False,TN,Bettychester,Energy,2018,https://castillowalkerandvazquez.com,Half stop glass adult boy before.,16,castillo-walker-and-vazquez,2023,USD,6891940,3271111,3620829,4261492,-640663,12516,-653179,68919,137838,-791017,178401,3650382,269230,3381152,,6891940,2148.69,10817.15,0.0718,3269,175.66,343809.07,0.52,0.5254
3683,Cook-Lopez,False,AU,East Matthewview,E-commerce,2012,https://cook-lopez.com,It election involve development article little.,29,cook-lopez,2023,USD,2467239,1366792,1100447,732783,367664,0,367664,24672,49344,318320,199687,1463406,470767,992639,,2467239,329.72,1953.0,0.0265,1393,147.58,27142.74,7.36,0.446
3684,Sexton-Evans,False,NG,East Crystalview,Marketplaces,2015,https://sexton-evans.com,Compare build people employee soon weight senior management affect technology.,22,sexton-evans,2023,USD,347175,124348,222827,248328,-25501,8337,-33838,3471,6943,-40781,13898,193754,59298,134456,,347175,20.0,92.41,0.0889,1446,20.0,61714.69,0.23,0.6418
3685,Flores-Perez,False,FR,South Lisaside,Energy,2008,https://flores-perez.com,These goal a hold under expect happen good.,18,flores-perez,2023,EUR,1342789,499777,843012,94346,748666,2214,746452,13427,26855,719597,35279,847561,276505,571056,,1342789,694.38,2889.71,0.0534,1053,106.26,39764.4,0.89,0.6278
3686,Velasquez Acosta and Brown,False,NG,East Tricia,Mobility,2018,https://velasquezacostaandbrown.com,Example official current weight change rock mother whose room.,25,velasquez-acosta-and-brown,2023,USD,282047,120004,162043,87421,74622,19558,55064,2820,5640,49424,8686,291361,149937,141424,,282047,1022.02,2024.32,0.0792,1175,20.0,17709.57,0.49,0.5745
3687,Russell Price and Lane,False,GB,North Anthonymouth,AgriTech,2015,https://russellpriceandlane.com,Morning expect find crime finish produce.,11,russell-price-and-lane,2023,USD,429558,107256,322302,306121,16181,0,16181,4295,8591,7590,21971,270803,54388,216415,,429558,376.33,1425.89,0.0158,143,248.77,59605.39,0.37,0.7503
3688,Forbes Garcia and Scott,False,EG,South Mariabury,Marketplaces,2022,https://forbesgarciaandscott.com,Adult point market end cause ahead themselves probably standard.,22,forbes-garcia-and-scott,2023,USD,728230,269046,459184,534619,-75435,0,-75435,7282,14564,-89999,24481,576496,287475,289021,,728230,1654.7,6258.82,0.052,776,78.18,39322.66,0.62,0.6305
3689,Brown-Santos,False,GB,Lindatown,IoT,2017,https://brown-santos.com,Now yet own kitchen safe mention bar use meet.,23,brown-santos,2023,USD,286641,36131,250510,60143,190367,8059,182308,2866,5732,176576,4224,184579,34882,149697,,286641,20.0,10.98,0.0443,1194,20.0,1000.0,4.22,0.874
3690,Garcia Bailey and Harper,False,GB,Michelleburgh,Cybersecurity,2009,https://garciabaileyandharper.com,News language executive analysis bit film whose.,25,garcia-bailey-and-harper,2023,USD,1185909,496418,689491,883631,-194140,6192,-200332,11859,23718,-224050,150672,843101,514084,329017,,1185909,868.37,1071.59,0.0925,878,112.44,110605.6,1.36,0.5814
3691,Smith-Hunt,False,KE,Freemanshire,E-commerce,2017,https://smith-hunt.com,Suggest back recently hundred open civil option various.,13,smith-hunt,2023,USD,958406,246120,712286,179617,532669,0,532669,9584,19168,513501,13420,614755,124105,490650,,958406,20.0,69.76,0.1556,3993,20.0,1000.0,13.42,0.7432
3692,Bryant PLC,False,NG,Lake Bryanside,Cybersecurity,2011,https://bryantplc.com,Example add recognize suggest ready discover sit reality us finally.,22,bryant-plc,2023,USD,1037247,439585,597662,280206,317456,4491,312965,10372,20744,292221,53422,637825,280651,357174,,1037247,1304.96,984.83,0.1251,4321,20.0,37844.95,1.41,0.5762
3693,Carlson Torres and Mckee,False,IN,Port Stephanie,Cybersecurity,2023,https://carlsontorresandmckee.com,Few level war herself start lead bill from single.,26,carlson-torres-and-mckee,2023,USD,213690,54586,159104,69650,89454,12087,77367,2136,4273,73094,10281,123600,35789,87811,,213690,20.0,99.89,0.0027,188,94.7,11399.46,0.9,0.7446
3694,Lowery-Moss,False,BR,Peterschester,EdTech,2023,https://lowery-moss.com,Range big fast however president relationship.,30,lowery-moss,2023,USD,186266,58736,127530,9313,118217,0,118217,1862,3725,114492,1155,278471,98024,180447,15522.17,186266,368.37,1974.35,0.0258,342,45.27,5867.96,0.2,0.6847
3695,Bernard PLC,False,IN,Brianastad,Cybersecurity,2020,https://bernardplc.com,Financial town brother mission feeling natural.,28,bernard-plc,2023,USD,193529,99097,94432,94482,-50,0,-50,1935,3870,-3920,1073,188710,62938,125772,,193529,911.8,3846.58,0.0655,90,179.18,1000.0,1.07,0.4879
3696,Russell-Wright,False,US,East Mark,E-commerce,2012,https://russell-wright.com,But bank close under.,20,russell-wright,2023,USD,10763109,7638832,3124277,7217681,-4093404,0,-4093404,107631,215262,-4308666,1819841,7214124,5186572,2027552,,10763109,1386.83,2255.43,0.1053,6085,147.38,612952.13,2.97,0.2903
3697,Mills Steele and Glover,False,ZA,West Chaseland,EdTech,2015,https://millssteeleandglover.com,Score animal bank law figure.,20,mills-steele-and-glover,2023,USD,68919,22033,46886,17623,29263,13308,15955,689,1378,14577,6927,54811,32782,22029,5743.25,68919,10.0,56.56,0.0357,70,81.54,12075.96,0.57,0.6803
3698,Graves-Davis,False,ZA,Glendashire,Cybersecurity,2009,https://graves-davis.com,Benefit onto specific though country may control attack election.,25,graves-davis,2023,USD,1919750,665355,1254395,704073,550322,27699,522623,19197,38395,484228,173708,1139391,401591,737800,,1919750,306.57,911.04,0.1417,727,219.76,30998.26,5.6,0.6534
3699,Ryan Baker and Chan,False,AU,New Tanyafort,HealthTech,2023,https://ryanbakerandchan.com,Once leave popular guy especially.,22,ryan-baker-and-chan,2023,USD,720888,138238,582650,213976,368674,0,368674,7208,14417,354257,161352,523092,26154,496938,60074.0,720888,10.0,22.19,0.001,953,63.01,47095.56,3.43,0.8082
3700,Ortiz LLC,False,ZA,West Joshua,Energy,2017,https://ortizllc.com,Quickly art common person blue five society.,14,ortiz-llc,2023,USD,1348923,290842,1058081,781719,276362,41705,234657,13489,26978,207679,36366,852875,125017,727858,,1348923,20.0,67.61,0.0152,373,301.01,40456.07,0.9,0.7844
3701,Ross-Graham,False,BR,Port Aaron,HealthTech,2008,https://ross-graham.com,Occur chance situation similar red result.,23,ross-graham,2023,USD,399358,89220,310138,120912,189226,0,189226,3993,7987,181239,29896,356833,17841,338992,33279.83,399358,330.5,330.5,0.0679,3735,8.91,1000.0,29.9,0.7766
3702,Wong Bray and Hicks,False,NG,Mcmahonbury,Energy,2018,https://wongbrayandhicks.com,Still few run go old watch.,19,wong-bray-and-hicks,2023,USD,4030437,1667680,2362757,850443,1512314,5356,1506958,40304,80608,1426350,349934,2545238,1613169,932069,,4030437,1155.45,2357.98,0.0752,2300,146.0,63898.54,5.48,0.5862
3703,Dunn PLC,False,TN,Lake Jameshaven,Marketplaces,2023,https://dunnplc.com,Hope tax maybe what news everything value child.,16,dunn-plc,2023,USD,201200,43724,157476,89929,67547,0,67547,2012,4024,63523,15947,116813,55207,61606,,201200,1003.04,1366.39,0.0294,838,20.0,21869.1,0.73,0.7827
3704,Gonzalez Schwartz and Hopkins,False,CA,Christineport,Energy,2020,https://gonzalezschwartzandhopkins.com,Range question fall window outside.,25,gonzalez-schwartz-and-hopkins,2023,USD,1693664,744246,949418,84683,864735,37231,827504,16936,33873,793631,61830,971916,192503,779413,,1693664,359.72,1026.08,0.0257,682,206.79,9150.61,6.76,0.5606
3705,Mitchell-Nguyen,False,FR,Jimmyfort,AI/ML,2017,https://mitchell-nguyen.com,Coach thus adult service again music son can raise chair.,18,mitchell-nguyen,2023,EUR,921196,307205,613991,494410,119581,0,119581,9211,18423,101158,76856,569592,202616,366976,,921196,1271.36,7769.18,0.0885,619,123.9,33875.24,2.27,0.6665
3706,Smith Fleming and Jackson,False,IN,Herrerachester,Cybersecurity,2014,https://smithflemingandjackson.com,Room need personal instead place dark participant chance weight.,24,smith-fleming-and-jackson,2023,USD,747836,373633,374203,103121,271082,23035,248047,7478,14956,233091,156658,579399,263218,316181,,747836,1092.67,6351.22,0.0367,409,152.0,13045.28,12.01,0.5004
3707,Anderson PLC,False,ZA,South Cindyborough,AI/ML,2020,https://andersonplc.com,Standard standard similar toward response change coach century.,20,anderson-plc,2023,USD,996196,530996,465200,581799,-116599,16114,-132713,9961,19923,-152636,36819,570195,28509,541686,,996196,629.64,4360.82,0.0047,885,93.72,55326.43,0.67,0.467
3708,Green-Adams,False,FR,Atkinsonhaven,HealthTech,2018,https://green-adams.com,News various property effect myself possible.,23,green-adams,2023,EUR,2143432,813649,1329783,235223,1094560,23055,1071505,21434,42868,1028637,149815,1390324,1130560,259764,178619.33,2143432,90.48,228.24,0.0166,6298,28.36,47242.7,3.17,0.6204
3709,Weaver-Caldwell,False,AU,East Gina,IoT,2009,https://weaver-caldwell.com,Camera maybe road interesting tax house.,22,weaver-caldwell,2023,USD,1472934,727466,745468,1198386,-452918,14411,-467329,14729,29458,-496787,106934,927229,219139,708090,,1472934,390.39,462.89,0.0812,614,199.82,50459.23,2.12,0.5061
3710,Silva Wallace and Williams,False,ZA,Port Williamborough,AgriTech,2022,https://silvawallaceandwilliams.com,View trade dream dinner view realize.,19,silva-wallace-and-williams,2023,USD,900231,272510,627721,143215,484506,0,484506,9002,18004,466502,49885,636662,199102,437560,,900231,20.0,46.05,0.0622,3750,20.0,16557.34,3.01,0.6973
3711,Landry Foley and Miller,False,BR,Melvinstad,HealthTech,2012,https://landryfoleyandmiller.com,Either capital long research their wrong traditional.,13,landry-foley-and-miller,2023,USD,1383710,548805,834905,682248,152657,0,152657,13837,27674,124983,262401,1101752,96790,1004962,115309.17,1383710,10.0,48.01,0.0407,1206,95.56,68629.74,3.82,0.6034
3712,Walsh Ritter and Pham,False,EG,Frederickburgh,Cybersecurity,2023,https://walshritterandpham.com,Party team customer despite education teacher half appear.,21,walsh-ritter-and-pham,2023,USD,1101477,468138,633339,582106,51233,5275,45958,11014,22029,23929,14807,746149,359104,387045,,1101477,20.0,47.47,0.001,560,163.73,15120.35,0.98,0.575
3713,Logan Group,False,IN,Melanieberg,HealthTech,2014,https://logangroup.com,Seem thousand wrong hundred above.,28,logan-group,2023,USD,1927750,318363,1609387,316248,1293139,34258,1258881,19277,38555,1220326,45138,1105623,70766,1034857,160645.83,1927750,370.33,1567.65,0.001,1537,104.48,34027.19,1.33,0.8349
3714,Casey Wright and Fowler,False,DE,Freemanchester,Cybersecurity,2014,https://caseywrightandfowler.com,Lot guy meet ok kid main behavior safe.,20,casey-wright-and-fowler,2023,EUR,1016922,348312,668610,459134,209476,19899,189577,10169,20338,169239,41158,553990,227978,326012,,1016922,513.99,1997.42,0.0841,404,209.72,30155.91,1.36,0.6575
3715,Stewart Pittman and Perez,False,ZA,Wendyhaven,Marketplaces,2008,https://stewartpittmanandperez.com,Material wife whom continue move us.,21,stewart-pittman-and-perez,2023,USD,1017225,401394,615831,527073,88758,20681,68077,10172,20344,47733,458516,1100335,427854,672481,,1017225,347.57,1967.46,0.0381,855,99.06,32411.21,14.15,0.6054
3716,Vargas Yu and Harrington,False,CA,West Samuelport,Cybersecurity,2011,https://vargasyuandharrington.com,Here bit partner leg scene modern check put analysis.,12,vargas-yu-and-harrington,2023,USD,528251,130069,398182,120181,278001,0,278001,5282,10565,267436,12341,404627,147453,257174,,528251,1221.36,610.68,0.0263,260,169.23,24498.41,0.5,0.7538
3717,Chen Moore and Weaver,False,BR,Ericview,HealthTech,2020,https://chenmooreandweaver.com,Senior foreign break last early wind.,19,chen-moore-and-weaver,2023,USD,1583468,537186,1046282,738203,308079,0,308079,15834,31669,276410,46235,972375,397807,574568,131955.67,1583468,128.74,652.48,0.001,7007,18.83,40828.62,1.13,0.6608
3718,Brown Group,False,TN,North Danielmouth,Marketplaces,2013,https://browngroup.com,Four hot least family easy born three law.,18,brown-group,2023,USD,772407,225440,546967,90592,456375,0,456375,7724,15448,440927,31795,530419,76718,453701,,772407,114.04,248.92,0.001,225,285.56,1000.0,31.8,0.7081
3719,Delacruz-Green,False,US,Port Jennaville,Fintech,2019,https://delacruz-green.com,Major man to school middle dog special with.,16,delacruz-green,2023,USD,400382,194590,205792,262878,-57086,0,-57086,4003,8007,-65093,46980,377524,41301,336223,,400382,645.15,1630.06,0.0133,1615,20.65,18161.52,2.59,0.514
3720,Allison Robinson and Rhodes,False,EG,North Annbury,HealthTech,2009,https://allisonrobinsonandrhodes.com,Building mouth south build floor fine range.,17,allison-robinson-and-rhodes,2023,USD,3142918,726398,2416520,654808,1761712,0,1761712,31429,62858,1698854,41564,1631162,437409,1193753,261909.83,3142918,10.0,71.85,0.001,20753,12.62,64724.52,0.64,0.7689
3721,Jensen and Sons,False,FR,Port Maryhaven,AI/ML,2018,https://jensenandsons.com,Couple hard day step.,22,jensen-and-sons,2023,EUR,703892,215615,488277,592942,-104665,22536,-127201,7038,14077,-141278,61259,587030,300067,286963,,703892,345.09,487.57,0.0211,519,112.89,22161.23,2.76,0.6937
3722,Alexander and Sons,False,KE,East Sarahshire,Energy,2012,https://alexanderandsons.com,Somebody ahead simple nearly method teach training nation.,28,alexander-and-sons,2023,USD,5235956,3514640,1721316,5270401,-3549085,27175,-3576260,52359,104719,-3680979,179597,2995014,1419736,1575278,,5235956,2031.04,7814.97,0.0788,9844,44.32,460279.3,0.39,0.3287
3723,Weaver Miles and Cunningham,False,BR,Perezburgh,Cybersecurity,2020,https://weavermilesandcunningham.com,Card street modern perform century miss think red offer much.,26,weaver-miles-and-cunningham,2023,USD,1402568,570227,832341,428875,403466,0,403466,14025,28051,375415,69901,797953,104425,693528,,1402568,1319.62,659.81,0.0229,519,224.79,49695.37,1.41,0.5934
3724,Sawyer Inc,False,DE,South Gregoryview,SaaS,2011,https://sawyerinc.com,Store no treat traditional shoulder myself surface often tree.,21,sawyer-inc,2023,EUR,909538,289121,620417,368665,251752,3864,247888,9095,18190,229698,19516,523789,26189,497600,75794.83,909538,268.27,936.63,0.0793,1296,58.48,53485.02,0.36,0.6821
3725,Gardner-Castillo,False,DE,Banksside,Energy,2023,https://gardner-castillo.com,Suggest standard evening ever ask nation bank black.,26,gardner-castillo,2023,EUR,4849451,1315813,3533638,935738,2597900,0,2597900,48494,96989,2500911,668661,3100528,875291,2225237,,4849451,20.0,43.92,0.0907,20206,20.0,104741.92,6.38,0.7287
3726,Caldwell-Alexander,False,IN,West Matthew,Cybersecurity,2013,https://caldwell-alexander.com,Direction say yeah section moment career me compare difference.,16,caldwell-alexander,2023,USD,639501,224353,415148,31975,383173,0,383173,6395,12790,370383,44026,378812,98934,279878,,639501,861.28,430.64,0.016,2664,20.0,33550.2,1.31,0.6492
3727,Martin Ltd,False,BR,Penningtonburgh,Cybersecurity,2020,https://martinltd.com,Reality story citizen reach successful collection sing role value.,25,martin-ltd,2023,USD,1952901,420302,1532599,1415033,117566,49675,67891,19529,39058,28833,65367,1179957,174582,1005375,,1952901,1331.94,8226.0,0.001,618,263.04,121933.87,0.54,0.7848
3728,Thomas Jones and Martinez,False,AU,Jeffreyland,Cybersecurity,2010,https://thomasjonesandmartinez.com,Himself tell my individual keep half old car.,23,thomas-jones-and-martinez,2023,USD,1193110,371566,821544,585218,236326,73037,163289,11931,23862,139427,81917,701784,497293,204491,,1193110,20.0,35.88,0.0711,474,209.57,60675.69,1.35,0.6886
3729,Owens-Valdez,False,AU,Richardstad,Mobility,2020,https://owens-valdez.com,Reflect feeling hour room point key.,22,owens-valdez,2023,USD,949595,462122,487473,347152,140321,48788,91533,9495,18991,72542,68289,543958,27197,516761,,949595,1633.22,3922.63,0.0632,567,139.37,5532.72,12.34,0.5133
3730,Austin PLC,False,IN,West Hannah,Marketplaces,2022,https://austinplc.com,West sit other majority interview face with small pass north.,17,austin-plc,2023,USD,570068,209686,360382,144893,215489,0,215489,5700,11401,204088,36401,386714,141124,245590,,570068,1627.39,813.7,0.1115,260,182.36,10886.34,3.34,0.6322
3731,Castillo-Lee,False,CA,West Johntown,SaaS,2011,https://castillo-lee.com,Travel be actually allow sure likely door theory yeah million.,25,castillo-lee,2023,USD,614651,254694,359957,170317,189640,851,188789,6146,12293,176496,134393,629864,273991,355873,51220.92,614651,261.94,261.94,0.1132,439,116.49,45804.83,2.93,0.5856
3732,Oconnor and Sons,False,FR,Fowlerland,Fintech,2011,https://oconnorandsons.com,Music quickly answer treatment control argue middle person discuss purpose.,16,oconnor-and-sons,2023,EUR,978044,380360,597684,797280,-199596,15090,-214686,9780,19560,-234246,72745,565614,279476,286138,,978044,815.2,1835.68,0.1441,283,287.99,92561.75,0.79,0.6111
3733,Wells LLC,False,EG,Morganview,Marketplaces,2024,https://wellsllc.com,Risk exist executive lot civil million management outside.,21,wells-llc,2023,USD,671620,110922,560698,505051,55647,0,55647,6716,13432,42215,41686,550910,161448,389462,,671620,564.01,808.05,0.0567,2798,20.0,1000.0,41.69,0.8348
3734,Roberts Group,False,DE,Nielsenland,SaaS,2023,https://robertsgroup.com,Find impact hot hold nothing official end test race.,21,roberts-group,2023,EUR,551184,200444,350740,231526,119214,0,119214,5511,11023,108191,22942,493979,160350,333629,45932.0,551184,129.03,561.88,0.0502,797,57.63,17014.31,1.35,0.6363
3735,Martinez-Kennedy,False,IN,East Shawn,Cybersecurity,2011,https://martinez-kennedy.com,State capital with painting today.,29,martinez-kennedy,2023,USD,768018,236575,531443,173022,358421,4157,354264,7680,15360,338904,60089,521162,154353,366809,,768018,150.46,408.48,0.0327,3200,20.0,1000.0,60.09,0.692
3736,Barr PLC,False,AU,Holmesfort,IoT,2013,https://barrplc.com,Ahead attorney matter baby water wall together describe something who.,31,barr-plc,2023,USD,762083,244870,517213,148304,368909,2687,366222,7620,15241,350981,246975,790308,108612,681696,,762083,585.38,2527.04,0.0131,220,288.62,19103.53,12.93,0.6787
3737,Rodriguez Hamilton and Jones,False,TN,South George,Mobility,2021,https://rodriguezhamiltonandjones.com,Series save part court information someone significant tend.,23,rodriguez-hamilton-and-jones,2023,USD,313226,115424,197802,110535,87267,0,87267,3132,6264,81003,6146,305089,134214,170875,,313226,20.0,22.56,0.099,1305,20.0,1000.0,6.15,0.6315
3738,Hall-Chambers,False,IN,New Jonathan,IoT,2012,https://hall-chambers.com,Term great recent around enter.,22,hall-chambers,2023,USD,288925,61815,227110,80390,146720,8203,138517,2889,5778,132739,14812,355559,131605,223954,,288925,700.83,1868.97,0.112,284,84.62,1000.0,14.81,0.7861
3739,Williams Inc,False,FR,New Kathleen,E-commerce,2010,https://williamsinc.com,Child loss pay probably issue sometimes.,17,williams-inc,2023,EUR,2174744,958288,1216456,108737,1107719,0,1107719,21747,43494,1064225,19374,1162081,476943,685138,,2174744,1531.85,4474.91,0.0724,1390,130.3,29782.0,0.65,0.5594
3740,Palmer-Johnson,False,ZA,South Gavinview,AI/ML,2013,https://palmer-johnson.com,Past democratic yeah go defense.,15,palmer-johnson,2023,USD,456743,190583,266160,217862,48298,19712,28586,4567,9134,19452,21096,415040,20752,394288,,456743,891.32,4021.59,0.0991,133,284.81,6645.75,3.17,0.5827
3741,Tanner-Fleming,False,TN,Alyssaport,Cybersecurity,2008,https://tanner-fleming.com,Require save manager pass yourself.,20,tanner-fleming,2023,USD,1030263,497823,532440,635491,-103051,31700,-134751,10302,20605,-155356,207611,909426,254048,655378,,1030263,37.06,146.4,0.0506,960,89.39,56681.85,3.66,0.5168
3742,Hawkins LLC,False,TN,New Erichaven,AI/ML,2024,https://hawkinsllc.com,Yeah see go smile from trade energy.,21,hawkins-llc,2023,USD,1481315,592204,889111,1026896,-137785,13347,-151132,14813,29626,-180758,109331,903906,433849,470057,,1481315,20.0,36.52,0.0616,2129,57.98,82060.86,1.33,0.6002
3743,Mayer-Ryan,False,EG,Cynthiashire,Fintech,2024,https://mayer-ryan.com,Really approach these another left ten.,20,mayer-ryan,2023,USD,764628,357540,407088,219509,187579,12491,175088,7646,15292,159796,69557,543158,248795,294363,,764628,377.94,2366.16,0.1095,207,307.68,28959.69,2.4,0.5324
3744,Chavez Cervantes and Franklin,False,KE,Martinmouth,AI/ML,2011,https://chavezcervantesandfranklin.com,Size probably fly can company pay thus speech product.,30,chavez-cervantes-and-franklin,2023,USD,585159,188046,397113,395827,1286,6297,-5011,5851,11703,-16714,199340,510558,143179,367379,,585159,502.15,2099.83,0.0854,2438,20.0,15826.22,12.6,0.6786
3745,Benjamin and Sons,False,AU,Josephport,EdTech,2011,https://benjaminandsons.com,Speak upon personal easy actually office national form sit light.,19,benjamin-and-sons,2023,USD,244394,36859,207535,72083,135452,12986,122466,2443,4887,117579,7716,229970,69677,160293,20366.17,244394,10.0,50.22,0.0281,381,53.43,9700.73,0.8,0.8492
3746,Hernandez-Montgomery,False,GB,Estradahaven,IoT,2013,https://hernandez-montgomery.com,Nor where floor ball cut above.,12,hernandez-montgomery,2023,USD,944016,427424,516592,862395,-345803,12417,-358220,9440,18880,-377100,3011,586993,136578,450415,,944016,20.0,82.41,0.0796,485,162.2,102544.58,0.03,0.5472
3747,White-Fischer,False,US,Alexandershire,AI/ML,2022,https://white-fischer.com,Learn level carry pay rich.,16,white-fischer,2023,USD,112276,26590,85686,23686,62000,15113,46887,1122,2245,44642,60944,186073,86738,99335,,112276,20.0,40.19,0.0251,467,20.0,1000.0,60.94,0.7632
3748,Price-Patel,False,AU,South Casey,E-commerce,2011,https://price-patel.com,Field agent responsibility organization tree particularly him affect.,15,price-patel,2023,USD,1893794,392170,1501624,532520,969104,14640,954464,18937,37875,916589,138579,1195288,789684,405604,,1893794,1629.29,9393.67,0.001,7890,20.0,38195.94,3.63,0.7929
3749,Burgess-Campbell,False,US,Chadview,HealthTech,2014,https://burgess-campbell.com,Conference camera difference foreign husband remember care order wish total.,18,burgess-campbell,2023,USD,2742885,906359,1836526,137144,1699382,19621,1679761,27428,54857,1624904,170038,1615027,181221,1433806,228573.75,2742885,403.75,1853.61,0.0035,2665,85.75,1026.89,165.59,0.6696
3750,Alvarado LLC,False,BR,Lopezbury,HealthTech,2010,https://alvaradollc.com,Same glass education white listen produce soldier enjoy front recently.,17,alvarado-llc,2023,USD,2621476,949572,1671904,131073,1540831,0,1540831,26214,52429,1488402,22915,1497854,545757,952097,218456.33,2621476,35.77,94.13,0.0398,8724,25.04,1000.0,22.92,0.6378
3751,Brooks-Lee,False,NG,Martinland,AgriTech,2009,https://brooks-lee.com,Must station force cut population.,15,brooks-lee,2023,USD,371856,188314,183542,55064,128478,8622,119856,3718,7437,112419,6102,271098,80059,191039,,371856,1476.72,1670.97,0.0935,178,173.84,19917.06,0.31,0.4936
3752,Griffin-Vargas,False,FR,Garciaburgh,Fintech,2024,https://griffin-vargas.com,From month represent painting growth friend sport create list.,25,griffin-vargas,2023,EUR,4541886,2381923,2159963,2367264,-207301,9624,-216925,45418,90837,-307762,226738,2638694,1591688,1047006,,4541886,835.8,1721.81,0.0632,3059,123.7,222559.2,1.02,0.4756
3753,Estrada Gamble and Fitzpatrick,False,IN,South Jenniferhaven,E-commerce,2013,https://estradagambleandfitzpatrick.com,Perhaps form bit near seem.,21,estrada-gamble-and-fitzpatrick,2023,USD,745027,135062,609965,285507,324458,30801,293657,7450,14900,278757,22996,529191,216898,312293,,745027,243.67,820.95,0.0299,3104,20.0,37796.94,0.61,0.8187
3754,Spencer Mitchell and Turner,False,TN,Leeburgh,Marketplaces,2008,https://spencermitchellandturner.com,Listen laugh meeting follow fish.,20,spencer-mitchell-and-turner,2023,USD,488231,143146,345085,401249,-56164,22917,-79081,4882,9764,-88845,65917,335270,76314,258956,,488231,20.0,103.13,0.0439,2034,20.0,1889.52,34.89,0.7068
3755,Woodard-Mclean,False,DE,Johnsonton,AgriTech,2009,https://woodard-mclean.com,Show some scene need medical course music health increase sell.,15,woodard-mclean,2023,EUR,188547,80044,108503,34722,73781,21651,52130,1885,3770,48360,5043,255022,48906,206116,,188547,20.0,101.01,0.0943,115,135.61,18486.68,0.27,0.5755
3756,Hall Jackson and Owens,False,NG,Kyleland,AgriTech,2022,https://halljacksonandowens.com,International change law trial us general want him.,18,hall-jackson-and-owens,2023,USD,248882,88926,159956,153447,6509,3373,3136,2488,4977,-1841,17844,176775,99176,77599,,248882,20.0,64.39,0.0408,87,236.63,48875.35,0.37,0.6427
3757,Morales-Avila,False,GB,New Brianstad,IoT,2023,https://morales-avila.com,Late space change and for huge.,24,morales-avila,2023,USD,240872,66303,174569,90210,84359,5375,78984,2408,4817,74167,11414,133292,30839,102453,,240872,1366.77,5269.21,0.0572,111,179.34,1000.0,11.41,0.7247
3758,Henderson LLC,False,ZA,Williamsfurt,E-commerce,2024,https://hendersonllc.com,Nor cut civil machine forget star decision.,17,henderson-llc,2023,USD,4807820,2097847,2709973,1548694,1161279,20290,1140989,48078,96156,1044833,1006672,3602654,807108,2795546,,4807820,410.36,276.57,0.065,4502,88.98,144382.22,6.97,0.5637
3759,Harris Pham and Perez,False,CA,West Bonnieberg,IoT,2024,https://harrisphamandperez.com,Surface memory use rate maybe very picture seat.,16,harris-pham-and-perez,2023,USD,344862,101818,243044,180591,62453,9276,53177,3448,6897,46280,55471,295664,114308,181356,,344862,20.0,27.76,0.001,1436,20.0,62701.62,0.88,0.7048
3760,Jordan-Morris,False,DE,Vincentmouth,Cybersecurity,2011,https://jordan-morris.com,Alone again charge Mr bar.,14,jordan-morris,2023,EUR,534310,112171,422139,380341,41798,18096,23702,5343,10686,13016,25170,423768,80348,343420,,534310,1129.65,1278.51,0.0907,282,157.53,34724.52,0.72,0.7901
3761,Smith and Sons,False,BR,Rossland,SaaS,2015,https://smithandsons.com,Night meet memory image either really try oil attorney.,22,smith-and-sons,2023,USD,1433500,445126,988374,755699,232675,24767,207908,14335,28670,179238,249188,1094204,321262,772942,119458.33,1433500,10.0,39.65,0.0651,2190,54.54,50113.11,4.97,0.6895
3762,Ashley Ltd,False,US,Osbornestad,EdTech,2012,https://ashleyltd.com,Challenge run shake value.,12,ashley-ltd,2023,USD,470795,129887,340908,140473,200435,0,200435,4707,9415,191020,20126,376700,192209,184491,39232.92,470795,627.63,4976.36,0.0628,597,65.62,10453.36,1.93,0.7241
3763,Gomez Inc,False,IN,East Lisa,EdTech,2012,https://gomezinc.com,Bring what happy lead would woman choose loss where less.,23,gomez-inc,2023,USD,228462,133711,94751,172919,-78168,2173,-80341,2284,4569,-84910,12245,171732,21063,150669,19038.5,228462,10.0,71.48,0.0437,3807,5.0,17628.74,0.69,0.4147
3764,Mcgee-Odonnell,False,KE,Jacksonberg,AI/ML,2014,https://mcgee-odonnell.com,Sell couple most body protect shake listen radio break leave.,18,mcgee-odonnell,2023,USD,202303,71710,130593,27970,102623,16156,86467,2023,4046,82421,11885,115040,33083,81957,,202303,890.45,2238.33,0.1448,48,350.22,5036.43,2.36,0.6455
3765,Parker-Smith,False,KE,West Vicki,E-commerce,2016,https://parker-smith.com,Enter bring sea act natural task dark up.,17,parker-smith,2023,USD,966647,257926,708721,347808,360913,0,360913,9666,19332,341581,85764,635876,474853,161023,,966647,2272.92,1136.46,0.001,720,111.85,53222.77,1.61,0.7332
3766,Walker LLC,False,GB,West Carmen,Cybersecurity,2021,https://walkerllc.com,Community student expert point style whom determine give.,15,walker-llc,2023,USD,4416577,1849501,2567076,4392083,-1825007,0,-1825007,44165,88331,-1913338,351706,2725068,1182508,1542560,,4416577,519.26,1598.87,0.0277,7110,51.76,370971.91,0.95,0.5812
3767,Rodriguez-Ramirez,False,FR,Nealhaven,AI/ML,2016,https://rodriguez-ramirez.com,Nice try couple responsibility purpose there well candidate more allow.,15,rodriguez-ramirez,2023,EUR,535383,211346,324037,329318,-5281,44047,-49328,5353,10707,-60035,31074,419966,339576,80390,,535383,318.49,992.61,0.088,226,196.97,25908.11,1.2,0.6052
3768,Roberts Weber and Bridges,False,IN,Lewisstad,Energy,2013,https://robertsweberandbridges.com,Tv pretty work attention at outside sort speak.,18,roberts-weber-and-bridges,2023,USD,360283,115293,244990,204578,40412,7491,32921,3602,7205,25716,72661,306338,159856,146482,,360283,215.0,397.82,0.001,318,94.12,37357.76,1.95,0.68
3769,Glass-Vargas,False,TN,Davidborough,Mobility,2010,https://glass-vargas.com,Office door account similar hold even room around.,17,glass-vargas,2023,USD,923063,355513,567550,764759,-197209,11296,-208505,9230,18461,-226966,6107,656232,101213,555019,,923063,1260.1,630.05,0.0784,508,151.31,88402.0,0.07,0.6149
3770,Heath Arellano and Ward,False,IN,West Lawrenceland,Marketplaces,2021,https://heatharellanoandward.com,Carry policy daughter nation.,19,heath-arellano-and-ward,2023,USD,1168616,410563,758053,286550,471503,0,471503,11686,23372,448131,95493,792501,92397,700104,,1168616,960.6,480.3,0.0915,761,127.93,51324.71,1.86,0.6487
3771,Smith-Hayes,False,ZA,Port Julie,HealthTech,2014,https://smith-hayes.com,Against explain capital center truth source accept experience must.,23,smith-hayes,2023,USD,1101617,433865,667752,591089,76663,32188,44475,11016,22032,22443,94296,664053,162061,501992,91801.42,1101617,254.22,1378.83,0.0262,1570,58.45,24843.01,3.8,0.6062
3772,Ruiz Thomas and Williams,False,FR,New Justinchester,Marketplaces,2016,https://ruizthomasandwilliams.com,Federal get walk remain wait military spend consumer.,23,ruiz-thomas-and-williams,2023,EUR,842474,235525,606949,273727,333222,13297,319925,8424,16849,303076,41633,469557,180519,289038,,842474,850.59,1743.32,0.0349,3510,20.0,28181.6,1.48,0.7204
3773,Brown Francis and Morris,False,BR,Justinville,Cybersecurity,2014,https://brownfrancisandmorris.com,Because girl television marriage over century describe test popular.,28,brown-francis-and-morris,2023,USD,604981,102392,502589,35692,466897,886,466011,6049,12099,453912,38733,540739,118578,422161,,604981,20.0,28.55,0.0655,307,163.84,7855.62,4.93,0.8308
3774,Houston Owens and Smith,False,ZA,Kinghaven,E-commerce,2024,https://houstonowensandsmith.com,Center drive serve white yard serve could no town.,19,houston-owens-and-smith,2023,USD,421078,164336,256742,26637,230105,22613,207492,4210,8421,199071,16152,369415,108004,261411,,421078,20.0,84.4,0.0708,162,216.57,12499.85,1.29,0.6097
3775,Mercado Mcclure and Miller,False,KE,Cynthiaton,HealthTech,2021,https://mercadomcclureandmiller.com,Let age fill crime account we hospital.,25,mercado-mcclure-and-miller,2023,USD,1944505,351229,1593276,930800,662476,12105,650371,19445,38890,611481,90992,1225078,466689,758389,162042.08,1944505,371.69,1358.89,0.0854,1941,83.45,86598.7,1.05,0.8194
3776,Hutchinson-Rich,False,GB,Matthewside,E-commerce,2021,https://hutchinson-rich.com,Least role democratic doctor recent house.,19,hutchinson-rich,2023,USD,1072657,530034,542623,476968,65655,21388,44267,10726,21453,22814,18428,683481,385189,298292,,1072657,635.87,2801.45,0.0429,612,146.03,46747.91,0.39,0.5059
3777,Cline LLC,False,TN,South Monicaborough,SaaS,2015,https://clinellc.com,Morning lay top quite carry week task.,16,cline-llc,2023,USD,909088,428223,480865,565861,-84996,0,-84996,9090,18181,-103177,22546,575014,155957,419057,75757.33,909088,227.79,681.49,0.0349,4042,18.74,48021.1,0.47,0.529
3778,Green Group,False,FR,Rogerstad,AgriTech,2011,https://greengroup.com,Eat argue own force far.,9,green-group,2023,EUR,99660,34295,65365,56382,8983,0,8983,996,1993,6990,25769,268769,34322,234447,,99660,977.47,3546.23,0.0518,69,119.51,17029.55,1.51,0.6559
3779,Weaver Ltd,False,NG,North Jason,Fintech,2021,https://weaverltd.com,Black analysis top realize after sense describe along shake.,20,weaver-ltd,2023,USD,4224068,1329360,2894708,2542768,351940,17657,334283,42240,84481,249802,99002,2301499,1122184,1179315,,4224068,20.0,65.46,0.0582,3574,98.49,220596.64,0.45,0.6853
3780,Ryan Roth and Matthews,False,FR,Port Jonathan,E-commerce,2010,https://ryanrothandmatthews.com,Stuff recent area more lose whatever mean project hot force.,19,ryan-roth-and-matthews,2023,EUR,1297442,611705,685737,458645,227092,0,227092,12974,25948,201144,232962,1012604,150666,861938,,1297442,1729.43,6415.64,0.0511,358,301.31,8802.15,26.47,0.5285
3781,Turner Martin and Lopez,False,CA,Gonzaleshaven,E-commerce,2016,https://turnermartinandlopez.com,Life hand itself should fall why ok management.,13,turner-martin-and-lopez,2023,USD,694540,203606,490934,447574,43360,13455,29905,6945,13890,16015,198163,576104,28805,547299,,694540,20.0,93.63,0.1206,521,111.01,1000.0,198.16,0.7068
3782,Johnson-Morrison,False,GB,Port Michael,EdTech,2016,https://johnson-morrison.com,Station fine evidence teach several community interesting around.,22,johnson-morrison,2023,USD,2124546,972392,1152154,2342266,-1190112,48838,-1238950,21245,42490,-1281440,23033,1129288,264154,865134,177045.5,2124546,10.0,15.32,0.0332,3489,50.73,193926.35,0.12,0.5423
3783,Thompson-Hicks,False,US,West Chelseamouth,Fintech,2020,https://thompson-hicks.com,Ready consider against trouble develop.,22,thompson-hicks,2023,USD,382955,135535,247420,167770,79650,7061,72589,3829,7659,64930,158177,548250,27412,520838,,382955,1733.49,7941.21,0.001,401,79.55,1000.0,158.18,0.6461
3784,Bryant-Jimenez,False,DE,North Gregory,Energy,2011,https://bryant-jimenez.com,Face early himself whole heart.,23,bryant-jimenez,2023,EUR,11715446,4124719,7590727,585772,7004955,47971,6956984,117154,234308,6722676,148604,6025916,2594142,3431774,,11715446,540.49,594.94,0.0021,18244,53.51,73807.87,2.01,0.6479
3785,Vang Group,False,AU,Danielleborough,Fintech,2013,https://vanggroup.com,Rule customer father low life it.,25,vang-group,2023,USD,278008,64758,213250,145831,67419,0,67419,2780,5560,61859,3346,164453,22072,142381,,278008,103.94,186.11,0.001,133,173.6,1000.0,3.35,0.7671
3786,Marks Ltd,False,NG,Floresside,Cybersecurity,2017,https://marksltd.com,Meeting law sound yard feel specific some task.,18,marks-ltd,2023,USD,2883927,991649,1892278,1373859,518419,0,518419,28839,57678,460741,63823,1546801,794174,752627,,2883927,20.0,56.81,0.0857,12016,20.0,105768.08,0.6,0.6561
3787,Willis Jones and Lowe,False,KE,Robinsontown,Mobility,2011,https://willisjonesandlowe.com,Republican send unit yourself us turn protect.,25,willis-jones-and-lowe,2023,USD,609774,163414,446360,303561,142799,31274,111525,6097,12195,99330,14979,421530,124260,297270,,609774,1720.74,6047.92,0.0845,661,76.87,78234.94,0.19,0.732
3788,Benson Day and Walsh,False,NG,New Alexandria,E-commerce,2017,https://bensondayandwalsh.com,Impact level boy again finish first.,11,benson-day-and-walsh,2023,USD,2401106,821526,1579580,1386896,192684,33082,159602,24011,48022,111580,223726,1556543,77827,1478716,,2401106,312.85,1224.27,0.0844,1088,183.87,103413.28,2.16,0.6579
3789,Garcia Ltd,False,NG,Staceystad,AgriTech,2011,https://garcialtd.com,Sort analysis us southern personal but miss somebody.,17,garcia-ltd,2023,USD,1568465,450346,1118119,527284,590835,16364,574471,15684,31369,543102,73614,1016840,50842,965998,,1568465,1110.45,2921.27,0.127,653,199.94,65581.3,1.12,0.7129
3790,Salas Blackwell and Miller,False,US,North Tonyhaven,HealthTech,2018,https://salasblackwellandmiller.com,Street or tough statement role think medical politics green.,15,salas-blackwell-and-miller,2023,USD,544273,168553,375720,327851,47869,6174,41695,5442,10885,30810,6599,369156,73033,296123,45356.08,544273,312.7,677.35,0.0766,694,65.27,4619.3,1.43,0.6903
3791,Jackson-Marks,False,AU,North Peter,Energy,2013,https://jackson-marks.com,Police with sing identify should loss particular gas.,23,jackson-marks,2023,USD,2043713,314242,1729471,1398061,331410,1251,330159,20437,40874,289285,205961,1371877,868401,503476,,2043713,564.77,2347.01,0.001,1648,103.34,119720.01,1.72,0.8462
3792,Cook and Sons,False,CA,Walterberg,Cybersecurity,2020,https://cookandsons.com,Painting those report base safe.,24,cook-and-sons,2023,USD,3625903,587123,3038780,3275537,-236757,0,-236757,36259,72518,-309275,201562,2054237,717461,1336776,,3625903,626.12,503.02,0.079,2659,113.6,260695.84,0.77,0.8381
3793,Anderson Wright and Crawford,False,EG,North Sheliafort,IoT,2012,https://andersonwrightandcrawford.com,Call wear half story build Congress speech.,28,anderson-wright-and-crawford,2023,USD,896986,160987,735999,87027,648972,0,648972,8969,17939,631033,54845,601554,367738,233816,,896986,20.0,78.81,0.009,308,242.31,1000.0,54.84,0.8205
3794,Valencia PLC,False,IN,West Robertview,SaaS,2024,https://valenciaplc.com,Yes themselves kitchen simple bad arm.,19,valencia-plc,2023,USD,2311891,1028190,1283701,1435406,-151705,0,-151705,23118,46237,-197942,125758,1317589,626571,691018,192657.58,2311891,163.71,710.61,0.0712,38531,5.0,152760.44,0.82,0.5553
3795,Ramirez Odom and Clark,False,ZA,Port Charlesfurt,HealthTech,2012,https://ramirezodomandclark.com,The present not manager vote decide after floor two.,15,ramirez-odom-and-clark,2023,USD,483691,113789,369902,353257,16645,0,16645,4836,9673,6972,18892,364068,140746,223322,40307.58,483691,10.0,30.23,0.001,1101,36.59,62012.25,0.3,0.7647
3796,Harvey-Rodriguez,False,GB,East Teresaberg,Energy,2016,https://harvey-rodriguez.com,Factor kitchen where officer matter eight billion group.,16,harvey-rodriguez,2023,USD,1072466,117028,955438,938315,17123,219,16904,10724,21449,-4545,531676,1165662,459444,706218,,1072466,1315.28,4323.79,0.1133,1076,83.05,88680.98,6.0,0.8909
3797,Randolph LLC,False,US,South Rachelchester,Cybersecurity,2019,https://randolphllc.com,Seem lot power structure his candidate onto.,27,randolph-llc,2023,USD,1408510,535925,872585,344536,528049,1268,526781,14085,28170,498611,43114,906674,364208,542466,,1408510,761.29,3516.24,0.0631,462,253.67,52301.38,0.82,0.6195
3798,Ortiz Ltd,False,ZA,East Christophermouth,EdTech,2021,https://ortizltd.com,Send example practice single store sit stand.,15,ortiz-ltd,2023,USD,554994,270902,284092,224344,59748,43335,16413,5549,11099,5314,9196,291279,69816,221463,46249.5,554994,655.47,5017.94,0.0782,637,72.5,3522.85,2.61,0.5119
3799,Duran-Horn,False,ZA,Elizabethhaven,Mobility,2013,https://duran-horn.com,Forget feeling computer claim rest woman rather.,18,duran-horn,2023,USD,429415,120063,309352,328986,-19634,0,-19634,4294,8588,-28222,9854,235370,157763,77607,,429415,230.41,434.13,0.001,206,173.47,36627.56,0.27,0.7204
3800,Davis Inc,False,EG,Toddfort,E-commerce,2022,https://davisinc.com,From large court risk stage effort.,19,davis-inc,2023,USD,385267,133253,252014,159092,92922,0,92922,3852,7705,85217,9596,365235,26832,338403,,385267,1467.36,733.68,0.0116,207,154.43,35482.46,0.27,0.6541
3801,Bell-Mcmillan,False,NG,South Scottport,AgriTech,2016,https://bell-mcmillan.com,Assume strong surface whom court indeed.,17,bell-mcmillan,2023,USD,852073,302817,549256,524035,25221,0,25221,8520,17041,8180,57074,497435,58119,439316,,852073,934.57,1461.13,0.1116,549,129.11,44867.67,1.27,0.6446
3802,Hill Gonzalez and Barber,False,TN,North Feliciahaven,AI/ML,2015,https://hillgonzalezandbarber.com,Cold know risk generation especially specific least.,17,hill-gonzalez-and-barber,2023,USD,308893,90900,217993,15444,202549,0,202549,3088,6177,196372,30039,289496,106723,182773,,308893,2388.88,6115.34,0.0465,128,200.83,4897.27,6.13,0.7057
3803,Morgan Ltd,False,IN,Arianamouth,Marketplaces,2010,https://morganltd.com,Within worry information peace meeting while.,10,morgan-ltd,2023,USD,810995,308351,502644,130714,371930,0,371930,8109,16219,355711,30955,527926,391798,136128,,810995,797.34,4193.37,0.0314,474,142.31,18522.59,1.67,0.6198
3804,Goodman Valenzuela and Martin,False,IN,Melindabury,Energy,2018,https://goodmanvalenzuelaandmartin.com,Ago whatever consider various end how often court.,24,goodman-valenzuela-and-martin,2023,USD,660004,207025,452979,183732,269247,0,269247,6600,13200,256047,88129,540195,27009,513186,,660004,601.82,300.91,0.0993,171,319.92,7843.23,11.24,0.6863
3805,Scott Sawyer and Robinson,False,FR,Eatonmouth,Marketplaces,2010,https://scottsawyerandrobinson.com,Think they Republican rock cell consumer bar radio phone civil.,25,scott-sawyer-and-robinson,2023,EUR,640964,220682,420282,32048,388234,22315,365919,6409,12819,353100,35877,504206,221466,282740,,640964,1380.53,4432.82,0.0347,2670,20.0,31916.29,1.12,0.6557
3806,Solomon Johnson and Torres,False,FR,East Dorothy,Cybersecurity,2015,https://solomonjohnsonandtorres.com,Card upon another difficult still long decision.,10,solomon-johnson-and-torres,2023,EUR,571465,381060,190405,233450,-43045,0,-43045,5714,11429,-54474,78372,374495,117789,256706,,571465,375.77,433.47,0.0393,2381,20.0,1000.0,78.37,0.3332
3807,Watson-Tate,False,FR,West Mary,HealthTech,2009,https://watson-tate.com,By finish road dream cup.,13,watson-tate,2023,EUR,1564804,476656,1088148,78240,1009908,0,1009908,15648,31296,978612,71973,893746,372246,521500,130400.33,1564804,199.54,567.37,0.0245,1357,96.04,19579.23,3.68,0.6954
3808,Perry-Ramirez,False,FR,South Monica,Cybersecurity,2017,https://perry-ramirez.com,Heart performance fight audience officer my themselves system box.,19,perry-ramirez,2023,EUR,3129924,1268944,1860980,2037375,-176395,3581,-179976,31299,62598,-242574,309203,1994825,873599,1121226,,3129924,1743.78,6572.42,0.001,1140,228.67,141383.17,2.19,0.5946
3809,Mckinney LLC,False,NG,Lauriemouth,Mobility,2008,https://mckinneyllc.com,Recent others marriage couple table ok the.,36,mckinney-llc,2023,USD,1471682,604894,866788,705492,161296,0,161296,14716,29433,131863,69413,905248,302017,603231,,1471682,642.73,2354.4,0.0698,430,284.57,32022.27,2.17,0.589
3810,Weaver Inc,False,TN,Rodriguezchester,Marketplaces,2024,https://weaverinc.com,Director spend continue mention alone bank fund rule.,21,weaver-inc,2023,USD,1944681,97234,1847447,769572,1077875,4792,1073083,19446,38893,1034190,184271,1345786,290661,1055125,,1944681,20.0,83.12,0.001,1819,89.07,60376.91,3.05,0.95
3811,Dixon-Phillips,False,ZA,Bryantstad,HealthTech,2023,https://dixon-phillips.com,Project box under usually end all the.,20,dixon-phillips,2023,USD,511844,95350,416494,504322,-87828,0,-87828,5118,10236,-98064,88702,402528,107834,294694,42653.67,511844,74.63,330.16,0.0753,8530,5.0,18054.98,4.91,0.8137
3812,Day-Archer,False,EG,Gomezburgh,AI/ML,2011,https://day-archer.com,Lot policy possible event others adult ground difficult big.,14,day-archer,2023,USD,190661,65056,125605,51034,74571,23418,51153,1906,3813,47340,21019,126276,56965,69311,,190661,1895.24,1519.13,0.1084,80,197.96,1000.0,21.02,0.6588
3813,Wright Boyle and Gutierrez,False,TN,East Kevin,SaaS,2014,https://wrightboyleandgutierrez.com,Foot suffer board realize child relate those suffer order write.,21,wright-boyle-and-gutierrez,2023,USD,2354891,613344,1741547,944572,796975,13178,783797,23548,47097,736700,67128,1297866,630774,667092,196240.92,2354891,197.33,393.97,0.0333,39248,5.0,75093.26,0.89,0.7395
3814,Morales-Peterson,False,ZA,Weststad,SaaS,2021,https://morales-peterson.com,Base event trip raise discover TV election fine magazine.,26,morales-peterson,2023,USD,1277087,337455,939632,250541,689091,9504,679587,12770,25541,654046,407676,1171581,333158,838423,106423.92,1277087,475.97,1501.92,0.001,9872,10.78,26851.93,15.18,0.7358
3815,Bridges Perkins and Rodgers,False,ZA,New Brenda,AI/ML,2019,https://bridgesperkinsandrodgers.com,Public summer beyond experience other understand western send.,13,bridges-perkins-and-rodgers,2023,USD,707422,208210,499212,199571,299641,4862,294779,7074,14148,280631,6889,430698,51252,379446,,707422,29.48,172.4,0.0855,2947,20.0,1000.0,6.89,0.7057
3816,Pearson Moore and Williams,False,DE,North Kathleen,Cybersecurity,2024,https://pearsonmooreandwilliams.com,Reduce read method language enough.,18,pearson-moore-and-williams,2023,EUR,587488,201223,386265,444386,-58121,0,-58121,5874,11749,-69870,16799,410908,155455,255453,,587488,43.49,122.76,0.046,146,333.98,11005.29,1.53,0.6575
3817,Osborne-West,False,BR,Bassmouth,IoT,2009,https://osborne-west.com,Capital leader mother wish identify education.,19,osborne-west,2023,USD,756902,210566,546336,667050,-120714,29653,-150367,7569,15138,-165505,40119,551176,57962,493214,,756902,20.0,126.11,0.0396,197,318.8,27743.9,1.45,0.7218
3818,Alvarado and Sons,False,KE,Mullinsfort,Mobility,2013,https://alvaradoandsons.com,Mean several rather require garden.,26,alvarado-and-sons,2023,USD,1550229,713357,836872,957594,-120722,0,-120722,15502,31004,-151726,445796,1320930,274782,1046148,,1550229,33.34,33.44,0.1924,4336,29.79,65480.26,6.81,0.5398
3819,Duncan Nunez and Adams,False,BR,West Karenland,AI/ML,2015,https://duncannunezandadams.com,Ask south seven on response recognize move five small suffer.,26,duncan-nunez-and-adams,2023,USD,673483,180131,493352,33674,459678,0,459678,6734,13469,446209,97172,446246,127095,319151,,673483,986.07,4197.04,0.1269,323,173.46,28904.83,3.36,0.7325
3820,Roberts-Myers,False,GB,Davidmouth,Fintech,2019,https://roberts-myers.com,Agreement group world strong model forget successful.,27,roberts-myers,2023,USD,2843046,854981,1988065,1122292,865773,39428,826345,28430,56860,769485,81433,1679265,833381,845884,,2843046,775.63,489.38,0.0273,2247,105.4,105255.05,0.77,0.6993
3821,Knight Waters and Robinson,False,GB,Johnsonville,AI/ML,2019,https://knightwatersandrobinson.com,Sea generation raise difference beautiful.,24,knight-waters-and-robinson,2023,USD,3348337,1282317,2066020,1560906,505114,45820,459294,33483,66966,392328,13083,1752836,737366,1015470,,3348337,47.82,89.95,0.0711,1241,224.75,132225.71,0.1,0.617
3822,Pollard Johnson and Collins,False,US,West Richard,Energy,2023,https://pollardjohnsonandcollins.com,Threat white my grow property now.,21,pollard-johnson-and-collins,2023,USD,2111351,663868,1447483,1020251,427232,29724,397508,21113,42227,355281,63445,1312892,492422,820470,,2111351,70.76,160.36,0.0901,1359,129.41,89908.31,0.71,0.6856
3823,Robles Bowman and Santana,False,TN,Hamptonbury,HealthTech,2019,https://roblesbowmanandsantana.com,Present apply author network join.,25,robles-bowman-and-santana,2023,USD,130924,41167,89757,53786,35971,4528,31443,1309,2618,28825,4174,244903,117330,127573,10910.33,130924,720.17,3454.41,0.0146,449,24.29,11618.74,0.36,0.6856
3824,Adams Ltd,False,FR,Lake Belinda,E-commerce,2015,https://adamsltd.com,Out win focus provide store hold change president city.,24,adams-ltd,2023,EUR,4681609,993762,3687847,1110537,2577310,0,2577310,46816,93632,2483678,1688217,4115676,2028228,2087448,,4681609,20.0,115.24,0.001,19506,20.0,56145.38,30.07,0.7877
3825,Carroll-Mason,False,NG,Rossland,Fintech,2017,https://carroll-mason.com,Responsibility industry whom week really executive wrong ball down notice.,17,carroll-mason,2023,USD,982674,383207,599467,648256,-48789,16252,-65041,9826,19653,-84694,17901,559815,367661,192154,,982674,351.97,1298.54,0.0369,612,133.74,59201.77,0.3,0.61
3826,Bell Ltd,False,IN,Port Vincent,Mobility,2017,https://bellltd.com,Certainly century free hot Republican so high book.,19,bell-ltd,2023,USD,488595,189979,298616,205383,93233,8862,84371,4885,9771,74600,9810,270574,108800,161774,,488595,20.0,10.0,0.077,2035,20.0,1000.0,9.81,0.6112
3827,Pope Ferguson and Brown,False,IN,Taylorchester,EdTech,2008,https://popefergusonandbrown.com,Study medical marriage health few manage.,22,pope-ferguson-and-brown,2023,USD,365566,182174,183392,249095,-65703,8138,-73841,3655,7311,-81152,8478,196574,85058,111516,30463.83,365566,10.0,83.37,0.0059,799,38.09,1000.0,8.48,0.5017
3828,Rodgers Inc,False,ZA,Scottville,Marketplaces,2020,https://rodgersinc.com,Heart particular method worker social thank picture.,13,rodgers-inc,2023,USD,1694442,593145,1101297,998112,103185,0,103185,16944,33888,69297,193107,1124175,385822,738353,,1694442,20.0,17.3,0.001,7060,20.0,74006.58,2.61,0.6499
3829,Sharp-Martinez,False,DE,Gordonside,AgriTech,2024,https://sharp-martinez.com,Lawyer size money four safe film late from.,18,sharp-martinez,2023,EUR,794579,280934,513645,321132,192513,0,192513,7945,15891,176622,127982,692983,258680,434303,,794579,20.0,137.15,0.092,481,137.53,32133.36,3.98,0.6464
3830,Austin Inc,False,US,Lake Peter,Mobility,2023,https://austininc.com,Themselves number decade her again.,20,austin-inc,2023,USD,288325,116340,171985,171955,30,24161,-24131,2883,5766,-29897,16159,245847,184469,61378,,288325,20.0,60.27,0.0709,664,36.14,2335.02,6.92,0.5965
3831,Schaefer Watts and Sanders,False,US,Lake Nathanmouth,E-commerce,2008,https://schaeferwattsandsanders.com,Worker test style science ten movement last.,24,schaefer-watts-and-sanders,2023,USD,329126,114840,214286,232053,-17767,25980,-43747,3291,6582,-50329,44983,300431,238918,61513,,329126,20.0,77.73,0.0776,145,188.58,36306.62,1.24,0.6511
3832,Smith Robinson and Miller,False,KE,New Ryanside,Mobility,2018,https://smithrobinsonandmiller.com,Again expect idea break chair edge including few help its.,18,smith-robinson-and-miller,2023,USD,713249,192305,520944,352271,168673,34413,134260,7132,14264,119996,225851,669894,238250,431644,,713249,1022.89,2612.58,0.001,241,246.53,29861.98,7.56,0.7304
3833,Vaughn Ltd,False,IN,South James,E-commerce,2011,https://vaughnltd.com,Project box trouble central process cell compare technology town whose.,16,vaughn-ltd,2023,USD,1350567,393537,957030,513932,443098,28356,414742,13505,27011,387731,79001,824848,290007,534841,,1350567,1591.54,5077.12,0.1352,962,116.91,39612.04,1.99,0.7086
3834,Davis and Sons,False,US,Wheelershire,E-commerce,2013,https://davisandsons.com,Spring tough few Mr none respond Democrat rich trip begin.,22,davis-and-sons,2023,USD,540313,194098,346215,289381,56834,10705,46129,5403,10806,35323,33373,454553,262556,191997,,540313,20.0,10.0,0.0178,482,93.33,24334.04,1.37,0.6408
3835,Harris Group,False,TN,Lake Troy,E-commerce,2008,https://harrisgroup.com,Remain get according condition candidate strategy perform people thousand.,23,harris-group,2023,USD,399139,55265,343874,121943,221931,8684,213247,3991,7982,205265,5664,218565,37669,180896,,399139,1014.01,3944.12,0.0251,1663,20.0,1000.0,5.66,0.8615
3836,Young Group,False,FR,Lake Justinfort,Energy,2023,https://younggroup.com,Require product threat any right line father.,18,young-group,2023,EUR,2403912,1255832,1148080,2025655,-877575,0,-877575,24039,48078,-925653,970177,2198142,714965,1483177,,2403912,217.33,212.33,0.05,10016,20.0,170051.34,5.71,0.4776
3837,Miller Schmitt and Holden,False,DE,New Dennis,Fintech,2024,https://millerschmittandholden.com,Oil security perhaps national challenge item difference draw.,28,miller-schmitt-and-holden,2023,EUR,1521771,683967,837804,458226,379578,23729,355849,15217,30435,325414,114774,947399,309912,637487,,1521771,67.22,157.0,0.0072,1998,63.46,45078.36,2.55,0.5505
3838,Watts Ltd,False,NG,East Anna,HealthTech,2021,https://wattsltd.com,Truth see section street cup reflect audience.,23,watts-ltd,2023,USD,373854,119989,253865,174000,79865,0,79865,3738,7477,72388,11076,287154,57555,229599,31154.5,373854,1076.56,1824.16,0.0867,6230,5.0,55366.82,0.2,0.679
3839,Mcmahon Campbell and Nunez,False,FR,New Keithstad,Mobility,2008,https://mcmahoncampbellandnunez.com,Beautiful prove floor blue book avoid huge western own.,25,mcmahon-campbell-and-nunez,2023,EUR,386190,160765,225425,266713,-41288,0,-41288,3861,7723,-49011,69328,318096,171378,146718,,386190,1515.07,10135.09,0.001,1609,20.0,23857.42,2.91,0.5837
3840,Villanueva Lindsey and English,False,GB,East Sarah,Marketplaces,2016,https://villanuevalindseyandenglish.com,Score make mean Republican that.,13,villanueva-lindsey-and-english,2023,USD,892457,479908,412549,284921,127628,44651,82977,8924,17849,65128,23017,543193,167974,375219,,892457,486.66,3535.66,0.0284,323,229.66,1142.48,20.15,0.4623
3841,Rhodes Branch and Clark,False,DE,North Caleb,Mobility,2020,https://rhodesbranchandclark.com,Yet nice soldier read truth.,25,rhodes-branch-and-clark,2023,EUR,417850,79871,337979,101581,236398,0,236398,4178,8357,228041,10176,414588,257589,156999,,417850,841.9,4538.14,0.001,155,223.72,3258.11,3.12,0.8089
3842,Moore-Hernandez,False,CA,Lake Patricia,AgriTech,2019,https://moore-hernandez.com,Feel science million song before three finally buy meeting.,28,moore-hernandez,2023,USD,246429,90326,156103,193163,-37060,0,-37060,2464,4928,-41988,4316,145247,44029,101218,,246429,505.53,1260.58,0.001,1026,20.0,11300.61,0.38,0.6335
3843,Harris Gill and Adams,False,TN,West John,HealthTech,2016,https://harrisgillandadams.com,Catch our feel southern may near little.,9,harris-gill-and-adams,2023,USD,613475,200478,412997,91482,321515,17325,304190,6134,12269,291921,95971,419770,141584,278186,51122.92,613475,404.57,1889.47,0.001,274,186.23,1000.0,95.97,0.6732
3844,Williams-Lewis,False,FR,New Ellen,Mobility,2022,https://williams-lewis.com,Bank owner hear tree others behavior.,14,williams-lewis,2023,EUR,116686,34040,82646,94438,-11792,15335,-27127,1166,2333,-29460,9862,150433,71933,78500,,116686,20.0,126.5,0.0937,486,20.0,1000.0,9.86,0.7083
3845,Davidson-Stevenson,False,GB,Hammondburgh,HealthTech,2019,https://davidson-stevenson.com,Wide too agreement section check sure certain.,15,davidson-stevenson,2023,USD,613538,320318,293220,352482,-59262,0,-59262,6135,12270,-71532,33818,376525,219733,156792,51128.17,613538,687.86,1493.87,0.0229,1025,49.85,17169.28,1.97,0.4779
3846,Morris Ltd,False,ZA,Harriston,Energy,2008,https://morrisltd.com,Several interest night example at nature soldier life.,25,morris-ltd,2023,USD,1115842,610449,505393,545602,-40209,0,-40209,11158,22316,-62525,109910,692984,123757,569227,,1115842,81.38,88.71,0.1488,1128,82.39,31860.91,3.45,0.4529
3847,Flowers-Mccall,False,CA,Millerfort,Cybersecurity,2014,https://flowers-mccall.com,Plant just cost whatever by than feeling shoulder manage.,15,flowers-mccall,2023,USD,3249592,1637005,1612587,1864239,-251652,20671,-272323,32495,64991,-337314,31813,1774772,1054826,719946,,3249592,20.0,41.76,0.0485,854,316.92,179643.57,0.18,0.4962
3848,Payne Davis and Avery,False,FR,Bryantown,EdTech,2017,https://paynedavisandavery.com,Road change TV player deep hit benefit long newspaper suddenly.,15,payne-davis-and-avery,2023,EUR,669943,209863,460080,89829,370251,0,370251,6699,13398,356853,44578,508215,160272,347943,55828.58,669943,10.0,52.35,0.021,11165,5.0,1000.0,44.58,0.6867
3849,Kemp-Flores,False,US,Port Mariah,HealthTech,2020,https://kemp-flores.com,Ago among participant indicate agency half industry agency successful media.,19,kemp-flores,2023,USD,448169,111769,336400,263634,72766,10383,62383,4481,8963,53420,20599,277902,35222,242680,37347.42,448169,133.71,358.59,0.0485,603,61.86,36239.99,0.57,0.7506
3850,Schneider Yang and Barrett,False,TN,South Kaitlintown,Cybersecurity,2018,https://schneideryangandbarrett.com,Call anyone executive decision against model key.,26,schneider-yang-and-barrett,2023,USD,337756,158282,179474,157442,22032,12306,9726,3377,6755,2971,21739,340421,71977,268444,,337756,20.0,96.17,0.0114,199,141.13,21808.33,1.0,0.5314
3851,Short Rivera and Martinez,False,US,East Gabriel,HealthTech,2014,https://shortriveraandmartinez.com,Their far do quickly focus present technology raise available democratic.,22,short-rivera-and-martinez,2023,USD,1178580,528743,649837,970648,-320811,7404,-328215,11785,23571,-351786,155492,918408,104961,813447,98215.0,1178580,59.37,227.52,0.0053,6708,14.64,94348.36,1.65,0.5514
3852,Woods Johnson and Allen,False,EG,West Amy,Marketplaces,2016,https://woodsjohnsonandallen.com,Former teach age community financial bar.,24,woods-johnson-and-allen,2023,USD,1532503,591746,940757,827285,113472,0,113472,15325,30650,82822,36948,979717,339963,639754,,1532503,791.56,4620.01,0.001,641,199.2,53813.06,0.69,0.6139
3853,Kennedy-Brown,False,FR,East William,Energy,2023,https://kennedy-brown.com,Table enough herself find game evidence speak fight.,24,kennedy-brown,2023,EUR,1962799,353210,1609589,1419219,190370,7191,183179,19627,39255,143924,239060,1258079,838774,419305,,1962799,1844.37,922.18,0.1198,8178,20.0,100786.96,2.37,0.82
3854,Espinoza Ltd,False,NG,Port Kyle,Mobility,2012,https://espinozaltd.com,Professor laugh expert inside far discussion writer argue.,19,espinoza-ltd,2023,USD,598473,201625,396848,466636,-69788,0,-69788,5984,11969,-81757,42874,439386,153423,285963,,598473,317.4,1417.76,0.0849,2493,20.0,37954.01,1.13,0.6631
3855,Robinson Inc,False,CA,Amyland,Energy,2024,https://robinsoninc.com,Brother production world door about their by charge week.,14,robinson-inc,2023,USD,2932979,882604,2050375,759413,1290962,24038,1266924,29329,58659,1208265,167573,1644162,602505,1041657,,2932979,963.93,1386.4,0.1017,1103,221.55,47995.05,3.49,0.6991
3856,Alvarado Gross and Carlson,False,ZA,Cherylshire,Cybersecurity,2020,https://alvaradogrossandcarlson.com,Similar kitchen cultural degree computer writer past.,21,alvarado-gross-and-carlson,2023,USD,3722573,1258213,2464360,716010,1748350,48566,1699784,37225,74451,1625333,45828,2042320,442999,1599321,,3722573,20.0,93.69,0.0453,15510,20.0,41840.07,1.1,0.662
3857,Terry Group,False,GB,Matthewside,Fintech,2011,https://terrygroup.com,Test arrive choose carry point adult couple religious.,23,terry-group,2023,USD,1362468,474039,888429,465431,422998,15445,407553,13624,27249,380304,10957,726427,198139,528288,,1362468,195.2,348.26,0.1384,388,291.88,52456.22,0.21,0.6521
3858,Mckay-Craig,False,AU,South Brooke,SaaS,2012,https://mckay-craig.com,Defense contain sing evidence foot.,18,mckay-craig,2023,USD,2296693,700254,1596439,487517,1108922,19534,1089388,22966,45933,1043455,168832,1355544,901225,454319,191391.08,2296693,174.47,174.47,0.0659,8034,23.82,24293.07,6.95,0.6951
3859,Lopez Wood and Hurley,False,GB,West Ryanburgh,E-commerce,2024,https://lopezwoodandhurley.com,Boy enter rock operation media.,23,lopez-wood-and-hurley,2023,USD,1035118,529792,505326,744368,-239042,12980,-252022,10351,20702,-272724,5446,675952,33797,642155,,1035118,158.99,341.48,0.1037,393,219.1,76701.13,0.07,0.4882
3860,Hill Inc,False,US,Underwoodland,Marketplaces,2015,https://hillinc.com,Piece beyond all rise run simple take kid drop.,20,hill-inc,2023,USD,1435526,403944,1031582,349699,681883,26071,655812,14355,28710,627102,41683,911883,114161,797722,,1435526,471.36,235.68,0.0187,5981,20.0,26138.27,1.59,0.7186
3861,Barber Jordan and Thompson,False,US,Michaelbury,Marketplaces,2018,https://barberjordanandthompson.com,Skill tell fly big word capital worker stay heart somebody very.,17,barber-jordan-and-thompson,2023,USD,565125,149169,415956,125462,290494,8498,281996,5651,11302,270694,45098,353728,114878,238850,,565125,542.41,611.97,0.0775,2354,20.0,4373.0,10.31,0.736
3862,Scott Inc,False,TN,North Dennisshire,IoT,2008,https://scottinc.com,Management remember task base direction although.,16,scott-inc,2023,USD,1591294,316245,1275049,798672,476377,1361,475016,15912,31825,443191,284464,1179669,210562,969107,,1591294,62.34,235.01,0.0513,868,152.6,49167.78,5.79,0.8013
3863,Lopez PLC,False,TN,Bentonview,Mobility,2017,https://lopezplc.com,Wish most make wonder.,17,lopez-plc,2023,USD,725017,238997,486020,93359,392661,0,392661,7250,14500,378161,245434,752695,342040,410655,,725017,1125.03,5992.54,0.1108,3020,20.0,19156.68,12.81,0.6704
3864,Mcgrath-Black,False,IN,Mollybury,Mobility,2010,https://mcgrath-black.com,Ball night purpose remain civil its Congress player.,16,mcgrath-black,2023,USD,383432,91009,292423,128807,163616,0,163616,3834,7668,155948,24389,333168,157190,175978,,383432,1724.65,862.32,0.0747,157,203.16,1000.0,24.39,0.7626
3865,Taylor Patel and Dixon,False,AU,South Jenniferview,Energy,2015,https://taylorpatelanddixon.com,Make practice upon machine perform partner style.,21,taylor-patel-and-dixon,2023,USD,576156,189358,386798,446664,-59866,20984,-80850,5761,11523,-92373,7666,365238,18261,346977,,576156,860.73,1486.44,0.0194,643,74.66,41602.57,0.18,0.6713
3866,Rosales Williamson and Garrison,False,KE,North Michael,HealthTech,2024,https://rosaleswilliamsonandgarrison.com,Structure song scientist let so.,22,rosales-williamson-and-garrison,2023,USD,990254,482225,508029,226080,281949,18461,263488,9902,19805,243683,12655,579114,77177,501937,82521.17,990254,422.69,1991.83,0.024,983,83.92,23774.21,0.53,0.513
3867,Dillon-Lopez,False,GB,North Keith,EdTech,2016,https://dillon-lopez.com,Perhaps new gun note truth stop real.,17,dillon-lopez,2023,USD,346681,171740,174941,167835,7106,20445,-13339,3466,6933,-20272,93971,274852,163379,111473,28890.08,346681,366.68,1557.59,0.0226,431,67.02,49387.11,1.9,0.5046
3868,Ruiz Carter and Allen,False,AU,Knoxborough,Fintech,2016,https://ruizcarterandallen.com,Window piece action participant dinner.,20,ruiz-carter-and-allen,2023,USD,1371264,678217,693047,68563,624484,0,624484,13712,27425,597059,20327,847632,368355,479277,,1371264,773.06,1205.93,0.0338,434,262.95,6984.62,2.91,0.5054
3869,Williams Inc,False,ZA,East Catherineland,EdTech,2021,https://williamsinc.com,Poor actually general window life.,24,williams-inc,2023,USD,8486013,3286900,5199113,2660440,2538673,30150,2508523,84860,169720,2338803,209847,4454506,2796199,1658307,707167.75,8486013,371.53,1751.55,0.048,17222,41.06,219038.6,0.96,0.6127
3870,Jackson-Christian,False,DE,West William,Mobility,2011,https://jackson-christian.com,Doctor arrive degree unit use plant long.,20,jackson-christian,2023,EUR,3323593,1491366,1832227,1277086,555141,16405,538736,33235,66471,472265,379322,2206441,110322,2096119,,3323593,309.48,864.44,0.0026,13848,20.0,108871.25,3.48,0.5513
3871,Stafford-Smith,False,ZA,East Angela,Cybersecurity,2024,https://stafford-smith.com,Play next under bag way president ok force middle task.,20,stafford-smith,2023,USD,676203,267353,408850,128657,280193,26423,253770,6762,13524,240246,111359,588148,432989,155159,,676203,20.0,20.03,0.0476,827,68.12,25218.56,4.42,0.6046
3872,Henry and Sons,False,KE,Martinezfurt,HealthTech,2014,https://henryandsons.com,Give family move itself mind increase set.,27,henry-and-sons,2023,USD,1493940,536202,957738,426597,531141,33088,498053,14939,29878,468175,38795,936685,175918,760767,124495.0,1493940,10.0,10.0,0.0229,1708,72.86,23976.42,1.62,0.6411
3873,Klein Rowe and Daniels,False,KE,North Jason,Marketplaces,2012,https://kleinroweanddaniels.com,Current development choice camera art participant.,23,klein-rowe-and-daniels,2023,USD,2222413,937295,1285118,1356232,-71114,0,-71114,22224,44448,-115562,450482,1700197,1020761,679436,,2222413,20.0,82.89,0.0848,9260,20.0,133543.52,3.37,0.5783
3874,Mcdowell and Sons,False,DE,Rasmussenport,Fintech,2012,https://mcdowellandsons.com,Civil good near pay energy.,25,mcdowell-and-sons,2023,EUR,3034571,718946,2315625,1701460,614165,0,614165,30345,60691,553474,281441,1891688,445912,1445776,,3034571,20.0,59.48,0.001,4311,58.65,167781.39,1.68,0.7631
3875,Mcintosh Martin and Griffith,False,TN,North Anthony,SaaS,2016,https://mcintoshmartinandgriffith.com,Mean positive result role stand.,16,mcintosh-martin-and-griffith,2023,USD,3039654,966841,2072813,835073,1237740,12472,1225268,30396,60793,1164475,29154,1645433,461921,1183512,253304.5,3039654,203.57,678.08,0.001,2324,108.98,73483.7,0.4,0.6819
3876,Maldonado Davis and Young,False,DE,South Jeremiah,HealthTech,2021,https://maldonadodavisandyoung.com,Tough animal of prevent market before test.,24,maldonado-davis-and-young,2023,EUR,513628,123673,389955,126662,263293,5049,258244,5136,10272,247972,16279,427309,246515,180794,42802.33,513628,23.29,116.12,0.0114,518,82.58,4303.05,3.78,0.7592
3877,Waters Valentine and Jones,False,US,Port Michelle,IoT,2014,https://watersvalentineandjones.com,Service image third reveal wide believe describe.,15,waters-valentine-and-jones,2023,USD,685248,271092,414156,250229,163927,19393,144534,6852,13704,130830,22078,371952,200305,171647,,685248,20.0,125.2,0.0496,2855,20.0,27997.15,0.79,0.6044
3878,Kim-Hogan,False,FR,South Brian,SaaS,2020,https://kim-hogan.com,Focus sense seek hospital fact near top boy.,11,kim-hogan,2023,EUR,575626,115582,460044,144167,315877,0,315877,5756,11512,304365,35285,401838,265491,136347,47968.83,575626,10.0,55.46,0.0773,9593,5.0,1000.0,35.28,0.7992
3879,Gomez Spence and Beck,False,TN,Lake Shannonview,AI/ML,2017,https://gomezspenceandbeck.com,Career seem population would country success increase carry plant reflect.,28,gomez-spence-and-beck,2023,USD,1410816,516784,894032,910210,-16178,10916,-27094,14108,28216,-55310,96764,854210,566909,287301,,1410816,1107.13,1998.91,0.001,5878,20.0,78475.4,1.23,0.6337
3880,Green Watkins and Hunt,False,ZA,Port Tiffany,Marketplaces,2015,https://greenwatkinsandhunt.com,First laugh health give threat practice page.,17,green-watkins-and-hunt,2023,USD,298052,101298,196754,114404,82350,0,82350,2980,5961,76389,19906,342050,190021,152029,,298052,1495.41,5061.24,0.0578,125,198.33,1000.0,19.91,0.6601
3881,Smith-Jordan,False,DE,East Thomas,E-commerce,2021,https://smith-jordan.com,Indeed suggest cut sense discover born better.,20,smith-jordan,2023,EUR,684835,207394,477441,417162,60279,6670,53609,6848,13696,39913,41386,452117,128895,323222,,684835,20.0,62.83,0.0991,592,96.26,38792.49,1.07,0.6972
3882,Sanchez-Porter,False,EG,New Vanessahaven,SaaS,2024,https://sanchez-porter.com,South either sign those type hotel.,19,sanchez-porter,2023,USD,3598217,2083533,1514684,2068065,-553381,0,-553381,35982,71964,-625345,296356,2217357,580183,1637174,299851.42,3598217,225.89,1335.63,0.0146,5958,50.32,204113.91,1.45,0.421
3883,Allen Inc,False,TN,South Michael,Marketplaces,2009,https://alleninc.com,Wall market local raise owner how make for.,15,allen-inc,2023,USD,282544,63188,219356,75698,143658,10163,133495,2825,5650,127845,38638,259832,12991,246841,,282544,20.0,42.79,0.0069,144,162.97,20474.58,1.89,0.7764
3884,Garcia Inc,False,IN,West Brandon,Fintech,2016,https://garciainc.com,Option source sister pay share rather data travel party.,8,garcia-inc,2023,USD,23464445,7686707,15777738,16582594,-804856,29132,-833988,234644,469288,-1303276,1658167,13511385,7448802,6062583,,23464445,634.1,1953.64,0.0459,97768,20.0,1368243.14,1.21,0.6724
3885,Myers Alvarez and Mccormick,False,CA,West Jeffery,AgriTech,2019,https://myersalvarezandmccormick.com,Test clearly black foot change sort card including.,21,myers-alvarez-and-mccormick,2023,USD,858744,325710,533034,632221,-99187,17805,-116992,8587,17174,-134166,37655,591179,362949,228230,,858744,811.45,1479.09,0.0352,2041,35.06,51232.26,0.73,0.6207
3886,Blevins PLC,False,ZA,South Jessica,Energy,2015,https://blevinsplc.com,Bed issue on include keep.,16,blevins-plc,2023,USD,5373875,1983834,3390041,2010605,1379436,433,1379003,53738,107477,1271526,268866,2969935,712091,2257844,,5373875,198.37,617.92,0.0218,2862,156.44,157841.68,1.7,0.6308
3887,Conner Inc,False,CA,Banksmouth,SaaS,2013,https://connerinc.com,Operation specific fear main say agency evidence difficult.,15,conner-inc,2023,USD,1215191,322461,892730,60759,831971,22796,809175,12151,24303,784872,306208,1086983,426496,660487,101265.92,1215191,10.0,10.0,0.0124,1003,100.89,1000.0,306.21,0.7346
3888,Mccann Group,False,US,Chapmanmouth,SaaS,2009,https://mccanngroup.com,Big itself least character spend each important town send determine.,21,mccann-group,2023,USD,1137552,429151,708401,711396,-2995,22589,-25584,11375,22751,-48335,30687,642136,379054,263082,94796.0,1137552,10.0,52.56,0.0574,1452,65.28,94584.81,0.32,0.6227
3889,Archer PLC,False,BR,East Jeanne,Cybersecurity,2018,https://archerplc.com,Ok baby matter senior professor half industry performance avoid mean.,22,archer-plc,2023,USD,580218,215936,364282,29010,335272,0,335272,5802,11604,323668,38908,468232,133850,334382,,580218,455.77,227.88,0.001,2417,20.0,1000.0,38.91,0.6278
3890,Spencer-Molina,False,DE,Thomasshire,AgriTech,2023,https://spencer-molina.com,Local detail science bring answer suddenly someone PM left federal.,16,spencer-molina,2023,EUR,1075609,429157,646452,284080,362372,29099,333273,10756,21512,311761,346732,943697,493622,450075,,1075609,20.0,28.96,0.001,4481,20.0,42970.11,8.07,0.601
3891,Mills-Shaffer,False,IN,North Christinemouth,IoT,2011,https://mills-shaffer.com,Put lead program that clear doctor positive simply value prepare hold.,21,mills-shaffer,2023,USD,139340,42702,96638,97506,-868,0,-868,1393,2786,-3654,11270,139273,75998,63275,,139340,1689.82,844.91,0.0458,580,20.0,9837.83,1.15,0.6935
3892,Lin-Velez,False,TN,New Seanberg,HealthTech,2016,https://lin-velez.com,Hour wrong himself positive think run majority still discover heart.,21,lin-velez,2023,USD,104741,45847,58894,66607,-7713,23205,-30918,1047,2094,-33012,22471,120634,46260,74374,8728.42,104741,767.6,3371.17,0.0444,93,92.89,1000.0,22.47,0.5623
3893,Boyer and Sons,False,EG,Allentown,E-commerce,2018,https://boyerandsons.com,So laugh happy either.,29,boyer-and-sons,2023,USD,634022,228943,405079,339412,65667,35412,30255,6340,12680,17575,13363,358553,155623,202930,,634022,871.86,1600.59,0.0625,383,137.87,8856.0,1.51,0.6389
3894,Hansen Wilson and Gonzalez,False,IN,Port Vincent,Fintech,2011,https://hansenwilsonandgonzalez.com,Best least trouble soldier population.,27,hansen-wilson-and-gonzalez,2023,USD,46811,6747,40064,29704,10360,16316,-5956,468,936,-6892,4540,205732,10286,195446,,46811,20.0,61.86,0.0435,195,20.0,11716.32,0.39,0.8559
3895,Cochran Ltd,False,BR,Harperfort,SaaS,2012,https://cochranltd.com,System turn prevent risk Mr I true company increase.,19,cochran-ltd,2023,USD,645145,322652,322493,351300,-28807,42819,-71626,6451,12902,-84528,12391,394786,117022,277764,53762.08,645145,237.56,1175.09,0.0332,487,110.18,59231.58,0.21,0.4999
3896,Perry LLC,False,CA,East Andreatown,E-commerce,2019,https://perryllc.com,Three night certain town conference feeling.,17,perry-llc,2023,USD,1248617,421051,827566,500930,326636,0,326636,12486,24972,301664,15289,663816,263313,400503,,1248617,722.58,2859.14,0.0739,1712,60.77,35214.3,0.43,0.6628
3897,Hamilton-Compton,False,ZA,Nguyenfort,IoT,2024,https://hamilton-compton.com,No huge year support great marriage appear trade.,12,hamilton-compton,2023,USD,305267,104500,200767,253106,-52339,45780,-98119,3052,6105,-104224,56787,235491,60574,174917,,305267,148.66,119.09,0.0653,631,40.3,28369.09,2.0,0.6577
3898,Burnett Harris and Webster,False,KE,East Valerie,E-commerce,2015,https://burnettharrisandwebster.com,Enter performance Republican cost house out lawyer she office half.,14,burnett-harris-and-webster,2023,USD,1569190,674230,894960,375193,519767,3640,516127,15691,31383,484744,29727,951296,340141,611155,,1569190,20.0,10.0,0.0987,2826,46.26,74008.15,0.4,0.5703
3899,Cantrell-Phillips,False,BR,Clarkmouth,AgriTech,2014,https://cantrell-phillips.com,Need energy area radio threat lead reveal up feel child.,17,cantrell-phillips,2023,USD,1211907,294853,917054,663058,253996,15612,238384,12119,24238,214146,187487,946846,288457,658389,,1211907,20.0,65.97,0.0494,5049,20.0,44634.35,4.2,0.7567
3900,Anderson Adams and Baxter,False,KE,Lindsayshire,Energy,2010,https://andersonadamsandbaxter.com,Learn order economy likely may subject back investment.,16,anderson-adams-and-baxter,2023,USD,2997751,577938,2419813,1679626,740187,3504,736683,29977,59955,676728,237718,1878167,1155079,723088,,2997751,470.77,443.25,0.0322,12490,20.0,148427.76,1.6,0.8072
3901,Williams Hall and Espinoza,False,FR,North Sandymouth,HealthTech,2011,https://williamshallandespinoza.com,Likely I walk another condition add possible economic record final.,17,williams-hall-and-espinoza,2023,EUR,407854,188841,219013,318525,-99512,0,-99512,4078,8157,-107669,53092,348380,35841,312539,33987.83,407854,10.0,75.92,0.001,6797,5.0,14867.08,3.57,0.537
3902,Robinson and Sons,False,US,East Matthew,IoT,2014,https://robinsonandsons.com,Cell own big yeah will pressure.,22,robinson-and-sons,2023,USD,324574,131045,193529,103284,90245,3776,86469,3245,6491,79978,34720,267180,103024,164156,,324574,2109.94,4251.6,0.0411,1352,20.0,1000.0,34.72,0.5963
3903,Lopez-Garrett,False,DE,Lake Nicole,Cybersecurity,2022,https://lopez-garrett.com,College election spend star.,13,lopez-garrett,2023,EUR,169898,52118,117780,153201,-35421,37574,-72995,1698,3397,-76392,3482,198287,9914,188373,,169898,20.0,81.83,0.0388,271,52.21,10106.93,0.34,0.6932
3904,King Miller and Lopez,False,FR,Cookstad,Fintech,2018,https://kingmillerandlopez.com,Forget finish know hope indeed party.,15,king-miller-and-lopez,2023,EUR,3440360,1487045,1953315,1437699,515616,394,515222,34403,68807,446415,859232,2673847,1332734,1341113,,3440360,1543.87,2365.0,0.0523,2297,124.76,114479.17,7.51,0.5678
3905,Fisher PLC,False,IN,Anthonyburgh,Cybersecurity,2023,https://fisherplc.com,Challenge until speak have win check why professional.,14,fisher-plc,2023,USD,613784,113388,500396,99126,401270,7430,393840,6137,12275,381565,207624,592094,331351,260743,,613784,194.44,523.09,0.0654,181,282.28,12078.38,17.19,0.8153
3906,Dawson Inc,False,AU,Heathertown,EdTech,2012,https://dawsoninc.com,Big door concern matter hand more perform laugh.,18,dawson-inc,2023,USD,399052,93947,305105,222821,82284,0,82284,3990,7981,74303,72547,350396,151971,198425,33254.33,399052,249.34,308.18,0.001,487,68.18,1000.0,72.55,0.7646
3907,Hopkins Li and Smith,False,US,New Ashleebury,HealthTech,2014,https://hopkinsliandsmith.com,Author election official manager prevent difference instead interest what.,19,hopkins-li-and-smith,2023,USD,309369,152656,156713,93423,63290,0,63290,3093,6187,57103,4573,349450,83219,266231,25780.75,309369,527.1,3383.5,0.001,1433,17.98,1000.0,4.57,0.5066
3908,Mcdowell Group,False,TN,Robertsonside,AI/ML,2016,https://mcdowellgroup.com,Country beyond popular leave suggest.,26,mcdowell-group,2023,USD,675686,100701,574985,183175,391810,3351,388459,6756,13513,374946,15505,355265,93326,261939,,675686,20.0,47.54,0.0242,346,162.39,2015.95,7.69,0.851
3909,French Rogers and Nixon,False,AU,Cookhaven,AI/ML,2019,https://frenchrogersandnixon.com,Future room edge Congress student later weight discover season leg seven.,16,french-rogers-and-nixon,2023,USD,1180103,338348,841755,974201,-132446,4149,-136595,11801,23602,-160197,20316,728787,264337,464450,,1180103,826.28,4355.93,0.001,4917,20.0,106035.62,0.19,0.7133
3910,Harris-Hahn,False,CA,Port Anthonyland,Mobility,2011,https://harris-hahn.com,Property spend close traditional simple individual rate.,16,harris-hahn,2023,USD,674945,180079,494866,357400,137466,0,137466,6749,13498,123968,27775,392728,92955,299773,,674945,83.4,41.7,0.001,2812,20.0,38864.44,0.71,0.7332
3911,Eaton Reid and Martinez,False,TN,Port Josephberg,Fintech,2023,https://eatonreidandmartinez.com,Sport use almost wide that necessary.,18,eaton-reid-and-martinez,2023,USD,2222501,418252,1804249,979702,824547,16893,807654,22225,44450,763204,650730,1807232,663867,1143365,,2222501,20.0,44.86,0.001,2043,90.63,83294.77,7.81,0.8118
3912,Diaz-Brooks,False,TN,East Jordan,AI/ML,2024,https://diaz-brooks.com,Model past fear cold behavior tonight just executive light.,26,diaz-brooks,2023,USD,683963,183152,500811,126511,374300,25334,348966,6839,13679,335287,29150,417884,201112,216772,,683963,973.18,3005.57,0.0039,2849,20.0,1000.0,29.15,0.7322
3913,Robinson-Miles,False,AU,Lake Courtneyville,SaaS,2013,https://robinson-miles.com,Think attorney upon ten concern difficult break ok.,16,robinson-miles,2023,USD,6471497,2223764,4247733,3310732,937001,0,937001,64714,129429,807572,130011,3431509,1753847,1677662,539291.42,6471497,346.45,742.23,0.001,6256,86.2,268284.24,0.48,0.6564
3914,Moses King and Wells,False,KE,Ewingmouth,AgriTech,2012,https://moseskingandwells.com,Any foreign Republican remain although forward himself.,9,moses-king-and-wells,2023,USD,881912,192326,689586,325436,364150,15651,348499,8819,17638,330861,36425,531490,269090,262400,,881912,613.76,1585.89,0.1107,577,127.31,30070.29,1.21,0.7819
3915,Martinez-Cole,False,IN,Clarkton,SaaS,2009,https://martinez-cole.com,North toward special enjoy dinner similar himself responsibility.,23,martinez-cole,2023,USD,657648,306467,351181,263150,88031,4372,83659,6576,13152,70507,26803,540785,362369,178416,54804.0,657648,162.74,576.33,0.0215,1043,52.51,38909.57,0.69,0.534
3916,Durham Ltd,False,AU,Port Kristinemouth,Cybersecurity,2014,https://durhamltd.com,Treat necessary political official capital.,17,durham-ltd,2023,USD,478202,57390,420812,383844,36968,0,36968,4782,9564,27404,26578,328316,57487,270829,,478202,1809.32,904.66,0.0521,544,73.22,23447.06,1.13,0.88
3917,Harris Garza and Thomas,False,ZA,East Natalie,Energy,2023,https://harrisgarzaandthomas.com,Education focus record describe your.,19,harris-garza-and-thomas,2023,USD,1399414,165759,1233655,718701,514954,11746,503208,13994,27988,475220,321218,1040816,655136,385680,,1399414,310.67,1175.19,0.1077,1160,100.51,39962.32,8.04,0.8816
3918,Bonilla-Crawford,False,BR,Jameschester,AI/ML,2024,https://bonilla-crawford.com,Mean could ever but of step.,13,bonilla-crawford,2023,USD,1209417,403081,806336,324032,482304,0,482304,12094,24188,458116,197917,967568,48378,919190,,1209417,20.0,60.94,0.0621,1232,81.78,26749.0,7.4,0.6667
3919,Alexander Sutton and Thomas,False,FR,Masonfurt,HealthTech,2022,https://alexandersuttonandthomas.com,Person drop here themselves population child message cultural role.,24,alexander-sutton-and-thomas,2023,EUR,280452,139109,141343,167059,-25716,0,-25716,2804,5609,-31325,21776,327471,91270,236201,23371.0,280452,46.25,286.81,0.0133,2249,10.39,37336.06,0.58,0.504
3920,Nichols-Alexander,False,AU,Osbornestad,AI/ML,2020,https://nichols-alexander.com,With second card style yeah various paper throw.,25,nichols-alexander,2023,USD,231182,78624,152558,165935,-13377,0,-13377,2311,4623,-18000,12387,179339,8966,170373,,231182,706.87,974.19,0.1081,963,20.0,35529.93,0.35,0.6599
3921,Mueller-Moore,False,NG,North Austinmouth,Energy,2020,https://mueller-moore.com,Bad task free speak line network.,24,mueller-moore,2023,USD,943463,498577,444886,678262,-233376,2422,-235798,9434,18869,-254667,9275,549900,27495,522405,,943463,178.7,834.53,0.1689,192,408.58,56664.94,0.16,0.4715
3922,Austin-Webster,False,KE,West Charles,AgriTech,2014,https://austin-webster.com,Parent place range mind across collection.,12,austin-webster,2023,USD,177939,90636,87303,116262,-28959,25213,-54172,1779,3558,-57730,4258,172606,62516,110090,,177939,280.75,182.3,0.0703,741,20.0,16483.28,0.26,0.4906
3923,Pierce Ltd,False,GB,Courtneyview,SaaS,2013,https://pierceltd.com,Per floor street face green south food end military.,25,pierce-ltd,2023,USD,2059274,1236006,823268,1433568,-610300,8130,-618430,20592,41185,-659615,76476,1176831,79562,1097269,171606.17,2059274,781.15,4484.46,0.0419,3856,44.5,149061.64,0.51,0.3998
3924,Burke-Foley,False,KE,South Audreyport,EdTech,2008,https://burke-foley.com,Often nature middle music paper official perform.,22,burke-foley,2023,USD,164202,89046,75156,98177,-23021,0,-23021,1642,3284,-26305,32967,282894,27849,255045,13683.5,164202,557.88,1957.49,0.0104,124,110.23,1000.0,32.97,0.4577
3925,Cline Torres and Ramirez,False,AU,South Benjaminfurt,AI/ML,2022,https://clinetorresandramirez.com,Series alone player other any quickly car wish money pay.,18,cline-torres-and-ramirez,2023,USD,2419649,715830,1703819,1261184,442635,0,442635,24196,48392,394243,20538,1263180,270479,992701,,2419649,20.0,88.85,0.0378,2003,100.65,102939.9,0.2,0.7042
3926,Melendez Group,False,NG,Jimenezton,Cybersecurity,2024,https://melendezgroup.com,Western me bed discover clear oil deal well something let.,15,melendez-group,2023,USD,1286315,274728,1011587,609799,401788,0,401788,12863,25726,376062,151479,960664,379040,581624,,1286315,1323.33,7827.17,0.001,5359,20.0,62139.71,2.44,0.7864
3927,Reed PLC,False,IN,Lanestad,AgriTech,2015,https://reedplc.com,Must big sing view receive onto billion.,22,reed-plc,2023,USD,273427,185762,87665,139179,-51514,0,-51514,2734,5468,-56982,27339,359024,204097,154927,,273427,2259.41,8659.57,0.082,307,73.99,1000.0,27.34,0.3206
3928,Thomas and Sons,False,IN,East Jacqueline,Cybersecurity,2016,https://thomasandsons.com,Serious meeting employee population world admit serious institution main concern.,25,thomas-and-sons,2023,USD,1088549,287141,801408,581294,220114,23519,196595,10885,21770,174825,58702,732980,274254,458726,,1088549,20.0,10.0,0.032,3611,25.12,73164.94,0.8,0.7362
3929,Anderson Inc,False,NG,Lake Marymouth,Fintech,2013,https://andersoninc.com,Prepare financial turn sell address quality series.,27,anderson-inc,2023,USD,820328,249984,570344,224665,345679,0,345679,8203,16406,329273,15122,526994,207802,319192,,820328,1125.55,6255.34,0.0598,215,316.78,31355.25,0.48,0.6953
3930,Jones Gregory and Jones,False,DE,North Troybury,SaaS,2015,https://jonesgregoryandjones.com,Machine oil season discuss wait plant friend believe field.,23,jones-gregory-and-jones,2023,EUR,1208760,525107,683653,294893,388760,0,388760,12087,24175,364585,21864,734870,293909,440961,100730.0,1208760,135.98,803.46,0.1185,789,127.57,34099.68,0.64,0.5656
3931,Smith-Lee,False,IN,Jacksonport,SaaS,2012,https://smith-lee.com,During concern push fear exist.,24,smith-lee,2023,USD,1347333,423963,923370,170339,753031,20610,732421,13473,26946,705475,51072,814393,243086,571307,112277.75,1347333,426.58,1049.59,0.0396,2895,38.78,1000.0,51.07,0.6853
3932,Garcia Inc,False,IN,Peterschester,HealthTech,2016,https://garciainc.com,Tonight series customer attorney front station.,15,garcia-inc,2023,USD,1165487,327707,837780,796652,41128,0,41128,11654,23309,17819,298799,1064399,170865,893534,97123.92,1165487,427.54,571.66,0.0617,1497,64.87,57382.82,5.21,0.7188
3933,Moore Inc,False,AU,Johnburgh,SaaS,2015,https://mooreinc.com,With movie interesting lead generation fall time whom staff sign.,20,moore-inc,2023,USD,3348328,720474,2627854,167416,2460438,31557,2428881,33483,66966,2361915,90298,1922096,1189732,732364,279027.33,3348328,348.0,2137.74,0.0354,4703,59.32,1000.0,90.3,0.7848
3934,Reyes and Sons,False,DE,North Ashley,AI/ML,2011,https://reyesandsons.com,Season image stuff course this together process ability modern water.,23,reyes-and-sons,2023,EUR,528048,78434,449614,158703,290911,3367,287544,5280,10560,276984,36107,463425,201053,262372,,528048,1135.53,567.76,0.0435,2200,20.0,15914.7,2.27,0.8515
3935,Jones LLC,False,US,Rodriguezhaven,Marketplaces,2019,https://jonesllc.com,Third arm pick clear recently direction perform entire hope.,24,jones-llc,2023,USD,1904504,337422,1567082,1468485,98597,25518,73079,19045,38090,34989,362315,1463360,160823,1302537,,1904504,96.33,256.19,0.0754,1105,143.53,127899.2,2.83,0.8228
3936,Deleon Davis and Costa,False,BR,Ramirezmouth,IoT,2019,https://deleondavisandcosta.com,Meet military compare center enter.,19,deleon-davis-and-costa,2023,USD,673612,142693,530919,405971,124948,0,124948,6736,13472,111476,143848,641758,112612,529146,,673612,2087.34,1043.67,0.106,2806,20.0,45099.11,3.19,0.7882
3937,Weber PLC,False,CA,Yorkport,Fintech,2016,https://weberplc.com,Question make we eat church ten option resource page.,27,weber-plc,2023,USD,2290946,400649,1890297,473125,1417172,0,1417172,22909,45818,1371354,13732,1216296,423601,792695,,2290946,559.09,279.54,0.0775,5738,33.27,38861.71,0.35,0.8251
3938,Miller Hall and Torres,False,ZA,South Charlesfurt,HealthTech,2021,https://millerhallandtorres.com,Population identify group open treat treatment edge he under return image.,28,miller-hall-and-torres,2023,USD,1291144,414495,876649,309181,567468,7288,560180,12911,25822,534358,174228,1008114,227535,780579,107595.33,1291144,206.7,621.68,0.0029,1360,79.11,38346.19,4.54,0.679
3939,Wade-Jackson,False,KE,Port Nicoleshire,AgriTech,2018,https://wade-jackson.com,Current whom pick mission sell.,12,wade-jackson,2023,USD,226085,69614,156471,149503,6968,35673,-28705,2260,4521,-33226,9766,273048,115779,157269,,226085,20.0,52.36,0.0597,173,108.81,34300.69,0.28,0.6921
3940,Hubbard PLC,False,US,East Lukefurt,Marketplaces,2008,https://hubbardplc.com,Bar kind little answer run around.,19,hubbard-plc,2023,USD,1855474,737068,1118406,554429,563977,14967,549010,18554,37109,511901,24098,1110273,300534,809739,,1855474,20.0,162.18,0.0456,2022,76.44,26883.44,0.9,0.6028
3941,Adams LLC,False,CA,Lake Erica,EdTech,2016,https://adamsllc.com,Heart institution that area identify east these agree.,17,adams-llc,2023,USD,343346,51933,291413,212163,79250,17910,61340,3433,6866,54474,29844,223262,111060,112202,28612.17,343346,275.4,962.21,0.0051,726,39.39,15966.58,1.87,0.8487
3942,Torres Group,False,GB,Bonillatown,AgriTech,2008,https://torresgroup.com,Simple design subject pattern lose more left local.,19,torres-group,2023,USD,383500,134688,248812,297767,-48955,15157,-64112,3835,7670,-71782,4744,272530,13626,258904,,383500,475.81,401.54,0.001,1597,20.0,9548.71,0.5,0.6488
3943,Mcguire-Morrison,False,NG,South Thomas,Marketplaces,2011,https://mcguire-morrison.com,Treat control sign computer either lot find reality computer.,26,mcguire-morrison,2023,USD,934451,360319,574132,223608,350524,22571,327953,9344,18689,309264,135767,685824,359833,325991,,934451,192.35,577.3,0.1282,437,177.82,17913.24,7.58,0.6144
3944,Estrada Bowman and Townsend,False,ZA,East Karenhaven,Cybersecurity,2020,https://estradabowmanandtownsend.com,Interview black evidence research partner stuff.,11,estrada-bowman-and-townsend,2023,USD,1595947,927956,667991,133892,534099,6042,528057,15959,31918,496139,23990,879211,329979,549232,,1595947,192.52,605.02,0.025,3289,40.43,19452.69,1.23,0.4186
3945,West-Bradley,False,BR,Donnahaven,AgriTech,2014,https://west-bradley.com,Old realize also religious business.,23,west-bradley,2023,USD,443851,282168,161683,22192,139491,0,139491,4438,8877,130614,10528,322879,16143,306736,,443851,460.91,681.68,0.0398,316,116.78,2026.77,5.19,0.3643
3946,Reed-Stuart,False,EG,West Robinside,EdTech,2018,https://reed-stuart.com,Line worker century social view me entire author her.,22,reed-stuart,2023,USD,261948,130835,131113,142438,-11325,13716,-25041,2619,5238,-30279,27894,322536,131987,190549,21829.0,261948,506.44,3384.58,0.0417,1144,19.07,7688.06,3.63,0.5005
3947,Hill Inc,False,IN,Reedfurt,EdTech,2020,https://hillinc.com,Create talk recognize site school throughout attorney consumer from book social.,21,hill-inc,2023,USD,581653,109450,472203,160237,311966,51390,260576,5816,11633,248943,15244,320820,187440,133380,48471.08,581653,10.0,10.0,0.0473,1382,35.07,1000.0,15.24,0.8118
3948,Johnson Webb and Fisher,False,GB,Stevenfort,Mobility,2015,https://johnsonwebbandfisher.com,Box watch heart catch.,16,johnson-webb-and-fisher,2023,USD,5106149,2195807,2910342,2340247,570095,10819,559276,51061,102122,457154,155229,2736998,149147,2587851,,5106149,20.0,10.0,0.0724,21275,20.0,219411.27,0.71,0.57
3949,Dyer and Sons,False,ZA,East Omar,Cybersecurity,2021,https://dyerandsons.com,Yeah hundred should purpose authority speech music former hit.,17,dyer-and-sons,2023,USD,8560758,3110925,5449833,7158719,-1708886,2211,-1711097,85607,171215,-1882312,376342,4749521,1305291,3444230,,8560758,682.57,1135.34,0.1092,35669,20.0,608886.15,0.62,0.6366
3950,Pineda LLC,False,CA,Michellestad,HealthTech,2023,https://pinedallc.com,Class word find nation not.,26,pineda-llc,2023,USD,480092,164301,315791,263236,52555,2908,49647,4800,9601,40046,9727,412116,118781,293335,40007.67,480092,165.89,393.97,0.001,6515,6.14,44568.28,0.22,0.6578
3951,Robinson-Arnold,False,FR,Devinton,Mobility,2013,https://robinson-arnold.com,Sure arm still smile second we run politics.,16,robinson-arnold,2023,EUR,2341772,906401,1435371,869169,566202,36815,529387,23417,46835,482552,158906,1506145,1062591,443554,,2341772,399.08,2517.6,0.048,1003,194.47,80342.45,1.98,0.6129
3952,Smith-Hawkins,False,EG,New Leslieburgh,HealthTech,2013,https://smith-hawkins.com,Deep policy president be yes personal east.,17,smith-hawkins,2023,USD,2788867,793327,1995540,1496806,498734,14747,483987,27888,55777,428210,210171,1800830,529411,1271419,232405.58,2788867,10.0,46.72,0.001,3593,64.68,140361.35,1.5,0.7155
3953,Arroyo Group,False,DE,East Danielchester,IoT,2023,https://arroyogroup.com,See I professor analysis stand participant wait consider these behavior.,18,arroyo-group,2023,EUR,358598,61718,296880,169599,127281,8057,119224,3585,7171,112053,4704,248614,58227,190387,,358598,1733.7,3866.18,0.0931,236,126.13,1000.0,4.7,0.8279
3954,Hunter Long and Bailey,False,ZA,Daltonshire,HealthTech,2017,https://hunterlongandbailey.com,Step lot book she toward.,25,hunter-long-and-bailey,2023,USD,973637,452248,521389,562390,-41001,11862,-52863,9736,19472,-72335,97395,651792,32589,619203,81136.42,973637,302.76,1288.62,0.0385,976,83.06,66436.15,1.47,0.5355
3955,Esparza-Lowe,False,US,South Linda,AgriTech,2013,https://esparza-lowe.com,Firm newspaper development help seven.,24,esparza-lowe,2023,USD,178432,83172,95260,62778,32482,16788,15694,1784,3568,12126,58334,190399,91794,98605,,178432,1603.5,801.75,0.0665,743,20.0,22149.25,2.63,0.5339
3956,Mitchell-Gonzalez,False,GB,Haynesbury,Energy,2014,https://mitchell-gonzalez.com,Do poor involve wall natural.,19,mitchell-gonzalez,2023,USD,2932939,862878,2070061,146646,1923415,7791,1915624,29329,58658,1856966,61285,1675470,721950,953520,,2932939,1738.02,6344.15,0.001,1385,176.4,3810.66,16.08,0.7058
3957,Burnett-Solis,False,FR,Dennisland,HealthTech,2010,https://burnett-solis.com,Should value human population thus.,17,burnett-solis,2023,EUR,1151182,493962,657220,391810,265410,9722,255688,11511,23023,232665,14215,616480,84341,532139,95931.83,1151182,10.0,42.6,0.001,19186,5.0,50576.05,0.28,0.5709
3958,Carlson Group,False,TN,Emilystad,EdTech,2022,https://carlsongroup.com,Memory support individual several rule away usually citizen wear.,19,carlson-group,2023,USD,85319,21684,63635,26850,36785,0,36785,853,1706,35079,45480,109366,62891,46475,7109.92,85319,101.2,576.2,0.024,1421,5.0,1000.0,45.48,0.7458
3959,Castaneda-Glenn,False,BR,Kaitlynfort,Energy,2011,https://castaneda-glenn.com,Admit factor must agreement lead marriage Republican.,10,castaneda-glenn,2023,USD,1045503,542218,503285,368873,134412,32322,102090,10455,20910,81180,152502,740890,331887,409003,,1045503,50.72,72.1,0.0518,1178,73.95,53639.5,2.84,0.4814
3960,Duffy Group,False,ZA,North Daniel,AI/ML,2012,https://duffygroup.com,Today interview so once house health site check little themselves.,26,duffy-group,2023,USD,2928660,697183,2231477,1730604,500873,2748,498125,29286,58573,439552,74041,1717104,374526,1342578,,2928660,534.34,2953.04,0.116,890,273.93,142197.25,0.52,0.7619
3961,Myers Peters and Bartlett,False,ZA,Jamesside,SaaS,2011,https://myerspetersandbartlett.com,No step successful read against hot mission blood field.,13,myers-peters-and-bartlett,2023,USD,470757,158392,312365,207418,104947,18170,86777,4707,9415,77362,21090,373929,188947,184982,39229.75,470757,265.93,695.15,0.001,794,49.39,21156.09,1.0,0.6635
3962,Macdonald-Gomez,False,TN,Staceymouth,Energy,2008,https://macdonald-gomez.com,Need assume plan response official other.,18,macdonald-gomez,2023,USD,2888737,964204,1924533,1477954,446579,13177,433402,28887,57774,375628,131550,1717921,412588,1305333,,2888737,898.52,5065.67,0.0134,878,273.92,126139.86,1.04,0.6662
3963,Day-Moreno,False,FR,Sarahland,SaaS,2009,https://day-moreno.com,Power by smile dinner claim loss.,20,day-moreno,2023,EUR,4881410,1389315,3492095,2291016,1201079,23276,1177803,48814,97628,1080175,389291,2967788,1246072,1721716,406784.17,4881410,139.67,712.82,0.001,3620,112.35,197206.58,1.97,0.7154
3964,Lewis-Jacobson,False,GB,Dawsonport,EdTech,2010,https://lewis-jacobson.com,Material will state late model quite himself on impact world.,21,lewis-jacobson,2023,USD,285840,51404,234436,152289,82147,19092,63055,2858,5716,57339,7069,321744,213000,108744,23820.0,285840,22.44,54.59,0.001,217,109.38,1000.0,7.07,0.8202
3965,Rodriguez-Tyler,False,IN,Lake Sarahstad,HealthTech,2008,https://rodriguez-tyler.com,Entire ok blue plant toward pay sign.,23,rodriguez-tyler,2023,USD,933016,334152,598864,255079,343785,0,343785,9330,18660,325125,12849,570394,83359,487035,77751.33,933016,328.4,745.75,0.0435,1989,39.09,20321.17,0.63,0.6419
3966,Wilson-Lara,False,AU,Robertborough,SaaS,2011,https://wilson-lara.com,Start around anyone brother open though spend.,27,wilson-lara,2023,USD,4089278,1214587,2874691,2159231,715460,14480,700980,40892,81785,619195,143473,2278505,1004215,1274290,340773.17,4089278,660.59,2046.6,0.0134,16614,20.51,181204.21,0.79,0.703
3967,Hamilton Group,False,NG,Mcleanburgh,Cybersecurity,2018,https://hamiltongroup.com,Small mean strong woman Democrat special concern two window.,22,hamilton-group,2023,USD,208304,85557,122747,146200,-23453,26956,-50409,2083,4166,-54575,46424,176685,141314,35371,,208304,20.0,81.37,0.094,386,44.95,47394.84,0.98,0.5893
3968,Brown Group,False,ZA,West James,Fintech,2014,https://browngroup.com,Matter author call animal issue news past citizen learn yard.,22,brown-group,2023,USD,1252266,481565,770701,250892,519809,208,519601,12522,25045,494556,43366,833606,166588,667018,,1252266,20.0,10.0,0.019,5217,20.0,33630.51,1.29,0.6154
3969,Richards-Little,False,GB,Shaffertown,Mobility,2022,https://richards-little.com,Citizen step myself weight should.,21,richards-little,2023,USD,2051114,1117475,933639,1520779,-587140,41840,-628980,20511,41022,-670002,126601,1279661,588129,691532,,2051114,20.0,73.97,0.0676,577,296.21,124853.44,1.01,0.4552
3970,Mack Jennings and Carter,False,GB,Hilltown,AgriTech,2018,https://mackjenningsandcarter.com,Rate goal ability policy question girl coach forward customer.,25,mack-jennings-and-carter,2023,USD,228377,56992,171385,125047,46338,0,46338,2283,4567,41771,4788,293988,106083,187905,,228377,386.12,1262.34,0.0383,194,97.64,1000.0,4.79,0.7504
3971,Green LLC,False,EG,Nealhaven,HealthTech,2015,https://greenllc.com,Move song peace change television tend with adult.,23,green-llc,2023,USD,826399,352585,473814,549672,-75858,0,-75858,8263,16527,-92385,15330,477684,257347,220337,68866.58,826399,86.19,169.81,0.0657,525,131.03,42861.34,0.36,0.5733
3972,Mcintosh-Reed,False,US,Lucasport,AI/ML,2016,https://mcintosh-reed.com,Father career argue medical wait.,20,mcintosh-reed,2023,USD,145151,24472,120679,115968,4711,0,4711,1451,2903,1808,3302,141667,93912,47755,,145151,515.89,257.94,0.007,47,254.97,4275.63,0.77,0.8314
3973,Gillespie and Sons,False,BR,Lake Nicholasside,AI/ML,2011,https://gillespieandsons.com,Summer common under agree strong investment modern line social.,14,gillespie-and-sons,2023,USD,203015,70238,132777,44151,88626,0,88626,2030,4060,84566,5168,126928,46190,80738,,203015,483.19,1453.54,0.0429,149,113.5,1000.0,5.17,0.654
3974,Lara Vance and Grant,False,US,Bishopberg,SaaS,2011,https://laravanceandgrant.com,Ball its board dog enter recent.,24,lara-vance-and-grant,2023,USD,1613633,782486,831147,823176,7971,37095,-29124,16136,32272,-61396,50928,871318,200118,671200,134469.42,1613633,307.27,2050.47,0.0677,26893,5.0,43060.77,1.18,0.5151
3975,Perez Khan and Drake,False,NG,Lake Juliaville,AgriTech,2011,https://perezkhananddrake.com,Prove group staff big different sometimes reflect cold.,16,perez-khan-and-drake,2023,USD,170766,38080,132686,8538,124148,0,124148,1707,3415,120733,10757,106526,8893,97633,,170766,754.12,4118.33,0.071,64,222.2,1000.0,10.76,0.777
3976,Chung Inc,False,NG,Boyertown,Energy,2012,https://chunginc.com,Beyond tax remember guy them unit.,19,chung-inc,2023,USD,1382900,315322,1067578,1328184,-260606,0,-260606,13829,27658,-288264,62231,768703,250069,518634,,1382900,824.4,3425.11,0.001,2219,51.93,85391.87,0.73,0.772
3977,Guzman LLC,False,US,Pierceport,EdTech,2008,https://guzmanllc.com,Natural reason however serious worker next employee know administration scientist.,20,guzman-llc,2023,USD,654330,194507,459823,330125,129698,12212,117486,6543,13086,104400,67858,470280,23514,446766,54527.5,654330,10.0,35.56,0.0295,10905,5.0,15076.72,4.5,0.7027
3978,Vaughn Turner and Clark,False,DE,Justinville,Energy,2020,https://vaughnturnerandclark.com,State heavy summer become while huge because color within.,11,vaughn-turner-and-clark,2023,EUR,850355,388694,461661,446888,14773,0,14773,8503,17007,-2234,76598,540866,153939,386927,,850355,20.0,92.25,0.0542,555,127.48,29995.07,2.55,0.5429
3979,Boyle Oliver and Smith,False,GB,Patrickland,E-commerce,2017,https://boyleoliverandsmith.com,Shake care bill fund source.,17,boyle-oliver-and-smith,2023,USD,773795,256184,517611,38689,478922,50572,428350,7737,15475,412875,13810,486051,283723,202328,,773795,20.0,75.65,0.0287,647,99.65,4068.77,3.39,0.6689
3980,Smith Hawkins and Hernandez,False,DE,Gregorymouth,Marketplaces,2020,https://smithhawkinsandhernandez.com,Role per suddenly movement upon.,19,smith-hawkins-and-hernandez,2023,EUR,451720,222368,229352,149862,79490,2467,77023,4517,9034,67989,17326,362414,104740,257674,,451720,874.3,1115.47,0.0671,1882,20.0,6186.17,2.8,0.5077
3981,Morrison LLC,False,BR,Courtneyland,Cybersecurity,2011,https://morrisonllc.com,Program like cost teacher over during even single.,20,morrison-llc,2023,USD,1936861,777119,1159742,994960,164782,0,164782,19368,38737,126045,44727,1053626,170508,883118,,1936861,20.0,10.0,0.043,1295,124.63,84450.66,0.53,0.5988
3982,Miller PLC,False,EG,Brendastad,HealthTech,2011,https://millerplc.com,Long book share just hour than.,23,miller-plc,2023,USD,578471,135152,443319,374278,69041,0,69041,5784,11569,57472,40081,460607,159756,300851,48205.92,578471,597.86,3616.63,0.001,916,52.58,25300.77,1.58,0.7664
3983,Livingston-Lopez,False,DE,East Williammouth,Fintech,2017,https://livingston-lopez.com,Record whether might by benefit.,19,livingston-lopez,2023,EUR,1298025,544218,753807,607258,146549,13738,132811,12980,25960,106851,46438,764006,110362,653644,,1298025,332.0,1097.53,0.0743,467,231.59,52779.54,0.88,0.5807
3984,Bradley Trujillo and Carpenter,False,CA,East Howard,Fintech,2018,https://bradleytrujilloandcarpenter.com,Concern then effort tax agree score it toward beat generation.,19,bradley-trujillo-and-carpenter,2023,USD,2558952,783085,1775867,1399009,376858,0,376858,25589,51179,325679,1073261,2363275,118163,2245112,,2558952,20.0,111.07,0.001,2174,98.07,120277.86,8.92,0.694
3985,Thompson Anderson and Williams,False,FR,Wilcoxview,E-commerce,2010,https://thompsonandersonandwilliams.com,Hit necessary security night give they read budget detail source.,25,thompson-anderson-and-williams,2023,EUR,1017878,344136,673742,538241,135501,0,135501,10178,20357,115144,30492,618260,242854,375406,,1017878,1069.37,3332.86,0.1504,694,122.17,46670.31,0.65,0.6619
3986,Erickson and Sons,False,US,Michaelton,IoT,2012,https://ericksonandsons.com,Baby company money although including space later message.,15,erickson-and-sons,2023,USD,64048,19705,44343,10286,34057,0,34057,640,1280,32777,4510,113501,5675,107826,,64048,20.0,39.55,0.1397,266,20.0,6413.09,0.7,0.6923
3987,Snyder Rodriguez and Peterson,False,GB,Scottborough,Energy,2024,https://snyderrodriguezandpeterson.com,Work choice arrive through yeah less.,21,snyder-rodriguez-and-peterson,2023,USD,242464,58557,183907,63738,120169,0,120169,2424,4849,115320,41662,168826,81376,87450,,242464,20.0,123.04,0.0128,84,239.13,31557.78,1.32,0.7585
3988,Walker Cox and Miranda,False,CA,West Timothy,IoT,2013,https://walkercoxandmiranda.com,Road smile look pressure offer over record remain second.,21,walker-cox-and-miranda,2023,USD,1194634,429682,764952,140671,624281,0,624281,11946,23892,600389,651281,1254176,704689,549487,,1194634,693.37,365.57,0.1245,4977,20.0,3075.2,211.78,0.6403
3989,Gilbert Avila and Lamb,False,BR,Port Chadmouth,Energy,2012,https://gilbertavilaandlamb.com,Trial power direction anything reduce rich.,16,gilbert-avila-and-lamb,2023,USD,532926,164181,368745,26646,342099,0,342099,5329,10658,331441,27100,310842,114277,196565,,532926,405.87,202.94,0.0173,2220,20.0,1000.0,27.1,0.6919
3990,Burns-Hughes,False,BR,Whitefort,Marketplaces,2017,https://burns-hughes.com,Character room bad size individual.,22,burns-hughes,2023,USD,533027,259731,273296,300877,-27581,7460,-35041,5330,10660,-45701,93507,490613,317715,172898,,533027,1080.3,2766.01,0.0634,2072,21.43,1000.0,93.51,0.5127
3991,Smith and Sons,False,KE,New Jamieburgh,AgriTech,2019,https://smithandsons.com,Share who official fight.,20,smith-and-sons,2023,USD,749099,138342,610757,369228,241529,1411,240118,7490,14981,225137,13007,562183,341277,220906,,749099,578.62,2250.25,0.0895,3121,20.0,40126.81,0.32,0.8153
3992,Walsh PLC,False,FR,New Lindsey,AgriTech,2023,https://walshplc.com,Successful site song easy bed attention thing.,20,walsh-plc,2023,EUR,197547,70483,127064,32499,94565,0,94565,1975,3950,90615,32557,251892,157360,94532,,197547,20.0,29.01,0.088,63,259.56,1000.0,32.56,0.6432
3993,Jackson Brown and Short,False,BR,East Briannaberg,E-commerce,2016,https://jacksonbrownandshort.com,Must line conference late leave decision wall security few table.,19,jackson-brown-and-short,2023,USD,3570158,1338384,2231774,1204456,1027318,12231,1015087,35701,71403,943684,341579,2224468,111223,2113245,,3570158,591.89,672.49,0.0439,2173,136.86,69960.18,4.88,0.6251
3994,Harrison Ross and Mosley,False,AU,North Joycefort,Cybersecurity,2010,https://harrisonrossandmosley.com,Pattern example responsibility then say paper leg situation chance.,19,harrison-ross-and-mosley,2023,USD,803407,494257,309150,206416,102734,0,102734,8034,16068,86666,203578,633700,142719,490981,,803407,20.0,35.5,0.1012,868,77.08,1000.0,203.58,0.3848
3995,Wilkinson PLC,False,AU,East Rosemouth,SaaS,2012,https://wilkinsonplc.com,We difficult technology leave possible economy pull.,29,wilkinson-plc,2023,USD,8660403,2316837,6343566,1476259,4867307,0,4867307,86604,173208,4694099,838199,5203774,2267356,2936418,721700.25,8660403,333.58,1064.56,0.001,144340,5.0,96902.91,8.65,0.7325
3996,Stokes-Martinez,False,AU,Johnnyburgh,Marketplaces,2012,https://stokes-martinez.com,Day eight compare response present west society.,16,stokes-martinez,2023,USD,1227088,495964,731124,731424,-300,20488,-20788,12270,24541,-45329,131143,863014,43150,819864,,1227088,258.26,859.39,0.1259,1177,86.81,59977.44,2.19,0.5958
3997,Smith PLC,False,CA,Lake Lisa,HealthTech,2020,https://smithplc.com,Benefit ability model laugh movement during fund strong skill.,22,smith-plc,2023,USD,1492090,589750,902340,154875,747465,0,747465,14920,29841,717624,236461,1044270,181814,862456,124340.83,1492090,10.0,27.33,0.0216,1426,87.16,22329.91,10.59,0.6047
3998,Larson Mitchell and Holloway,False,EG,New Julieberg,Cybersecurity,2023,https://larsonmitchellandholloway.com,Economy ten wind former watch serve natural seat.,20,larson-mitchell-and-holloway,2023,USD,1263439,408702,854737,905423,-50686,0,-50686,12634,25268,-75954,305396,942527,649335,293192,,1263439,867.45,1775.53,0.0573,2496,42.18,60221.53,5.07,0.6765
3999,Herrera-Richardson,False,FR,West Thomas,Fintech,2021,https://herrera-richardson.com,Space respond activity turn very.,18,herrera-richardson,2023,EUR,1510709,802282,708427,370777,337650,34395,303255,15107,30214,273041,153759,1030991,228191,802800,,1510709,1603.29,2710.51,0.0904,6294,20.0,42674.7,3.6,0.4689
4000,Hernandez-Villegas,False,ZA,Scottport,AgriTech,2012,https://hernandez-villegas.com,Oil worry bed nice become why this receive question.,17,hernandez-villegas,2023,USD,255204,74883,180321,12760,167561,6953,160608,2552,5104,155504,5777,161737,115666,46071,,255204,24.66,12.33,0.1431,1063,20.0,30496.76,0.19,0.7066
4001,Price PLC,False,FR,Lake Christinafort,E-commerce,2012,https://priceplc.com,Place tough game out heavy.,21,price-plc,2023,EUR,305926,170691,135235,188560,-53325,31319,-84644,3059,6118,-90762,5008,338611,139169,199442,,305926,813.23,2050.78,0.0632,167,151.96,41389.41,0.12,0.4421
4002,Brennan Allen and Johnson,False,GB,Browntown,Energy,2019,https://brennanallenandjohnson.com,Long even military wide yourself.,28,brennan-allen-and-johnson,2023,USD,551013,245646,305367,380183,-74816,19483,-94299,5510,11020,-105319,90971,443153,201262,241891,,551013,20.0,67.8,0.0474,164,279.2,10941.86,8.31,0.5542
4003,Waller and Sons,False,CA,Michelemouth,Mobility,2021,https://wallerandsons.com,Outside artist resource wife song stay.,25,waller-and-sons,2023,USD,270725,127804,142921,150010,-7089,23454,-30543,2707,5414,-35957,14024,336660,302994,33666,,270725,184.15,195.84,0.0355,190,118.17,1000.0,14.02,0.5279
4004,Gaines-Watts,False,EG,Port Allisonstad,Cybersecurity,2021,https://gaines-watts.com,Future president nice class event decade.,26,gaines-watts,2023,USD,894153,269109,625044,268999,356045,22744,333301,8941,17883,315418,89733,580495,81804,498691,,894153,346.06,306.56,0.0561,2414,30.86,53544.53,1.68,0.699
4005,Morrison Villanueva and Bryan,False,KE,Ruthville,Marketplaces,2018,https://morrisonvillanuevaandbryan.com,Course attorney resource impact our traditional cultural.,17,morrison-villanueva-and-bryan,2023,USD,1128501,398605,729896,985328,-255432,30082,-285514,11285,22570,-308084,7981,579013,226897,352116,,1128501,20.0,33.85,0.001,379,247.5,118557.35,0.07,0.6468
4006,White Group,False,GB,West Michael,Marketplaces,2015,https://whitegroup.com,Pay necessary society prevent market statement loss citizen apply.,22,white-group,2023,USD,2036094,881402,1154692,753511,401181,9120,392061,20360,40721,351340,60746,1270494,206819,1063675,,2036094,682.39,1996.01,0.0539,8483,20.0,52053.99,1.17,0.5671
4007,Bradshaw Group,False,TN,New Williamview,Energy,2023,https://bradshawgroup.com,Let book heavy person first example.,23,bradshaw-group,2023,USD,4837399,3071810,1765589,2306725,-541136,0,-541136,48373,96747,-637883,29430,2450664,1156044,1294620,,4837399,1285.7,2956.27,0.0074,1266,318.22,153900.48,0.19,0.365
4008,Howard-Robinson,False,NG,New Jose,AI/ML,2023,https://howard-robinson.com,Want main very husband scientist really.,22,howard-robinson,2023,USD,1349801,407061,942740,1029512,-86772,30411,-117183,13498,26996,-144179,177315,915736,329431,586305,,1349801,20.0,88.79,0.0381,1053,106.78,80391.66,2.21,0.6984
4009,Smith-Long,False,NG,Edwardborough,AI/ML,2015,https://smith-long.com,Middle however discussion than we air.,25,smith-long,2023,USD,325147,144677,180470,116941,63529,4096,59433,3251,6502,52931,53428,365890,51455,314435,,325147,1598.7,799.35,0.0718,331,81.77,22554.43,2.37,0.555
4010,Holland PLC,False,TN,Thompsonborough,Fintech,2021,https://hollandplc.com,Myself country admit clearly reason special whom phone game though.,26,holland-plc,2023,USD,5243951,1827575,3416376,2774237,642139,5258,636881,52439,104879,532002,79314,2728161,2053051,675110,,5243951,697.75,658.23,0.1021,6359,68.72,235863.44,0.34,0.6515
4011,Wade PLC,False,NG,Estradachester,IoT,2015,https://wadeplc.com,Baby start attorney blue system.,21,wade-plc,2023,USD,1130924,188083,942841,432727,510114,0,510114,11309,22618,487496,58995,717392,354624,362768,,1130924,1061.03,530.52,0.1056,2312,40.76,63717.62,0.93,0.8337
4012,Mcintosh Campos and Braun,False,ZA,Byrdton,Fintech,2015,https://mcintoshcamposandbraun.com,Or watch allow whole seat away standard another.,15,mcintosh-campos-and-braun,2023,USD,1316453,467954,848499,912396,-63897,0,-63897,13164,26329,-90226,302881,1044207,181179,863028,,1316453,575.94,3176.62,0.0388,5485,20.0,98060.39,3.09,0.6445
4013,Snyder Freeman and Gomez,False,CA,Port David,SaaS,2014,https://snyderfreemanandgomez.com,Few least fall hold consumer work fine image type difference.,21,snyder-freeman-and-gomez,2023,USD,492728,180829,311899,334506,-22607,11802,-34409,4927,9854,-44263,21195,328403,77046,251357,41060.67,492728,58.23,369.07,0.0059,438,93.62,39908.23,0.53,0.633
4014,Henderson Ltd,False,US,Port Nancybury,E-commerce,2023,https://hendersonltd.com,Chair tonight skin marriage off card three brother.,20,henderson-ltd,2023,USD,2372928,753650,1619278,247455,1371823,3529,1368294,23729,47458,1320836,265167,1645590,1043420,602170,,2372928,875.07,800.18,0.1208,9887,20.0,57143.26,4.64,0.6824
4015,Thompson Nichols and Jones,False,GB,Port Jackieland,Fintech,2009,https://thompsonnicholsandjones.com,Choice beat adult too.,24,thompson-nichols-and-jones,2023,USD,184388,50171,134217,83032,51185,11825,39360,1843,3687,35673,6281,236305,60333,175972,,184388,1616.25,3658.78,0.0826,94,162.77,1000.0,6.28,0.7279
4016,Miller Stevens and Camacho,False,CA,Contrerasmouth,E-commerce,2012,https://millerstevensandcamacho.com,Cell with describe opportunity learn scientist remain late.,23,miller-stevens-and-camacho,2023,USD,885923,195276,690647,418208,272439,32386,240053,8859,17718,222335,6334,465448,280174,185274,,885923,114.34,338.1,0.0763,471,156.61,48345.06,0.13,0.7796
4017,Rose Barber and Gonzalez,False,IN,Lindseyview,Mobility,2012,https://rosebarberandgonzalez.com,Media particular else style whom summer debate detail.,26,rose-barber-and-gonzalez,2023,USD,855543,222266,633277,374258,259019,26399,232620,8555,17110,215510,16687,493803,97129,396674,,855543,1226.45,2234.19,0.0994,617,115.41,50222.65,0.33,0.7402
4018,Williams Ltd,False,NG,West Stephenfurt,Energy,2015,https://williamsltd.com,Speech charge expect present hand seat story word.,18,williams-ltd,2023,USD,1954648,1037464,917184,1609102,-691918,33656,-725574,19546,39092,-764666,186330,1237699,399425,838274,,1954648,380.45,2408.23,0.067,745,218.55,144427.27,1.29,0.4692
4019,Schultz Ltd,False,DE,New Keithtown,EdTech,2009,https://schultzltd.com,Bed onto care maintain reveal.,17,schultz-ltd,2023,EUR,770609,358592,412017,450180,-38163,0,-38163,7706,15412,-53575,60277,564853,316141,248712,64217.42,770609,10.0,41.34,0.0513,2499,25.69,31885.55,1.89,0.5347
4020,Nichols Ltd,False,ZA,Connorfurt,HealthTech,2011,https://nicholsltd.com,Indicate individual door and also end real policy.,18,nichols-ltd,2023,USD,1193851,790648,403203,462821,-59618,42700,-102318,11938,23877,-126195,156183,857369,520448,336921,99487.58,1193851,211.95,942.36,0.0611,1151,86.38,51805.8,3.01,0.3377
4021,Lee-Schaefer,False,ZA,Christopherbury,Cybersecurity,2012,https://lee-schaefer.com,Whether team goal enjoy scientist call race this.,13,lee-schaefer,2023,USD,478760,173788,304972,78475,226497,19644,206853,4787,9575,197278,4059,433238,178233,255005,,478760,902.5,5222.47,0.1001,259,153.78,1000.0,4.06,0.637
4022,Ellis-Glass,False,TN,Johnsonfort,Cybersecurity,2008,https://ellis-glass.com,Site top officer offer trial before child.,16,ellis-glass,2023,USD,3254617,162730,3091887,2181586,910301,48302,861999,32546,65092,796907,96366,1914691,395857,1518834,,3254617,685.69,2288.2,0.001,1332,203.6,160601.78,0.6,0.95
4023,Obrien LLC,False,ZA,West Craigville,Energy,2019,https://obrienllc.com,Skill he stay father around well young sort friend account.,24,obrien-llc,2023,USD,538201,178725,359476,257441,102035,8868,93167,5382,10764,82403,28982,342220,117267,224953,,538201,20.0,26.5,0.0499,194,231.04,1000.0,28.98,0.6679
4024,Hughes-Wood,False,US,Carlamouth,Cybersecurity,2011,https://hughes-wood.com,Season toward station whatever guess into there at.,19,hughes-wood,2023,USD,598763,150736,448027,512422,-64395,17605,-82000,5987,11975,-93975,7672,408246,151552,256694,,598763,20.0,91.24,0.1495,891,56.0,45494.07,0.17,0.7483
4025,Carter Inc,False,BR,Port Heidiberg,IoT,2010,https://carterinc.com,Partner think agent become agent involve.,22,carter-inc,2023,USD,1683034,847483,835551,1140964,-305413,13903,-319316,16830,33660,-352976,165326,1130578,422448,708130,,1683034,440.89,2033.36,0.0788,1003,139.79,74114.77,2.23,0.4965
4026,Higgins Nelson and Johnson,False,EG,Lake Daniel,IoT,2013,https://higginsnelsonandjohnson.com,Since among feel eight cost military.,16,higgins-nelson-and-johnson,2023,USD,321622,98225,223397,182494,40903,31355,9548,3216,6432,3116,21709,290540,14527,276013,,321622,1371.92,5169.76,0.0095,1340,20.0,13387.58,1.62,0.6946
4027,Phillips Inc,False,US,Stevenhaven,HealthTech,2019,https://phillipsinc.com,Decision book resource whether chance always reflect difficult manage.,14,phillips-inc,2023,USD,609806,49119,560687,283723,276964,0,276964,6098,12196,264768,40043,448806,22440,426366,50817.17,609806,10.0,28.07,0.0264,4986,10.19,13352.24,3.0,0.9195
4028,Lewis Moss and Mason,False,GB,Kingfort,Fintech,2015,https://lewismossandmason.com,Travel or decade term radio traditional clear move than speak.,23,lewis-moss-and-mason,2023,USD,962748,317700,645048,269168,375880,11133,364747,9627,19254,345493,21736,597097,29854,567243,,962748,20.0,32.6,0.0648,4011,20.0,43381.74,0.5,0.67
4029,Reid-Montgomery,False,FR,Davidview,SaaS,2021,https://reid-montgomery.com,Wide easy upon eye natural.,24,reid-montgomery,2023,EUR,739436,203084,536352,487392,48960,11279,37681,7394,14788,22893,21963,473149,128877,344272,61619.67,739436,10.0,10.0,0.075,977,63.02,34435.43,0.64,0.7254
4030,Wu and Sons,False,GB,New Williamside,HealthTech,2023,https://wuandsons.com,Room international enjoy budget wall feel child second.,14,wu-and-sons,2023,USD,2475772,841927,1633845,1717529,-83684,0,-83684,24757,49515,-133199,145337,1522797,76139,1446658,206314.33,2475772,53.9,283.81,0.0031,3992,51.68,156778.02,0.93,0.6599
4031,Williams Delacruz and James,False,ZA,East Kimberly,HealthTech,2024,https://williamsdelacruzandjames.com,Record off any for green admit nation test.,9,williams-delacruz-and-james,2023,USD,1304132,481442,822690,995607,-172917,0,-172917,13041,26082,-198999,101640,911551,310885,600666,108677.67,1304132,56.82,79.78,0.0688,1586,68.5,69393.16,1.46,0.6308
4032,Armstrong PLC,False,ZA,Martinstad,AgriTech,2023,https://armstrongplc.com,Physical to produce Congress.,17,armstrong-plc,2023,USD,64334,23209,41125,29706,11419,0,11419,643,1286,10133,4787,225125,83613,141512,,64334,20.0,106.3,0.0277,41,129.21,1000.0,4.79,0.6392
4033,Price Allen and Williams,False,TN,Thomashaven,Cybersecurity,2018,https://priceallenandwilliams.com,Part government team nature travel.,21,price-allen-and-williams,2023,USD,913832,182853,730979,533432,197547,6552,190995,9138,18276,172719,412518,946645,586778,359867,,913832,20.0,114.88,0.072,3807,20.0,21936.12,18.81,0.7999
4034,Kelly PLC,False,EG,West Kyle,Marketplaces,2008,https://kellyplc.com,Consider gun energy make apply.,19,kelly-plc,2023,USD,1091411,107030,984381,575931,408450,45708,362742,10914,21828,340914,71040,686197,406674,279523,,1091411,2285.26,9617.05,0.001,4547,20.0,60156.26,1.18,0.9019
4035,Thompson-Ellison,False,IN,Andrewborough,Fintech,2012,https://thompson-ellison.com,Office herself different along then but especially fear number.,15,thompson-ellison,2023,USD,2987212,1065593,1921619,1109124,812495,10625,801870,29872,59744,742126,45098,1649749,588639,1061110,,2987212,20.0,41.56,0.1018,12446,20.0,75092.87,0.6,0.6433
4036,Burton Ltd,False,US,Paulfurt,Marketplaces,2009,https://burtonltd.com,Could fill often after institution term treatment culture.,20,burton-ltd,2023,USD,519671,277491,242180,214343,27837,42659,-14822,5196,10393,-25215,204413,582489,61105,521384,,519671,967.35,1834.59,0.0889,252,171.55,1000.0,204.41,0.466
4037,Martinez Bennett and Brown,False,KE,Trevorborough,HealthTech,2024,https://martinezbennettandbrown.com,Always grow point court yourself south cover over phone six.,30,martinez-bennett-and-brown,2023,USD,333552,117197,216355,129554,86801,0,86801,3335,6671,80130,8416,272700,95497,177203,27796.0,333552,189.22,480.83,0.0291,1281,21.69,1000.0,8.42,0.6486
4038,Wolfe Ltd,False,GB,Lake Brandonville,SaaS,2020,https://wolfeltd.com,Radio your describe major course risk.,16,wolfe-ltd,2023,USD,673971,168471,505500,257351,248149,0,248149,6739,13479,234670,70125,498565,161965,336600,56164.25,673971,326.2,571.91,0.001,808,69.48,11737.25,5.97,0.75
4039,Johnson Johnson and Griffin,False,TN,Pattonside,Marketplaces,2022,https://johnsonjohnsonandgriffin.com,Six might teach reality necessary type true really indicate history.,11,johnson-johnson-and-griffin,2023,USD,2891651,1150402,1741249,1408025,333224,19723,313501,28916,57833,255668,42225,1531560,759197,772363,,2891651,1281.15,3795.82,0.0285,1068,225.53,88839.1,0.48,0.6022
4040,Hicks-Hunter,False,NG,Port James,Cybersecurity,2016,https://hicks-hunter.com,Item allow myself different mother.,12,hicks-hunter,2023,USD,2288023,641436,1646587,990499,656088,0,656088,22880,45760,610328,120096,1363604,494881,868723,,2288023,36.7,45.89,0.0522,4778,39.9,72539.23,1.66,0.7197
4041,White Taylor and Carter,False,KE,North Meganview,AI/ML,2017,https://whitetaylorandcarter.com,Growth current other evidence white.,21,white-taylor-and-carter,2023,USD,277318,117473,159845,148509,11336,6412,4924,2773,5546,-622,11850,193980,113541,80439,,277318,20.0,37.18,0.034,186,124.23,1000.0,11.85,0.5764
4042,Guzman Baker and Douglas,False,ZA,Johnmouth,EdTech,2021,https://guzmanbakeranddouglas.com,Tax concern happen military bed trial.,14,guzman-baker-and-douglas,2023,USD,387772,63687,324085,197929,126156,48517,77639,3877,7755,69884,25558,389533,96497,293036,32314.33,387772,191.0,810.87,0.0229,634,50.9,19083.8,1.34,0.8358
4043,Wade LLC,False,GB,Ashleyberg,AgriTech,2010,https://wadellc.com,Along consumer different class.,24,wade-llc,2023,USD,178924,89660,89264,67922,21342,16567,4775,1789,3578,1197,12707,238995,36982,202013,,178924,1087.0,3307.11,0.0673,217,68.66,14215.2,0.89,0.4989
4044,Durham PLC,False,NG,South Diana,Energy,2012,https://durhamplc.com,Art book director great ready guy any believe.,23,durham-plc,2023,USD,452887,297071,155816,22644,133172,2369,130803,4528,9057,121746,50996,310590,146290,164300,,452887,179.52,629.5,0.0898,665,56.68,8872.1,5.75,0.3441
4045,Davis Padilla and Roach,False,ZA,Wallsland,EdTech,2020,https://davispadillaandroach.com,City social catch figure in local relationship.,23,davis-padilla-and-roach,2023,USD,299695,130175,169520,71513,98007,4906,93101,2996,5993,87108,8910,205526,78236,127290,24974.58,299695,369.27,2298.39,0.0337,754,33.11,1000.0,8.91,0.5656
4046,Soto-Lyons,False,KE,North Walterton,SaaS,2015,https://soto-lyons.com,Thought popular hotel every billion until prevent live suddenly young or.,18,soto-lyons,2023,USD,2070667,602417,1468250,996542,471708,34174,437534,20706,41413,396121,13499,1065289,90987,974302,172555.58,2070667,429.36,1121.85,0.0165,1521,113.43,100021.49,0.13,0.7091
4047,Adams-Watson,False,TN,Morganborough,HealthTech,2010,https://adams-watson.com,Kitchen senior various according simply.,25,adams-watson,2023,USD,662594,309393,353201,412404,-59203,18755,-77958,6625,13251,-91209,28639,385855,172580,213275,55216.17,662594,593.64,2676.7,0.0913,1172,47.11,53892.5,0.53,0.5331
4048,Thompson-Howard,False,ZA,Paulborough,Mobility,2023,https://thompson-howard.com,Cup either summer national part pay agent story send.,33,thompson-howard,2023,USD,1125373,227346,898027,208854,689173,20140,669033,11253,22507,646526,141132,866444,171522,694922,,1125373,1386.54,4581.34,0.0537,309,302.54,29601.37,4.77,0.798
4049,Jackson and Sons,False,CA,Port Charlesberg,Marketplaces,2020,https://jacksonandsons.com,Left social home huge they health old with likely.,23,jackson-and-sons,2023,USD,1381613,430051,951562,594637,356925,2862,354063,13816,27632,326431,43649,795716,237057,558659,,1381613,20.0,55.29,0.112,5756,20.0,47034.79,0.93,0.6887
4050,Phillips-Rodriguez,False,TN,Lake Wesley,HealthTech,2009,https://phillips-rodriguez.com,Expert behavior win compare smile effect too piece back.,22,phillips-rodriguez,2023,USD,5144525,2616903,2527622,695366,1832256,29032,1803224,51445,102890,1700334,134251,2741071,1190953,1550118,428710.42,5144525,10.0,43.03,0.001,3220,133.12,70618.48,1.9,0.4913
4051,Howell Brown and Harmon,False,AU,Tonifort,E-commerce,2021,https://howellbrownandharmon.com,Rich support public dark look join piece modern far open.,18,howell-brown-and-harmon,2023,USD,2333098,1341567,991531,541258,450273,39595,410678,23330,46661,364017,50477,1306232,508200,798032,,2333098,1393.01,3270.88,0.0892,9721,20.0,39934.24,1.26,0.425
4052,Fuller Lester and Greene,False,DE,Lake Ericbury,AgriTech,2011,https://fullerlesterandgreene.com,Reach camera they final fill population smile about letter them.,16,fuller-lester-and-greene,2023,EUR,72521,30428,42093,49377,-7284,4113,-11397,725,1450,-12847,16065,196056,80502,115554,,72521,20.0,79.01,0.0446,35,171.17,34243.98,0.47,0.5804
4053,Gonzalez Inc,False,FR,Williamshaven,Fintech,2019,https://gonzalezinc.com,Region subject treat national see many.,23,gonzalez-inc,2023,EUR,459996,80065,379931,145876,234055,0,234055,4599,9199,224856,7811,369268,110170,259098,,459996,575.34,679.16,0.001,524,73.07,1000.0,7.81,0.8259
4054,Gilbert-Sims,False,KE,West Kevin,E-commerce,2008,https://gilbert-sims.com,Want hope decide probably him loss notice.,30,gilbert-sims,2023,USD,1151955,421001,730954,747880,-16926,10802,-27728,11519,23039,-50767,67113,839581,570057,269524,,1151955,963.46,1458.94,0.0719,4799,20.0,52980.59,1.27,0.6345
4055,Bradley-Wright,False,DE,North Chadstad,AgriTech,2013,https://bradley-wright.com,Study rest without person behavior third.,18,bradley-wright,2023,EUR,468546,213000,255546,277183,-21637,5656,-27293,4685,9370,-36663,4591,390593,144790,245803,,468546,1001.75,500.88,0.1479,175,222.37,21259.71,0.22,0.5454
4056,Kelly Fernandez and Jones,False,NG,South Lauren,Fintech,2010,https://kellyfernandezandjones.com,Money his meet need community challenge voice big east one.,25,kelly-fernandez-and-jones,2023,USD,1402048,597802,804246,928436,-124190,29395,-153585,14020,28040,-181625,23392,812604,284205,528399,,1402048,610.63,3435.23,0.001,1817,64.3,60125.95,0.39,0.5736
4057,Martin Morris and Baker,False,DE,Michaeltown,IoT,2008,https://martinmorrisandbaker.com,Bag I probably argue strategy beautiful.,20,martin-morris-and-baker,2023,EUR,866073,338748,527325,456531,70794,6189,64605,8660,17321,47284,27885,508316,183136,325180,,866073,69.71,34.85,0.1394,3608,20.0,38524.46,0.72,0.6089
4058,Lewis Moore and Harrison,False,AU,Lopezhaven,AgriTech,2014,https://lewismooreandharrison.com,Fall everyone we keep just.,25,lewis-moore-and-harrison,2023,USD,93600,40478,53122,17676,35446,0,35446,936,1872,33574,23796,162585,20434,142151,,93600,1312.91,3603.54,0.053,35,218.66,1000.0,23.8,0.5675
4059,Erickson-Becker,False,NG,Michelleville,EdTech,2009,https://erickson-becker.com,Service discussion political above image recently energy meet hot.,20,erickson-becker,2023,USD,330011,117207,212804,16500,196304,0,196304,3300,6600,189704,3744,237165,86949,150216,27500.92,330011,263.33,1321.4,0.0052,369,74.4,6711.17,0.56,0.6448
4060,Schmidt-Mullen,False,DE,Jillland,AgriTech,2010,https://schmidt-mullen.com,Hospital win throughout good player up so certain newspaper.,22,schmidt-mullen,2023,EUR,178365,87907,90458,32721,57737,2292,55445,1783,3567,51878,8197,292889,75504,217385,,178365,20.0,62.71,0.0466,409,36.33,10782.26,0.76,0.5072
4061,Moore-Tate,False,KE,Brownville,IoT,2009,https://moore-tate.com,Than fight low subject they community push parent world.,21,moore-tate,2023,USD,332053,16602,315451,299461,15990,0,15990,3320,6641,9349,6518,364542,108030,256512,,332053,1028.74,6516.63,0.0314,1164,23.76,47194.54,0.14,0.95
4062,Lloyd Rivera and Shah,False,KE,Mccarthymouth,Mobility,2009,https://lloydriveraandshah.com,His society these better product.,12,lloyd-rivera-and-shah,2023,USD,1544761,741933,802828,716223,86605,12620,73985,15447,30895,43090,157609,979595,490301,489294,,1544761,46.9,235.65,0.0789,743,173.1,67485.78,2.34,0.5197
4063,Adams-Smith,False,US,Jessicahaven,E-commerce,2010,https://adams-smith.com,Professor painting shoulder affect.,26,adams-smith,2023,USD,143716,49358,94358,50752,43606,0,43606,1437,2874,40732,7701,256918,36919,219999,,143716,161.15,901.86,0.1116,52,230.25,1000.0,7.7,0.6566
4064,Hodges-Sanders,False,IN,Lake Christinaton,SaaS,2019,https://hodges-sanders.com,Past opportunity soldier international school receive difficult black this against suffer.,18,hodges-sanders,2023,USD,1669356,606659,1062697,963449,99248,37267,61981,16693,33387,28594,70921,985797,465962,519835,139113.0,1669356,277.68,1118.48,0.0495,7850,17.72,102759.07,0.69,0.6366
4065,Stevens Figueroa and Cook,False,AU,Heatherville,AgriTech,2020,https://stevensfigueroaandcook.com,Summer attack thing item any offer tonight involve speech.,27,stevens-figueroa-and-cook,2023,USD,351804,70373,281431,90580,190851,0,190851,3518,7036,183815,51852,358992,39802,319190,,351804,20.0,24.88,0.0654,1024,28.62,1000.0,51.85,0.8
4066,Nichols Wilson and Coleman,False,NG,North James,EdTech,2018,https://nicholswilsonandcoleman.com,Year stop certainly middle life federal art thank front turn.,21,nichols-wilson-and-coleman,2023,USD,1526521,406254,1120267,1396523,-276256,28085,-304341,15265,30530,-334871,39221,804117,156684,647433,127210.08,1526521,10.0,37.45,0.055,2718,46.8,99629.09,0.39,0.7339
4067,Miller Richardson and Smith,False,AU,Christopherside,Energy,2019,https://millerrichardsonandsmith.com,Political ball question shoulder majority such majority even write nice.,15,miller-richardson-and-smith,2023,USD,4236127,1841154,2394973,2621897,-226924,22140,-249064,42361,84722,-333786,1716198,3904182,1549360,2354822,,4236127,20.0,135.16,0.152,3749,94.14,227353.46,7.55,0.5654
4068,Wilson-King,False,GB,Linmouth,Cybersecurity,2011,https://wilson-king.com,Leader beyond weight number fact cell behind site.,23,wilson-king,2023,USD,680785,355221,325564,349344,-23780,29176,-52956,6807,13615,-66571,30862,444573,162987,281586,,680785,640.15,2025.73,0.0575,175,324.18,30687.91,1.01,0.4782
4069,Hodges LLC,False,CA,Lake Paul,Energy,2024,https://hodgesllc.com,Party single him peace left whole.,18,hodges-llc,2023,USD,1738460,520868,1217592,293049,924543,0,924543,17384,34769,889774,35181,930006,99567,830439,,1738460,666.86,1788.07,0.0874,702,206.2,58593.13,0.6,0.7004
4070,Walters Fuentes and Marshall,False,FR,North Robertoport,AI/ML,2012,https://waltersfuentesandmarshall.com,Assume certainly run this walk company mind knowledge.,18,walters-fuentes-and-marshall,2023,EUR,1745764,245585,1500179,1164871,335308,0,335308,17457,34915,300393,197866,1214818,323828,890990,,1745764,20.0,95.35,0.0809,3790,38.38,109945.78,1.8,0.8593
4071,Mendez Blanchard and Williams,False,US,West Jessicafurt,IoT,2020,https://mendezblanchardandwilliams.com,Ever off themselves theory scene.,16,mendez-blanchard-and-williams,2023,USD,948961,255499,693462,342456,351006,26155,324851,9489,18979,305872,79962,688908,418992,269916,,948961,81.46,159.43,0.1348,731,108.1,13737.24,5.82,0.7308
4072,Thomas-Elliott,False,EG,East Michael,IoT,2009,https://thomas-elliott.com,Six represent data international budget accept not task current resource.,17,thomas-elliott,2023,USD,894315,223538,670777,743919,-73142,30322,-103464,8943,17886,-121350,27412,573926,96894,477032,,894315,370.68,2012.2,0.1739,230,322.64,80161.75,0.34,0.75
4073,Gonzales and Sons,False,IN,South Randystad,HealthTech,2012,https://gonzalesandsons.com,Thing positive hair officer degree admit lead.,17,gonzales-and-sons,2023,USD,415693,208593,207100,129947,77153,0,77153,4156,8313,68840,3948,265204,81330,183874,34641.08,415693,45.35,218.06,0.0299,342,101.28,29362.51,0.13,0.4982
4074,Allen Rowe and Brooks,False,BR,New Katrinahaven,Mobility,2010,https://allenroweandbrooks.com,About husband star nor might talk.,16,allen-rowe-and-brooks,2023,USD,942246,476153,466093,479670,-13577,6298,-19875,9422,18844,-38719,88843,640460,424144,216316,,942246,20.0,10.0,0.0937,447,175.51,56793.07,1.56,0.4947
4075,Ramirez PLC,False,BR,Freemanshire,Fintech,2015,https://ramirezplc.com,Career result share travel view investment water.,23,ramirez-plc,2023,USD,1811625,654464,1157161,1161461,-4300,29695,-33995,18116,36232,-70227,180128,1129922,402577,727345,,1811625,20.0,72.15,0.0991,1427,105.73,94253.22,1.91,0.6387
4076,Hayes PLC,False,DE,North Josephmouth,Marketplaces,2012,https://hayesplc.com,Ability realize most Mrs report writer.,7,hayes-plc,2023,EUR,464050,177654,286396,259446,26950,0,26950,4640,9281,17669,16475,414098,56616,357482,,464050,186.48,1095.67,0.0793,262,147.33,36704.49,0.45,0.6172
4077,Ramos Ellison and Hogan,False,AU,Port Annamouth,Cybersecurity,2013,https://ramosellisonandhogan.com,Although attorney property throw feel common environment eat and.,13,ramos-ellison-and-hogan,2023,USD,1344804,623499,721305,81350,639955,5932,634023,13448,26896,607127,52544,819532,485311,334221,,1344804,1333.43,7770.54,0.0739,3254,34.43,14229.31,3.69,0.5364
4078,Oliver and Sons,False,NG,North Andrew,AI/ML,2024,https://oliverandsons.com,You line table stage along continue.,24,oliver-and-sons,2023,USD,3054778,1029394,2025384,914399,1110985,5510,1105475,30547,61095,1044380,352596,1966587,558035,1408552,,3054778,1234.12,5155.69,0.0257,831,306.08,89716.67,3.93,0.663
4079,Peterson Parsons and Gross,False,AU,South Andrew,E-commerce,2022,https://petersonparsonsandgross.com,Method blue television take want art simply could trip bit.,21,peterson-parsons-and-gross,2023,USD,670975,255706,415269,259852,155417,25013,130404,6709,13419,116985,52756,517237,128359,388878,,670975,1355.88,3259.02,0.0081,1107,50.48,25256.26,2.09,0.6189
4080,Patton May and Ibarra,False,AU,Julieport,HealthTech,2018,https://pattonmayandibarra.com,Agent tell near under PM rate out speak.,23,patton-may-and-ibarra,2023,USD,512134,148770,363364,252261,111103,3342,107761,5121,10242,97519,16792,300558,183548,117010,42677.83,512134,13.11,110.3,0.0051,271,157.38,46679.88,0.36,0.7095
4081,Stone-Kidd,False,IN,New Susanview,E-commerce,2021,https://stone-kidd.com,Necessary red federal pretty election they color commercial Mr.,15,stone-kidd,2023,USD,455013,60087,394926,327624,67302,16213,51089,4550,9100,41989,21808,379294,18964,360330,,455013,296.39,598.75,0.0487,562,67.44,1000.0,21.81,0.8679
4082,Martin-Cook,False,US,Rickmouth,Cybersecurity,2020,https://martin-cook.com,Use you scene site fall.,16,martin-cook,2023,USD,563989,142162,421827,94448,327379,20446,306933,5639,11279,295654,70549,432318,55910,376408,,563989,20.0,100.24,0.001,222,211.5,1000.0,70.55,0.7479
4083,Cox-Meyers,False,DE,Robinchester,EdTech,2010,https://cox-meyers.com,Soldier treatment establish agent audience protect special church PM.,11,cox-meyers,2023,EUR,242858,40416,202442,89265,113177,22676,90501,2428,4857,85644,79449,399025,205702,193323,20238.17,242858,549.06,2023.71,0.0525,200,100.93,19765.19,4.02,0.8336
4084,Horn Wilson and Spencer,False,GB,Lake Robertmouth,IoT,2023,https://hornwilsonandspencer.com,Condition big once staff particular tree clear safe.,17,horn-wilson-and-spencer,2023,USD,1063402,351500,711902,587239,124663,40367,84296,10634,21268,63028,12395,723653,80239,643414,,1063402,20.0,10.0,0.001,360,245.65,52868.34,0.23,0.6695
4085,Bennett LLC,False,FR,Whitetown,SaaS,2012,https://bennettllc.com,Another crime six attack alone option.,31,bennett-llc,2023,EUR,917849,296639,621210,643543,-22333,0,-22333,9178,18356,-40689,75273,569029,209927,359102,76487.42,917849,520.27,2223.62,0.0148,888,86.06,51389.66,1.46,0.6768
4086,Scott-White,False,AU,Julieport,AgriTech,2010,https://scott-white.com,Professor something teach reduce.,19,scott-white,2023,USD,636212,301744,334468,164162,170306,0,170306,6362,12724,157582,32857,370531,192104,178427,,636212,563.84,281.92,0.1113,286,185.2,31825.28,1.03,0.5257
4087,Hernandez-Berry,False,EG,Mcgeefort,Fintech,2022,https://hernandez-berry.com,Short social service traditional case man.,16,hernandez-berry,2023,USD,215084,44276,170808,104370,66438,0,66438,2150,4301,62137,9277,167193,15178,152015,,215084,124.07,640.7,0.0191,201,89.05,2187.65,4.24,0.7941
4088,Jones PLC,False,CA,Johnsonton,HealthTech,2017,https://jonesplc.com,Environment center decision example explain government available.,16,jones-plc,2023,USD,1051413,383230,668183,456040,212143,18846,193297,10514,21028,172269,28189,741572,361966,379606,87617.75,1051413,364.61,3134.03,0.0351,1220,71.78,30003.94,0.94,0.6355
4089,Jones Graham and Woods,False,GB,Hollyland,Fintech,2016,https://jonesgrahamandwoods.com,Certain before everything less next back discuss.,18,jones-graham-and-woods,2023,USD,1699473,883009,816464,617291,199173,31212,167961,16994,33989,133972,32224,1002747,195070,807677,,1699473,20.0,33.06,0.001,1156,122.46,37953.68,0.85,0.4804
4090,Alvarado-Nicholson,False,KE,Port Brittany,E-commerce,2019,https://alvarado-nicholson.com,Arm military develop nor common boy section road central.,24,alvarado-nicholson,2023,USD,6156298,1570531,4585767,3365256,1220511,36309,1184202,61562,123125,1061077,295074,3403727,430793,2972934,,6156298,2049.7,5083.66,0.001,6222,82.45,267937.43,1.1,0.7449
4091,Brown-Contreras,False,FR,Elizabethshire,Fintech,2013,https://brown-contreras.com,Campaign campaign receive sometimes service inside.,21,brown-contreras,2023,EUR,1663819,164117,1499702,239781,1259921,0,1259921,16638,33276,1226645,230609,1180897,173689,1007208,,1663819,1640.17,7330.8,0.0935,1116,124.17,1000.0,230.61,0.9014
4092,Williams-Johnson,False,ZA,Lynnview,Mobility,2016,https://williams-johnson.com,Entire PM skill to research hair.,30,williams-johnson,2023,USD,641900,300680,341220,279494,61726,14906,46820,6419,12838,33982,39731,415708,145811,269897,,641900,301.2,150.6,0.0589,1019,52.49,44320.92,0.9,0.5316
4093,Russell-Foster,False,EG,Millerhaven,AgriTech,2022,https://russell-foster.com,Subject cause turn history drop.,20,russell-foster,2023,USD,273326,105918,167408,86341,81067,0,81067,2733,5466,75601,4457,143730,7186,136544,,273326,20.0,128.35,0.0713,252,90.36,5010.0,0.89,0.6125
4094,Kelly-Lane,False,BR,Harveymouth,HealthTech,2011,https://kelly-lane.com,Thus leave industry her instead help very source.,18,kelly-lane,2023,USD,776582,255572,521010,105664,415346,20074,395272,7765,15531,379741,82960,575301,295596,279705,64715.17,776582,10.0,48.02,0.0566,4423,14.63,46928.26,1.77,0.6709
4095,Klein Robinson and Park,False,KE,South Sabrinaview,Mobility,2009,https://kleinrobinsonandpark.com,Defense few center book.,12,klein-robinson-and-park,2023,USD,877558,303700,573858,344883,228975,12727,216248,8775,17551,198697,376898,943352,573207,370145,,877558,573.59,2480.65,0.1124,509,143.67,8910.09,42.3,0.6539
4096,Scott Gomez and Miles,False,CA,Jenniferport,AgriTech,2020,https://scottgomezandmiles.com,Build human actually exist message firm.,20,scott-gomez-and-miles,2023,USD,2216537,453657,1762880,714930,1047950,0,1047950,22165,44330,1003620,327964,1615965,80798,1535167,,2216537,20.0,23.37,0.0378,9235,20.0,46479.36,7.06,0.7953
4097,Williams Brown and Cameron,False,TN,Port Christineside,IoT,2012,https://williamsbrownandcameron.com,Institution away fall ok follow program.,21,williams-brown-and-cameron,2023,USD,957081,419455,537626,823532,-285906,13100,-299006,9570,19141,-318147,17375,609612,137847,471765,,957081,1018.97,1430.11,0.001,472,168.72,45180.16,0.38,0.5617
4098,Knox Olson and Gomez,False,EG,Rayton,E-commerce,2024,https://knoxolsonandgomez.com,Fly wrong describe eight admit.,24,knox-olson-and-gomez,2023,USD,603852,250941,352911,303141,49770,24076,25694,6038,12077,13617,29039,433679,21683,411996,,603852,20.0,86.68,0.1328,398,126.22,12036.12,2.41,0.5844
4099,Jimenez Inc,False,KE,Brianborough,E-commerce,2019,https://jimenezinc.com,Evening while both treat with also rise parent.,18,jimenez-inc,2023,USD,682383,269772,412611,34119,378492,0,378492,6823,13647,364845,36135,486805,24340,462465,,682383,1573.12,3480.43,0.0926,287,197.77,1000.0,36.14,0.6047
4100,Thompson-Chandler,False,FR,Lake Ericamouth,Marketplaces,2021,https://thompson-chandler.com,Fly wall wrong between society recently benefit front of offer.,28,thompson-chandler,2023,EUR,380105,126637,253468,266213,-12745,18393,-31138,3801,7602,-38740,20673,240778,77718,163060,,380105,20.0,95.54,0.0266,805,39.3,1000.0,20.67,0.6668
4101,Richardson Rowe and Durham,False,NG,New Heatherville,Mobility,2016,https://richardsonroweanddurham.com,Hot follow soon here animal national body like a.,22,richardson-rowe-and-durham,2023,USD,1132668,330257,802411,372652,429759,18517,411242,11326,22653,388589,48415,756011,47284,708727,,1132668,1798.6,5555.53,0.0312,4719,20.0,9421.5,5.14,0.7084
4102,Kelley Ltd,False,BR,East Heather,SaaS,2009,https://kelleyltd.com,Mr however then environment step remember.,20,kelley-ltd,2023,USD,626023,274194,351829,506330,-154501,0,-154501,6260,12520,-167021,50554,396677,39612,357065,52168.58,626023,34.99,112.35,0.0596,1120,46.54,50119.55,1.01,0.562
4103,Harrison and Sons,False,ZA,Lake Robertland,EdTech,2008,https://harrisonandsons.com,Strong would building as ten teacher today.,21,harrison-and-sons,2023,USD,404007,184076,219931,195235,24696,0,24696,4040,8080,16616,83233,350135,179212,170923,33667.25,404007,275.73,1227.64,0.0154,2503,13.45,29180.48,2.85,0.5444
4104,Tran-Clements,False,GB,Wilsonfort,Fintech,2017,https://tran-clements.com,Long common heart nation shake either among.,20,tran-clements,2023,USD,1617177,824677,792500,383143,409357,15548,393809,16171,32343,361466,6009,981153,329991,651162,,1617177,86.94,436.08,0.1906,1689,79.78,36948.09,0.16,0.4901
4105,Cox Ltd,False,TN,Mcintoshbury,HealthTech,2020,https://coxltd.com,Current blue bring sound speak.,22,cox-ltd,2023,USD,7086960,3139688,3947272,4651214,-703942,2664,-706606,70869,141739,-848345,136836,3697346,2135378,1561968,590580.0,7086960,587.33,3385.2,0.0212,10514,56.17,383425.34,0.36,0.557
4106,Cordova and Sons,False,FR,Jamesfurt,EdTech,2020,https://cordovaandsons.com,Recent campaign painting whether two south win back.,15,cordova-and-sons,2023,EUR,677435,163847,513588,277475,236113,11737,224376,6774,13548,210828,6075,531488,216403,315085,56452.92,677435,10.0,21.84,0.001,289,195.33,29181.71,0.21,0.7581
4107,Vargas LLC,False,EG,Port Patrickland,Marketplaces,2010,https://vargasllc.com,Industry both capital gas world every newspaper.,24,vargas-llc,2023,USD,732519,369477,363042,534256,-171214,2505,-173719,7325,14650,-188369,18403,437461,140951,296510,,732519,20.0,67.7,0.001,188,324.19,74350.09,0.25,0.4956
4108,Villa-Watson,False,CA,South Rebecca,Mobility,2022,https://villa-watson.com,Look middle TV sure country.,19,villa-watson,2023,USD,288088,95205,192883,38949,153934,29383,124551,2880,5761,118790,12429,206234,10770,195464,,288088,20.0,147.13,0.0941,227,105.56,1000.0,12.43,0.6695
4109,Clark Ltd,False,BR,South Rebekah,AI/ML,2022,https://clarkltd.com,As kitchen book ahead about production hit.,16,clark-ltd,2023,USD,3061640,1125219,1936421,334102,1602319,0,1602319,30616,61232,1541087,313165,2027471,936502,1090969,,3061640,20.0,90.77,0.0499,3115,81.9,57755.65,5.42,0.6325
4110,Thomas Benjamin and Green,False,FR,New Ronald,Fintech,2013,https://thomasbenjaminandgreen.com,Because cup your future miss particular two above.,13,thomas-benjamin-and-green,2023,EUR,1427033,769921,657112,995594,-338482,9421,-347903,14270,28540,-376443,182998,1018607,239057,779550,,1427033,288.78,144.39,0.001,847,140.31,105146.47,1.74,0.4605
4111,Williams Ltd,False,ZA,South Michelleshire,Fintech,2020,https://williamsltd.com,What pull finish within eat international kind.,24,williams-ltd,2023,USD,2188779,1022399,1166380,882260,284120,8591,275529,21887,43775,231754,170783,1442970,425088,1017882,,2188779,432.13,1461.95,0.0916,9119,20.0,67051.34,2.55,0.5329
4112,Durham and Sons,False,AU,Goodmanhaven,Energy,2014,https://durhamandsons.com,East nation learn film age protect consider explain.,18,durham-and-sons,2023,USD,3314718,1486441,1828277,2262444,-434167,0,-434167,33147,66294,-500461,433005,2096170,919831,1176339,,3314718,410.08,205.04,0.1859,2221,124.37,165448.2,2.62,0.5516
4113,Howard Bryan and Newton,False,TN,New Jordan,E-commerce,2010,https://howardbryanandnewton.com,Worry memory seat chance some thought build goal indicate.,27,howard-bryan-and-newton,2023,USD,390793,76040,314753,308010,6743,0,6743,3907,7815,-1072,13617,282675,125634,157041,,390793,20.0,93.72,0.1226,1628,20.0,36115.36,0.38,0.8054
4114,Weber Morton and Smith,False,CA,East Angelamouth,E-commerce,2023,https://webermortonandsmith.com,Figure let affect exactly bad dream matter.,23,weber-morton-and-smith,2023,USD,275908,97523,178385,24431,153954,48880,105074,2759,5518,99556,7803,268405,158870,109535,,275908,671.31,2584.81,0.0557,234,98.04,1000.0,7.8,0.6465
4115,Williamson PLC,False,DE,West Michelle,Cybersecurity,2023,https://williamsonplc.com,Upon discussion foot and national fine serious.,17,williamson-plc,2023,EUR,1625345,525208,1100137,1365815,-265678,29781,-295459,16253,32506,-327965,46062,940330,279514,660816,,1625345,735.06,3125.95,0.0758,982,137.85,102536.06,0.45,0.6769
4116,Garza and Sons,False,FR,Johnsonberg,AgriTech,2022,https://garzaandsons.com,Cultural region discover body case fast two seat reach.,17,garza-and-sons,2023,EUR,203445,80147,123298,62230,61068,25886,35182,2034,4068,31114,1431,292678,117974,174704,,203445,20.0,10.0,0.0406,102,165.41,1000.0,1.43,0.6061
4117,Ramirez-Tyler,False,US,Roberttown,AI/ML,2012,https://ramirez-tyler.com,Professional power stuff my mean stay.,18,ramirez-tyler,2023,USD,2232007,756124,1475883,1324024,151859,3743,148116,22320,44640,103476,271023,1472440,439950,1032490,,2232007,20.0,34.19,0.0301,9300,20.0,108744.13,2.49,0.6612
4118,Aguilar-Wells,False,EG,Saraville,HealthTech,2014,https://aguilar-wells.com,Computer political far wife expect strong throw leave by run girl.,16,aguilar-wells,2023,USD,775333,310336,464997,174507,290490,20623,269867,7753,15506,254361,8803,507059,176717,330342,64611.08,775333,138.32,547.75,0.0012,981,65.84,1000.0,8.8,0.5997
4119,Lynn Inc,False,CA,Danielbury,IoT,2009,https://lynninc.com,Father quickly likely official budget maybe exist financial.,14,lynn-inc,2023,USD,155761,49935,105826,114449,-8623,0,-8623,1557,3115,-11738,39877,244546,157045,87501,,155761,271.91,1194.86,0.0738,649,20.0,1601.6,24.9,0.6794
4120,Ayala Salinas and West,False,KE,New Gregoryborough,Energy,2009,https://ayalasalinasandwest.com,Range skill book power good.,18,ayala-salinas-and-west,2023,USD,1010613,551473,459140,506217,-47077,0,-47077,10106,20212,-67289,93748,791224,39561,751663,,1010613,1221.81,7835.25,0.0777,521,161.35,23870.29,3.93,0.4543
4121,Anderson Bates and Green,False,AU,Roseburgh,E-commerce,2021,https://andersonbatesandgreen.com,Win police medical ahead guess partner before compare my.,24,anderson-bates-and-green,2023,USD,1327978,298492,1029486,646705,382781,1331,381450,13279,26559,354891,49896,814792,299414,515378,,1327978,408.13,660.75,0.029,2077,53.28,26620.12,1.87,0.7752
4122,Cunningham Wilson and Rodriguez,False,EG,Orrport,EdTech,2009,https://cunninghamwilsonandrodriguez.com,Upon when seek season hot buy mean situation light.,17,cunningham-wilson-and-rodriguez,2023,USD,733868,187992,545876,196534,349342,7890,341452,7338,14677,326775,39069,535471,317364,218107,61155.67,733868,10.0,35.4,0.0514,936,65.32,1000.0,39.07,0.7438
4123,Ellis-Fletcher,False,DE,Port Shawn,SaaS,2021,https://ellis-fletcher.com,Pretty clear against skill continue run.,22,ellis-fletcher,2023,EUR,1572527,730614,841913,1183074,-341161,6258,-347419,15725,31450,-378869,189317,1161227,138661,1022566,131043.92,1572527,269.31,1207.61,0.0384,2848,46.01,98487.78,1.92,0.5354
4124,Smith and Sons,False,IN,Wyattbury,AgriTech,2013,https://smithandsons.com,Picture know worry produce bar soldier yet radio item consider enough.,28,smith-and-sons,2023,USD,556469,221291,335178,337564,-2386,21533,-23919,5564,11129,-35048,25772,332193,221459,110734,,556469,20.0,90.13,0.0699,412,112.45,1000.0,25.77,0.6023
4125,Baker LLC,False,FR,Williammouth,HealthTech,2010,https://bakerllc.com,Do she other so nothing project.,20,baker-llc,2023,EUR,1941744,775266,1166478,710260,456218,13484,442734,19417,38834,403900,87781,1246637,508826,737811,161812.0,1941744,297.84,830.43,0.001,2619,61.77,49914.18,1.76,0.6007
4126,Pratt Coffey and Rowe,False,IN,Ericburgh,Energy,2010,https://prattcoffeyandrowe.com,Choose keep skill consider piece soldier exist night floor fire.,26,pratt-coffey-and-rowe,2023,USD,1993724,475033,1518691,973331,545360,11851,533509,19937,39874,493635,28239,1184710,775493,409217,,1993724,20.0,56.69,0.12,617,269.19,64034.46,0.44,0.7617
4127,Taylor-Skinner,False,IN,Kellyhaven,Cybersecurity,2022,https://taylor-skinner.com,Value style than official control mean read radio I.,20,taylor-skinner,2023,USD,1521642,545473,976169,761184,214985,21305,193680,15216,30432,163248,32473,904586,345412,559174,,1521642,2084.67,11676.25,0.0414,2369,53.51,47741.7,0.68,0.6415
4128,Wright LLC,False,TN,South Anthony,AI/ML,2014,https://wrightllc.com,Investment democratic deal about avoid beat window same whom green stop.,15,wright-llc,2023,USD,619274,367875,251399,292639,-41240,26078,-67318,6192,12385,-79703,39388,353945,86828,267117,,619274,1069.12,2544.89,0.001,275,187.58,27774.7,1.42,0.406
4129,Lopez-Larson,False,BR,Debraville,AgriTech,2013,https://lopez-larson.com,Table call then real play study establish newspaper.,19,lopez-larson,2023,USD,1258188,433938,824250,894477,-70227,28325,-98552,12581,25163,-123715,36880,763709,253048,510661,,1258188,898.13,2778.81,0.0806,1039,100.83,64418.82,0.57,0.6551
4130,Harris-Campbell,False,US,Williamstown,Fintech,2021,https://harris-campbell.com,Including during teach into relationship camera.,26,harris-campbell,2023,USD,670889,341345,329544,238436,91108,22822,68286,6708,13417,54869,47090,441485,172329,269156,,670889,1385.07,3858.09,0.0371,518,107.78,40553.82,1.16,0.4912
4131,Dixon Carey and Becker,False,CA,Savannahview,AgriTech,2013,https://dixoncareyandbecker.com,Free whose at phone.,19,dixon-carey-and-becker,2023,USD,643104,124286,518818,270058,248760,15460,233300,6431,12862,220438,17937,528780,246404,282376,,643104,20.0,21.11,0.0978,525,102.07,6059.4,2.96,0.8067
4132,Rivera-Nguyen,False,DE,New Willie,E-commerce,2021,https://rivera-nguyen.com,Hope but church evening individual action there bed several.,17,rivera-nguyen,2023,EUR,3185867,1315784,1870083,1077798,792285,0,792285,31858,63717,728568,205502,1892392,264799,1627593,,3185867,56.55,178.17,0.0974,4273,62.13,96371.86,2.13,0.587
4133,Dunlap Hawkins and Brock,False,EG,Johnsonbury,Mobility,2013,https://dunlaphawkinsandbrock.com,Become beat open public realize know full suddenly.,17,dunlap-hawkins-and-brock,2023,USD,509236,138969,370267,189269,180998,8106,172892,5092,10184,162708,24122,431622,102399,329223,,509236,20.0,15.29,0.0276,2121,20.0,18941.19,1.27,0.7271
4134,Munoz Inc,False,ZA,Adamsview,Energy,2019,https://munozinc.com,Soon realize process author community.,16,munoz-inc,2023,USD,1295307,447282,848025,121398,726627,0,726627,12953,25906,700721,51056,736051,36802,699249,,1295307,382.44,191.22,0.001,5397,20.0,29754.39,1.72,0.6547
4135,Perez-Roberts,False,ZA,Rodriguezmouth,IoT,2020,https://perez-roberts.com,Personal consumer they picture social way nice quickly.,20,perez-roberts,2023,USD,2265082,831490,1433592,1035676,397916,0,397916,22650,45301,352615,55673,1266971,400926,866045,,2265082,20.0,70.15,0.0573,1446,130.47,63815.15,0.87,0.6329
4136,Brown LLC,False,US,North Jermainetown,AI/ML,2014,https://brownllc.com,Window thus organization course avoid its per player stuff but.,21,brown-llc,2023,USD,1568639,574086,994553,494969,499584,29661,469923,15686,31372,438551,36348,983913,129041,854872,,1568639,20.0,88.1,0.0584,2081,62.8,69952.22,0.52,0.634
4137,Thomas and Sons,False,FR,Markton,Cybersecurity,2012,https://thomasandsons.com,North ahead something lose avoid score describe tax should himself.,27,thomas-and-sons,2023,EUR,877461,361609,515852,558076,-42224,9604,-51828,8774,17549,-69377,29080,599406,99944,499462,,877461,20.0,84.35,0.0423,3656,20.0,63768.55,0.46,0.5879
4138,Smith-Sawyer,False,CA,South Kathrynchester,Marketplaces,2018,https://smith-sawyer.com,Upon response art information agreement.,19,smith-sawyer,2023,USD,1863081,624100,1238981,361572,877409,0,877409,18630,37261,840148,25934,1039903,390348,649555,,1863081,20.0,12.21,0.001,442,350.59,1000.0,25.93,0.665
4139,Davis and Sons,False,US,New Jessica,HealthTech,2022,https://davisandsons.com,Still seat process rise.,14,davis-and-sons,2023,USD,112632,34823,77809,51432,26377,11510,14867,1126,2252,12615,8528,196179,91031,105148,9386.0,112632,10.0,62.08,0.0943,109,85.93,1000.0,8.53,0.6908
4140,Gibson Inc,False,GB,Jameshaven,Mobility,2018,https://gibsoninc.com,Thousand stage fly big couple chair fact board total group.,17,gibson-inc,2023,USD,490889,141449,349440,288949,60491,0,60491,4908,9817,50674,18262,379273,80215,299058,,490889,75.49,329.31,0.1125,550,74.35,63242.27,0.29,0.7119
4141,Roberts Ltd,False,FR,North Johnview,Marketplaces,2021,https://robertsltd.com,Family need value catch rule.,16,roberts-ltd,2023,EUR,695281,340221,355060,567340,-212280,0,-212280,6952,13905,-226185,119304,658468,32923,625545,,695281,460.37,2183.51,0.0848,2897,20.0,1000.0,119.3,0.5107
4142,Anderson Short and Wood,False,IN,West Sophia,AI/ML,2008,https://andersonshortandwood.com,Line Mr support risk wear improve.,16,anderson-short-and-wood,2023,USD,238235,92855,145380,155542,-10162,16823,-26985,2382,4764,-31749,19160,176669,50891,125778,,238235,1855.08,9805.57,0.001,148,133.45,1000.0,19.16,0.6102
4143,Payne Russell and Baldwin,False,EG,Costaview,HealthTech,2022,https://paynerussellandbaldwin.com,Sense member summer keep whether system there people.,16,payne-russell-and-baldwin,2023,USD,911773,475062,436711,331464,105247,10038,95209,9117,18235,76974,17411,557331,204140,353191,75981.08,911773,56.78,98.48,0.0795,1036,73.34,49394.49,0.35,0.479
4144,Bradley-Lawrence,False,BR,Annetteburgh,IoT,2011,https://bradley-lawrence.com,Each section that stand woman similar part pattern above present need.,22,bradley-lawrence,2023,USD,467169,231129,236040,23358,212682,0,212682,4671,9343,203339,112662,437744,126144,311600,,467169,1112.65,1347.55,0.1477,585,66.48,1000.0,112.66,0.5053
4145,Gibson-Rivas,False,US,Johnton,EdTech,2014,https://gibson-rivas.com,Speak doctor lose themselves boy you.,28,gibson-rivas,2023,USD,874502,156317,718185,247815,470370,579,469791,8745,17490,452301,18360,537883,250561,287322,72875.17,874502,371.72,531.99,0.0394,1368,53.26,18631.27,0.99,0.8213
4146,Rios-Holloway,False,TN,Lake Yolandaberg,Cybersecurity,2013,https://rios-holloway.com,Instead style your medical know strong yourself all authority tonight.,26,rios-holloway,2023,USD,830516,513497,317019,521542,-204523,0,-204523,8305,16610,-221133,58403,587480,195411,392069,,830516,50.25,76.41,0.0501,321,215.01,30612.13,1.91,0.3817
4147,Joseph Fernandez and Neal,False,KE,South Allison,Energy,2014,https://josephfernandezandneal.com,Book expect about pressure environment.,22,joseph-fernandez-and-neal,2023,USD,282551,121062,161489,117569,43920,0,43920,2825,5651,38269,19995,351984,125616,226368,,282551,20.0,10.0,0.0053,144,162.55,11823.91,1.69,0.5715
4148,Cobb Scott and Vincent,False,CA,Port Vickie,EdTech,2014,https://cobbscottandvincent.com,Give like become still reason none.,11,cobb-scott-and-vincent,2023,USD,162908,29686,133222,102666,30556,11175,19381,1629,3258,16123,6855,110127,36821,73306,13575.67,162908,10.0,18.57,0.015,178,75.99,1000.0,6.86,0.8178
4149,Jones-Ibarra,False,BR,New Josephberg,IoT,2008,https://jones-ibarra.com,Government series policy car image ground feel its.,18,jones-ibarra,2023,USD,522503,163831,358672,282701,75971,0,75971,5225,10450,65521,43244,367778,88584,279194,,522503,959.18,2711.09,0.0469,2177,20.0,15434.52,2.8,0.6864
4150,Humphrey Smith and Smith,False,CA,Mayport,E-commerce,2008,https://humphreysmithandsmith.com,Final leader knowledge civil medical.,18,humphrey-smith-and-smith,2023,USD,1413779,850066,563713,687139,-123426,7193,-130619,14137,28275,-158894,17532,904028,377555,526473,,1413779,1831.92,8419.71,0.1069,1304,90.33,54659.46,0.32,0.3987
4151,Mcmahon-Jordan,False,IN,North Mary,AgriTech,2024,https://mcmahon-jordan.com,Nor great movie author and use customer.,19,mcmahon-jordan,2023,USD,600971,181043,419928,446051,-26123,15893,-42016,6009,12019,-54035,19004,357570,187742,169828,,600971,20.0,58.22,0.0169,2504,20.0,34539.35,0.55,0.6987
4152,Butler-Middleton,False,FR,New Emmaton,Cybersecurity,2023,https://butler-middleton.com,Language likely east best soldier stand five.,19,butler-middleton,2023,EUR,1754934,527745,1227189,646063,581126,22297,558829,17549,35098,523731,117029,1097012,163864,933148,,1754934,20.0,69.27,0.1316,943,155.08,24182.81,4.84,0.6993
4153,Patton Ltd,False,BR,Micheleshire,Mobility,2021,https://pattonltd.com,Decade vote finish reason get attention fast.,25,patton-ltd,2023,USD,2511995,900885,1611110,3293178,-1682068,28684,-1710752,25119,50239,-1760991,236161,1522772,645237,877535,,2511995,502.56,866.98,0.0933,768,272.41,285864.98,0.83,0.6414
4154,Williams-Smith,False,TN,Sandrachester,E-commerce,2019,https://williams-smith.com,Care onto significant speech view miss win bit why.,25,williams-smith,2023,USD,1946237,844372,1101865,976410,125455,10291,115164,19462,38924,76240,196402,1177814,180608,997206,,1946237,1161.93,4785.13,0.0182,3065,52.9,82632.91,2.38,0.5662
4155,Davis Ltd,False,NG,South Nicholaston,Energy,2024,https://davisltd.com,Program short turn throughout movement plant range yes.,14,davis-ltd,2023,USD,3047273,1768089,1279184,3164572,-1885388,0,-1885388,30472,60945,-1946333,356940,1963901,441523,1522378,,3047273,1686.7,4638.22,0.039,12696,20.0,257449.04,1.39,0.4198
4156,King LLC,False,AU,Lake Samuel,E-commerce,2011,https://kingllc.com,Image respond image resource capital health even hot air.,26,king-llc,2023,USD,527981,75708,452273,138729,313544,34902,278642,5279,10559,268083,24116,408785,36736,372049,,527981,20.0,10.0,0.0122,724,60.74,24059.71,1.0,0.8566
4157,Glover-Thompson,False,GB,Lewisfort,Mobility,2021,https://glover-thompson.com,Decide agreement lay wish break system.,23,glover-thompson,2023,USD,1361833,513591,848242,1300660,-452418,0,-452418,13618,27236,-479654,90226,911453,290975,620478,,1361833,405.42,2581.46,0.001,692,163.86,110431.59,0.82,0.6229
4158,Arellano Yoder and Graham,False,CA,Powersfurt,HealthTech,2013,https://arellanoyoderandgraham.com,Piece read local enter model than president enter however foot.,15,arellano-yoder-and-graham,2023,USD,2806533,140326,2666207,1039385,1626822,0,1626822,28065,56130,1570692,73293,1647773,271871,1375902,233877.75,2806533,10.0,34.15,0.0119,34751,6.73,96230.09,0.76,0.95
4159,Carter Long and Smith,False,NG,Osbornhaven,Energy,2020,https://carterlongandsmith.com,Forward media painting situation dream certainly perhaps provide spend director.,23,carter-long-and-smith,2023,USD,245447,89078,156369,22216,134153,0,134153,2454,4908,129245,14476,223802,69639,154163,,245447,910.17,2569.09,0.0718,135,150.93,50108.96,0.29,0.6371
4160,Johnson Ramirez and Martinez,False,IN,Jacobsborough,Marketplaces,2021,https://johnsonramirezandmartinez.com,Whatever mother get edge glass add fine.,19,johnson-ramirez-and-martinez,2023,USD,355207,166830,188377,117301,71076,51638,19438,3552,7104,12334,36747,364714,35466,329248,,355207,1824.87,2759.16,0.1192,292,101.27,59293.18,0.62,0.5303
4161,Scott LLC,False,BR,Wendyville,AgriTech,2011,https://scottllc.com,Use begin right respond seem should explain believe.,18,scott-llc,2023,USD,112487,24822,87665,30784,56881,6070,50811,1124,2249,48562,1315,153551,47120,106431,,112487,20.0,63.52,0.0526,38,243.95,13406.58,0.1,0.7793
4162,Brown and Sons,False,FR,South Brenda,Fintech,2010,https://brownandsons.com,With third entire by car travel international.,22,brown-and-sons,2023,EUR,2069875,424928,1644947,1407777,237170,40028,197142,20698,41397,155745,62711,1220153,840791,379362,,2069875,20.0,66.81,0.001,1109,155.49,137192.15,0.46,0.7947
4163,Foster Brooks and Craig,False,BR,Lake Mariemouth,SaaS,2021,https://fosterbrooksandcraig.com,Order according capital next ok physical appear they maybe.,20,foster-brooks-and-craig,2023,USD,583146,268630,314516,382505,-67989,10600,-78589,5831,11662,-90251,46340,455676,82446,373230,48595.5,583146,429.26,2593.03,0.0108,953,50.99,51910.55,0.89,0.5393
4164,Patrick-Hill,False,FR,South Marktown,Mobility,2011,https://patrick-hill.com,Wait know left charge strong interest year hot knowledge everything.,23,patrick-hill,2023,EUR,1142931,350604,792327,197737,594590,0,594590,11429,22858,571732,118070,797722,179776,617946,,1142931,428.85,539.17,0.001,4762,20.0,1000.0,118.07,0.6932
4165,Wu-Boyd,False,BR,Beltranland,Mobility,2024,https://wu-boyd.com,Research and he new serve offer Republican ready.,23,wu-boyd,2023,USD,1024744,427403,597341,337049,260292,23082,237210,10247,20494,216716,95348,800290,234194,566096,,1024744,932.09,4662.04,0.0163,257,331.22,12583.94,7.58,0.5829
4166,Jones-Mosley,False,KE,North Douglas,SaaS,2017,https://jones-mosley.com,Rest western floor image low.,22,jones-mosley,2023,USD,207416,83958,123458,133995,-10537,9633,-20170,2074,4148,-24318,10091,138497,56152,82345,17284.67,207416,361.42,1895.89,0.001,557,30.98,20891.74,0.48,0.5952
4167,Barnes Brown and Richards,False,TN,Port Holly,EdTech,2015,https://barnesbrownandrichards.com,Cell agree attack join must theory wait leg east.,19,barnes-brown-and-richards,2023,USD,164648,55074,109574,56099,53475,996,52479,1646,3292,49187,1503,245118,82059,163059,13720.67,164648,763.43,1084.1,0.0538,1309,10.48,17801.06,0.08,0.6655
4168,Wade PLC,False,AU,Lake Brendachester,Mobility,2020,https://wadeplc.com,Effect thing direction successful field why.,17,wade-plc,2023,USD,855022,295350,559672,564278,-4606,26328,-30934,8550,17100,-48034,98905,708839,54033,654806,,855022,1350.99,1793.42,0.076,282,251.78,16353.49,6.05,0.6546
4169,Henson and Sons,False,FR,Darlenefurt,EdTech,2023,https://hensonandsons.com,Boy four well poor own put account news well very.,24,henson-and-sons,2023,EUR,156055,40406,115649,84318,31331,0,31331,1560,3121,28210,12106,124184,104168,20016,13004.58,156055,10.0,15.95,0.0113,197,65.94,15321.7,0.79,0.7411
4170,Schwartz-Martin,False,FR,Aaronchester,E-commerce,2022,https://schwartz-martin.com,Begin stuff alone why treat reflect of sea.,19,schwartz-martin,2023,EUR,1357999,592660,765339,174052,591287,0,591287,13579,27159,564128,25515,841514,174250,667264,,1357999,32.64,27.74,0.117,3725,30.38,37767.19,0.68,0.5636
4171,Mcguire Inc,False,TN,Lake Eddie,Marketplaces,2020,https://mcguireinc.com,Issue cover into his both ground prove network no next.,16,mcguire-inc,2023,USD,254790,84265,170525,145819,24706,28623,-3917,2547,5095,-9012,5199,275413,13770,261643,,254790,767.7,1691.19,0.0456,72,291.77,6948.52,0.75,0.6693
4172,Yu Group,False,US,Karenborough,E-commerce,2015,https://yugroup.com,Position computer assume coach produce still hit best.,19,yu-group,2023,USD,1813402,358190,1455212,1346018,109194,0,109194,18134,36268,72926,99187,1133238,233298,899940,,1813402,1121.13,2011.97,0.0329,861,175.33,116149.81,0.85,0.8025
4173,Maynard Rhodes and Anderson,False,NG,West Lisaburgh,AgriTech,2016,https://maynardrhodesandanderson.com,Choose some so person so.,18,maynard-rhodes-and-anderson,2023,USD,737344,461365,275979,443805,-167826,10293,-178119,7373,14746,-192865,229714,673656,111008,562648,,737344,769.39,941.92,0.1116,762,80.54,67774.57,3.39,0.3743
4174,Payne and Sons,False,BR,North Feliciaton,AgriTech,2017,https://payneandsons.com,Practice stage son operation own who grow.,14,payne-and-sons,2023,USD,322519,82237,240282,48365,191917,0,191917,3225,6450,185467,44335,263343,115707,147636,,322519,20.0,64.16,0.1472,1343,20.0,29094.6,1.52,0.745
4175,Perez-Newton,False,AU,Richardsonport,Energy,2015,https://perez-newton.com,Against opportunity final case long.,24,perez-newton,2023,USD,1229191,534901,694290,486370,207920,0,207920,12291,24583,183337,36950,757527,37876,719651,,1229191,169.59,130.14,0.0782,504,202.95,5374.11,6.88,0.5648
4176,Lynch-Nelson,False,US,East Tylerview,Energy,2009,https://lynch-nelson.com,Federal bag woman wait various mention those effort floor choose.,25,lynch-nelson,2023,USD,508611,165887,342724,25430,317294,7150,310144,5086,10172,299972,166797,594525,250130,344395,,508611,1232.3,3692.07,0.1421,395,107.26,1000.0,166.8,0.6738
4177,Carson LLC,False,US,Susanview,SaaS,2012,https://carsonllc.com,College game term author before dog.,15,carson-llc,2023,USD,2276580,591063,1685517,113829,1571688,0,1571688,22765,45531,1526157,70996,1347163,891454,455709,189715.0,2276580,42.25,75.95,0.0153,2181,86.95,1000.0,71.0,0.7404
4178,Doyle-Hernandez,False,AU,Allisonchester,E-commerce,2024,https://doyle-hernandez.com,Dog same until degree girl.,17,doyle-hernandez,2023,USD,1303777,388138,915639,347367,568272,21361,546911,13037,26075,520836,490463,1321790,464130,857660,,1303777,589.04,1344.49,0.0243,519,209.0,24773.54,19.8,0.7023
4179,Roman Ltd,False,ZA,North Christian,IoT,2018,https://romanltd.com,Manage walk recent than inside response per.,15,roman-ltd,2023,USD,330866,147144,183722,80480,103242,0,103242,3308,6617,96625,16039,327785,61433,266352,,330866,852.95,3433.41,0.0708,142,193.31,12404.24,1.29,0.5553
4180,White Bean and Landry,False,CA,Jessicaburgh,HealthTech,2021,https://whitebeanandlandry.com,Baby bring billion one war near.,15,white-bean-and-landry,2023,USD,1576324,430425,1145899,688701,457198,33284,423914,15763,31526,392388,172603,1101760,387849,713911,131360.33,1576324,199.28,213.93,0.0134,1250,105.01,69694.08,2.48,0.7269
4181,Simon Romero and Richards,False,DE,East Jamie,AI/ML,2020,https://simonromeroandrichards.com,Present as might power bar population no yeah institution up.,23,simon-romero-and-richards,2023,EUR,1045770,422733,623037,425560,197477,0,197477,10457,20915,176562,59275,781067,283986,497081,,1045770,788.5,864.76,0.0718,1872,46.53,30826.57,1.92,0.5958
4182,Smith PLC,False,DE,New Anne,IoT,2020,https://smithplc.com,Player nation entire daughter fish young space trade instead.,21,smith-plc,2023,EUR,142503,73061,69442,17418,52024,25363,26661,1425,2850,23811,15159,277566,88740,188826,,142503,20.0,115.79,0.0297,159,74.68,1000.0,15.16,0.4873
4183,Wright Bender and Wagner,False,US,West Tiffanyhaven,IoT,2021,https://wrightbenderandwagner.com,Magazine week or matter leader news notice condition exist.,24,wright-bender-and-wagner,2023,USD,343214,118774,224440,17160,207280,42920,164360,3432,6864,157496,9171,252945,12647,240298,,343214,20.0,72.34,0.0983,250,114.22,19775.11,0.46,0.6539
4184,Hill-Reilly,False,GB,Savannahhaven,Marketplaces,2020,https://hill-reilly.com,Even event real water on rather line thing.,16,hill-reilly,2023,USD,1078167,371226,706941,634579,72362,0,72362,10781,21563,50799,50414,678029,429742,248287,,1078167,20.0,46.38,0.0263,353,254.46,31153.32,1.62,0.6557
4185,Williams Washington and Watson,False,ZA,Port Maria,HealthTech,2020,https://williamswashingtonandwatson.com,Unit policy never need before less.,21,williams-washington-and-watson,2023,USD,674823,270172,404651,319596,85055,0,85055,6748,13496,71559,73813,476872,176427,300445,56235.25,674823,10.0,15.72,0.0033,3469,16.21,1000.0,73.81,0.5996
4186,Ray Rowe and Briggs,False,CA,Leeville,AI/ML,2013,https://rayroweandbriggs.com,Time hot share heart quality result blood approach.,22,ray-rowe-and-briggs,2023,USD,1253599,494162,759437,283925,475512,4193,471319,12535,25071,446248,94092,904925,561251,343674,,1253599,1002.86,1616.67,0.0828,1468,71.13,5203.36,18.08,0.6058
4187,Davenport PLC,False,TN,Paigeview,EdTech,2011,https://davenportplc.com,Drop lawyer stage successful present common indicate design.,20,davenport-plc,2023,USD,209497,100801,108696,106591,2105,53,2052,2094,4189,-2137,47838,217086,10854,206232,17458.08,209497,10.0,61.99,0.0354,307,56.85,1000.0,47.84,0.5188
4188,Fleming-Brown,False,ZA,North Sandrastad,HealthTech,2024,https://fleming-brown.com,Help source weight fact process home mind environmental one modern.,20,fleming-brown,2023,USD,175721,8786,166935,27743,139192,14612,124580,1757,3514,121066,6461,109313,32312,77001,14643.42,175721,196.64,853.49,0.001,357,40.92,18077.35,0.36,0.95
4189,Owen Joseph and Ruiz,False,FR,South Bradleyville,Marketplaces,2020,https://owenjosephandruiz.com,Either add compare probably step.,11,owen-joseph-and-ruiz,2023,EUR,1377781,459400,918381,721946,196435,15707,180728,13777,27555,153173,155718,871885,480965,390920,,1377781,914.37,4433.61,0.0168,1288,89.13,32691.46,4.76,0.6666
4190,Shannon-Herman,False,AU,Smithstad,Marketplaces,2016,https://shannon-herman.com,Friend goal concern set sit without age public eye itself.,24,shannon-herman,2023,USD,1117451,393930,723521,537087,186434,6916,179518,11174,22349,157169,32680,592175,91284,500891,,1117451,20.0,18.24,0.105,4656,20.0,7071.36,4.62,0.6475
4191,Nelson Palmer and Joyce,False,NG,Cortezland,HealthTech,2018,https://nelsonpalmerandjoyce.com,Body exist keep first I weight it degree its recently.,16,nelson-palmer-and-joyce,2023,USD,4010775,1597501,2413274,926314,1486960,0,1486960,40107,80215,1406745,184411,2379420,1135288,1244132,334231.25,4010775,355.55,1356.42,0.0301,49224,6.79,64906.96,2.84,0.6017
4192,Reid PLC,False,DE,Hahnbury,Fintech,2010,https://reidplc.com,Determine great past team along.,16,reid-plc,2023,EUR,2471737,558466,1913271,1997844,-84573,0,-84573,24717,49434,-134007,67097,1402193,510305,891888,,2471737,2444.65,7462.67,0.0293,2675,77.0,117953.84,0.57,0.7741
4193,Hill-Kim,False,US,Jasonport,Energy,2008,https://hill-kim.com,Note radio approach full.,24,hill-kim,2023,USD,413269,105456,307813,412119,-104306,0,-104306,4132,8265,-112571,45805,401283,120450,280833,,413269,20.0,90.35,0.001,1684,20.44,27509.46,1.67,0.7448
4194,Rodriguez Ltd,False,BR,East James,IoT,2012,https://rodriguezltd.com,Ten yourself second word like care range.,20,rodriguez-ltd,2023,USD,304919,171383,133536,192858,-59322,0,-59322,3049,6098,-65420,111548,401499,107764,293735,,304919,269.34,1012.76,0.062,262,96.78,25268.02,4.41,0.4379
4195,Roberts David and Dominguez,False,US,New Tiffanystad,IoT,2010,https://robertsdavidanddominguez.com,Seat after certainly thus step any forward.,21,roberts-david-and-dominguez,2023,USD,1616677,292351,1324326,566944,757382,0,757382,16166,32333,725049,14963,938416,286915,651501,,1616677,1707.69,853.84,0.0305,676,199.21,21836.4,0.69,0.8192
4196,Richard Coffey and Hernandez,False,KE,East Jared,Energy,2008,https://richardcoffeyandhernandez.com,Animal reflect so summer phone.,23,richard-coffey-and-hernandez,2023,USD,2753100,748310,2004790,736580,1268210,23307,1244903,27531,55062,1189841,135946,1599965,889887,710078,,2753100,23.87,71.07,0.0654,1442,159.07,66189.23,2.05,0.7282
4197,Harrison-Robertson,False,ZA,Robertton,Cybersecurity,2012,https://harrison-robertson.com,Stuff care see because million hotel member like.,13,harrison-robertson,2023,USD,685633,239601,446032,251903,194129,0,194129,6856,13712,180417,71490,561606,223382,338224,,685633,813.63,544.02,0.108,2856,20.0,3929.43,18.19,0.6505
4198,Perez-Turner,False,EG,Port Williamland,Marketplaces,2019,https://perez-turner.com,North specific key eight near avoid me.,27,perez-turner,2023,USD,497233,196186,301047,318929,-17882,5249,-23131,4972,9944,-33075,31735,351821,144302,207519,,497233,20.0,47.44,0.0423,2071,20.0,1000.0,31.74,0.6054
4199,Ford Ltd,False,GB,Stephanieville,EdTech,2015,https://fordltd.com,Seek operation moment science night cell.,20,ford-ltd,2023,USD,319893,84524,235369,62915,172454,5316,167138,3198,6397,160741,18725,347296,258359,88937,26657.75,319893,406.06,1889.59,0.0715,451,59.01,1000.0,18.73,0.7358
4200,Hale-Nelson,False,IN,Ryanstad,EdTech,2015,https://hale-nelson.com,Safe mother realize more PM service fish evidence whole.,15,hale-nelson,2023,USD,604923,181704,423219,66567,356652,0,356652,6049,12098,344554,29007,367035,48413,318622,50410.25,604923,334.1,1608.73,0.0586,10082,5.0,7131.43,4.07,0.6996
4201,Mitchell-Murray,False,ZA,Marymouth,Energy,2016,https://mitchell-murray.com,Large vote season other dark then.,23,mitchell-murray,2023,USD,7585717,3147921,4437796,5800400,-1362604,8100,-1370704,75857,151714,-1522418,257888,4113324,1294204,2819120,,7585717,483.36,241.68,0.0755,5377,117.56,463966.61,0.56,0.585
4202,Fuentes Fernandez and Ramos,False,BR,East James,SaaS,2016,https://fuentesfernandezandramos.com,Mention raise right former establish something civil detail early.,25,fuentes-fernandez-and-ramos,2023,USD,1185092,407747,777345,604695,172650,0,172650,11850,23701,148949,206445,848308,278904,569404,98757.67,1185092,659.96,2543.44,0.0117,19751,5.0,31722.82,6.51,0.6559
4203,Vargas Hayes and Miles,False,FR,West Ericaview,HealthTech,2008,https://vargashayesandmiles.com,True music tough base house crime during nor.,22,vargas-hayes-and-miles,2023,EUR,1795542,307830,1487712,158207,1329505,7437,1322068,17955,35910,1286158,32487,947284,283795,663489,149628.5,1795542,10.0,31.52,0.0247,1056,141.66,38523.1,0.84,0.8286
4204,Ross and Sons,False,BR,Hayesmouth,IoT,2011,https://rossandsons.com,Rest may also administration change source with.,17,ross-and-sons,2023,USD,1695168,467987,1227181,845391,381790,0,381790,16951,33903,347887,38258,1050672,393741,656931,,1695168,1464.35,3053.67,0.087,7063,20.0,84996.61,0.45,0.7239
4205,Carlson Tucker and Horton,False,FR,Stephentown,Mobility,2011,https://carlsontuckerandhorton.com,Quickly image individual process hospital.,18,carlson-tucker-and-horton,2023,EUR,562114,222067,340047,272156,67891,28313,39578,5621,11242,28336,41608,504824,223713,281111,,562114,20.0,44.15,0.0386,2342,20.0,1000.0,41.61,0.6049
4206,Armstrong-Carson,False,FR,South Sandra,HealthTech,2017,https://armstrong-carson.com,Home research test region tonight ok.,17,armstrong-carson,2023,EUR,1244152,532448,711704,426305,285399,26151,259248,12441,24883,234365,98466,740370,427440,312930,103679.33,1244152,10.0,39.21,0.0233,908,114.06,12853.0,7.66,0.572
4207,Williams Horn and Tucker,False,IN,Port Allen,HealthTech,2010,https://williamshornandtucker.com,Memory doctor wish during audience actually toward country these exactly.,22,williams-horn-and-tucker,2023,USD,329418,70535,258883,238093,20790,24259,-3469,3294,6588,-10057,1929,276013,48198,227815,27451.5,329418,451.78,1714.0,0.0515,771,35.57,7516.09,0.26,0.7859
4208,Paul Miller and Cook,False,FR,Lake Tammy,Mobility,2019,https://paulmillerandcook.com,End house experience edge focus reality cover rich.,25,paul-miller-and-cook,2023,EUR,1693178,664399,1028779,593178,435601,0,435601,16931,33863,401738,68472,1108981,713247,395734,,1693178,20.0,24.59,0.0036,828,170.32,69686.38,0.98,0.6076
4209,Thomas Ltd,False,DE,Andrewport,Energy,2011,https://thomasltd.com,Letter mission minute produce may new student activity.,19,thomas-ltd,2023,EUR,4027334,1707973,2319361,1920342,399019,0,399019,40273,80546,318473,153641,2231304,1154109,1077195,,4027334,20.0,43.59,0.001,5525,60.74,186202.95,0.83,0.5759
4210,Lane-Baker,False,EG,Henrytown,SaaS,2021,https://lane-baker.com,Mouth now chance field yet product.,29,lane-baker,2023,USD,1127425,772089,355336,210689,144647,0,144647,11274,22548,122099,54667,665847,370284,295563,93952.08,1127425,10.0,70.52,0.0523,12976,7.24,10252.56,5.33,0.3152
4211,Schmitt and Sons,False,FR,Jameshaven,Mobility,2010,https://schmittandsons.com,Art but travel leave try process parent movement term step.,22,schmitt-and-sons,2023,EUR,541055,201741,339314,229019,110295,0,110295,5410,10821,99474,28272,427739,215425,212314,,541055,20.0,59.22,0.08,2254,20.0,20992.47,1.35,0.6271
4212,Bauer Powell and Carrillo,False,DE,Travishaven,Marketplaces,2021,https://bauerpowellandcarrillo.com,Do let success board very activity case station.,15,bauer-powell-and-carrillo,2023,EUR,1507673,535147,972526,560512,412014,0,412014,15076,30153,381861,10876,909703,237603,672100,,1507673,20.0,69.52,0.039,6281,20.0,47508.07,0.23,0.6451
4213,Robles-Frazier,False,TN,West Patrickburgh,E-commerce,2022,https://robles-frazier.com,Change many along collection TV ready.,20,robles-frazier,2023,USD,666957,307276,359681,245825,113856,0,113856,6669,13339,100517,65141,459548,89150,370398,,666957,189.7,700.9,0.0255,177,313.44,57138.95,1.14,0.5393
4214,Harrington Ltd,False,AU,South Amanda,HealthTech,2013,https://harringtonltd.com,Arrive Mr act reach.,25,harrington-ltd,2023,USD,502298,127278,375020,270739,104281,0,104281,5022,10045,94236,13800,303079,63228,239851,41858.17,502298,27.69,170.93,0.0587,8371,5.0,1000.0,13.8,0.7466
4215,Duke-Hernandez,False,IN,New Stephanie,SaaS,2013,https://duke-hernandez.com,Force always physical country sister term account read.,35,duke-hernandez,2023,USD,418953,56125,362828,226780,136048,8745,127303,4189,8379,118924,27515,351968,91979,259989,34912.75,418953,79.81,79.81,0.0427,608,57.41,13662.82,2.01,0.866
4216,Moreno Barrett and Solis,False,BR,Josephshire,IoT,2009,https://morenobarrettandsolis.com,Detail physical such a he prevent.,27,moreno-barrett-and-solis,2023,USD,173738,77152,96586,78877,17709,1883,15826,1737,3474,12352,10672,233692,57113,176579,,173738,605.52,4175.7,0.1241,49,292.13,29190.89,0.37,0.5559
4217,Brown-Martinez,False,FR,South Jonathan,E-commerce,2019,https://brown-martinez.com,Ever better style why buy carry color both.,22,brown-martinez,2023,EUR,4173298,1733417,2439881,2594041,-154160,18158,-172318,41732,83465,-255783,134459,2418203,1255617,1162586,,4173298,328.77,1762.26,0.089,1055,329.45,199612.52,0.67,0.5846
4218,Joseph Martin and Quinn,False,EG,Bryantown,IoT,2008,https://josephmartinandquinn.com,Each crime science return send building.,20,joseph-martin-and-quinn,2023,USD,866973,290962,576011,159057,416954,6734,410220,8669,17339,392881,25854,519164,25958,493206,,866973,2211.61,3373.57,0.0538,480,150.47,20286.37,1.27,0.6644
4219,Lane Maldonado and House,False,GB,Sarahaven,AI/ML,2016,https://lanemaldonadoandhouse.com,Executive cost do already case require.,19,lane-maldonado-and-house,2023,USD,354279,65050,289229,292574,-3345,2543,-5888,3542,7085,-12973,30666,270208,118270,151938,,354279,20.0,10.0,0.1278,101,290.48,3219.78,9.52,0.8164
4220,Miller Charles and Williams,False,FR,New Mackenzieshire,EdTech,2008,https://millercharlesandwilliams.com,Difference center begin forget look political yourself so.,12,miller-charles-and-williams,2023,EUR,90894,13049,77845,44985,32860,5843,27017,908,1817,25200,17353,188545,54330,134215,7574.5,90894,10.0,81.8,0.001,105,71.58,1000.0,17.35,0.8564
4221,Fernandez Lindsey and Randolph,False,NG,Lake Mario,SaaS,2024,https://fernandezlindseyandrandolph.com,Republican people fight relationship person number.,30,fernandez-lindsey-and-randolph,2023,USD,527228,163308,363920,395988,-32068,30589,-62657,5272,10544,-73201,65458,433999,98253,335746,43935.67,527228,332.41,1600.12,0.0105,8787,5.0,24879.76,2.63,0.6903
4222,French Melton and Washington,False,NG,North Elizabeth,HealthTech,2014,https://frenchmeltonandwashington.com,Spring section stuff bill girl soon decade box itself knowledge.,20,french-melton-and-washington,2023,USD,4527391,924931,3602460,732527,2869933,13342,2856591,45273,90547,2766044,1235126,3678466,2122326,1556140,377282.58,4527391,10.0,10.0,0.0356,2690,140.23,80125.44,15.41,0.7957
4223,Miller LLC,False,CA,North Sheilaport,Fintech,2014,https://millerllc.com,Miss spring image professor herself certainly personal picture pattern could.,20,miller-llc,2023,USD,3588218,1737297,1850921,1092814,758107,10426,747681,35882,71764,675917,70383,1949739,116999,1832740,,3588218,842.73,811.45,0.0836,14950,20.0,80212.2,0.88,0.5158
4224,Thornton and Sons,False,US,Wangberg,E-commerce,2012,https://thorntonandsons.com,Wind particular capital worry role call sea point her include.,20,thornton-and-sons,2023,USD,537266,60204,477062,97238,379824,0,379824,5372,10745,369079,47644,339020,126650,212370,,537266,903.22,4734.39,0.0276,200,223.52,1000.0,47.64,0.8879
4225,Marshall Moran and Beard,False,DE,Wallaceland,Fintech,2012,https://marshallmoranandbeard.com,Less space three financial even affect.,17,marshall-moran-and-beard,2023,EUR,574675,120124,454551,241950,212601,19940,192661,5746,11493,181168,7888,351226,75667,275559,,574675,479.64,239.82,0.001,443,108.02,32256.81,0.24,0.791
4226,Johnson PLC,False,IN,Andersonborough,AgriTech,2023,https://johnsonplc.com,Possible close sign on south leader culture.,25,johnson-plc,2023,USD,241161,117599,123562,56811,66751,42823,23928,2411,4823,19105,3262,160649,46282,114367,,241161,20.0,58.62,0.019,1004,20.0,1000.0,3.26,0.5124
4227,Hawkins-Delacruz,False,DE,Maynardchester,Fintech,2019,https://hawkins-delacruz.com,Off walk stay Republican well.,17,hawkins-delacruz,2023,EUR,2353440,404526,1948914,1894754,54160,48194,5966,23534,47068,-41102,56110,1322235,300471,1021764,,2353440,349.95,1313.62,0.0257,797,245.79,158000.61,0.36,0.8281
4228,Fuentes and Sons,False,ZA,Keithview,AI/ML,2017,https://fuentesandsons.com,Center seek investment hope.,15,fuentes-and-sons,2023,USD,611196,190709,420487,384694,35793,0,35793,6111,12223,23570,50424,520705,170218,350487,,611196,483.88,1675.38,0.0496,862,59.08,48177.46,1.05,0.688
4229,Douglas Flores and Brown,False,EG,Lauraberg,Cybersecurity,2023,https://douglasfloresandbrown.com,Garden must million performance adult actually.,21,douglas-flores-and-brown,2023,USD,11466330,3044995,8421335,3646842,4774493,0,4774493,114663,229326,4545167,2877739,8665616,2269612,6396004,,11466330,20.0,10.0,0.0517,30567,31.26,282724.74,10.18,0.7344
4230,Poole-Goodman,False,TN,Lake Scott,AI/ML,2020,https://poole-goodman.com,Executive listen along professional its.,24,poole-goodman,2023,USD,601712,30085,571627,511893,59734,10118,49616,6017,12034,37582,46931,488787,425487,63300,,601712,1042.07,521.04,0.0262,2159,23.22,30873.37,1.52,0.95
4231,Parsons Byrd and Bridges,False,DE,New David,AgriTech,2013,https://parsonsbyrdandbridges.com,Nor believe statement development west grow court fear.,18,parsons-byrd-and-bridges,2023,EUR,414934,132908,282026,310470,-28444,0,-28444,4149,8298,-36742,41667,281855,65245,216610,,414934,20.0,148.95,0.001,182,189.9,14777.42,2.82,0.6797
4232,Smith Ltd,False,DE,South Carolyn,Marketplaces,2016,https://smithltd.com,Member culture brother wonder computer shoulder anyone future check.,28,smith-ltd,2023,EUR,2296999,1085166,1211833,1501521,-289688,0,-289688,22969,45939,-335627,54175,1276502,202375,1074127,,2296999,20.0,58.62,0.0822,9570,20.0,140715.82,0.38,0.5276
4233,Cox Green and Mendez,False,TN,East Jonathanton,Fintech,2017,https://coxgreenandmendez.com,Mr group ground pattern half on likely either.,23,cox-green-and-mendez,2023,USD,1074226,459902,614324,412105,202219,11079,191140,10742,21484,169656,42777,672834,232452,440382,,1074226,504.81,2101.15,0.0276,529,169.22,58851.46,0.73,0.5719
4234,Parsons LLC,False,GB,West Vanessaport,EdTech,2023,https://parsonsllc.com,Term relate record rule some sense admit.,25,parsons-llc,2023,USD,822008,595313,226695,287407,-60712,0,-60712,8220,16440,-77152,19459,513874,304365,209509,68500.67,822008,303.22,1163.73,0.0326,1256,54.52,25609.79,0.76,0.2758
4235,Ramirez-Diaz,False,TN,East Karenborough,Mobility,2021,https://ramirez-diaz.com,Strong south threat now expect.,19,ramirez-diaz,2023,USD,3728766,975681,2753085,2480243,272842,16283,256559,37287,74575,181984,640020,2703481,1011600,1691881,,3728766,20.0,39.65,0.0707,15536,20.0,181241.42,3.53,0.7383
4236,Carter Nelson and Anderson,False,KE,East Claire,Cybersecurity,2016,https://carternelsonandanderson.com,Friend may learn their choice wear trade three stay improve.,25,carter-nelson-and-anderson,2023,USD,2267917,488295,1779622,899710,879912,0,879912,22679,45358,834554,1090479,2331916,1554209,777707,,2267917,1258.4,5283.06,0.0679,3705,51.0,82066.78,13.29,0.7847
4237,Smith LLC,False,CA,Madisonmouth,IoT,2011,https://smithllc.com,Nothing social fight kid.,19,smith-llc,2023,USD,672764,457418,215346,397197,-181851,30040,-211891,6727,13455,-225346,26814,459371,113300,346071,,672764,20.0,85.53,0.0448,2803,20.0,50963.4,0.53,0.3201
4238,Craig Mckinney and Jones,False,KE,Gonzalezside,Energy,2021,https://craigmckinneyandjones.com,Media truth add return from student.,13,craig-mckinney-and-jones,2023,USD,624269,338059,286210,531834,-245624,0,-245624,6242,12485,-258109,36173,352609,17630,334979,,624269,20.0,80.31,0.0582,1916,27.15,34697.56,1.04,0.4585
4239,Bailey and Sons,False,DE,North Monicahaven,IoT,2019,https://baileyandsons.com,Road executive city work which its throw hard today hard.,16,bailey-and-sons,2023,EUR,390745,99815,290930,170161,120769,0,120769,3907,7814,112955,191621,419832,176617,243215,,390745,413.93,837.86,0.0297,246,131.98,8232.42,23.28,0.7446
4240,Macdonald Group,False,CA,North Brandon,Marketplaces,2010,https://macdonaldgroup.com,Star speech dark ok their bad how.,25,macdonald-group,2023,USD,1946840,668856,1277984,776231,501753,0,501753,19468,38936,462817,831272,1911754,210787,1700967,,1946840,20.0,10.0,0.001,1259,128.77,65928.34,12.61,0.6564
4241,Smith-Estrada,False,EG,Marymouth,HealthTech,2009,https://smith-estrada.com,Note support enough hope road kitchen decision people.,16,smith-estrada,2023,USD,897142,397520,499622,91158,408464,2127,406337,8971,17942,388395,55639,664473,308953,355520,74761.83,897142,338.11,1032.62,0.0126,740,100.96,9157.0,6.08,0.5569
4242,Vaughn and Sons,False,NG,Burnettstad,AgriTech,2021,https://vaughnandsons.com,Thank energy big hotel southern thought turn hair reach.,25,vaughn-and-sons,2023,USD,324644,115068,209576,89362,120214,0,120214,3246,6492,113722,26993,298848,86244,212604,,324644,20.0,60.68,0.1524,79,338.35,42019.04,0.64,0.6456
4243,Winters-Morales,False,IN,South Jasonfurt,IoT,2024,https://winters-morales.com,Future hot language base institution statement least hope.,20,winters-morales,2023,USD,1344262,522931,821331,1172297,-350966,19382,-370348,13442,26885,-397233,31861,852056,632150,219906,,1344262,20.0,80.95,0.001,1042,107.45,77280.33,0.41,0.611
4244,Gilbert and Sons,False,CA,Patriciachester,Energy,2008,https://gilbertandsons.com,Dinner exist institution true me firm.,22,gilbert-and-sons,2023,USD,921294,476260,445034,559724,-114690,8377,-123067,9212,18425,-141492,32921,531691,26584,505107,,921294,2019.88,10866.6,0.0247,904,84.91,56592.77,0.58,0.4831
4245,Perry-Reeves,False,FR,South Carmen,HealthTech,2018,https://perry-reeves.com,Know piece attorney say development easy school.,19,perry-reeves,2023,EUR,817338,151812,665526,182499,483027,0,483027,8173,16346,466681,61460,667683,268150,399533,68111.5,817338,504.59,504.59,0.001,393,172.99,25866.43,2.38,0.8143
4246,Wilson Group,False,TN,Woodston,HealthTech,2019,https://wilsongroup.com,Democrat second friend daughter us style sister between.,19,wilson-group,2023,USD,526918,258142,268776,223717,45059,46791,-1732,5269,10538,-12270,26254,346843,42290,304553,43909.83,526918,461.1,2579.76,0.001,663,66.21,49192.07,0.53,0.5101
4247,Stevenson Alvarado and Cox,False,DE,Cherylside,Fintech,2014,https://stevensonalvaradoandcox.com,Treat area question board suffer high never table heavy whole protect.,21,stevenson-alvarado-and-cox,2023,EUR,362773,196001,166772,105507,61265,8126,53139,3627,7255,45884,16476,237542,11877,225665,,362773,20.0,24.4,0.0957,302,99.95,32539.95,0.51,0.4597
4248,Foley-Winters,False,BR,Roytown,E-commerce,2019,https://foley-winters.com,System theory dark college executive Mr.,21,foley-winters,2023,USD,2115252,618778,1496474,1989686,-493212,10205,-503417,21152,42305,-545722,356948,1500226,619242,880984,,2115252,20.0,10.0,0.0187,1251,140.87,158518.33,2.25,0.7075
4249,Sullivan-Thomas,False,GB,New Tammyberg,E-commerce,2011,https://sullivan-thomas.com,Lead improve security from itself.,27,sullivan-thomas,2023,USD,570841,284719,286122,449742,-163620,17107,-180727,5708,11416,-192143,13829,425356,184520,240836,,570841,1243.45,3708.45,0.001,434,109.58,41037.19,0.34,0.5012
4250,Hall-Lawson,False,US,Durhamton,E-commerce,2008,https://hall-lawson.com,Tough marriage manager clear skin crime health land avoid.,24,hall-lawson,2023,USD,1669683,832742,836941,1457266,-620325,44812,-665137,16696,33393,-698530,61181,955587,430115,525472,,1669683,20.0,83.94,0.0735,1003,138.62,169992.12,0.36,0.5013
4251,Stevens-Reynolds,False,ZA,Heatherfort,E-commerce,2014,https://stevens-reynolds.com,Brother effort today citizen body require scientist camera cultural technology old.,23,stevens-reynolds,2023,USD,3148149,1120719,2027430,2390386,-362956,0,-362956,31481,62962,-425918,129886,1789154,434485,1354669,,3148149,20.0,41.41,0.0236,13117,20.0,191099.01,0.68,0.644
4252,Olsen-Morgan,False,EG,Thompsonview,IoT,2018,https://olsen-morgan.com,World lay even response contain benefit son player ago other.,24,olsen-morgan,2023,USD,439544,250521,189023,276820,-87797,30447,-118244,4395,8790,-127034,9320,339946,178600,161346,,439544,20.0,68.6,0.0418,1831,20.0,15743.39,0.59,0.43
4253,Hull-Mendoza,False,DE,New Johnhaven,AI/ML,2010,https://hull-mendoza.com,Make actually place see.,21,hull-mendoza,2023,EUR,208837,53057,155780,10441,145339,1416,143923,2088,4176,139747,2766,247356,12367,234989,,208837,1029.24,3325.03,0.0508,156,110.88,1000.0,2.77,0.7459
4254,Long-Butler,False,TN,Smithborough,AgriTech,2014,https://long-butler.com,Positive strong American sit beautiful movie myself.,24,long-butler,2023,USD,702206,243820,458386,876917,-418531,7308,-425839,7022,14044,-439883,31322,514787,200067,314720,,702206,20.0,81.09,0.008,2925,20.0,71143.27,0.44,0.6528
4255,Brown-Carroll,False,NG,West Virginia,EdTech,2011,https://brown-carroll.com,Wear hair scientist beat amount create want story open themselves.,18,brown-carroll,2023,USD,362381,114764,247617,208590,39027,7906,31121,3623,7247,23874,9143,364093,88631,275462,30198.42,362381,254.32,676.87,0.0445,6039,5.0,19073.92,0.48,0.6833
4256,Cruz Peters and Rios,False,NG,West Brianport,AgriTech,2010,https://cruzpetersandrios.com,Best home how player worry best son.,16,cruz-peters-and-rios,2023,USD,213566,78061,135505,91664,43841,0,43841,2135,4271,39570,1470,283193,88363,194830,,213566,861.01,4131.6,0.0414,68,259.53,18808.3,0.08,0.6345
4257,Harris-Mitchell,False,KE,Jameschester,Marketplaces,2021,https://harris-mitchell.com,Picture sell successful actually size.,9,harris-mitchell,2023,USD,1378979,656935,722044,919962,-197918,29172,-227090,13789,27579,-254669,32615,899424,301425,597999,,1378979,20.0,79.3,0.0873,456,251.6,78196.21,0.42,0.5236
4258,Robertson Inc,False,BR,Meganfort,Energy,2018,https://robertsoninc.com,Yet quite mission represent growth remain education.,23,robertson-inc,2023,USD,1555001,310191,1244810,851844,392966,0,392966,15550,31100,361866,52392,862046,471500,390546,,1555001,422.11,1811.52,0.0121,3586,36.13,88506.28,0.59,0.8005
4259,Atkinson Jackson and Hines,False,CA,New Steve,EdTech,2014,https://atkinsonjacksonandhines.com,Mrs out central nothing discover prove.,18,atkinson-jackson-and-hines,2023,USD,551261,261372,289889,195089,94800,15802,78998,5512,11025,67973,7330,428088,21404,406684,45938.42,551261,10.0,52.41,0.0409,932,49.24,52344.67,0.14,0.5259
4260,Parks-Rogers,False,US,West Michelemouth,Mobility,2023,https://parks-rogers.com,Present which option over car avoid.,23,parks-rogers,2023,USD,1880433,620987,1259446,1090767,168679,2825,165854,18804,37608,128246,25246,1076374,294563,781811,,1880433,1375.56,687.78,0.1555,462,339.08,100856.86,0.25,0.6698
4261,Graves-Mcguire,False,US,Bowmanburgh,AgriTech,2021,https://graves-mcguire.com,Happy policy interesting its another book might.,30,graves-mcguire,2023,USD,126579,47293,79286,47191,32095,0,32095,1265,2531,29564,26087,125983,37430,88553,,126579,20.0,86.51,0.046,110,95.09,3946.65,6.61,0.6264
4262,Jenkins Group,False,FR,Perezland,Fintech,2022,https://jenkinsgroup.com,Drug senior cup the strong how picture house shake.,18,jenkins-group,2023,EUR,965827,592372,373455,649449,-275994,18903,-294897,9658,19316,-314213,39822,716838,264309,452529,,965827,483.5,1920.61,0.0248,4024,20.0,78139.98,0.51,0.3867
4263,West-Dennis,False,GB,Port Dannyton,IoT,2018,https://west-dennis.com,Establish build support child concern risk if.,18,west-dennis,2023,USD,192076,34226,157850,94416,63434,37085,26349,1920,3841,22508,23404,122863,35487,87376,,192076,1386.34,693.17,0.0714,90,177.04,21597.31,1.08,0.8218
4264,Farrell LLC,False,KE,East Mike,Energy,2015,https://farrellllc.com,Because someone admit world maintain pay star despite movement.,20,farrell-llc,2023,USD,2584296,1129426,1454870,1569032,-114162,40435,-154597,25842,51685,-206282,236200,1583231,228636,1354595,,2584296,489.14,3294.72,0.0793,10767,20.0,131067.22,1.8,0.563
4265,James and Sons,False,KE,Mirandahaven,SaaS,2017,https://jamesandsons.com,Almost work have finally reach thing do budget successful.,24,james-and-sons,2023,USD,2894718,896773,1997945,1146961,850984,0,850984,28947,57894,793090,48243,1679181,83959,1595222,241226.5,2894718,189.16,513.82,0.0674,2717,88.77,90447.9,0.53,0.6902
4266,Sanders-Richards,False,US,South Anthonyshire,Marketplaces,2008,https://sanders-richards.com,American off let enough popular follow speak shoulder.,26,sanders-richards,2023,USD,96737,26095,70642,45289,25353,11951,13402,967,1934,11468,4962,170790,82058,88732,,96737,1521.65,6831.99,0.0073,403,20.0,1000.0,4.96,0.7302
4267,Cox-Rios,False,EG,Morachester,AgriTech,2012,https://cox-rios.com,Vote guy practice stuff deal.,24,cox-rios,2023,USD,82931,22009,60922,53788,7134,0,7134,829,1658,5476,8205,120606,12633,107973,,82931,726.66,3227.01,0.0253,345,20.0,30284.74,0.27,0.7346
4268,Smith-Shelton,False,TN,North Karenland,SaaS,2024,https://smith-shelton.com,Rate defense conference again three market interview.,17,smith-shelton,2023,USD,383997,144147,239850,159283,80567,0,80567,3839,7679,72888,22746,261527,65571,195956,31999.75,383997,514.48,2877.2,0.001,1570,20.37,8367.8,2.72,0.6246
4269,Alexander-Murillo,False,US,New Christopherton,E-commerce,2008,https://alexander-murillo.com,Garden debate section wide analysis certainly.,16,alexander-murillo,2023,USD,2258612,857367,1401245,1416502,-15257,0,-15257,22586,45172,-60429,112145,1386371,451791,934580,,2258612,1206.8,4710.85,0.0223,9410,20.0,111054.05,1.01,0.6204
4270,Bishop Cross and Reese,False,FR,Derrickside,Mobility,2011,https://bishopcrossandreese.com,Sport treat pick process moment next development civil.,20,bishop-cross-and-reese,2023,EUR,2728992,1248575,1480417,826047,654370,3142,651228,27289,54579,596649,694184,2254319,1074306,1180013,,2728992,1007.37,3020.81,0.0498,1269,179.14,62242.34,11.15,0.5425
4271,Wiley and Sons,False,AU,Simpsonstad,Energy,2017,https://wileyandsons.com,Later create sort race enough her understand lot usually human.,16,wiley-and-sons,2023,USD,1653047,559911,1093136,317171,775965,0,775965,16530,33060,742905,62358,1045873,565761,480112,,1653047,274.3,137.15,0.001,499,275.56,43888.8,1.42,0.6613
4272,Gilbert Inc,False,IN,Lake Tracyfort,E-commerce,2019,https://gilbertinc.com,Drive measure laugh management.,18,gilbert-inc,2023,USD,2855080,604078,2251002,2682539,-431537,11935,-443472,28550,57101,-500573,57110,1667499,954808,712691,,2855080,1100.58,2321.1,0.001,3151,75.49,220900.55,0.26,0.7884
4273,Sweeney-Adams,False,TN,Andrehaven,Fintech,2018,https://sweeney-adams.com,Head late executive tonight series sit.,24,sweeney-adams,2023,USD,2261149,1090566,1170583,457747,712836,44598,668238,22611,45222,623016,43859,1336233,468679,867554,,2261149,1073.09,2055.13,0.0442,2195,85.83,44475.48,0.99,0.5177
4274,Martin-Sanchez,False,EG,Fullerburgh,IoT,2009,https://martin-sanchez.com,Another entire tax and simply.,13,martin-sanchez,2023,USD,924194,361558,562636,220945,341691,25807,315884,9241,18483,297401,56839,594707,291464,303243,,924194,923.59,4453.81,0.0497,3850,20.0,21756.17,2.61,0.6088
4275,Hartman Wilkinson and Garza,False,TN,Julieshire,AgriTech,2022,https://hartmanwilkinsonandgarza.com,Discussion theory minute stop state travel agreement resource happen resource.,21,hartman-wilkinson-and-garza,2023,USD,407279,170743,236536,216686,19850,14113,5737,4072,8145,-2408,29906,289114,186310,102804,,407279,20.0,70.84,0.1531,233,145.12,1000.0,29.91,0.5808
4276,Cooke and Sons,False,EG,Katiemouth,Marketplaces,2011,https://cookeandsons.com,Situation whatever technology region consider always method own in.,26,cooke-and-sons,2023,USD,913779,339108,574671,308367,266304,0,266304,9137,18275,248029,72401,548863,86095,462768,,913779,297.19,1102.25,0.0088,1962,38.81,40807.59,1.77,0.6289
4277,Carter-Mckenzie,False,CA,Crystalborough,IoT,2011,https://carter-mckenzie.com,Population across room describe today discuss kitchen trip bag your.,23,carter-mckenzie,2023,USD,275206,162935,112271,168448,-56177,21820,-77997,2752,5504,-83501,11585,156171,73622,82549,,275206,1221.8,7635.96,0.0828,161,142.4,1000.0,11.58,0.408
4278,Simpson-Williams,False,US,Pearsonside,EdTech,2009,https://simpson-williams.com,General rate reflect economy skin.,12,simpson-williams,2023,USD,97803,43465,54338,29595,24743,0,24743,978,1956,22787,13682,122395,44540,77855,8150.25,97803,164.49,1084.56,0.0553,115,70.36,2360.56,5.8,0.5556
4279,Jackson Robertson and Blackburn,False,US,West Amyside,HealthTech,2011,https://jacksonrobertsonandblackburn.com,Else occur benefit medical dark simple always miss lose.,16,jackson-robertson-and-blackburn,2023,USD,939864,161182,778682,235512,543170,28625,514545,9398,18797,495748,34071,620417,86407,534010,78322.0,939864,10.0,66.05,0.0533,1046,74.87,15888.34,2.14,0.8285
4280,Ross Guzman and Scott,False,CA,Jonesview,Cybersecurity,2021,https://rossguzmanandscott.com,His run artist billion material.,18,ross-guzman-and-scott,2023,USD,375021,150494,224527,176777,47750,3343,44407,3750,7500,36907,6042,202194,66162,136032,,375021,1010.69,2264.33,0.005,132,235.9,36551.44,0.17,0.5987
4281,Lowe Hines and Hanna,False,DE,North Markchester,HealthTech,2010,https://lowehinesandhanna.com,They in condition everybody design under.,15,lowe-hines-and-hanna,2023,EUR,1967826,761323,1206503,712342,494161,11504,482657,19678,39356,443301,153558,1264857,429103,835754,163985.5,1967826,410.31,1664.42,0.0199,4507,36.38,44599.14,3.44,0.6131
4282,Mcmillan LLC,False,DE,Danielschester,Cybersecurity,2019,https://mcmillanllc.com,Suggest friend necessary industry least degree stuff agreement.,24,mcmillan-llc,2023,EUR,807902,320126,487776,580681,-92905,0,-92905,8079,16158,-109063,216468,788852,390577,398275,,807902,20.0,49.17,0.0623,317,212.22,39891.12,5.43,0.6038
4283,Grimes Inc,False,NG,West Marc,SaaS,2009,https://grimesinc.com,Bank they lot official medical thought together ready big.,18,grimes-inc,2023,USD,4354552,1135756,3218796,1095446,2123350,0,2123350,43545,87091,2036259,379997,2705649,1135297,1570352,362879.33,4354552,254.75,1092.27,0.0367,5849,62.04,88320.92,4.3,0.7392
4284,Bailey George and Jenkins,False,IN,Lake Eric,SaaS,2011,https://baileygeorgeandjenkins.com,Walk smile truth story open around century detail body.,15,bailey-george-and-jenkins,2023,USD,1265526,369235,896291,849326,46965,0,46965,12655,25310,21655,197355,851981,232161,619820,105460.5,1265526,10.0,78.05,0.0689,5151,20.47,53508.76,3.69,0.7082
4285,Vargas-Smith,False,US,East Jeremiah,AgriTech,2010,https://vargas-smith.com,Meeting everybody remain early under skill contain evening recognize sense.,19,vargas-smith,2023,USD,40586,13615,26971,15502,11469,14131,-2662,405,811,-3473,23601,121126,70120,51006,,40586,20.0,94.92,0.0604,140,24.12,39800.51,0.59,0.6645
4286,Choi-Paul,False,IN,North Ronaldstad,E-commerce,2020,https://choi-paul.com,Hospital season style suffer land ask happy budget prove yeah.,27,choi-paul,2023,USD,182483,53082,129401,30972,98429,18725,79704,1824,3649,76055,23577,174836,57848,116988,,182483,20.0,60.24,0.1605,62,241.96,1535.93,15.35,0.7091
4287,Owens-Wilson,False,IN,North Hailey,Cybersecurity,2013,https://owens-wilson.com,Will model order husband practice total memory hour sit behavior section.,20,owens-wilson,2023,USD,361148,153830,207318,173144,34174,0,34174,3611,7222,26952,5490,221982,74463,147519,,361148,1084.94,4236.69,0.001,142,210.67,26648.33,0.21,0.5741
4288,Knight PLC,False,GB,Lake Jennifer,IoT,2022,https://knightplc.com,Already candidate political start property thought different.,24,knight-plc,2023,USD,377706,210685,167021,207049,-40028,0,-40028,3777,7554,-47582,14784,284213,72431,211782,,377706,1841.87,1858.98,0.0405,1573,20.0,19981.45,0.74,0.4422
4289,Peters Oconnor and Francis,False,FR,Campbellborough,HealthTech,2018,https://petersoconnorandfrancis.com,Population article until significant some simple nature city.,31,peters-oconnor-and-francis,2023,EUR,2156492,881143,1275349,1076551,198798,51730,147068,21564,43129,103939,538886,1742998,747785,995213,179707.67,2156492,241.37,1427.65,0.0568,1849,97.16,83082.48,6.49,0.5914
4290,Evans LLC,False,GB,Sandraburgh,IoT,2021,https://evansllc.com,Manager unit prove item firm seek important night away.,15,evans-llc,2023,USD,434934,61397,373537,111692,261845,0,261845,4349,8698,253147,18355,361978,129903,232075,,434934,20.0,113.41,0.0198,632,57.28,11297.03,1.62,0.8588
4291,Kidd-Lewis,False,BR,Lake Kristopher,Mobility,2011,https://kidd-lewis.com,World you customer thought major.,16,kidd-lewis,2023,USD,763750,287976,475774,325824,149950,13270,136680,7637,15275,121405,41131,461821,235008,226813,,763750,20.0,41.53,0.0637,414,153.4,27455.0,1.5,0.6229
4292,Pratt Group,False,NG,Maryhaven,AI/ML,2015,https://prattgroup.com,Over federal expert number art.,19,pratt-group,2023,USD,855094,326001,529093,258961,270132,25704,244428,8550,17101,227327,59859,578907,149802,429105,,855094,430.88,1563.6,0.0327,237,300.21,25899.83,2.31,0.6188
4293,Johnson LLC,False,KE,Port Taylor,Mobility,2023,https://johnsonllc.com,Particular board west behavior live property into unit.,19,johnson-llc,2023,USD,1015532,226757,788775,311976,476799,0,476799,10155,20310,456489,14684,655828,227695,428133,,1015532,349.77,1914.96,0.0725,282,300.06,46346.54,0.32,0.7767
4294,Hill Schmidt and Walton,False,IN,Millerburgh,E-commerce,2023,https://hillschmidtandwalton.com,Smile finish push member.,20,hill-schmidt-and-walton,2023,USD,7138124,3033165,4104959,5389290,-1284331,0,-1284331,71381,142762,-1427093,85651,3760886,203760,3557126,,7138124,20.0,10.0,0.069,13166,45.18,473931.29,0.18,0.5751
4295,Johnson PLC,False,DE,South Ericport,Fintech,2016,https://johnsonplc.com,Young head toward assume professional call character if education.,16,johnson-plc,2023,EUR,1444810,313240,1131570,285848,845722,24194,821528,14448,28896,792632,239899,972559,284124,688435,,1444810,572.39,1327.63,0.1058,6020,20.0,22651.22,10.59,0.7832
4296,Murray and Sons,False,AU,Lake Vickie,AgriTech,2010,https://murrayandsons.com,Interest type employee true thing.,10,murray-and-sons,2023,USD,114707,60305,54402,62219,-7817,5123,-12940,1147,2294,-15234,70884,289101,160432,128669,,114707,150.2,382.16,0.0077,60,156.96,1000.0,70.88,0.4743
4297,Fisher Simpson and Nielsen,False,CA,Maddoxmouth,AI/ML,2015,https://fishersimpsonandnielsen.com,Attack anything town window TV.,22,fisher-simpson-and-nielsen,2023,USD,3309799,1400065,1909734,1196112,713622,0,713622,33097,66195,647427,98959,1850840,897470,953370,,3309799,1485.88,2284.24,0.1002,1900,145.13,125481.9,0.79,0.577
4298,Suarez Webb and Maddox,False,BR,New Nicole,Marketplaces,2014,https://suarezwebbandmaddox.com,Work simple laugh effort day behavior.,12,suarez-webb-and-maddox,2023,USD,782210,284226,497984,809277,-311293,0,-311293,7822,15644,-326937,66899,638811,31940,606871,,782210,981.13,5393.51,0.0571,2162,30.14,65747.84,1.02,0.6366
4299,Alvarez Inc,False,ZA,Melissafurt,Fintech,2010,https://alvarezinc.com,Blood artist rest success national may maintain forget someone seven grow.,25,alvarez-inc,2023,USD,480442,136550,343892,381003,-37111,24449,-61560,4804,9608,-71168,106078,429041,94213,334828,,480442,1353.01,6113.89,0.1078,137,290.63,71002.34,1.49,0.7158
4300,Kramer Rice and Leach,False,EG,East Carolyn,SaaS,2014,https://kramerriceandleach.com,Million arm possible attack hair bad teach would there.,28,kramer-rice-and-leach,2023,USD,2677058,1017692,1659366,1788909,-129543,0,-129543,26770,53541,-183084,154943,1556854,474917,1081937,223088.17,2677058,265.57,740.69,0.001,44617,5.0,146804.54,1.06,0.6198
4301,Smith Inc,False,US,West Rebeccaland,Marketplaces,2014,https://smithinc.com,Sense and pretty time middle sound although area top TV.,20,smith-inc,2023,USD,633498,400216,233282,378270,-144988,11298,-156286,6334,12669,-168955,113398,495190,132351,362839,,633498,20.0,10.0,0.079,412,127.89,1000.0,113.4,0.3682
4302,Mahoney Gamble and Liu,False,EG,Rodneyborough,Energy,2014,https://mahoneygambleandliu.com,Bank center team plant community likely who create world interest.,23,mahoney-gamble-and-liu,2023,USD,1440968,599073,841895,553028,288867,24230,264637,14409,28819,235818,88173,921998,383764,538234,,1440968,590.97,2679.93,0.1273,1624,73.93,46872.75,1.88,0.5843
4303,Rodriguez LLC,False,EG,Smithland,Fintech,2018,https://rodriguezllc.com,Hour adult have imagine relate trade.,20,rodriguez-llc,2023,USD,942748,272468,670280,120843,549437,0,549437,9427,18854,530583,99252,678128,133295,544833,,942748,20.0,43.16,0.0259,1311,59.91,4032.37,24.61,0.711
4304,Bolton and Sons,False,DE,Hughesburgh,IoT,2024,https://boltonandsons.com,Hold appear behind your eye than edge.,19,bolton-and-sons,2023,EUR,2211572,648624,1562948,1432887,130061,8012,122049,22115,44231,77818,62596,1202664,228861,973803,,2211572,1208.62,4463.04,0.1061,1454,126.75,89810.86,0.7,0.7067
4305,Fuentes Kim and Johnson,False,NG,Keyhaven,E-commerce,2017,https://fuenteskimandjohnson.com,Ball adult build hospital minute.,24,fuentes-kim-and-johnson,2023,USD,414954,20747,394207,101998,292209,13746,278463,4149,8299,270164,19329,406070,37774,368296,,414954,433.77,2006.06,0.0518,352,98.21,6452.85,3.0,0.95
4306,Lee-Lawrence,False,ZA,Lake Michael,Mobility,2012,https://lee-lawrence.com,Cost into marriage though example modern model record top.,20,lee-lawrence,2023,USD,2801221,633695,2167526,1367449,800077,21158,778919,28012,56024,722895,74798,1628673,100322,1528351,,2801221,20.0,40.91,0.001,7616,30.65,89619.29,0.83,0.7738
4307,Rivera-Harvey,False,NG,New Abigailside,Fintech,2012,https://rivera-harvey.com,Rich degree build man culture.,15,rivera-harvey,2023,USD,5265161,3217398,2047763,736796,1310967,22245,1288722,52651,105303,1183419,80466,2834584,1294661,1539923,,5265161,20.0,24.07,0.0365,21938,20.0,34830.03,2.31,0.3889
4308,Spencer and Sons,False,DE,New Isaac,E-commerce,2020,https://spencerandsons.com,Floor begin data morning anyone two experience example something.,18,spencer-and-sons,2023,EUR,588257,251236,337021,414500,-77479,0,-77479,5882,11765,-89244,91033,508633,165246,343387,,588257,600.23,1629.97,0.035,282,173.39,37502.48,2.43,0.5729
4309,Norris-Tucker,False,EG,Jamesport,IoT,2024,https://norris-tucker.com,Tv inside street American live.,21,norris-tucker,2023,USD,573838,100953,472885,182295,290590,0,290590,5738,11476,279114,184256,577284,183573,393711,,573838,20.0,68.3,0.0028,169,282.58,1000.0,184.26,0.8241
4310,Hardy LLC,False,DE,West Emilytown,Energy,2014,https://hardyllc.com,Ten line necessary method inside seem science read trip.,20,hardy-llc,2023,EUR,387805,75782,312023,286595,25428,16570,8858,3878,7756,1102,7715,284300,202052,82248,,387805,1736.04,1710.87,0.001,715,45.15,39069.38,0.2,0.8046
4311,Hill LLC,False,FR,Matthewport,AgriTech,2021,https://hillllc.com,Many have letter lawyer coach how.,22,hill-llc,2023,EUR,263683,111261,152422,177457,-25035,49363,-74398,2636,5273,-79671,38219,207208,80446,126762,,263683,1034.8,877.31,0.0351,1098,20.0,14905.89,2.56,0.5781
4312,Johnston Reed and Hayes,False,GB,Larryshire,Marketplaces,2017,https://johnstonreedandhayes.com,Rich build true help option very face thought to.,18,johnston-reed-and-hayes,2023,USD,617289,238035,379254,301423,77831,19438,58393,6172,12345,46048,6601,495875,207854,288021,,617289,85.58,297.15,0.111,266,192.93,21661.85,0.3,0.6144
4313,Harper-Middleton,False,KE,North Bethanyberg,Marketplaces,2011,https://harper-middleton.com,Responsibility memory dog find various care machine admit.,20,harper-middleton,2023,USD,470855,144929,325926,121391,204535,13589,190946,4708,9417,181529,21916,339635,159548,180087,,470855,20.0,101.57,0.0946,888,44.15,22265.02,0.98,0.6922
4314,Gomez Romero and Mueller,False,GB,Johnsonchester,Mobility,2011,https://gomezromeroandmueller.com,Along day technology especially offer street news.,7,gomez-romero-and-mueller,2023,USD,347803,199028,148775,184172,-35397,2502,-37899,3478,6956,-44855,39936,295345,162647,132698,,347803,20.0,16.03,0.0667,1449,20.0,40431.66,0.99,0.4278
4315,Patterson and Sons,False,ZA,Jamesberg,Fintech,2015,https://pattersonandsons.com,Huge according result number outside during nation.,17,patterson-and-sons,2023,USD,1411716,684017,727699,776286,-48587,0,-48587,14117,28234,-76821,429017,1208607,708205,500402,,1411716,20.0,43.84,0.073,456,257.79,78656.89,5.45,0.5155
4316,Phillips LLC,False,US,Lynchtown,Mobility,2013,https://phillipsllc.com,Also science ready six four event actually seven.,14,phillips-llc,2023,USD,611143,159292,451851,354311,97540,4249,93291,6111,12222,81069,111816,422869,114396,308473,,611143,20.0,20.54,0.0136,179,283.06,53874.47,2.08,0.7394
4317,Villa Group,False,IN,South Tiffany,SaaS,2023,https://villagroup.com,Away prevent always write out magazine bit view.,15,villa-group,2023,USD,2073629,1139807,933822,1952547,-1018725,36072,-1054797,20736,41472,-1096269,86310,1289850,353903,935947,172802.42,2073629,534.78,3249.68,0.0501,2113,81.75,167200.18,0.52,0.4503
4318,Cox Alexander and Hawkins,False,BR,South Timothyview,AI/ML,2022,https://coxalexanderandhawkins.com,Newspaper newspaper find officer.,18,cox-alexander-and-hawkins,2023,USD,194750,103042,91708,73287,18421,24743,-6322,1947,3895,-10217,23459,181526,80814,100712,,194750,539.97,954.19,0.001,96,168.29,14563.94,1.61,0.4709
4319,Douglas-Jones,False,CA,West Joanport,AgriTech,2011,https://douglas-jones.com,War security inside Democrat during political more mind.,20,douglas-jones,2023,USD,343799,65972,277827,115690,162137,0,162137,3437,6875,155262,5392,328045,121293,206752,,343799,825.03,2305.11,0.001,128,222.96,50309.1,0.11,0.8081
4320,Cruz Group,False,NG,North Brittanyview,Fintech,2019,https://cruzgroup.com,Sure need indeed size show.,25,cruz-group,2023,USD,3249714,1530701,1719013,967131,751882,0,751882,32497,64994,686888,354381,2077130,768743,1308387,,3249714,20.0,61.54,0.0668,1617,167.42,98021.11,3.62,0.529
4321,Barron Frey and Henry,False,TN,Tracyville,EdTech,2012,https://barronfreyandhenry.com,Purpose my least cost similar cover rather game under stop.,14,barron-frey-and-henry,2023,USD,295359,113715,181644,150348,31296,0,31296,2953,5907,25389,10530,205586,29865,175721,24613.25,295359,29.92,107.02,0.0452,310,79.2,7418.62,1.42,0.615
4322,Russell Santos and Gray,False,TN,Craigborough,AI/ML,2021,https://russellsantosandgray.com,Already suggest daughter claim.,20,russell-santos-and-gray,2023,USD,2500144,1044358,1455786,1190848,264938,0,264938,25001,50002,214936,311565,1728226,599955,1128271,,2500144,20.0,10.0,0.0713,1285,162.05,63706.33,4.89,0.5823
4323,Russell Group,False,NG,North Robert,E-commerce,2009,https://russellgroup.com,Maintain pattern may indicate be phone require rich ahead.,21,russell-group,2023,USD,565551,211053,354498,383103,-28605,11585,-40190,5655,11311,-51501,25182,443445,268498,174947,,565551,778.74,2654.1,0.1147,809,58.2,10365.96,2.43,0.6268
4324,Miles Wolfe and Thompson,False,EG,Harrishaven,AgriTech,2019,https://mileswolfeandthompson.com,Computer find others pressure.,22,miles-wolfe-and-thompson,2023,USD,230543,17016,213527,11527,202000,5015,196985,2305,4610,192375,59413,299619,120044,179575,,230543,325.55,1559.38,0.1098,246,77.92,1000.0,59.41,0.9262
4325,Whitaker PLC,False,FR,East Charlesville,SaaS,2020,https://whitakerplc.com,Three college issue politics moment record kid company whatever position general.,29,whitaker-plc,2023,EUR,1454722,537487,917235,1047284,-130049,33969,-164018,14547,29094,-193112,104139,914827,289870,624957,121226.83,1454722,10.0,26.52,0.001,24245,5.0,62366.84,1.67,0.6305
4326,Gonzalez Young and Perry,False,ZA,East Jeffreymouth,Energy,2014,https://gonzalezyoungandperry.com,Chance force international American play much blood.,19,gonzalez-young-and-perry,2023,USD,4194597,1833059,2361538,3130487,-768949,11969,-780918,41945,83891,-864809,24698,2248492,1238427,1010065,,4194597,1730.5,1450.39,0.1347,5500,63.55,259025.56,0.1,0.563
4327,Hardin and Sons,False,IN,South Jasonhaven,EdTech,2020,https://hardinandsons.com,Price various baby center beautiful enough current simple radio sport.,11,hardin-and-sons,2023,USD,204264,46081,158183,49164,109019,14022,94997,2042,4085,90912,53809,267385,144716,122669,17022.0,204264,10.0,56.63,0.0443,230,73.82,15287.28,3.52,0.7744
4328,Raymond-Herring,False,GB,North Chrismouth,IoT,2016,https://raymond-herring.com,Forward traditional another girl anything operation office.,22,raymond-herring,2023,USD,470655,235272,235383,359445,-124062,372,-124434,4706,9413,-133847,30309,284263,131144,153119,,470655,101.5,954.46,0.001,1961,20.0,35401.19,0.86,0.5001
4329,Franklin Ltd,False,NG,Wilsonhaven,IoT,2023,https://franklinltd.com,Member he but will as.,18,franklin-ltd,2023,USD,881857,285043,596814,217465,379349,0,379349,8818,17637,361712,133601,600904,182692,418212,,881857,20.0,10.0,0.0681,3674,20.0,13308.99,10.04,0.6768
4330,Johnson-Graves,False,NG,East Margaretmouth,Energy,2011,https://johnson-graves.com,Stuff box coach mean since.,18,johnson-graves,2023,USD,539824,149283,390541,394836,-4295,0,-4295,5398,10796,-15091,47141,433339,126947,306392,,539824,513.64,1277.17,0.001,158,283.45,31607.77,1.49,0.7235
4331,Brown-Boyd,False,BR,Mcdonaldton,SaaS,2015,https://brown-boyd.com,Not open east across pattern behind.,18,brown-boyd,2023,USD,1028222,337614,690608,763633,-73025,0,-73025,10282,20564,-93589,241200,823682,244737,578945,85685.17,1028222,299.3,1423.05,0.0492,574,149.09,53782.6,4.48,0.6717
4332,Best Vasquez and Barry,False,FR,New Christopherview,EdTech,2011,https://bestvasquezandbarry.com,Book business high Mrs soldier building manager sell.,17,best-vasquez-and-barry,2023,EUR,91840,42404,49436,48796,640,0,640,918,1836,-1196,6817,190275,65212,125063,7653.33,91840,484.6,2353.38,0.0447,108,70.7,1000.0,6.82,0.5383
4333,Williams LLC,False,US,Port Tanya,SaaS,2016,https://williamsllc.com,Reveal fund other staff life then whether seat feeling test.,21,williams-llc,2023,USD,2963099,1166776,1796323,1873213,-76890,6517,-83407,29630,59261,-142668,159054,1735935,937555,798380,246924.92,2963099,199.6,737.77,0.0699,15930,15.5,155661.11,1.02,0.6062
4334,Hooper Paul and Gomez,False,DE,Lake James,Fintech,2011,https://hooperpaulandgomez.com,Live add similar sport sure throw nearly.,19,hooper-paul-and-gomez,2023,EUR,10266368,3645032,6621336,4829181,1792155,0,1792155,102663,205327,1586828,703293,5861270,3476252,2385018,,10266368,857.63,771.54,0.0032,42776,20.0,393806.4,1.79,0.645
4335,Simon-Lee,False,IN,Conradview,EdTech,2020,https://simon-lee.com,World very prove month form.,18,simon-lee,2023,USD,232504,82756,149748,248843,-99095,10091,-109186,2325,4650,-113836,12639,154554,59177,95377,19375.33,232504,10.0,41.37,0.0397,420,46.05,13095.46,0.97,0.6441
4336,Jones Gardner and Bell,False,TN,Millertown,Energy,2011,https://jonesgardnerandbell.com,Such guess international to travel worry left around speech.,16,jones-gardner-and-bell,2023,USD,1433640,251798,1181842,937139,244703,14782,229921,14336,28672,201249,145985,899055,391805,507250,,1433640,20.0,109.11,0.0707,5973,20.0,76999.31,1.9,0.8244
4337,Garcia-Johnson,False,DE,Port Kathleen,Cybersecurity,2016,https://garcia-johnson.com,Again deal region give no more teacher.,22,garcia-johnson,2023,EUR,3159210,616055,2543155,457085,2086070,18602,2067468,31592,63184,2004284,90359,1784856,336044,1448812,,3159210,336.44,1533.62,0.1318,5115,51.46,24920.75,3.63,0.805
4338,Morris Group,False,EG,North Jenniferside,EdTech,2013,https://morrisgroup.com,Three try investment a start fish end letter.,23,morris-group,2023,USD,892199,351290,540909,391825,149084,0,149084,8921,17843,131241,139219,610692,319367,291325,74349.92,892199,206.19,1439.95,0.0711,1548,48.01,30760.28,4.53,0.6063
4339,Brown-Gonzales,False,AU,West Kevinport,EdTech,2019,https://brown-gonzales.com,Several energy improve own hundred company sign.,24,brown-gonzales,2023,USD,1106514,570350,536164,659373,-123209,0,-123209,11065,22130,-145339,10415,594454,438501,155953,92209.5,1106514,230.31,979.87,0.0525,1159,79.53,70868.62,0.15,0.4846
4340,English Davis and Oconnell,False,BR,Lake Madisonside,AgriTech,2017,https://englishdavisandoconnell.com,Country trial them population we five front.,17,english-davis-and-oconnell,2023,USD,525639,172870,352769,333259,19510,0,19510,5256,10512,8998,248664,622852,286637,336215,,525639,407.97,478.59,0.001,653,67.08,31801.6,7.82,0.6711
4341,Berry PLC,False,ZA,South Steven,SaaS,2011,https://berryplc.com,Become hard pay white positive bring special age ball.,29,berry-plc,2023,USD,253532,67035,186497,93132,93365,9691,83674,2535,5070,78604,9770,209626,60061,149565,21127.67,253532,629.53,2858.49,0.0842,300,70.4,2974.8,3.28,0.7356
4342,Wilson Ltd,False,GB,Masonland,AI/ML,2023,https://wilsonltd.com,Likely paper leave remain political often occur drop off two.,21,wilson-ltd,2023,USD,189591,60163,129428,136911,-7483,9122,-16605,1895,3791,-20396,11050,260107,63782,196325,,189591,794.39,1427.03,0.0735,789,20.0,1000.0,11.05,0.6827
4343,Lynn-Taylor,False,ZA,Angelaton,AgriTech,2015,https://lynn-taylor.com,Paper accept increase cost former.,20,lynn-taylor,2023,USD,684058,230114,453944,465648,-11704,0,-11704,6840,13681,-25385,32796,423735,108896,314839,,684058,415.56,1426.02,0.001,179,318.45,39326.39,0.83,0.6636
4344,Osborn Nelson and Bush,False,GB,Smithtown,E-commerce,2010,https://osbornnelsonandbush.com,Might ago sound consumer guy hard choose measure shoulder.,20,osborn-nelson-and-bush,2023,USD,1940711,421888,1518823,1394704,124119,0,124119,19407,38814,85305,61751,1174643,313135,861508,,1940711,20.0,78.9,0.0932,959,168.57,114060.47,0.54,0.7826
4345,Gibson Stevens and Hansen,False,GB,South Donnaview,HealthTech,2018,https://gibsonstevensandhansen.com,Ok community environmental building whose.,22,gibson-stevens-and-hansen,2023,USD,1217922,320887,897035,698434,198601,0,198601,12179,24358,174243,197460,947415,734149,213266,101493.5,1217922,149.18,921.46,0.0622,1021,99.33,47114.64,4.19,0.7365
4346,Simpson and Sons,False,EG,South Ashley,HealthTech,2008,https://simpsonandsons.com,Seven allow suffer forget difference subject set break opportunity.,23,simpson-and-sons,2023,USD,884152,256480,627672,544294,83378,24977,58401,8841,17683,40718,227394,799101,191136,607965,73679.33,884152,712.47,2224.74,0.0198,2316,31.81,49731.22,4.57,0.7099
4347,Martinez-Kirk,False,BR,Campbelltown,Mobility,2021,https://martinez-kirk.com,Month scientist fish color bank sister wife.,20,martinez-kirk,2023,USD,199596,56674,142922,184925,-42003,0,-42003,1995,3991,-45994,1891,240318,149186,91132,,199596,20.0,61.98,0.1451,340,48.85,35879.59,0.05,0.7161
4348,Carter Nelson and Freeman,False,CA,Robinstad,SaaS,2013,https://carternelsonandfreeman.com,Design list food say traditional.,24,carter-nelson-and-freeman,2023,USD,374431,137645,236786,91970,144816,24061,120755,3744,7488,113267,14420,320974,143180,177794,31202.58,374431,10.0,43.26,0.0172,3092,10.09,1000.0,14.42,0.6324
4349,Washington PLC,False,IN,New Edward,Fintech,2013,https://washingtonplc.com,Certain area central certain woman together travel southern identify task.,26,washington-plc,2023,USD,2023024,505894,1517130,887138,629992,13295,616697,20230,40460,576237,28455,1050968,205477,845491,,2023024,395.84,1559.01,0.1163,1119,150.63,121692.28,0.23,0.7499
4350,Webb Ltd,False,BR,Jenningsshire,SaaS,2019,https://webbltd.com,Republican manage quickly billion series item outside writer.,18,webb-ltd,2023,USD,782638,346452,436186,834871,-398685,8226,-406911,7826,15652,-422563,63152,644930,385923,259007,65219.83,782638,182.83,823.64,0.019,792,82.32,93362.72,0.68,0.5573
4351,Richardson Inc,False,EG,Atkinsonmouth,IoT,2008,https://richardsoninc.com,Interest visit method sort poor old operation.,19,richardson-inc,2023,USD,294298,90348,203950,195427,8523,0,8523,2942,5885,2638,37621,259826,12991,246835,,294298,2046.6,1023.3,0.0029,1070,22.9,6603.43,5.7,0.693
4352,York Ltd,False,EG,North Cynthia,EdTech,2023,https://yorkltd.com,Body theory you newspaper southern.,21,york-ltd,2023,USD,43746,11427,32319,20728,11591,0,11591,437,874,10717,3689,67801,16899,50902,3645.5,43746,10.0,96.27,0.0156,48,74.46,3593.57,1.03,0.7388
4353,Gonzalez Ferrell and Rivera,False,FR,Joneston,SaaS,2008,https://gonzalezferrellandrivera.com,Read realize important rest low important medical medical moment member.,23,gonzalez-ferrell-and-rivera,2023,EUR,600394,266177,334217,238087,96130,0,96130,6003,12007,84123,4798,389346,180961,208385,50032.83,600394,215.96,242.84,0.0132,2600,19.24,1000.0,4.8,0.5567
4354,Lara Group,False,KE,South Carlosmouth,Marketplaces,2017,https://laragroup.com,Car green read throughout general.,29,lara-group,2023,USD,874386,419108,455278,488003,-32725,39160,-71885,8743,17487,-89372,125299,647332,380264,267068,,874386,1300.98,3393.51,0.0524,3643,20.0,43596.65,2.87,0.5207
4355,Berry-Lynch,False,DE,Fryeburgh,AI/ML,2024,https://berry-lynch.com,Entire around natural culture use event debate article though.,16,berry-lynch,2023,EUR,220062,63518,156544,132488,24056,30682,-6626,2200,4401,-11027,5568,179680,93691,85989,,220062,1485.42,8167.36,0.0326,237,77.31,8664.02,0.64,0.7114
4356,Rogers Davila and Edwards,False,GB,North Williammouth,HealthTech,2011,https://rogersdavilaandedwards.com,Major stop help radio finish.,20,rogers-davila-and-edwards,2023,USD,283952,81771,202181,174560,27621,0,27621,2839,5679,21942,10953,234304,92638,141666,23662.67,283952,569.29,569.29,0.0058,4732,5.0,1000.0,10.95,0.712
4357,Smith Lee and Yang,False,FR,New Rogerhaven,AgriTech,2018,https://smithleeandyang.com,Claim act which data safe hotel.,12,smith-lee-and-yang,2023,EUR,87547,28240,59307,10879,48428,0,48428,875,1750,46678,18699,196689,20099,176590,,87547,326.52,602.0,0.1164,364,20.0,9010.07,2.08,0.6774
4358,Hall-Smith,False,EG,East Tamarashire,Mobility,2019,https://hall-smith.com,Modern learn carry energy turn imagine.,19,hall-smith,2023,USD,944226,434725,509501,199384,310117,22335,287782,9442,18884,268898,15044,625032,150346,474686,,944226,20.0,10.0,0.0808,301,260.79,50704.33,0.3,0.5396
4359,Chan Robinson and Cabrera,False,NG,Wellsfurt,AgriTech,2023,https://chanrobinsonandcabrera.com,Benefit big require mouth into.,24,chan-robinson-and-cabrera,2023,USD,658019,252506,405513,326154,79359,0,79359,6580,13160,66199,81351,429020,207188,221832,,658019,381.47,190.74,0.001,2741,20.0,17467.48,4.66,0.6163
4360,Cox-Miller,False,IN,West Karenville,E-commerce,2022,https://cox-miller.com,War sign friend Congress lay reality I employee institution term.,24,cox-miller,2023,USD,961951,370770,591181,669571,-78390,0,-78390,9619,19239,-97629,17738,557750,95093,462657,,961951,1288.6,3017.07,0.0336,4008,20.0,51533.23,0.34,0.6146
4361,Howard-Butler,False,US,Antonioburgh,E-commerce,2017,https://howard-butler.com,Base artist stay environment walk cover federal increase wish city.,22,howard-butler,2023,USD,189271,55730,133541,31458,102083,526,101557,1892,3785,97772,9129,190401,9520,180881,,189271,20.0,67.88,0.0375,172,91.31,15659.86,0.58,0.7056
4362,Park LLC,False,ZA,Reynoldsport,E-commerce,2024,https://parkllc.com,Focus listen term score protect.,22,park-llc,2023,USD,346188,136307,209881,208654,1227,0,1227,3461,6923,-5696,5620,245491,64047,181444,,346188,487.66,243.83,0.0075,412,69.91,1644.48,3.42,0.6063
4363,Gregory Inc,False,AU,East Brandifurt,Marketplaces,2023,https://gregoryinc.com,True sort that though collection son civil later magazine computer.,22,gregory-inc,2023,USD,599070,94161,504909,383948,120961,26277,94684,5990,11981,82703,24660,363250,83656,279594,,599070,54.99,245.01,0.0299,683,73.09,52459.49,0.47,0.8428
4364,Simpson Inc,False,FR,East Staceytown,AgriTech,2024,https://simpsoninc.com,Country include seem opportunity standard explain cell.,21,simpson-inc,2023,EUR,159299,63294,96005,68391,27614,0,27614,1592,3185,24429,3519,112910,69212,43698,,159299,71.09,369.67,0.077,145,91.27,24779.33,0.14,0.6027
4365,Harris Alvarez and Ramirez,False,ZA,Lopezport,Marketplaces,2008,https://harrisalvarezandramirez.com,Later week occur form teacher even set itself.,19,harris-alvarez-and-ramirez,2023,USD,646266,198678,447588,355490,92098,1453,90645,6462,12925,77720,41630,426008,81563,344445,,646266,20.0,93.72,0.0686,187,287.1,47653.73,0.87,0.6926
4366,Alvarez-Esparza,False,GB,Williamsland,Energy,2015,https://alvarez-esparza.com,Tonight behavior matter magazine history one.,23,alvarez-esparza,2023,USD,1339014,169282,1169732,463129,706603,6407,700196,13390,26780,673416,52444,870689,429619,441070,,1339014,20.0,72.97,0.0308,689,161.75,81361.63,0.64,0.8736
4367,Nelson-Lopez,False,BR,New Nicholas,HealthTech,2019,https://nelson-lopez.com,Evening always action cold race weight.,18,nelson-lopez,2023,USD,879314,178858,700456,952886,-252430,16084,-268514,8793,17586,-286100,24352,650395,278044,372351,73276.17,879314,570.74,3312.51,0.0156,14655,5.0,104022.39,0.23,0.7966
4368,Ayers-Cummings,False,EG,Vickiefort,SaaS,2015,https://ayers-cummings.com,Close already discussion while him.,20,ayers-cummings,2023,USD,273159,109741,163418,111734,51684,27147,24537,2731,5463,19074,7076,179727,8986,170741,22763.25,273159,10.0,47.8,0.001,1278,17.8,1000.0,7.08,0.5983
4369,Herrera Group,False,KE,West Donald,Cybersecurity,2021,https://herreragroup.com,Play listen just really whose cup vote nothing movie officer necessary.,17,herrera-group,2023,USD,403791,227466,176325,375154,-198829,2248,-201077,4037,8075,-209152,46131,445020,211454,233566,,403791,1327.99,664.0,0.1527,1459,23.05,28629.1,1.61,0.4367
4370,Whitney Lawson and Williams,False,CA,Shellyshire,EdTech,2010,https://whitneylawsonandwilliams.com,Mention every step radio though boy test.,21,whitney-lawson-and-williams,2023,USD,1698697,647986,1050711,1568566,-517855,0,-517855,16986,33973,-551828,76046,1058704,357888,700816,141558.08,1698697,511.71,511.71,0.0653,2896,48.88,132524.7,0.57,0.6185
4371,Smith Hall and Nelson,False,DE,Williamstown,Energy,2011,https://smithhallandnelson.com,Blood institution Democrat soldier make memory ahead real early.,15,smith-hall-and-nelson,2023,EUR,2693013,1475299,1217714,1952192,-734478,26487,-760965,26930,53860,-814825,28738,1414245,726221,688024,,2693013,1513.8,1795.56,0.0315,2392,93.79,134888.22,0.21,0.4522
4372,Conrad Group,False,IN,North Anna,Marketplaces,2022,https://conradgroup.com,Night carry ask easy animal.,25,conrad-group,2023,USD,136540,67358,69182,68514,668,5938,-5270,1365,2730,-8000,5260,122295,89505,32790,,136540,20.0,96.91,0.048,212,53.53,27142.32,0.19,0.5067
4373,Price-Carr,False,NG,Veronicatown,HealthTech,2016,https://price-carr.com,Live wind star article worker.,16,price-carr,2023,USD,291137,105008,186129,167933,18196,0,18196,2911,5822,12374,7355,293289,66645,226644,24261.42,291137,10.0,43.14,0.0428,560,43.27,1000.0,7.36,0.6393
4374,Gibson LLC,False,BR,West Brittanybury,E-commerce,2018,https://gibsonllc.com,Last boy behavior whatever walk agency style run.,18,gibson-llc,2023,USD,1432496,71624,1360872,583875,776997,23627,753370,14324,28649,724721,50046,933589,73699,859890,,1432496,20.0,47.48,0.0297,780,152.9,66577.35,0.75,0.95
4375,Lee PLC,False,TN,Harperberg,IoT,2021,https://leeplc.com,Draw only order training statement maybe buy too pretty when.,26,lee-plc,2023,USD,786200,156675,629525,766437,-136912,24469,-161381,7862,15724,-177105,13558,420945,48836,372109,,786200,188.09,94.04,0.1274,332,196.92,45724.45,0.3,0.8007
4376,Macdonald-Flynn,False,IN,Port Tylerbury,AgriTech,2014,https://macdonald-flynn.com,Hit Mr risk education cold difference.,26,macdonald-flynn,2023,USD,316484,166544,149940,115283,34657,0,34657,3164,6329,28328,1545,279744,138993,140751,,316484,1215.11,8784.89,0.0832,1318,20.0,20920.71,0.07,0.4738
4377,Cruz-Krueger,False,US,West Nicholas,IoT,2024,https://cruz-krueger.com,Or event certainly standard common catch.,17,cruz-krueger,2023,USD,335096,81719,253377,130507,122870,11183,111687,3350,6701,104986,7107,294199,82528,211671,,335096,356.62,386.89,0.1182,1396,20.0,1000.0,7.11,0.7561
4378,Mitchell-Mendoza,False,ZA,Lake John,E-commerce,2011,https://mitchell-mendoza.com,Second citizen her significant under public conference.,18,mitchell-mendoza,2023,USD,2248832,945289,1303543,639518,664025,3594,660431,22488,44976,615455,41402,1360362,310004,1050358,,2248832,395.89,1069.68,0.0954,890,210.33,42924.09,0.96,0.5797
4379,Barrett LLC,False,TN,Garciastad,Mobility,2019,https://barrettllc.com,Degree radio provide author lead agent spend medical themselves base.,25,barrett-llc,2023,USD,1174291,874630,299661,822787,-523126,0,-523126,11742,23485,-546611,77741,666047,33302,632745,,1174291,650.03,1870.93,0.001,470,208.07,107444.4,0.72,0.2552
4380,Walton Higgins and Andrews,False,IN,West Jessica,Fintech,2008,https://waltonhigginsandandrews.com,Evidence speech color join difficult specific.,19,walton-higgins-and-andrews,2023,USD,1107387,331705,775682,346064,429618,8047,421571,11073,22147,399424,53432,692262,53748,638514,,1107387,246.97,329.07,0.0252,4614,20.0,11909.2,4.49,0.7005
4381,Wood-Taylor,False,EG,East Anthony,Marketplaces,2012,https://wood-taylor.com,Detail majority energy natural stage start paper particularly imagine keep happy.,18,wood-taylor,2023,USD,853268,370334,482934,398841,84093,12297,71796,8532,17065,54731,67926,527589,229521,298068,,853268,1822.15,911.08,0.0647,3555,20.0,38987.34,1.74,0.566
4382,Hill LLC,False,EG,Josephport,Marketplaces,2012,https://hillllc.com,Event fill size over position TV majority.,14,hill-llc,2023,USD,5951652,1629689,4321963,2013512,2308451,7178,2301273,59516,119033,2182240,358728,3533644,565504,2968140,,5951652,20.0,40.66,0.0378,1655,299.56,160268.83,2.24,0.7262
4383,Hart-Martin,False,NG,East Theresa,AgriTech,2013,https://hart-martin.com,Mouth dark pull head ready point support.,20,hart-martin,2023,USD,437833,198814,239019,227776,11243,0,11243,4378,8756,2487,32459,370223,83305,286918,,437833,832.84,1741.87,0.1175,201,181.38,22993.23,1.41,0.5459
4384,Vasquez LLC,False,IN,East Tanyaborough,Mobility,2017,https://vasquezllc.com,Blue training hope democratic certain.,15,vasquez-llc,2023,USD,2522208,1501302,1020906,2196751,-1175845,0,-1175845,25222,50444,-1226289,425081,1761547,677181,1084366,,2522208,1537.42,10114.68,0.001,1127,186.36,179295.34,2.37,0.4048
4385,King-Hurley,False,FR,Wallacestad,AgriTech,2008,https://king-hurley.com,Alone local start long gun population present development discover.,21,king-hurley,2023,EUR,628710,165062,463648,174527,289121,18178,270943,6287,12574,258369,19483,352415,43329,309086,,628710,1362.03,3502.35,0.1049,253,206.37,23377.79,0.83,0.7375
4386,Hall Group,False,EG,Port Cynthia,SaaS,2014,https://hallgroup.com,From business friend necessary both simple religious drug.,31,hall-group,2023,USD,1127203,647131,480072,599986,-119914,2292,-122206,11272,22544,-144750,129990,867502,212122,655380,93933.58,1127203,369.89,2436.25,0.0129,2228,42.15,72473.77,1.79,0.4259
4387,Miller-Woodard,False,IN,Leeberg,IoT,2011,https://miller-woodard.com,Various play campaign allow wish.,16,miller-woodard,2023,USD,951365,369424,581941,573331,8610,0,8610,9513,19027,-10417,12852,571968,28598,543370,,951365,766.86,2896.3,0.1223,327,241.81,64742.19,0.2,0.6117
4388,Perez-Fuentes,False,US,Port David,Mobility,2017,https://perez-fuentes.com,Simple always son much picture that news seat including.,20,perez-fuentes,2023,USD,2481307,646074,1835233,241059,1594174,0,1594174,24813,49626,1544548,253348,1678432,611335,1067097,,2481307,20.0,24.51,0.1141,10338,20.0,64023.31,3.96,0.7396
4389,Smith Group,False,US,New Cindychester,Energy,2019,https://smithgroup.com,Name music sort two see meeting laugh.,27,smith-group,2023,USD,1040454,370807,669647,52022,617625,18027,599598,10404,20809,578789,59507,655617,196681,458936,,1040454,20.0,24.6,0.0528,4335,20.0,1000.0,59.51,0.6436
4390,Castro-Garcia,False,BR,New Ashley,SaaS,2009,https://castro-garcia.com,Off which beat adult peace moment ok debate.,10,castro-garcia,2023,USD,281985,114349,167636,110790,56846,0,56846,2819,5639,51207,20981,328122,183915,144207,23498.75,281985,363.39,1237.29,0.001,3759,6.25,1000.0,20.98,0.5945
4391,Flores PLC,False,IN,East Sarah,HealthTech,2019,https://floresplc.com,Couple pay home face may how their produce.,18,flores-plc,2023,USD,322730,100173,222557,222561,-4,0,-4,3227,6454,-6458,5200,362414,83031,279383,26894.17,322730,193.54,759.92,0.0277,416,64.5,20338.69,0.26,0.6896
4392,Terry Inc,False,IN,Lake Shawna,AI/ML,2012,https://terryinc.com,Suggest student sister cut.,22,terry-inc,2023,USD,2756209,332080,2424129,990014,1434115,0,1434115,27562,55124,1378991,31360,1551700,419127,1132573,,2756209,1222.8,3506.23,0.0645,2921,78.62,123164.89,0.25,0.8795
4393,Burke Group,False,FR,Port Connorside,Cybersecurity,2016,https://burkegroup.com,Herself this share wonder fund yes history stock.,18,burke-group,2023,EUR,5286698,2723853,2562845,4354107,-1791262,0,-1791262,52866,105733,-1896995,326611,3081267,837105,2244162,,5286698,492.83,434.34,0.0527,22027,20.0,350678.56,0.93,0.4848
4394,Short Glass and Robles,False,GB,East Christy,Cybersecurity,2014,https://shortglassandrobles.com,Until organization no it affect money about lay.,22,short-glass-and-robles,2023,USD,246835,96671,150164,43164,107000,0,107000,2468,4936,102064,15810,229823,99823,130000,,246835,865.9,605.77,0.0015,995,20.67,1526.64,10.36,0.6084
4395,Lopez Group,False,TN,Lake Alexanderhaven,IoT,2010,https://lopezgroup.com,Sign most teach process tree ball reason environment least.,18,lopez-group,2023,USD,118020,35551,82469,116521,-34052,26265,-60317,1180,2360,-62677,1671,213980,22166,191814,,118020,1079.25,539.62,0.025,491,20.0,3772.63,0.44,0.6988
4396,Ibarra Inc,False,IN,Jasonhaven,EdTech,2009,https://ibarrainc.com,Population over beyond claim region find these evening me strategy.,18,ibarra-inc,2023,USD,109701,44071,65630,32086,33544,0,33544,1097,2194,31350,22766,261481,108026,153455,9141.75,109701,10.0,49.12,0.027,108,84.04,15012.74,1.52,0.5983
4397,Allen Group,False,EG,South Arthurland,E-commerce,2015,https://allengroup.com,Professional perform man second.,26,allen-group,2023,USD,416527,158072,258455,360477,-102022,15843,-117865,4165,8330,-126195,44639,266595,34766,231829,,416527,20.0,22.29,0.001,371,93.55,37249.01,1.2,0.6205
4398,Hanson Gould and Joseph,False,AU,North David,Marketplaces,2020,https://hansongouldandjoseph.com,Always whom serious accept increase.,18,hanson-gould-and-joseph,2023,USD,981522,376374,605148,293505,311643,0,311643,9815,19630,292013,101713,739227,586530,152697,,981522,20.0,68.53,0.1484,435,187.93,24187.78,4.21,0.6165
4399,York PLC,False,TN,Mortonport,Energy,2011,https://yorkplc.com,Lot ago voice policy record ok pull week street if.,25,york-plc,2023,USD,760545,387954,372591,179438,193153,13638,179515,7605,15210,164305,132820,702216,253672,448544,,760545,1162.66,581.33,0.0425,967,65.53,56009.87,2.37,0.4899
4400,Lambert-Allen,False,IN,North Carrieport,AgriTech,2017,https://lambert-allen.com,Cut others teach town place cause trip himself.,14,lambert-allen,2023,USD,269598,80818,188780,101421,87359,0,87359,2695,5391,81968,6369,193332,15887,177445,,269598,63.04,192.35,0.1093,657,34.15,16243.59,0.39,0.7002
4401,Stokes Martin and Miller,False,GB,Roweburgh,IoT,2021,https://stokesmartinandmiller.com,Actually want specific cultural standard wish learn whole.,13,stokes-martin-and-miller,2023,USD,704280,153310,550970,289817,261153,0,261153,7042,14085,247068,12664,397707,19885,377822,,704280,336.01,1737.76,0.1371,542,108.23,19875.31,0.64,0.7823
4402,Perkins LLC,False,BR,Lisaview,E-commerce,2012,https://perkinsllc.com,Develop many two soldier program expert ok surface yeah across.,23,perkins-llc,2023,USD,718863,297773,421090,381000,40090,0,40090,7188,14377,25713,12328,433818,113917,319901,,718863,695.39,347.7,0.001,276,216.58,5162.21,2.39,0.5858
4403,Sanders Group,False,BR,Shahfurt,EdTech,2016,https://sandersgroup.com,Save unit customer class subject price loss.,17,sanders-group,2023,USD,703395,429510,273885,456175,-182290,0,-182290,7033,14067,-196357,16718,501570,144818,356752,58616.25,703395,268.33,1076.2,0.001,1354,43.29,51354.18,0.33,0.3894
4404,Green Allen and Clark,False,GB,South Madisonville,Energy,2014,https://greenallenandclark.com,Skin pass nation accept notice statement.,22,green-allen-and-clark,2023,USD,1122833,358135,764698,521013,243685,0,243685,11228,22456,221229,188411,927245,397141,530104,,1122833,314.56,782.11,0.0407,2603,35.94,66891.49,2.82,0.681
4405,Stone Thompson and Chambers,False,IN,Lake Valerie,AgriTech,2010,https://stonethompsonandchambers.com,Morning carry event tell prevent direction factor seven.,23,stone-thompson-and-chambers,2023,USD,711765,296260,415505,272189,143316,31998,111318,7117,14235,97083,41824,400500,209895,190605,,711765,20.0,144.88,0.0257,287,206.29,22333.35,1.87,0.5838
4406,Butler Inc,False,IN,North Jonathanview,IoT,2022,https://butlerinc.com,Court accept herself hospital front just.,24,butler-inc,2023,USD,787445,201560,585885,122021,463864,0,463864,7874,15748,448116,47686,443794,50457,393337,,787445,20.0,60.15,0.0939,367,178.66,24354.39,1.96,0.744
4407,Smith-Hubbard,False,NG,Lake Danastad,HealthTech,2020,https://smith-hubbard.com,Magazine draw common agreement find yet.,21,smith-hubbard,2023,USD,1650198,986434,663764,554411,109353,21933,87420,16501,33003,54417,177220,1136868,289562,847306,137516.5,1650198,262.94,1774.74,0.0595,3052,45.05,28610.08,6.19,0.4022
4408,Wall Frederick and Stephenson,False,AU,East Janetchester,Energy,2011,https://wallfrederickandstephenson.com,In hope water action weight stay hotel ten never factor.,21,wall-frederick-and-stephenson,2023,USD,421826,21091,400735,127831,272904,0,272904,4218,8436,264468,26767,323187,169838,153349,,421826,20.0,13.62,0.0793,1757,20.0,1000.0,26.77,0.95
4409,Reed Soto and Garcia,False,GB,Alvaradochester,AI/ML,2022,https://reedsotoandgarcia.com,Challenge man soon range TV.,13,reed-soto-and-garcia,2023,USD,482396,59438,422958,204801,218157,0,218157,4823,9647,208510,19418,418963,129461,289502,,482396,20.0,98.23,0.0235,147,272.47,19257.19,1.01,0.8768
4410,Nguyen Vazquez and Bryant,False,ZA,Turnerchester,E-commerce,2024,https://nguyenvazquezandbryant.com,Citizen item our through wide consumer west list wait recognize.,20,nguyen-vazquez-and-bryant,2023,USD,1358588,629896,728692,1105394,-376702,0,-376702,13585,27171,-403873,51225,897606,242343,655263,,1358588,828.54,2758.05,0.001,908,124.64,68377.91,0.75,0.5364
4411,Mendez-Goodwin,False,BR,West Jennifer,Cybersecurity,2019,https://mendez-goodwin.com,Life during far laugh next commercial answer court.,20,mendez-goodwin,2023,USD,96869,34714,62155,87245,-25090,10475,-35565,968,1937,-37502,10453,195532,9776,185756,,96869,228.58,723.01,0.0925,44,179.75,1000.0,10.45,0.6416
4412,Hughes Wright and Frost,False,EG,Lake Joyce,E-commerce,2021,https://hugheswrightandfrost.com,Back machine push common send we information happen western fine.,24,hughes-wright-and-frost,2023,USD,3613434,1311486,2301948,1762259,539689,21384,518305,36134,72268,446037,337531,2230672,547911,1682761,,3613434,1265.72,4645.37,0.0582,15055,20.0,153204.51,2.2,0.6371
4413,Rios Ltd,False,EG,West Lisafort,Energy,2021,https://riosltd.com,Her manager occur cover analysis sure.,27,rios-ltd,2023,USD,483283,281267,202016,111576,90440,0,90440,4832,9665,80775,46078,308985,49647,259338,,483283,1604.81,4071.53,0.001,510,78.95,21633.84,2.13,0.418
4414,Griffith Inc,False,EG,North Joseph,SaaS,2008,https://griffithinc.com,Any so less style reveal PM.,12,griffith-inc,2023,USD,1473747,502334,971413,853840,117573,15519,102054,14737,29474,72580,143136,913978,659413,254565,122812.25,1473747,317.57,1021.89,0.0177,11256,10.91,76604.57,1.87,0.6591
4415,Pruitt LLC,False,AU,East John,Energy,2010,https://pruittllc.com,Final task partner have act soon street magazine newspaper anything.,18,pruitt-llc,2023,USD,8925506,1745691,7179815,4770968,2408847,50944,2357903,89255,178510,2179393,469647,5130531,2532690,2597841,,8925506,20.0,10.0,0.001,37189,20.0,410031.32,1.15,0.8044
4416,Jones PLC,False,AU,Justinside,HealthTech,2017,https://jonesplc.com,It last room even whose.,21,jones-plc,2023,USD,1758119,806098,952021,1571098,-619077,0,-619077,17581,35162,-654239,25331,919262,698392,220870,146509.92,1758119,262.22,768.77,0.0215,4864,30.12,161291.76,0.16,0.5415
4417,Fields Ltd,False,AU,Lake Mollychester,EdTech,2024,https://fieldsltd.com,Artist girl car husband thank economic live culture.,18,fields-ltd,2023,USD,240848,169575,71273,82308,-11035,13453,-24488,2408,4816,-29304,37517,295158,153674,141484,20070.67,240848,404.46,1752.96,0.001,397,50.48,1000.0,37.52,0.2959
4418,Nelson Ltd,False,CA,Port Kevinstad,HealthTech,2017,https://nelsonltd.com,Dog last walk seem manage arrive.,29,nelson-ltd,2023,USD,436511,175030,261481,173502,87979,2719,85260,4365,8730,76530,2078,407485,36184,371301,36375.92,436511,10.0,53.78,0.0169,7275,5.0,1000.0,2.08,0.599
4419,Smith PLC,False,US,Josephstad,Energy,2012,https://smithplc.com,Imagine others south personal huge.,16,smith-plc,2023,USD,970809,403275,567534,386469,181065,35726,145339,9708,19416,125923,29244,669573,140202,529371,,970809,1351.96,3326.84,0.0939,1137,71.13,14445.08,2.02,0.5846
4420,Clark Huffman and Wilson,False,TN,West Marie,Marketplaces,2008,https://clarkhuffmanandwilson.com,Wide present involve white choice deal.,8,clark-huffman-and-wilson,2023,USD,2838209,1070691,1767518,1258147,509371,1703,507668,28382,56764,450904,304977,1867937,194075,1673862,,2838209,307.53,1757.92,0.0586,882,267.98,104551.77,2.92,0.6228
4421,Brown-Little,False,EG,Lake Tylermouth,AI/ML,2022,https://brown-little.com,Like too information Mr drop its participant.,21,brown-little,2023,USD,294105,106122,187983,165672,22311,0,22311,2941,5882,16429,52663,355309,107249,248060,,294105,1368.73,8059.93,0.001,149,163.83,13150.35,4.0,0.6392
4422,Graham-Cole,False,US,West Peggychester,Fintech,2009,https://graham-cole.com,And friend serve school.,21,graham-cole,2023,USD,450333,222564,227769,262856,-35087,0,-35087,4503,9006,-44093,24439,259313,40175,219138,,450333,122.92,61.46,0.0509,215,174.41,1000.0,24.44,0.5058
4423,Riley Berry and Lopez,False,IN,Josephland,Marketplaces,2011,https://rileyberryandlopez.com,Be pay cost nice participant no charge pretty.,14,riley-berry-and-lopez,2023,USD,1521674,625920,895754,128889,766865,13039,753826,15216,30433,723393,383949,1223623,97560,1126063,,1521674,606.2,303.1,0.044,885,143.22,9095.18,42.21,0.5887
4424,Blackburn LLC,False,CA,Seanport,IoT,2011,https://blackburnllc.com,People end general plan summer.,19,blackburn-llc,2023,USD,980216,302500,677716,473084,204632,5435,199197,9802,19604,179593,75528,619493,299416,320077,,980216,20.0,10.0,0.0397,500,163.17,14113.66,5.35,0.6914
4425,Schultz Salazar and Hamilton,False,IN,East Robertview,IoT,2023,https://schultzsalazarandhamilton.com,Old because sense theory.,23,schultz-salazar-and-hamilton,2023,USD,834657,228855,605802,563697,42105,3030,39075,8346,16693,22382,18823,537320,159314,378006,,834657,1038.05,2429.06,0.0341,257,270.09,29241.93,0.64,0.7258
4426,Bartlett PLC,False,ZA,North John,E-commerce,2009,https://bartlettplc.com,Eat customer follow someone move environmental.,23,bartlett-plc,2023,USD,425843,132956,292887,194930,97957,0,97957,4258,8516,89441,19365,288453,200754,87699,,425843,662.11,1971.55,0.001,309,114.49,32048.59,0.6,0.6878
4427,Lopez Ltd,False,FR,Scottview,Cybersecurity,2024,https://lopezltd.com,Situation believe few wind indeed benefit foreign citizen.,22,lopez-ltd,2023,EUR,1169950,235817,934133,657451,276682,21989,254693,11699,23399,231294,100951,836513,345247,491266,,1169950,518.92,711.74,0.1105,602,161.7,70392.84,1.43,0.7984
4428,Ortiz Wilson and Bray,False,ZA,West Robertport,Cybersecurity,2009,https://ortizwilsonandbray.com,Picture real onto number.,19,ortiz-wilson-and-bray,2023,USD,750031,244353,505678,39962,465716,0,465716,7500,15000,450716,198189,707920,191559,516361,,750031,632.69,2606.93,0.0234,269,231.91,14490.48,13.68,0.6742
4429,Valdez-Mcclure,False,ZA,South Allenside,EdTech,2024,https://valdez-mcclure.com,Cause keep artist air receive.,18,valdez-mcclure,2023,USD,951936,368821,583115,860724,-277609,17948,-295557,9519,19038,-314595,13513,555032,284238,270794,79328.0,951936,332.44,720.71,0.0352,657,120.66,52933.76,0.26,0.6126
4430,Bowen Tapia and Baker,False,GB,Jonesfort,AI/ML,2023,https://bowentapiaandbaker.com,Yard major participant staff allow.,21,bowen-tapia-and-baker,2023,USD,564665,205473,359192,292007,67185,3546,63639,5646,11293,52346,3426,419557,197608,221949,,564665,1345.18,3434.47,0.001,2352,20.0,29162.11,0.12,0.6361
4431,Rowe Ltd,False,GB,East Meaganshire,EdTech,2012,https://roweltd.com,Per truth senior instead someone knowledge prepare ready important.,22,rowe-ltd,2023,USD,311808,140663,171145,109445,61700,0,61700,3118,6236,55464,21014,350941,145376,205565,25984.0,311808,359.8,359.8,0.0823,270,96.04,25785.72,0.81,0.5489
4432,Miller LLC,False,IN,Jonesport,Marketplaces,2017,https://millerllc.com,In forward young get cell he instead soon career.,27,miller-llc,2023,USD,595251,170457,424794,201381,223413,22252,201161,5952,11905,189256,4127,341045,63359,277686,,595251,423.03,452.63,0.0601,2480,20.0,1000.0,4.13,0.7136
4433,Soto Thompson and Meadows,False,ZA,Haroldberg,SaaS,2023,https://sotothompsonandmeadows.com,Tv production material his main gas business instead month parent.,25,soto-thompson-and-meadows,2023,USD,282703,80929,201774,192620,9154,8511,643,2827,5654,-5011,25764,232785,33482,199303,23558.58,282703,390.26,1020.91,0.0399,377,62.37,7771.11,3.32,0.7137
4434,Johnson Hill and Gross,False,KE,West Gina,Cybersecurity,2014,https://johnsonhillandgross.com,Stand seat power usually late.,11,johnson-hill-and-gross,2023,USD,1326657,586092,740565,768263,-27698,13701,-41399,13266,26533,-67932,43095,707761,138363,569398,,1326657,349.53,1579.9,0.1554,5527,20.0,65815.86,0.65,0.5582
4435,Bishop Group,False,FR,West Davidberg,Fintech,2008,https://bishopgroup.com,Wife particular within get maybe.,19,bishop-group,2023,EUR,1018263,587532,430731,722992,-292261,0,-292261,10182,20365,-312626,11169,714476,35723,678753,,1018263,693.42,4231.35,0.0141,222,381.03,29961.81,0.37,0.423
4436,Gordon Jones and Bolton,False,GB,Schultzburgh,IoT,2011,https://gordonjonesandbolton.com,Picture should decision similar wrong feeling effort agree.,22,gordon-jones-and-bolton,2023,USD,507289,201403,305886,188954,116932,329,116603,5072,10145,106458,11336,358906,64873,294033,,507289,20.0,62.75,0.09,1201,35.19,25606.4,0.44,0.603
4437,Jones Dixon and Hanson,False,NG,North Susan,Fintech,2015,https://jonesdixonandhanson.com,Name garden care under design week find.,16,jones-dixon-and-hanson,2023,USD,1164867,314000,850867,539452,311415,17446,293969,11648,23297,270672,36681,816874,40843,776031,,1164867,20.0,66.57,0.0487,4853,20.0,39598.99,0.93,0.7304
4438,Allison Inc,False,DE,West Moniqueport,Fintech,2023,https://allisoninc.com,Stage old laugh rock station election perhaps personal number.,19,allison-inc,2023,EUR,742751,367833,374918,74436,300482,26479,274003,7427,14855,259148,83503,484523,73088,411435,,742751,20.0,86.01,0.0975,2872,21.55,19183.31,4.35,0.5048
4439,Bates Everett and Gay,False,US,Port Michelleburgh,AI/ML,2022,https://bateseverettandgay.com,Her along stay old.,24,bates-everett-and-gay,2023,USD,1053899,413357,640542,609787,30755,27079,3676,10538,21077,-17401,459602,1096776,479505,617271,,1053899,1421.22,2031.34,0.124,390,224.88,70065.69,6.56,0.6078
4440,Sanchez-Erickson,False,TN,Michaelland,SaaS,2011,https://sanchez-erickson.com,Street professor nor movie recent TV.,18,sanchez-erickson,2023,USD,608521,177806,430715,107260,323455,0,323455,6085,12170,311285,71263,419354,125677,293677,50710.08,608521,248.5,395.57,0.0453,672,75.46,6871.27,10.37,0.7078
4441,Harris-Smith,False,IN,Ashleyland,Energy,2023,https://harris-smith.com,White month increase exactly kind above accept.,19,harris-smith,2023,USD,3066733,1988048,1078685,1506853,-428168,0,-428168,30667,61334,-489502,237692,1843669,92183,1751486,,3066733,482.48,436.81,0.0814,864,295.57,155086.72,1.53,0.3517
4442,Williams Inc,False,GB,Brownchester,EdTech,2016,https://williamsinc.com,Second name challenge number sport argue boy common meeting after.,18,williams-inc,2023,USD,876453,221100,655353,407347,248006,16485,231521,8764,17529,213992,133639,732116,364681,367435,73037.75,876453,10.0,53.06,0.0686,769,94.95,54171.87,2.47,0.7477
4443,Fernandez-Johnson,False,KE,Allenburgh,Marketplaces,2022,https://fernandez-johnson.com,Bit off third personal political allow make avoid very news.,12,fernandez-johnson,2023,USD,661912,95108,566804,306962,259842,16486,243356,6619,13238,230118,20173,369007,122776,246231,,661912,1422.29,6044.58,0.0998,1151,47.92,50676.06,0.4,0.8563
4444,Jordan LLC,False,BR,Lake Matthewstad,IoT,2011,https://jordanllc.com,Do wish until anyone change radio manage include.,14,jordan-llc,2023,USD,376501,178361,198140,177978,20162,8665,11497,3765,7530,3967,6556,276017,66513,209504,,376501,1105.84,2989.48,0.0049,131,238.58,1000.0,6.56,0.5263
4445,Taylor-Ellis,False,TN,Jimshire,HealthTech,2008,https://taylor-ellis.com,Else decide behavior physical present behind available imagine.,23,taylor-ellis,2023,USD,462618,173222,289396,168954,120442,593,119849,4626,9252,110597,33756,327750,103951,223799,38551.5,462618,10.0,53.42,0.0261,417,92.41,25012.4,1.35,0.6256
4446,Rodriguez Ramirez and Klein,False,GB,Lake Misty,HealthTech,2015,https://rodriguezramirezandklein.com,Have Congress upon appear agent far war paper church.,16,rodriguez-ramirez-and-klein,2023,USD,1527396,449399,1077997,1208505,-130508,9865,-140373,15273,30547,-170920,306652,1123045,742043,381002,127283.0,1527396,10.0,45.58,0.0215,2680,47.48,91722.79,3.34,0.7058
4447,Adams Salinas and Arnold,False,GB,Moralesville,AI/ML,2014,https://adamssalinasandarnold.com,State simply bring head already anyone store suggest.,12,adams-salinas-and-arnold,2023,USD,1730492,359082,1371410,545922,825488,1073,824415,17304,34609,789806,196535,1207407,570872,636535,,1730492,20.0,21.96,0.1133,2245,64.23,43043.51,4.57,0.7925
4448,Brown Group,False,EG,South Andrea,Mobility,2017,https://browngroup.com,I grow tonight list boy from weight lot note.,12,brown-group,2023,USD,171721,86620,85101,70689,14412,792,13620,1717,3434,10186,7290,107696,61524,46172,,171721,20.0,76.74,0.0278,715,20.0,1000.0,7.29,0.4956
4449,Baker Ltd,False,IN,New Robert,Marketplaces,2011,https://bakerltd.com,Author his market question television watch visit president.,23,baker-ltd,2023,USD,182553,59776,122777,27891,94886,32877,62009,1825,3651,58358,8678,167513,98257,69256,,182553,227.89,933.44,0.0638,153,99.15,1000.0,8.68,0.6726
4450,Wong and Sons,False,KE,Jacksonshire,Mobility,2019,https://wongandsons.com,Huge course partner despite choose.,16,wong-and-sons,2023,USD,2092162,813196,1278966,554191,724775,8372,716403,20921,41843,674560,176582,1380368,1199500,180868,,2092162,1138.55,4916.5,0.1038,1567,111.26,67016.43,2.63,0.6113
4451,Wolfe Inc,False,BR,North Catherineville,AgriTech,2020,https://wolfeinc.com,Person operation consider road event unit.,25,wolfe-inc,2023,USD,186492,109612,76880,155305,-78425,24331,-102756,1864,3729,-106485,19850,190514,81860,108654,,186492,981.08,1793.58,0.117,62,249.41,1000.0,19.85,0.4122
4452,Davis-Sutton,False,TN,North Jamesmouth,Cybersecurity,2011,https://davis-sutton.com,Ago let reach arm operation coach visit effect game public.,17,davis-sutton,2023,USD,435217,105895,329322,169338,159984,0,159984,4352,8704,151280,12592,274376,168181,106195,,435217,292.43,2038.24,0.0968,1813,20.0,25700.73,0.49,0.7567
4453,Dixon PLC,False,EG,Chelseafurt,Energy,2021,https://dixonplc.com,Miss few economic rise technology national box.,23,dixon-plc,2023,USD,1673867,776689,897178,1772816,-875638,0,-875638,16738,33477,-909115,429070,1307589,429541,878048,,1673867,1202.56,7665.96,0.001,4356,32.02,149517.3,2.87,0.536
4454,Cruz-Wilcox,False,GB,North Jamesmouth,SaaS,2017,https://cruz-wilcox.com,Hospital letter thank wind general usually sport.,14,cruz-wilcox,2023,USD,1386536,602343,784193,397087,387106,0,387106,13865,27730,359376,317563,1170759,152422,1018337,115544.67,1386536,10.0,39.87,0.0324,2076,55.64,44348.53,7.16,0.5656
4455,Jones Brown and Medina,False,EG,Lake Kristinafort,Fintech,2020,https://jonesbrownandmedina.com,Difficult side money improve fact study field enough simple green.,15,jones-brown-and-medina,2023,USD,1014832,434686,580146,562734,17412,0,17412,10148,20296,-2884,76911,669719,356945,312774,,1014832,696.89,6467.07,0.0374,387,218.14,34612.86,2.22,0.5717
4456,West-Stafford,False,US,North Pamelaberg,IoT,2017,https://west-stafford.com,Term western participant kitchen summer consumer five various.,19,west-stafford,2023,USD,5333661,2376514,2957147,2755007,202140,0,202140,53336,106673,95467,605309,3328792,924315,2404477,,5333661,834.29,3464.51,0.001,4584,96.96,256974.3,2.36,0.5544
4457,Mills-Estes,False,US,West Michael,Marketplaces,2022,https://mills-estes.com,Best if dark participant many economic later act project result free.,18,mills-estes,2023,USD,245332,75729,169603,66427,103176,0,103176,2453,4906,98270,10811,199942,122688,77254,,245332,357.63,1716.08,0.001,1022,20.0,22249.77,0.49,0.6913
4458,Gutierrez Walls and Fox,False,US,Saraburgh,E-commerce,2012,https://gutierrezwallsandfox.com,Soon guess former since the country speech tell chance.,27,gutierrez-walls-and-fox,2023,USD,3013908,1105593,1908315,1786781,121534,34871,86663,30139,60278,26385,31857,1688103,776918,911185,,3013908,375.58,2643.44,0.0331,1844,136.19,117191.35,0.27,0.6332
4459,Li and Sons,False,EG,North Theresa,Cybersecurity,2022,https://liandsons.com,Toward return carry thing second example past black section fine.,19,li-and-sons,2023,USD,999792,306362,693430,527715,165715,33261,132454,9997,19995,112459,224350,880756,679824,200932,,999792,685.82,880.57,0.0582,1842,45.22,27617.93,8.12,0.6936
4460,Rodriguez and Sons,False,IN,New Kenneth,SaaS,2013,https://rodriguezandsons.com,Production pull operation article nothing American kind.,23,rodriguez-and-sons,2023,USD,643912,117845,526067,264990,261077,18554,242523,6439,12878,229645,11341,433088,21654,411434,53659.33,643912,356.89,3310.71,0.0374,649,82.65,44666.75,0.25,0.817
4461,Petersen-Green,False,CA,New Gregoryhaven,AI/ML,2024,https://petersen-green.com,Cell not stand born opportunity interview.,29,petersen-green,2023,USD,1354396,553127,801269,613304,187965,16153,171812,13543,27087,144725,296899,1085593,412710,672883,,1354396,1013.88,3955.98,0.0378,399,282.32,52950.87,5.61,0.5916
4462,Monroe Hayes and Vega,False,DE,West Cindy,E-commerce,2024,https://monroehayesandvega.com,Sell officer participant some return.,17,monroe-hayes-and-vega,2023,EUR,601677,196508,405169,117646,287523,0,287523,6016,12033,275490,15089,507164,120488,386676,,601677,20.0,99.37,0.0408,624,80.29,1000.0,15.09,0.6734
4463,Grant Chavez and Perry,False,TN,Nelsonfurt,AI/ML,2010,https://grantchavezandperry.com,Parent trial reason left brother she to successful compare.,26,grant-chavez-and-perry,2023,USD,683680,191676,492004,352070,139934,0,139934,6836,13673,126261,39146,572877,181843,391034,,683680,423.54,1580.58,0.0603,579,98.26,20525.21,1.91,0.7196
4464,Willis Frazier and Taylor,False,GB,Lake Lindafurt,Marketplaces,2012,https://willisfrazierandtaylor.com,Practice wear hour concern matter easy hand kind hit put.,19,willis-frazier-and-taylor,2023,USD,426143,83638,342505,317350,25155,4149,21006,4261,8522,12484,19774,318487,69443,249044,,426143,1473.1,2052.18,0.0151,1775,20.0,24391.39,0.81,0.8037
4465,Palmer-Daniel,False,CA,North Christopher,Marketplaces,2018,https://palmer-daniel.com,Hand rock Congress no like floor.,18,palmer-daniel,2023,USD,490015,153394,336621,53178,283443,18683,264760,4900,9800,254960,34630,371812,105625,266187,,490015,20.0,76.3,0.106,459,88.87,1000.0,34.63,0.687
4466,Collins-Walker,False,EG,East Regina,Cybersecurity,2012,https://collins-walker.com,Their health hit data matter.,19,collins-walker,2023,USD,173877,62723,111154,31799,79355,5886,73469,1738,3477,69992,39309,161970,61385,100585,,173877,20.0,139.44,0.0091,76,190.62,1000.0,39.31,0.6393
4467,Johns Ltd,False,IN,New Jennifer,Marketplaces,2017,https://johnsltd.com,Wonder about military fall raise provide window.,16,johns-ltd,2023,USD,359122,110303,248819,184064,64755,41756,22999,3591,7182,15817,19817,337728,100482,237246,,359122,195.53,797.48,0.0644,1356,22.06,1000.0,19.82,0.6929
4468,Harrison LLC,False,TN,Port Jenniferhaven,Fintech,2023,https://harrisonllc.com,Perhaps painting bill usually up try must effect ball.,23,harrison-llc,2023,USD,541810,224024,317786,339846,-22060,0,-22060,5418,10836,-32896,4224,313203,126695,186508,,541810,20.0,109.29,0.0833,381,118.42,43116.24,0.1,0.5865
4469,Zhang Henry and Horton,False,TN,West Jessicaburgh,Mobility,2013,https://zhanghenryandhorton.com,Focus add plant when why international surface step cost.,12,zhang-henry-and-horton,2023,USD,548190,165373,382817,313598,69219,0,69219,5481,10963,58256,53327,392888,129578,263310,,548190,1395.04,1818.57,0.0763,378,120.77,19833.01,2.69,0.6983
4470,Brown-Harrell,False,KE,Randallburgh,Cybersecurity,2024,https://brown-harrell.com,Create commercial media believe success save.,23,brown-harrell,2023,USD,1304308,438917,865391,79689,785702,2412,783290,13043,26086,757204,74511,768398,235124,533274,,1304308,811.03,1121.18,0.0181,1266,85.79,1000.0,74.51,0.6635
4471,Drake Bryant and Dean,False,AU,Port Danland,Marketplaces,2024,https://drakebryantanddean.com,Ago director inside bed send outside.,22,drake-bryant-and-dean,2023,USD,2816186,589018,2227168,1181299,1045869,0,1045869,28161,56323,989546,80996,1666465,499661,1166804,,2816186,1069.78,3998.61,0.0652,941,249.14,94656.53,0.86,0.7908
4472,Ellis-Rodriguez,False,IN,Lawrencechester,HealthTech,2018,https://ellis-rodriguez.com,Just attack community here behind establish item nation imagine ready.,21,ellis-rodriguez,2023,USD,12076072,7215898,4860174,6827963,-1967789,800,-1968589,120760,241521,-2210110,613549,6743098,2755492,3987606,1006339.33,12076072,118.89,478.13,0.0364,201267,5.0,560446.44,1.09,0.4025
4473,Vasquez Brown and Lewis,False,KE,North Yolanda,IoT,2019,https://vasquezbrownandlewis.com,Later property two be great significant.,22,vasquez-brown-and-lewis,2023,USD,1396524,354285,1042239,1033562,8677,3349,5328,13965,27930,-22602,26984,887047,304609,582438,,1396524,79.68,39.84,0.1349,3000,38.79,64333.38,0.42,0.7463
4474,Preston-Rubio,False,KE,Webstermouth,IoT,2020,https://preston-rubio.com,Body investment data education note change stuff.,16,preston-rubio,2023,USD,524058,104738,419320,94481,324839,0,324839,5240,10481,314358,63693,374469,18723,355746,,524058,501.63,1832.95,0.0233,2183,20.0,7670.67,8.3,0.8001
4475,Reynolds PLC,False,FR,Mossmouth,SaaS,2008,https://reynoldsplc.com,Such act feel give wonder both admit black say.,22,reynolds-plc,2023,EUR,743067,277717,465350,475355,-10005,0,-10005,7430,14861,-24866,16611,425739,227630,198109,61922.25,743067,497.07,1111.53,0.0149,979,63.25,23712.07,0.7,0.6263
4476,Montoya Walter and Harrison,False,ZA,West Josephhaven,HealthTech,2015,https://montoyawalterandharrison.com,Machine traditional real money teach part successful service travel.,19,montoya-walter-and-harrison,2023,USD,1443043,526521,916522,584176,332346,4079,328267,14430,28860,299407,218264,1116593,287667,828926,120253.58,1443043,953.18,4033.58,0.0515,1406,85.52,59257.4,3.68,0.6351
4477,Peters-Garcia,False,FR,Lake Michael,Marketplaces,2011,https://peters-garcia.com,Do responsibility nor none opportunity thought program degree may.,20,peters-garcia,2023,EUR,1041534,208483,833051,52076,780975,13542,767433,10415,20830,746603,269887,811443,224066,587377,,1041534,20.0,88.61,0.0851,854,101.56,19268.98,14.01,0.7998
4478,Moore-Stewart,False,EG,Lake Dennisfurt,Marketplaces,2023,https://moore-stewart.com,Yes onto at career Republican.,12,moore-stewart,2023,USD,2228799,521727,1707072,413332,1293740,0,1293740,22287,44575,1249165,38741,1308122,597168,710954,,2228799,20.0,49.17,0.0642,9286,20.0,22720.63,1.71,0.7659
4479,Freeman-Gray,False,CA,Jamesshire,EdTech,2015,https://freeman-gray.com,Reflect with into phone level visit church senior spring yet.,20,freeman-gray,2023,USD,583508,284030,299478,233673,65805,6998,58807,5835,11670,47137,30240,410013,285458,124555,48625.67,583508,135.31,639.89,0.052,539,90.06,1000.0,30.24,0.5132
4480,Graham Group,False,FR,Ramostown,HealthTech,2020,https://grahamgroup.com,Energy card dark probably magazine.,16,graham-group,2023,EUR,2565423,510442,2054981,1336349,718632,50281,668351,25654,51308,617043,117273,1545330,520093,1025237,213785.25,2565423,397.36,2609.21,0.001,2424,88.18,90905.9,1.29,0.801
4481,Craig Allen and Johnson,False,AU,Jonesfurt,Energy,2010,https://craigallenandjohnson.com,Should magazine job lose research recent.,21,craig-allen-and-johnson,2023,USD,1478311,513263,965048,1098684,-133636,15642,-149278,14783,29566,-178844,135538,935120,154329,780791,,1478311,20.0,45.05,0.1006,1522,80.89,109885.33,1.23,0.6528
4482,Hamilton Davidson and Reyes,False,US,East Christophertown,IoT,2016,https://hamiltondavidsonandreyes.com,I treatment and child reduce many past four.,19,hamilton-davidson-and-reyes,2023,USD,276653,101820,174833,51876,122957,38869,84088,2766,5533,78555,32351,281727,171690,110037,,276653,343.75,650.54,0.1484,91,252.53,17206.36,1.88,0.632
4483,Jarvis LLC,False,FR,Smithshire,SaaS,2010,https://jarvisllc.com,Away employee minute I author.,17,jarvis-llc,2023,EUR,4020644,1046445,2974199,1229489,1744710,0,1744710,40206,80412,1664298,189456,2245620,821381,1424239,335053.67,4020644,462.44,1136.76,0.031,5133,65.27,92457.27,2.05,0.7397
4484,Sims-Glenn,False,EG,Glendaborough,E-commerce,2008,https://sims-glenn.com,Study radio chair commercial dinner follow friend scene.,22,sims-glenn,2023,USD,1614143,794774,819369,1254979,-435610,16775,-452385,16141,32282,-484667,158300,1089281,799191,290090,,1614143,20.0,47.6,0.0501,6725,20.0,130711.54,1.21,0.5076
4485,Carter Moore and Lopez,False,GB,Smithburgh,E-commerce,2011,https://cartermooreandlopez.com,Nice today want two exist argue too might week.,17,carter-moore-and-lopez,2023,USD,309001,56002,252999,73257,179742,0,179742,3090,6180,173562,33739,266812,24664,242148,,309001,20.0,118.25,0.0016,1287,20.0,1000.0,33.74,0.8188
4486,Larson-Joyce,False,ZA,Aliciaton,Mobility,2020,https://larson-joyce.com,Degree adult point assume see help.,19,larson-joyce,2023,USD,275958,103456,172502,44818,127684,0,127684,2759,5519,122165,2123,234961,56642,178319,,275958,20.0,36.53,0.0581,200,114.94,1000.0,2.12,0.6251
4487,Figueroa Group,False,GB,Davidville,Marketplaces,2014,https://figueroagroup.com,Modern manager fish capital rise plan many event.,22,figueroa-group,2023,USD,411444,79781,331663,155988,175675,0,175675,4114,8228,167447,161583,552070,187535,364535,,411444,24.83,75.93,0.001,168,203.35,23527.48,6.87,0.8061
4488,Stewart Ltd,False,DE,Vanessatown,AgriTech,2023,https://stewartltd.com,Forward will else official personal tend occur benefit never.,8,stewart-ltd,2023,EUR,621281,234055,387226,197547,189679,0,189679,6212,12425,177254,73552,507815,340287,167528,,621281,524.42,914.29,0.1182,2588,20.0,1000.0,73.55,0.6233
4489,Hudson LLC,False,EG,Port Joshua,Marketplaces,2017,https://hudsonllc.com,Tax short hundred fact follow.,14,hudson-llc,2023,USD,187013,22858,164155,76457,87698,14673,73025,1870,3740,69285,10184,157916,62680,95236,,187013,20.0,102.02,0.0831,465,33.49,1000.0,10.18,0.8778
4490,Duarte Joseph and Richard,False,DE,North Danielleberg,EdTech,2013,https://duartejosephandrichard.com,Interview without former Republican manage others.,22,duarte-joseph-and-richard,2023,EUR,364673,52760,311913,73340,238573,0,238573,3646,7293,231280,29180,244567,116995,127572,30389.42,364673,142.39,670.72,0.0424,585,51.94,5702.32,5.12,0.8553
4491,Fisher and Sons,False,TN,Jeromeview,AI/ML,2014,https://fisherandsons.com,Three skin wrong assume few.,20,fisher-and-sons,2023,USD,6025939,1448283,4577656,452637,4125019,8826,4116193,60259,120518,3995675,749833,3953844,1115668,2838176,,6025939,20.0,80.65,0.0092,8213,61.14,20233.23,37.06,0.7597
4492,Doyle Medina and Bush,False,FR,Wardside,IoT,2008,https://doylemedinaandbush.com,Billion imagine charge which station bring baby old.,19,doyle-medina-and-bush,2023,EUR,846158,383056,463102,42307,420795,0,420795,8461,16923,403872,10084,568600,124230,444370,,846158,20.0,136.02,0.0791,644,109.44,1000.0,10.08,0.5473
4493,James Marshall and Cox,False,BR,Valerieburgh,Marketplaces,2011,https://jamesmarshallandcox.com,Research list magazine question environment until.,17,james-marshall-and-cox,2023,USD,1769633,590783,1178850,88481,1090369,5157,1085212,17696,35392,1049820,223687,1198748,604289,594459,,1769633,20.0,15.39,0.001,7257,20.32,1000.0,223.69,0.6662
4494,Ryan PLC,False,DE,Donnabury,SaaS,2012,https://ryanplc.com,Appear already appear trouble cell rule service research fish red.,14,ryan-plc,2023,EUR,2765015,873317,1891698,1536399,355299,0,355299,27650,55300,299999,62013,1576245,725254,850991,230417.92,2765015,289.72,468.95,0.012,2349,98.08,116460.85,0.53,0.6842
4495,Olson Campbell and Owens,False,US,North Caitlin,E-commerce,2021,https://olsoncampbellandowens.com,Upon ask friend pretty staff director.,21,olson-campbell-and-owens,2023,USD,2684324,711146,1973178,353355,1619823,16467,1603356,26843,53686,1549670,84710,1433237,585215,848022,,2684324,350.5,1601.55,0.0772,3029,73.83,31882.68,2.66,0.7351
4496,Lewis-Taylor,False,KE,Davidchester,AI/ML,2010,https://lewis-taylor.com,Idea concern prevent international throw hot site true analysis.,17,lewis-taylor,2023,USD,456355,119657,336698,243042,93656,31767,61889,4563,9127,52762,26385,420814,67138,353676,,456355,153.12,563.56,0.1379,590,64.4,26728.35,0.99,0.7378
4497,Smith Hernandez and Kelley,False,CA,Caseyland,HealthTech,2024,https://smithhernandezandkelley.com,Player agreement grow choice heart bed.,22,smith-hernandez-and-kelley,2023,USD,557061,171555,385506,224749,160757,0,160757,5570,11141,149616,7626,432515,159650,272865,46421.75,557061,786.04,887.84,0.0119,1485,31.25,17546.9,0.43,0.692
4498,Wood-Bauer,False,EG,South Tonya,EdTech,2014,https://wood-bauer.com,Provide before event throw find group them movie image.,21,wood-bauer,2023,USD,352474,48243,304231,57947,246284,5004,241280,3524,7049,234231,26875,260489,64943,195546,29372.83,352474,344.75,1047.96,0.0826,305,96.04,47272.33,0.57,0.8631
4499,Reynolds Pugh and Smith,False,KE,Lake Feliciamouth,Mobility,2024,https://reynoldspughandsmith.com,Herself friend theory wide scientist when.,17,reynolds-pugh-and-smith,2023,USD,1442433,606737,835696,77544,758152,28841,729311,14424,28848,700463,88900,833693,478969,354724,,1442433,20.0,53.02,0.0802,619,194.1,3923.76,22.66,0.5794
4500,Gross-Cruz,False,CA,Port Jamesberg,E-commerce,2012,https://gross-cruz.com,Blue camera decade field next image director institution almost part.,19,gross-cruz,2023,USD,1453462,663048,790414,280427,509987,20185,489802,14534,29069,460733,14203,830855,385669,445186,,1453462,20.0,28.12,0.0889,6056,20.0,17112.35,0.83,0.5438
4501,Adams-Stephens,False,AU,Murphyburgh,Fintech,2022,https://adams-stephens.com,Get south major statement get cause record exist.,16,adams-stephens,2023,USD,742728,374158,368570,311262,57308,21832,35476,7427,14854,20622,27162,471433,297087,174346,,742728,20.0,40.97,0.1033,3094,20.0,13117.03,2.07,0.4962
4502,Suarez and Sons,False,TN,Lake Sarahside,Marketplaces,2020,https://suarezandsons.com,Relationship international require other in.,22,suarez-and-sons,2023,USD,326460,105524,220936,169133,51803,0,51803,3264,6529,45274,2822,167442,82702,84740,,326460,1136.82,2908.53,0.0115,1360,20.0,13636.81,0.21,0.6768
4503,Jennings Cunningham and Nguyen,False,FR,Davisfurt,IoT,2010,https://jenningscunninghamandnguyen.com,Food bill total account many.,19,jennings-cunningham-and-nguyen,2023,EUR,98904,45436,53468,65170,-11702,50704,-62406,989,1978,-64384,8232,180923,84290,96633,,98904,20.0,38.74,0.0073,38,215.28,1000.0,8.23,0.5406
4504,Walters Armstrong and Hernandez,False,GB,North Christine,AI/ML,2017,https://waltersarmstrongandhernandez.com,Understand single already really many such foreign understand gun skill form.,21,walters-armstrong-and-hernandez,2023,USD,1113627,343469,770158,724498,45660,15513,30147,11136,22272,7875,22038,604276,293180,311096,,1113627,216.73,321.56,0.0586,691,134.21,64880.57,0.34,0.6916
4505,Vang and Sons,False,FR,Tylerport,Fintech,2023,https://vangandsons.com,Suggest region as example front member hear stop.,22,vang-and-sons,2023,EUR,1196287,330718,865569,238779,626790,23449,603341,11962,23925,579416,238794,945717,439822,505895,,1196287,156.27,275.65,0.0836,1005,99.1,12952.15,18.44,0.7235
4506,Dennis Riley and Wilson,False,DE,New Lawrenceton,SaaS,2018,https://dennisrileyandwilson.com,Heavy table start hope tend image station road.,12,dennis-riley-and-wilson,2023,EUR,675087,249234,425853,498295,-72442,448,-72890,6750,13501,-86391,63900,596635,122947,473688,56257.25,675087,363.38,1943.45,0.036,1605,35.03,14487.79,4.41,0.6308
4507,Quinn-Brown,False,US,West Melissatown,EdTech,2017,https://quinn-brown.com,Life almost dinner summer class improve under industry person information.,17,quinn-brown,2023,USD,666237,117571,548666,118743,429923,15461,414462,6662,13324,401138,49550,384479,246176,138303,55519.75,666237,621.87,3601.16,0.0343,1477,37.57,1000.0,49.55,0.8235
4508,Peters Vincent and Dennis,False,IN,Ayersland,Energy,2019,https://petersvincentanddennis.com,Meet worker performance way account.,23,peters-vincent-and-dennis,2023,USD,1327077,282594,1044483,684221,360262,0,360262,13270,26541,333721,16599,829814,369019,460795,,1327077,800.43,2811.52,0.0232,492,224.7,101503.44,0.16,0.7871
4509,Moore Elliott and Gross,False,FR,Jacksonport,HealthTech,2017,https://mooreelliottandgross.com,Full break such large voice election write society behavior southern.,24,moore-elliott-and-gross,2023,EUR,945522,234252,711270,323741,387529,0,387529,9455,18910,368619,39019,693983,245996,447987,78793.5,945522,10.0,23.85,0.0569,1608,48.98,42744.01,0.91,0.7523
4510,Beck Inc,False,FR,Lake Courtney,AI/ML,2015,https://beckinc.com,Stage who American think dinner despite usually somebody.,15,beck-inc,2023,EUR,211538,54657,156881,61900,94981,18099,76882,2115,4230,72652,26939,292141,36112,256029,,211538,492.18,881.86,0.001,264,66.68,1000.0,26.94,0.7416
4511,Davila Sanchez and Freeman,False,NG,Brookschester,IoT,2024,https://davilasanchezandfreeman.com,I next front nor teacher read.,14,davila-sanchez-and-freeman,2023,USD,903608,288587,615021,269939,345082,0,345082,9036,18072,327010,56981,686032,394735,291297,,903608,111.17,55.58,0.0589,437,172.17,16891.68,3.37,0.6806
4512,Hunter Ltd,False,IN,South Sarah,Energy,2009,https://hunterltd.com,Edge purpose will space carry industry so.,22,hunter-ltd,2023,USD,2703590,510224,2193366,596697,1596669,0,1596669,27035,54071,1542598,73070,1539202,603445,935757,,2703590,688.4,2559.64,0.001,5507,40.91,65176.68,1.12,0.8113
4513,Ross Hurley and Reynolds,False,NG,Jasonbury,Cybersecurity,2011,https://rosshurleyandreynolds.com,Generation article right now have.,20,ross-hurley-and-reynolds,2023,USD,176978,52878,124100,23033,101067,0,101067,1769,3539,97528,19856,296525,61186,235339,,176978,1363.36,7285.65,0.0422,737,20.0,4531.37,4.38,0.7012
4514,Dixon-Cruz,False,KE,South Donald,Mobility,2016,https://dixon-cruz.com,Several would east person already ok plant through.,23,dixon-cruz,2023,USD,1812891,548451,1264440,1092425,172015,5935,166080,18128,36257,129823,279772,1326010,535040,790970,,1812891,20.0,10.0,0.001,7553,20.0,104759.11,2.67,0.6975
4515,Ramirez Inc,False,BR,South Thomasstad,SaaS,2009,https://ramirezinc.com,Region investment make both low fact church at.,27,ramirez-inc,2023,USD,287226,112318,174908,21468,153440,0,153440,2872,5744,147696,7729,314718,79432,235286,23935.5,287226,531.46,3565.89,0.001,682,35.09,8994.38,0.86,0.609
4516,Anderson-Miranda,False,CA,Port Ryan,Energy,2016,https://anderson-miranda.com,Those information official manager like tend per hair discussion age.,15,anderson-miranda,2023,USD,185678,75495,110183,64351,45832,0,45832,1856,3713,42119,35602,323729,36729,287000,,185678,1434.74,3898.7,0.0992,77,200.12,35892.09,0.99,0.5934
4517,Mccoy PLC,False,DE,Carrillohaven,E-commerce,2009,https://mccoyplc.com,Create organization beyond different provide line green serve feeling.,15,mccoy-plc,2023,EUR,1472315,542005,930310,181574,748736,0,748736,14723,29446,719290,27482,954806,432077,522729,,1472315,754.25,1293.52,0.001,464,263.96,21233.28,1.29,0.6319
4518,Owens Ltd,False,GB,Johnsonfurt,EdTech,2018,https://owensltd.com,Yet carry including meet hair itself well.,21,owens-ltd,2023,USD,166917,61008,105909,35262,70647,17387,53260,1669,3338,49922,30908,174775,105813,68962,13909.75,166917,194.25,635.31,0.0568,2781,5.0,1000.0,30.91,0.6345
4519,Moore PLC,False,AU,West Josephborough,Marketplaces,2009,https://mooreplc.com,Type find subject arm catch research bill effort economy choice.,20,moore-plc,2023,USD,864484,354094,510390,191075,319315,20272,299043,8644,17289,281754,12894,462989,97216,365773,,864484,20.0,10.0,0.006,205,350.3,19176.93,0.67,0.5904
4520,Carroll-Savage,False,DE,Jonesburgh,Mobility,2010,https://carroll-savage.com,Act few back black purpose his part prove main student worker.,14,carroll-savage,2023,EUR,736046,329266,406780,112202,294578,0,294578,7360,14720,279858,161278,706541,373075,333466,,736046,20.0,79.32,0.1082,591,103.72,13492.78,11.95,0.5527
4521,Gordon Mitchell and Lee,False,AU,Port Gabrielshire,IoT,2009,https://gordonmitchellandlee.com,Town its southern teach recent today.,20,gordon-mitchell-and-lee,2023,USD,474892,206009,268883,240845,28038,25088,2950,4748,9497,-6547,111004,369692,121013,248679,,474892,20.0,100.2,0.0579,211,186.85,1000.0,111.0,0.5662
4522,Rojas PLC,False,CA,Lake Rodney,Fintech,2021,https://rojasplc.com,Among like away happen beautiful technology position though you.,18,rojas-plc,2023,USD,498116,165595,332521,149710,182811,0,182811,4981,9962,172849,21235,392755,132036,260719,,498116,1086.91,1495.19,0.0969,146,283.85,11220.32,1.89,0.6676
4523,Green-Williams,False,KE,West Jonbury,Cybersecurity,2010,https://green-williams.com,Window provide camera require individual.,23,green-williams,2023,USD,514827,125025,389802,398090,-8288,0,-8288,5148,10296,-18584,31815,425339,224713,200626,,514827,927.15,2457.11,0.001,171,249.84,42079.8,0.76,0.7572
4524,Schmitt Walker and Ramos,False,NG,Cynthiastad,Mobility,2012,https://schmittwalkerandramos.com,These develop official decade loss.,26,schmitt-walker-and-ramos,2023,USD,1997651,513188,1484463,1339181,145282,0,145282,19976,39953,105329,207190,1305662,526574,779088,,1997651,1221.35,3382.01,0.07,5643,29.5,122930.19,1.69,0.7431
4525,Ramirez Howell and Flores,False,IN,East Melinda,Cybersecurity,2009,https://ramirezhowellandflores.com,Road little fast Congress policy serve.,24,ramirez-howell-and-flores,2023,USD,2350940,627940,1723000,404653,1318347,0,1318347,23509,47018,1271329,180305,1393325,179909,1213416,,2350940,20.0,34.25,0.1011,713,274.58,32916.25,5.48,0.7329
4526,James PLC,False,FR,Johnstad,SaaS,2023,https://jamesplc.com,Expert treat risk identify hope follow.,18,james-plc,2023,EUR,1235774,380335,855439,275043,580396,0,580396,12357,24715,555681,9417,676450,261716,414734,102981.17,1235774,422.06,2311.44,0.0551,2055,50.1,45345.81,0.21,0.6922
4527,Gordon LLC,False,NG,Michaelhaven,EdTech,2019,https://gordonllc.com,World operation safe suddenly morning serve artist use.,17,gordon-llc,2023,USD,132638,56928,75710,104495,-28785,0,-28785,1326,2652,-31437,22349,109843,76632,33211,11053.17,132638,10.0,44.84,0.0448,347,31.83,2359.26,9.47,0.5708
4528,Stevens-Fitzpatrick,False,TN,Julieshire,Mobility,2017,https://stevens-fitzpatrick.com,Size why free region serve spring buy tell.,24,stevens-fitzpatrick,2023,USD,413581,192082,221499,350413,-128914,0,-128914,4135,8271,-137185,5022,410335,20516,389819,,413581,186.65,261.76,0.0451,329,104.53,1281.71,3.92,0.5356
4529,Walker Inc,False,AU,East Jill,EdTech,2008,https://walkerinc.com,Tonight bit strong interview throughout.,16,walker-inc,2023,USD,140679,50388,90291,50592,39699,23998,15701,1406,2813,12888,16368,138611,58683,79928,11723.25,140679,327.77,1270.21,0.0206,167,69.86,1000.0,16.37,0.6418
4530,Snow Barnes and Kelly,False,US,Port Krystalmouth,SaaS,2014,https://snowbarnesandkelly.com,Style beyond air soldier production military.,25,snow-barnes-and-kelly,2023,USD,1309453,433192,876261,706802,169459,0,169459,13094,26189,143270,11558,807589,40379,767210,109121.08,1309453,161.77,809.82,0.0316,21824,5.0,40298.75,0.29,0.6692
4531,Robinson Inc,False,NG,South Mark,IoT,2020,https://robinsoninc.com,President believe yeah total exist table.,23,robinson-inc,2023,USD,533560,219212,314348,30151,284197,0,284197,5335,10671,273526,51751,462637,172777,289860,,533560,423.94,1650.46,0.0019,370,119.87,2589.34,19.99,0.5892
4532,Payne Guerrero and Ryan,False,BR,North Michaelhaven,Marketplaces,2008,https://payneguerreroandryan.com,Also situation their speak these arm usually.,16,payne-guerrero-and-ryan,2023,USD,293063,105178,187885,168809,19076,22908,-3832,2930,5861,-9693,65330,366951,137525,229426,,293063,179.09,110.16,0.001,102,239.2,19026.02,3.43,0.6411
4533,Jenkins-Stone,False,NG,West Melindabury,Mobility,2009,https://jenkins-stone.com,Choose then drop drive pass decision everybody investment.,19,jenkins-stone,2023,USD,8139747,3494750,4644997,3217504,1427493,0,1427493,81397,162794,1264699,196764,4376860,2626660,1750200,,8139747,643.23,3716.17,0.001,4273,158.73,241338.36,0.82,0.5707
4534,Adams-Frazier,False,TN,Mcintoshshire,Energy,2012,https://adams-frazier.com,Address feel newspaper gun level defense.,22,adams-frazier,2023,USD,2075013,835153,1239860,1109789,130071,0,130071,20750,41500,88571,100427,1296041,710086,585955,,2075013,20.0,81.26,0.0074,8645,20.0,131243.08,0.77,0.5975
4535,Ford-Miller,False,TN,Lake Dawn,Cybersecurity,2021,https://ford-miller.com,Than tonight close paper hair.,15,ford-miller,2023,USD,1436014,374486,1061528,497325,564203,15645,548558,14360,28720,519838,157512,881417,406894,474523,,1436014,20.0,77.93,0.0282,594,201.22,46513.44,3.39,0.7392
4536,Weeks Inc,False,NG,Butlermouth,HealthTech,2011,https://weeksinc.com,Future almost action career also table.,22,weeks-inc,2023,USD,1739314,568341,1170973,1592310,-421337,6420,-427757,17393,34786,-462543,325838,1224175,989433,234742,144942.83,1739314,73.65,156.3,0.0605,1097,132.07,148408.23,2.2,0.6732
4537,Williams-Diaz,False,EG,East Dustin,Fintech,2019,https://williams-diaz.com,Quickly mention or difference as method.,18,williams-diaz,2023,USD,1943598,626173,1317425,1197115,120310,11812,108498,19435,38871,69627,88911,1082209,551930,530279,,1943598,142.17,434.05,0.1035,8098,20.0,97014.91,0.92,0.6778
4538,Wagner-Wagner,False,CA,Harriston,EdTech,2018,https://wagner-wagner.com,Do how look really keep traditional put themselves.,18,wagner-wagner,2023,USD,568786,257986,310800,155900,154900,0,154900,5687,11375,143525,10344,386058,59438,326620,47398.83,568786,44.66,322.56,0.0096,9479,5.0,8199.9,1.26,0.5464
4539,Meyers Ramos and Montoya,False,TN,Shortside,SaaS,2015,https://meyersramosandmontoya.com,Data kitchen business visit understand.,18,meyers-ramos-and-montoya,2023,USD,851314,393715,457599,469203,-11604,0,-11604,8513,17026,-28630,71873,526285,141745,384540,70942.83,851314,302.15,1634.28,0.083,4621,15.35,49269.34,1.46,0.5375
4540,King Powell and Wood,False,DE,North Jacobmouth,Fintech,2008,https://kingpowellandwood.com,Money whatever culture pattern wind partner leave already my.,25,king-powell-and-wood,2023,EUR,660305,124893,535412,543868,-8456,0,-8456,6603,13206,-21662,86183,463681,138918,324763,,660305,389.05,610.0,0.0445,577,95.36,29044.8,2.97,0.8109
4541,Williams-Hernandez,False,DE,New Miguel,Energy,2009,https://williams-hernandez.com,How final even take some key plant.,18,williams-hernandez,2023,EUR,1530757,522965,1007792,403764,604028,22225,581803,15307,30615,551188,360492,1240600,739931,500669,,1530757,2101.24,9361.23,0.1289,515,247.67,3638.87,99.07,0.6584
4542,Hudson-Knight,False,AU,New Amandafurt,SaaS,2015,https://hudson-knight.com,Serious accept oil moment without trial security only cover after.,25,hudson-knight,2023,USD,1120307,226527,893780,493820,399960,0,399960,11203,22406,377554,125475,688889,34444,654445,93358.92,1120307,10.0,66.43,0.001,1230,75.88,36944.73,3.4,0.7978
4543,Price Carter and Rose,False,US,South Mariestad,Fintech,2009,https://pricecarterandrose.com,Spring strong discover whole phone shake.,22,price-carter-and-rose,2023,USD,698841,213604,485237,462989,22248,0,22248,6988,13976,8272,41216,585176,133181,451995,,698841,867.42,3014.17,0.0882,402,144.66,54075.48,0.76,0.6943
4544,Morris-Sexton,False,GB,North Katherineborough,Mobility,2013,https://morris-sexton.com,Name read letter customer safe.,20,morris-sexton,2023,USD,5227215,2870974,2356241,2926057,-569816,1450,-571266,52272,104544,-675810,479618,3246137,1227854,2018283,,5227215,923.38,3755.26,0.1184,2655,164.03,263220.15,1.82,0.4508
4545,Williams-Thompson,False,IN,Brownborough,SaaS,2018,https://williams-thompson.com,Card social study full turn significant picture.,24,williams-thompson,2023,USD,580993,172453,408540,273221,135319,21481,113838,5809,11619,102219,38933,399550,127683,271867,48416.08,580993,193.74,348.18,0.0257,9683,5.0,38830.38,1.0,0.7032
4546,Williams Ltd,False,CA,New Madison,IoT,2015,https://williamsltd.com,Same investment within difference pick against mean people minute drop.,18,williams-ltd,2023,USD,269415,72629,196786,79039,117747,0,117747,2694,5388,112359,34700,331843,166254,165589,,269415,20.0,52.84,0.0602,204,109.77,1000.0,34.7,0.7304
4547,Fitzgerald Ltd,False,IN,South Jessicamouth,HealthTech,2020,https://fitzgeraldltd.com,Item talk reach family.,27,fitzgerald-ltd,2023,USD,4651770,1269463,3382307,1661608,1720699,0,1720699,46517,93035,1627664,63775,2401220,120061,2281159,387647.5,4651770,195.76,1264.73,0.0557,17725,21.87,130997.63,0.49,0.7271
4548,Davila-Brown,False,EG,Lake Elizabethstad,Marketplaces,2011,https://davila-brown.com,Suffer discussion one though every.,17,davila-brown,2023,USD,447854,86355,361499,152486,209013,1023,207990,4478,8957,199033,14939,412452,171247,241205,,447854,20.0,102.64,0.1235,208,178.98,30055.82,0.5,0.8072
4549,Russell Bright and Osborne,False,BR,Kingside,Fintech,2010,https://russellbrightandosborne.com,Science Mrs help home baby together seat nature.,18,russell-bright-and-osborne,2023,USD,328535,151095,177440,261181,-83741,38313,-122054,3285,6570,-128624,3089,243375,87684,155691,,328535,996.45,3476.57,0.0271,1368,20.0,31881.91,0.1,0.5401
4550,Jackson Group,False,IN,Christinefort,AI/ML,2014,https://jacksongroup.com,Foot test west throughout need candidate through assume response.,9,jackson-group,2023,USD,1564981,812836,752145,1385337,-633192,15412,-648604,15649,31299,-679903,125128,947429,335725,611704,,1564981,1047.83,3718.21,0.0999,2022,64.47,126933.35,0.99,0.4806
4551,Johnson-Weber,False,EG,Stephanieville,Cybersecurity,2019,https://johnson-weber.com,Various sound indicate campaign down deal success purpose body material.,24,johnson-weber,2023,USD,2612119,1353132,1258987,831216,427771,0,427771,26121,52242,375529,315001,1696241,879180,817061,,2612119,20.0,53.89,0.0601,3613,60.24,87091.25,3.62,0.482
4552,Williams Young and Taylor,False,DE,Darleneton,Mobility,2017,https://williamsyoungandtaylor.com,Production budget particularly group beat appear father happen visit alone.,19,williams-young-and-taylor,2023,EUR,1702336,890298,812038,750352,61686,12461,49225,17023,34046,15179,401347,1397676,69883,1327793,,1702336,1047.45,1763.25,0.001,759,186.87,50541.15,7.94,0.477
4553,Gonzalez PLC,False,CA,Lake Andrew,AI/ML,2017,https://gonzalezplc.com,Training position their table cultural radio step choice.,17,gonzalez-plc,2023,USD,4489315,1753307,2736008,3927429,-1191421,20866,-1212287,44893,89786,-1302073,332922,2630044,987232,1642812,,4489315,20.0,58.43,0.1149,2654,140.94,319617.44,1.04,0.6094
4554,Salinas Inc,False,BR,North Tyler,EdTech,2024,https://salinasinc.com,Phone at politics skill challenge paper single.,18,salinas-inc,2023,USD,1413054,572651,840403,404801,435602,0,435602,14130,28261,407341,21679,808331,382007,426324,117754.5,1413054,10.0,20.45,0.0351,23550,5.0,45497.53,0.48,0.5947
4555,Garcia-Mccoy,False,IN,Debbiefort,E-commerce,2024,https://garcia-mccoy.com,There professional but reason country site bring instead ahead current much.,16,garcia-mccoy,2023,USD,773816,339092,434724,245613,189111,0,189111,7738,15476,173635,20369,460410,105170,355240,,773816,207.25,686.82,0.001,1832,35.18,1000.0,20.37,0.5618
4556,Burke Shelton and Craig,False,FR,Allenland,SaaS,2019,https://burkesheltonandcraig.com,Factor again color behind decide.,20,burke-shelton-and-craig,2023,EUR,6624120,2749573,3874547,3849697,24850,10006,14844,66241,132482,-117638,137021,3618091,180904,3437187,552010.0,6624120,523.83,2762.87,0.0059,83134,6.64,313281.49,0.44,0.5849
4557,Holder Inc,False,TN,Brianmouth,Cybersecurity,2023,https://holderinc.com,Authority throughout national big step view operation early.,19,holder-inc,2023,USD,535640,235556,300084,216719,83365,0,83365,5356,10712,72653,6457,363283,187549,175734,,535640,344.4,573.55,0.0812,273,163.27,45189.91,0.14,0.5602
4558,Hill LLC,False,IN,Devinberg,Fintech,2014,https://hillllc.com,Protect be local material body home.,23,hill-llc,2023,USD,278450,56263,222187,114520,107667,30414,77253,2784,5569,71684,25949,183706,84323,99383,,278450,677.69,1411.24,0.0068,299,77.44,1000.0,25.95,0.7979
4559,Daniel and Sons,False,GB,Perrychester,AI/ML,2015,https://danielandsons.com,Just again interest attack effort building despite fine.,14,daniel-and-sons,2023,USD,2103099,853122,1249977,336808,913169,0,913169,21030,42061,871108,240535,1347613,635820,711793,,2103099,48.91,38.8,0.0456,3042,57.6,4738.4,50.76,0.5944
4560,Taylor Campbell and Miller,False,IN,South Debraville,Cybersecurity,2014,https://taylorcampbellandmiller.com,Then wonder section hope executive front me.,26,taylor-campbell-and-miller,2023,USD,515541,205824,309717,311111,-1394,44232,-45626,5155,10310,-55936,40043,342159,57999,284160,,515541,973.02,5042.08,0.0423,217,197.65,32994.85,1.21,0.6008
4561,Johnson PLC,False,FR,Katherineberg,E-commerce,2012,https://johnsonplc.com,Effect buy best others sport forward situation.,15,johnson-plc,2023,EUR,1173442,373337,800105,318582,481523,40429,441094,11734,23468,417626,10803,730863,249378,481485,,1173442,20.0,10.0,0.042,4889,20.0,34965.76,0.31,0.6818
4562,Weber and Sons,False,US,Franklinhaven,EdTech,2022,https://weberandsons.com,Sound consumer development send style Republican window.,24,weber-and-sons,2023,USD,127631,74758,52873,87038,-34165,25629,-59794,1276,2552,-62346,11915,143499,45202,98297,10635.92,127631,10.0,42.69,0.0567,1164,9.13,33122.48,0.36,0.4143
4563,Franco-Harper,False,BR,Jamesport,Mobility,2011,https://franco-harper.com,Government similar many business special first.,19,franco-harper,2023,USD,693853,446248,247605,287084,-39479,0,-39479,6938,13877,-53356,30411,512740,246393,266347,,693853,20.0,17.24,0.0678,2891,20.0,31318.28,0.97,0.3569
4564,Nash Gregory and Martinez,False,US,Sandrastad,Mobility,2009,https://nashgregoryandmartinez.com,Enough office economic ability seem line.,29,nash-gregory-and-martinez,2023,USD,1188558,412379,776179,965370,-189191,23335,-212526,11885,23771,-236297,25275,728368,302962,425406,,1188558,20.0,16.1,0.0207,4041,24.51,107722.11,0.23,0.653
4565,Smith Inc,False,IN,Davisside,AgriTech,2020,https://smithinc.com,Whatever final wall stop billion your thought assume candidate but.,27,smith-inc,2023,USD,79122,9453,69669,16903,52766,18141,34625,791,1582,33043,7491,164541,86867,77674,,79122,3042.83,1521.42,0.0231,116,56.56,15353.94,0.49,0.8805
4566,Santiago Fowler and Coleman,False,IN,North Jasmineberg,Fintech,2009,https://santiagofowlerandcoleman.com,Since hope environment industry relate like memory create number create.,25,santiago-fowler-and-coleman,2023,USD,1773386,410677,1362709,1914503,-551794,0,-551794,17733,35467,-587261,39698,946706,395259,551447,,1773386,741.84,1454.57,0.0317,7389,20.0,140794.42,0.28,0.7684
4567,Lindsey-Bowen,False,IN,Lake Mary,IoT,2020,https://lindsey-bowen.com,Dog guy find ahead game feel thousand bar kind floor.,20,lindsey-bowen,2023,USD,1999280,871527,1127753,501283,626470,0,626470,19992,39985,586485,83824,1150703,392695,758008,,1999280,359.37,1319.85,0.0967,8330,20.0,53288.81,1.57,0.5641
4568,Carter-Johnston,False,EG,Kingberg,SaaS,2020,https://carter-johnston.com,Require single onto discussion special vote.,15,carter-johnston,2023,USD,409905,191462,218443,319709,-101266,7122,-108388,4099,8198,-116586,14965,316886,147982,168904,34158.75,409905,389.43,1595.71,0.0435,1411,24.2,9017.98,1.66,0.5329
4569,Nguyen PLC,False,TN,Smithborough,Mobility,2009,https://nguyenplc.com,City dark cultural out issue affect executive career after south girl.,23,nguyen-plc,2023,USD,1076249,371578,704671,1047270,-342599,16485,-359084,10762,21524,-380608,111380,719023,287162,431861,,1076249,1010.77,4744.08,0.1202,910,98.47,48907.28,2.28,0.6547
4570,Hayes and Sons,False,DE,North Carloshaven,EdTech,2020,https://hayesandsons.com,Wish draw day personal expect local garden class news watch tend.,27,hayes-and-sons,2023,EUR,669803,274288,395515,168032,227483,0,227483,6698,13396,214087,46514,413049,174124,238925,55816.92,669803,10.0,31.42,0.0393,1524,36.61,1000.0,46.51,0.5905
4571,Mooney Lawson and Thornton,False,GB,Hobbsbury,Marketplaces,2021,https://mooneylawsonandthornton.com,Art billion hold knowledge computer minute war similar member popular move.,25,mooney-lawson-and-thornton,2023,USD,870273,212084,658189,696095,-37906,25544,-63450,8702,17405,-80855,52803,625383,166286,459097,,870273,836.97,4017.63,0.0364,288,251.66,71340.84,0.74,0.7563
4572,Bryant LLC,False,NG,North Ashley,SaaS,2017,https://bryantllc.com,Great large defense house why serious theory these itself leave.,15,bryant-llc,2023,USD,3794136,1564668,2229468,2423310,-193842,38537,-232379,37941,75882,-308261,340517,2327337,729359,1597978,316178.0,3794136,208.36,1548.01,0.001,5701,55.46,199706.75,1.71,0.5876
4573,Pierce Wheeler and Brown,False,US,Jenniferport,AI/ML,2019,https://piercewheelerandbrown.com,Threat card product manage per trade.,15,pierce-wheeler-and-brown,2023,USD,201943,48893,153050,25286,127764,12398,115366,2019,4038,111328,33721,153977,62752,91225,,201943,942.42,1108.02,0.151,440,38.18,49164.5,0.69,0.7579
4574,Brooks-Gibson,False,US,North Olivia,IoT,2018,https://brooks-gibson.com,Result reason increase nature modern.,19,brooks-gibson,2023,USD,1655039,186570,1468469,1285213,183256,7354,175902,16550,33100,142802,75698,1093217,606044,487173,,1655039,1238.57,8249.53,0.001,705,195.54,104789.55,0.72,0.8873
4575,Williams Johnston and Hill,False,IN,Robinbury,IoT,2014,https://williamsjohnstonandhill.com,Computer bill light including receive clear size especially present edge.,22,williams-johnston-and-hill,2023,USD,834839,330562,504277,275135,229142,11342,217800,8348,16696,201104,67804,557549,148228,409321,,834839,779.32,1389.54,0.001,575,120.93,27759.78,2.44,0.604
4576,Snow LLC,False,AU,Lake Aaron,SaaS,2018,https://snowllc.com,Blue reflect rise source cover history condition win important sound thought.,22,snow-llc,2023,USD,839943,356751,483192,41997,441195,7142,434053,8399,16798,417255,37336,589565,186225,403340,69995.25,839943,257.47,1027.31,0.001,13999,5.0,1000.0,37.34,0.5753
4577,Martinez-Bernard,False,ZA,Shawntown,IoT,2021,https://martinez-bernard.com,Ok shake investment employee add ask certain opportunity thus ground.,17,martinez-bernard,2023,USD,665819,165824,499995,266213,233782,40506,193276,6658,13316,179960,31900,557504,309163,248341,,665819,20.0,179.26,0.0517,1719,32.26,15149.34,2.11,0.7509
4578,Lowe-Craig,False,TN,Marvinmouth,Cybersecurity,2009,https://lowe-craig.com,Usually imagine professor but class system account thank.,11,lowe-craig,2023,USD,210801,85551,125250,34471,90779,18151,72628,2108,4216,68412,6058,145549,40928,104621,,210801,2490.52,1245.26,0.0199,135,129.73,30504.11,0.2,0.5942
4579,Franco-Parks,False,AU,Sharonton,Fintech,2020,https://franco-parks.com,After sometimes everything phone other most citizen.,25,franco-parks,2023,USD,814131,379707,434424,548750,-114326,12089,-126415,8141,16282,-142697,294316,787134,318295,468839,,814131,1024.6,2956.33,0.0353,740,91.57,52077.75,5.65,0.5336
4580,Cole Smith and Valdez,False,ZA,Catherineborough,Marketplaces,2017,https://colesmithandvaldez.com,Goal president compare cold next economy top.,16,cole-smith-and-valdez,2023,USD,565281,193787,371494,241390,130104,0,130104,5652,11305,118799,37332,415862,88070,327792,,565281,1505.67,4112.72,0.0548,289,162.92,27392.85,1.36,0.6572
4581,Wright and Sons,False,NG,North Julialand,Mobility,2021,https://wrightandsons.com,However main wait ready well.,22,wright-and-sons,2023,USD,435106,156988,278118,207340,70778,0,70778,4351,8702,62076,9370,249445,19846,229599,,435106,197.33,448.01,0.0825,263,137.37,41310.03,0.23,0.6392
4582,Reynolds Patrick and Pacheco,False,KE,New Gina,Cybersecurity,2024,https://reynoldspatrickandpacheco.com,Shoulder course physical wait material real card next.,18,reynolds-patrick-and-pacheco,2023,USD,358194,101957,256237,264453,-8216,0,-8216,3581,7163,-15379,16500,384218,345796,38422,,358194,20.0,81.76,0.0304,127,233.98,42329.21,0.39,0.7154
4583,Lamb PLC,False,IN,Karenstad,HealthTech,2020,https://lambplc.com,There less according than save then note specific natural leave.,23,lamb-plc,2023,USD,1831651,782324,1049327,1772499,-723172,25116,-748288,18316,36633,-784921,254378,1191374,685374,506000,152637.58,1831651,614.96,2444.73,0.001,1472,103.66,154933.46,1.64,0.5729
4584,Hall and Sons,False,EG,Curtismouth,Cybersecurity,2015,https://hallandsons.com,Past white country east event.,20,hall-and-sons,2023,USD,910237,305159,605078,301922,303156,0,303156,9102,18204,284952,15076,603942,167950,435992,,910237,20.0,83.9,0.008,3792,20.0,1000.0,15.08,0.6647
4585,Cox Trevino and Chandler,False,GB,Port Angela,SaaS,2016,https://coxtrevinoandchandler.com,Name during cultural knowledge miss daughter probably force modern for total.,17,cox-trevino-and-chandler,2023,USD,7687543,2613940,5073603,4874188,199415,0,199415,76875,153750,45665,500465,4509855,1673967,2835888,640628.58,7687543,374.42,1205.13,0.0083,33158,19.32,414254.23,1.21,0.66
4586,Salazar PLC,False,AU,Ashleyhaven,Marketplaces,2016,https://salazarplc.com,Executive military activity war free.,24,salazar-plc,2023,USD,1149355,632279,517076,721398,-204322,15818,-220140,11493,22987,-243127,5828,632783,86539,546244,,1149355,350.53,1416.04,0.0525,529,181.05,50392.99,0.12,0.4499
4587,Peterson-Freeman,False,FR,Turnerburgh,EdTech,2017,https://peterson-freeman.com,Current also dream fall although source long family cell.,25,peterson-freeman,2023,EUR,201945,63650,138295,175766,-37471,0,-37471,2019,4038,-41509,10243,204991,10249,194742,16828.75,201945,207.74,1518.52,0.0728,337,49.83,1000.0,10.24,0.6848
4588,Williams Nelson and Barnett,False,CA,New Donaldport,IoT,2020,https://williamsnelsonandbarnett.com,Establish instead crime probably major own third member upon sister six.,18,williams-nelson-and-barnett,2023,USD,623590,168351,455239,543042,-87803,0,-87803,6235,12471,-100274,55482,494374,390741,103633,,623590,53.86,256.43,0.0665,1008,51.53,63825.03,0.87,0.73
4589,Sanchez Inc,False,US,South Russell,IoT,2016,https://sanchezinc.com,Trouble option only better.,17,sanchez-inc,2023,USD,673490,185052,488438,33674,454764,12979,441785,6734,13469,428316,102411,638617,177556,461061,,673490,1888.58,7766.55,0.062,250,223.87,1000.0,102.41,0.7252
4590,Larson-Mcdonald,False,CA,Spencermouth,AgriTech,2016,https://larson-mcdonald.com,Between mean rule maintain attorney direction.,17,larson-mcdonald,2023,USD,90512,36712,53800,4525,49275,9056,40219,905,1810,38409,36207,265103,144267,120836,,90512,411.23,1870.0,0.0422,55,135.04,34138.84,1.06,0.5944
4591,Martin-Grimes,False,AU,Michaelhaven,Marketplaces,2008,https://martin-grimes.com,Author nor eat campaign available determine recently.,23,martin-grimes,2023,USD,526982,220309,306673,144041,162632,0,162632,5269,10539,152093,37689,350385,17519,332866,,526982,400.26,1389.72,0.0924,587,74.78,1000.0,37.69,0.5819
4592,Simmons Davidson and Reese,False,FR,Hamiltontown,AgriTech,2018,https://simmonsdavidsonandreese.com,Address some bag send focus worry city education under.,20,simmons-davidson-and-reese,2023,EUR,1152473,322185,830288,182605,647683,46388,601295,11524,23049,578246,38297,793065,264502,528563,,1152473,20.0,96.42,0.0565,1235,77.73,1000.0,38.3,0.7204
4593,Peterson Romero and Guerrero,False,IN,Michaelborough,HealthTech,2022,https://petersonromeroandguerrero.com,Note meet produce personal will glass role finally.,20,peterson-romero-and-guerrero,2023,USD,992409,335900,656509,919449,-262940,23649,-286589,9924,19848,-306437,24585,605939,30296,575643,82700.75,992409,10.0,33.22,0.001,8705,9.5,68919.87,0.36,0.6615
4594,Walker-Crawford,False,EG,Ashleyborough,SaaS,2022,https://walker-crawford.com,Reach at anyone rise on.,28,walker-crawford,2023,USD,219316,74673,144643,129815,14828,27455,-12627,2193,4386,-17013,6070,151241,64993,86248,18276.33,219316,10.0,20.89,0.0139,195,93.27,2556.65,2.37,0.6595
4595,Nelson Group,False,US,Charlesbury,Mobility,2009,https://nelsongroup.com,Program study who collection lawyer feel professional follow eat different.,18,nelson-group,2023,USD,1513338,364046,1149292,1041616,107676,0,107676,15133,30266,77410,40517,855727,215587,640140,,1513338,1026.19,3597.57,0.1454,3985,31.64,116976.51,0.35,0.7594
4596,Anderson-Luna,False,CA,South Monicatown,Mobility,2014,https://anderson-luna.com,Lose fish the laugh loss teach.,22,anderson-luna,2023,USD,1099726,415783,683943,84604,599339,971,598368,10997,21994,576374,67165,714808,465169,249639,,1099726,2285.28,13940.48,0.0851,1164,78.71,18888.34,3.56,0.6219
4597,Cross Group,False,TN,Port Sherri,SaaS,2010,https://crossgroup.com,Born yourself book no cover worker strong fund billion.,17,cross-group,2023,USD,592942,205542,387400,214618,172782,18223,154559,5929,11858,142701,35842,503881,236853,267028,49411.83,592942,146.72,675.76,0.042,9882,5.0,2487.6,14.41,0.6534
4598,Hunter-Johnson,False,IN,Ericmouth,IoT,2018,https://hunter-johnson.com,Could law poor deep.,20,hunter-johnson,2023,USD,1108762,476598,632164,1140396,-508232,13707,-521939,11087,22175,-544114,17816,697294,245823,451471,,1108762,2306.59,9573.9,0.1319,4619,20.0,114289.48,0.16,0.5702
4599,Thompson-Potter,False,FR,Lake Kimberly,Mobility,2013,https://thompson-potter.com,List society before which father art leader notice.,16,thompson-potter,2023,EUR,93583,44457,49126,42552,6574,49144,-42570,935,1871,-44441,6510,203095,72021,131074,,93583,20.0,10.0,0.0888,36,216.51,1000.0,6.51,0.5249
4600,Dunn Walker and Keith,False,IN,East Todd,AgriTech,2016,https://dunnwalkerandkeith.com,Base actually letter itself game American hard still act pressure term.,37,dunn-walker-and-keith,2023,USD,128457,47688,80769,66274,14495,27672,-13177,1284,2569,-15746,11479,186297,27796,158501,,128457,20.0,23.17,0.1466,141,75.47,1000.0,11.48,0.6288
4601,Henderson Ltd,False,EG,Gibbsburgh,HealthTech,2015,https://hendersonltd.com,Choose field street politics civil those.,22,henderson-ltd,2023,USD,713697,244274,469423,392626,76797,0,76797,7136,14273,62524,14191,474652,107592,367060,59474.75,713697,99.97,566.74,0.0527,1470,40.45,32591.94,0.44,0.6577
4602,Lester-Smith,False,BR,New Sharon,HealthTech,2012,https://lester-smith.com,May first yeah cut lot fast after.,20,lester-smith,2023,USD,1133219,307681,825538,568083,257455,0,257455,11332,22664,234791,107072,677792,388997,288795,94434.92,1133219,243.15,840.68,0.001,1087,86.81,34367.77,3.12,0.7285
4603,Young Bowen and Mathis,False,KE,Patriciaside,Marketplaces,2009,https://youngbowenandmathis.com,Follow assume notice civil paper everybody heart detail after.,19,young-bowen-and-mathis,2023,USD,1051291,309416,741875,98067,643808,19957,623851,10512,21025,602826,15389,644002,191622,452380,,1051291,20.0,56.69,0.1033,657,133.21,1000.0,15.39,0.7057
4604,Wilson Khan and Taylor,False,DE,Grahammouth,Fintech,2009,https://wilsonkhanandtaylor.com,Degree grow box reduce who like minute interest actually scientist.,25,wilson-khan-and-taylor,2023,EUR,3686549,1609123,2077426,4094350,-2016924,82,-2017006,36865,73730,-2090736,126935,1972303,785814,1186489,,3686549,20.0,67.23,0.1364,15360,20.0,319712.36,0.4,0.5635
4605,Bryant PLC,False,GB,Jensenview,Marketplaces,2024,https://bryantplc.com,Defense now mind manage cell me across language article letter.,24,bryant-plc,2023,USD,80280,26177,54103,11537,42566,48031,-5465,802,1605,-7070,22082,202208,33346,168862,,80280,20.0,39.54,0.001,52,126.79,1000.0,22.08,0.6739
4606,Ramirez-Mathis,False,EG,East Deannachester,IoT,2018,https://ramirez-mathis.com,Source suddenly middle group course into risk prove participant individual according.,17,ramirez-mathis,2023,USD,678341,273479,404862,237460,167402,11868,155534,6783,13566,141968,141456,566750,158006,408744,,678341,20.0,25.81,0.0886,2826,20.0,14570.81,9.71,0.5968
4607,Johnson and Sons,False,US,Port Alyssaville,AI/ML,2015,https://johnsonandsons.com,Leave arm film image which forward them eye also music.,19,johnson-and-sons,2023,USD,2657430,820327,1837103,235232,1601871,11251,1590620,26574,53148,1537472,156984,1676781,361026,1315755,,2657430,20.0,112.31,0.1762,965,229.48,5036.94,31.17,0.6913
4608,Rogers Smith and Lang,False,US,North Sabrina,Cybersecurity,2016,https://rogerssmithandlang.com,Day film begin small mind fear car show admit represent.,22,rogers-smith-and-lang,2023,USD,2145952,456886,1689066,615060,1074006,17919,1056087,21459,42919,1013168,117516,1367047,465343,901704,,2145952,1125.43,4790.21,0.0318,1027,174.03,34288.36,3.43,0.7871
4609,Moore-Burnett,False,IN,Hallside,SaaS,2019,https://moore-burnett.com,Determine collection hand hospital smile fast current.,31,moore-burnett,2023,USD,1111164,495864,615300,751493,-136193,36606,-172799,11111,22223,-195022,57537,763724,97713,666011,92597.0,1111164,10.0,15.27,0.0575,1290,71.77,36456.93,1.58,0.5537
4610,Keith Tucker and Horn,False,NG,Lake Michael,Cybersecurity,2009,https://keithtuckerandhorn.com,Medical garden example film decide commercial popular.,22,keith-tucker-and-horn,2023,USD,2862617,259688,2602929,1969950,632979,10447,622532,28626,57252,565280,77423,1701834,983961,717873,,2862617,20.0,68.69,0.074,3861,61.77,199109.24,0.39,0.9093
4611,Kelly Nguyen and West,False,KE,Johnhaven,EdTech,2019,https://kellynguyenandwest.com,Gun itself general upon author society spring.,18,kelly-nguyen-and-west,2023,USD,1167753,535252,632501,100432,532069,28426,503643,11677,23355,480288,337202,938241,234908,703333,97312.75,1167753,46.05,291.59,0.0476,1133,85.84,21448.79,15.72,0.5416
4612,Bowman-Hill,False,FR,Johnshire,Fintech,2024,https://bowman-hill.com,Notice real able throw wife very but certain question.,26,bowman-hill,2023,EUR,1067510,291853,775657,426376,349281,5321,343960,10675,21350,322610,52850,785264,89339,695925,,1067510,819.94,409.97,0.034,4447,20.0,74284.69,0.71,0.7266
4613,Stafford-Smith,False,EG,East Cynthia,Fintech,2024,https://stafford-smith.com,Moment wind part listen arrive Congress.,29,stafford-smith,2023,USD,1135889,531421,604468,523001,81467,602,80865,11358,22717,58148,66130,762740,469199,293541,,1135889,20.0,49.87,0.0924,805,117.45,67395.9,0.98,0.5322
4614,Mclaughlin Johnson and Reid,False,FR,North Rodney,EdTech,2014,https://mclaughlinjohnsonandreid.com,Air student expert these special.,20,mclaughlin-johnson-and-reid,2023,EUR,761386,262639,498747,468096,30651,0,30651,7613,15227,15424,109009,534389,182892,351497,63448.83,761386,10.0,28.17,0.0171,3446,18.41,19898.07,5.48,0.6551
4615,Juarez-Browning,False,CA,Wellsmouth,IoT,2019,https://juarez-browning.com,Could cause near court policy like under room.,29,juarez-browning,2023,USD,931274,277308,653966,612623,41343,0,41343,9312,18625,22718,225565,735872,288009,447863,,931274,910.82,455.41,0.0333,536,144.74,29385.6,7.68,0.7022
4616,Wilson PLC,False,BR,Jenniferfort,Energy,2010,https://wilsonplc.com,Teach method professor affect rich region.,19,wilson-plc,2023,USD,2570669,1311236,1259433,2005538,-746105,0,-746105,25706,51413,-797518,391380,1857414,1174842,682572,,2570669,1125.01,2033.6,0.001,10711,20.0,183405.29,2.13,0.4899
4617,Foster Inc,False,BR,Churchport,Energy,2017,https://fosterinc.com,Scene never apply well movement owner.,19,foster-inc,2023,USD,2912425,145621,2766804,683613,2083191,16516,2066675,29124,58248,2008427,463610,1959567,722407,1237160,,2912425,277.49,298.82,0.1518,1938,125.19,37893.18,12.23,0.95
4618,Perkins Inc,False,GB,New Natashaville,SaaS,2018,https://perkinsinc.com,Federal forget capital last floor current team threat edge.,13,perkins-inc,2023,USD,358122,133901,224221,226569,-2348,0,-2348,3581,7162,-9510,66619,379390,61016,318374,29843.5,358122,46.8,435.82,0.001,2049,14.56,45042.89,1.48,0.6261
4619,Rangel and Sons,False,KE,East Meghan,E-commerce,2018,https://rangelandsons.com,No expert bad hot page make.,21,rangel-and-sons,2023,USD,983175,261556,721619,618871,102748,0,102748,9831,19663,83085,9775,537740,154694,383046,,983175,20.0,71.73,0.0435,4096,20.0,44771.82,0.22,0.734
4620,Williams Shah and Wheeler,False,TN,Lake Jeffreychester,Marketplaces,2019,https://williamsshahandwheeler.com,Old source it force away month others.,17,williams-shah-and-wheeler,2023,USD,174764,66554,108210,132201,-23991,0,-23991,1747,3495,-27486,706,123444,27566,95878,,174764,20.0,82.02,0.0447,623,23.36,28233.83,0.03,0.6192
4621,Lawrence and Sons,False,EG,New Anthonyton,AgriTech,2008,https://lawrenceandsons.com,My whether even heart machine.,20,lawrence-and-sons,2023,USD,533441,166652,366789,351937,14852,9549,5303,5334,10668,-5365,15096,366301,128883,237418,,533441,440.89,763.22,0.05,192,230.96,9152.94,1.65,0.6876
4622,Mitchell-Tucker,False,GB,East Paulaland,E-commerce,2009,https://mitchell-tucker.com,Best staff low over training someone show partner during.,27,mitchell-tucker,2023,USD,1825913,597822,1228091,317001,911090,31819,879271,18259,36518,842753,90030,1057185,246282,810903,,1825913,1089.4,1334.76,0.0594,622,244.29,1000.0,90.03,0.6726
4623,Wood Young and Webb,False,IN,Thomastown,HealthTech,2008,https://woodyoungandwebb.com,Service husband unit something anyone suffer coach trip.,15,wood-young-and-webb,2023,USD,901219,485555,415664,1127639,-711975,20451,-732426,9012,18024,-750450,65439,638959,167269,471690,75101.58,901219,10.0,32.57,0.041,3452,21.75,103539.54,0.63,0.4612
4624,Sanchez Gilmore and Love,False,FR,Glenville,IoT,2014,https://sanchezgilmoreandlove.com,Itself hard own up degree enough quickly man control effect.,19,sanchez-gilmore-and-love,2023,EUR,488321,127166,361155,233722,127433,0,127433,4883,9766,117667,224906,512571,175066,337505,,488321,1731.75,3653.46,0.1208,430,94.44,1000.0,224.91,0.7396
4625,Carter Brown and Wall,False,AU,Port Jonathan,E-commerce,2024,https://carterbrownandwall.com,Sense once choose develop trip effort night according.,16,carter-brown-and-wall,2023,USD,214456,133928,80528,150949,-70421,560,-70981,2144,4289,-75270,18209,168069,38318,129751,,214456,536.63,277.69,0.001,893,20.0,1000.0,18.21,0.3755
4626,Meadows LLC,False,ZA,Matthewhaven,Cybersecurity,2024,https://meadowsllc.com,Hope audience different law six college hope material politics its science.,17,meadows-llc,2023,USD,2023900,775420,1248480,1716335,-467855,16904,-484759,20239,40478,-525237,313796,1411766,184882,1226884,,2023900,20.0,53.3,0.001,1339,125.91,136790.64,2.29,0.6169
4627,Clarke and Sons,False,AU,Matthewmouth,IoT,2019,https://clarkeandsons.com,Age bit mention impact goal suffer.,13,clarke-and-sons,2023,USD,851442,190072,661370,687393,-26023,10709,-36732,8514,17028,-53760,22122,530592,26529,504063,,851442,20.0,66.24,0.0945,831,85.35,70679.93,0.31,0.7768
4628,Simmons Group,False,DE,East James,Energy,2009,https://simmonsgroup.com,Though race so animal actually land group.,17,simmons-group,2023,EUR,1091235,421915,669320,454479,214841,21010,193831,10912,21824,172007,336828,905520,263629,641891,,1091235,1414.05,707.02,0.0758,2257,40.28,20087.85,16.77,0.6134
4629,Berry-Rosario,False,BR,Baileyland,Cybersecurity,2012,https://berry-rosario.com,Federal she really less tax strong.,19,berry-rosario,2023,USD,4739310,1693078,3046232,3173468,-127236,0,-127236,47393,94786,-222022,245424,2720543,939124,1781419,,4739310,1840.68,4548.35,0.0733,19747,20.0,290666.75,0.84,0.6428
4630,Francis-Hall,False,TN,Russellbury,Marketplaces,2010,https://francis-hall.com,Near why build who accept end government performance market.,25,francis-hall,2023,USD,2158022,893874,1264148,897989,366159,0,366159,21580,43160,322999,89117,1293519,388213,905306,,2158022,20.0,41.32,0.0804,882,203.7,72688.55,1.23,0.5858
4631,Olson-Griffith,False,FR,Brianstad,EdTech,2024,https://olson-griffith.com,How wall politics coach stop.,22,olson-griffith,2023,EUR,549533,182097,367436,158746,208690,2942,205748,5495,10990,194758,62791,343786,96203,247583,45794.42,549533,10.0,10.0,0.063,9158,5.0,17541.02,3.58,0.6686
4632,Mcmahon Pace and Frederick,False,KE,West Donnachester,Marketplaces,2021,https://mcmahonpaceandfrederick.com,Wife soon concern team lawyer new picture if.,31,mcmahon-pace-and-frederick,2023,USD,433305,87200,346105,210797,135308,32775,102533,4333,8666,93867,103612,490963,24548,466415,,433305,159.95,389.2,0.0211,286,126.05,15940.96,6.5,0.7988
4633,Maldonado-Smith,False,NG,Ryanfort,Cybersecurity,2011,https://maldonado-smith.com,Despite current door fund role character we night which well.,22,maldonado-smith,2023,USD,942115,245720,696395,551815,144580,0,144580,9421,18842,125738,3821,661607,522172,139435,,942115,838.4,1876.24,0.0726,3925,20.0,36740.49,0.1,0.7392
4634,Escobar Harris and Lowe,False,NG,West Robinbury,SaaS,2023,https://escobarharrisandlowe.com,Sea alone ready paper model suggest bank stand.,23,escobar-harris-and-lowe,2023,USD,3476859,680131,2796728,2486222,310506,0,310506,34768,69537,240969,93454,2024311,140566,1883745,289738.25,3476859,538.18,2768.59,0.0913,5840,49.61,229115.52,0.41,0.8044
4635,Smith Inc,False,BR,Port Bonniefurt,AI/ML,2024,https://smithinc.com,We discover individual floor quality lawyer shoulder week until.,22,smith-inc,2023,USD,1601572,335321,1266251,967935,298316,15448,282868,16015,32031,250837,66925,927512,187767,739745,,1601572,20.0,64.55,0.1063,3837,34.78,53119.63,1.26,0.7906
4636,Perry-Wilson,False,EG,Amandaport,E-commerce,2016,https://perry-wilson.com,What set should medical field about book stock ground center.,25,perry-wilson,2023,USD,804212,83919,720293,590086,130207,0,130207,8042,16084,114123,34265,564931,339068,225863,,804212,20.0,21.74,0.0204,304,220.44,75486.54,0.45,0.8957
4637,Baker Ltd,False,DE,Hendersonchester,IoT,2017,https://bakerltd.com,Mission reduce big mother set high government during current.,28,baker-ltd,2023,EUR,407604,120789,286815,238946,47869,0,47869,4076,8152,39717,10180,334122,16706,317416,,407604,1353.59,3873.65,0.1137,802,42.34,11636.51,0.87,0.7037
4638,Harris Inc,False,DE,Carsonport,E-commerce,2015,https://harrisinc.com,Hundred world beat like leader population east official enough.,19,harris-inc,2023,EUR,226130,35038,191092,107330,83762,43172,40590,2261,4522,36068,2985,167020,38901,128119,,226130,314.45,1505.81,0.0498,220,85.61,20816.84,0.14,0.8451
4639,Mckee-Davis,False,AU,Gibbsstad,E-commerce,2015,https://mckee-davis.com,Staff notice need compare send arm participant range former.,18,mckee-davis,2023,USD,261383,79071,182312,121255,61057,38354,22703,2613,5227,17476,5700,318845,165755,153090,,261383,20.0,64.65,0.001,1089,20.0,7459.4,0.76,0.6975
4640,Jones-Smith,False,EG,Benitezstad,E-commerce,2011,https://jones-smith.com,Fine section material responsibility action listen raise least.,16,jones-smith,2023,USD,134199,69652,64547,66620,-2073,947,-3020,1341,2683,-5703,2506,119498,53462,66036,,134199,20.0,31.98,0.1083,217,51.39,4923.78,0.51,0.481
4641,Gamble Ltd,False,ZA,New Stephenborough,EdTech,2022,https://gambleltd.com,Between yes build cultural industry along across.,16,gamble-ltd,2023,USD,1217837,395951,821886,879125,-57239,18648,-75887,12178,24356,-100243,134875,846711,577363,269348,101486.42,1217837,76.28,252.83,0.0114,2050,49.5,88917.12,1.52,0.6749
4642,Brown LLC,False,ZA,West Karen,Energy,2019,https://brownllc.com,Ten large news and risk impact.,14,brown-llc,2023,USD,729842,36492,693350,248057,445293,1903,443390,7298,14596,428794,29005,444040,114668,329372,,729842,20.0,101.74,0.1103,276,220.21,5243.28,5.53,0.95
4643,Hicks Group,False,FR,Port Angela,E-commerce,2024,https://hicksgroup.com,Beat where cell name specific special end.,22,hicks-group,2023,EUR,1406297,588362,817935,582802,235133,33550,201583,14062,28125,173458,172524,949384,248792,700592,,1406297,1117.49,5418.95,0.0761,859,136.32,47324.47,3.65,0.5816
4644,Campbell-Oliver,False,FR,Tylerburgh,E-commerce,2023,https://campbell-oliver.com,Collection rule side cup follow indeed much.,13,campbell-oliver,2023,EUR,382354,174823,207531,237282,-29751,23258,-53009,3823,7647,-60656,5269,349045,170709,178336,,382354,20.0,43.7,0.0773,104,306.12,28526.68,0.18,0.5428
4645,Gonzalez-Obrien,False,KE,West Nicholas,EdTech,2022,https://gonzalez-obrien.com,Both get letter share I between practice.,18,gonzalez-obrien,2023,USD,288982,93039,195943,168943,27000,4699,22301,2889,5779,16522,1886,173517,67840,105677,24081.83,288982,252.38,1018.92,0.0887,314,76.48,19544.95,0.1,0.678
4646,Ford Group,False,AU,Robertfort,Energy,2015,https://fordgroup.com,His really reduce let others student gun move space room.,28,ford-group,2023,USD,1334442,482740,851702,953544,-101842,2341,-104183,13344,26688,-130871,362279,1074241,208524,865717,,1334442,660.28,2272.89,0.0213,5560,20.0,61588.9,5.88,0.6382
4647,Morris Watts and Hopkins,False,KE,Kimberg,HealthTech,2015,https://morriswattsandhopkins.com,Visit take design read piece moment.,30,morris-watts-and-hopkins,2023,USD,272278,31715,240563,13613,226950,0,226950,2722,5445,221505,4077,147862,49267,98595,22689.83,272278,195.36,479.9,0.0191,1078,21.04,5872.38,0.69,0.8835
4648,Mooney Gray and Adams,False,AU,North Brettville,Energy,2012,https://mooneygrayandadams.com,Measure son catch seat heart.,26,mooney-gray-and-adams,2023,USD,708053,265394,442659,425684,16975,13748,3227,7080,14161,-10934,12739,440942,22047,418895,,708053,20.0,47.99,0.0574,413,142.64,1000.0,12.74,0.6252
4649,Martinez-Smith,False,KE,Port Nicole,AgriTech,2017,https://martinez-smith.com,Move focus stuff follow live need again mouth.,21,martinez-smith,2023,USD,367270,70470,296800,138831,157969,9658,148311,3672,7345,140966,9273,293086,152990,140096,,367270,20.0,77.9,0.001,1530,20.0,15873.22,0.58,0.8081
4650,Anderson-Gates,False,CA,Sanchezside,E-commerce,2011,https://anderson-gates.com,Kind will administration report lay huge.,24,anderson-gates,2023,USD,889164,212652,676512,567561,108951,2514,106437,8891,17783,88654,46676,543866,194845,349021,,889164,461.46,1339.66,0.0428,3704,20.0,30620.25,1.52,0.7608
4651,Cuevas-Conrad,False,FR,Port Elizabethburgh,Energy,2021,https://cuevas-conrad.com,Will behind weight much watch participant for join.,15,cuevas-conrad,2023,EUR,2830129,1122375,1707754,2265779,-558025,0,-558025,28301,56602,-614627,538903,2091350,820775,1270575,,2830129,301.12,612.06,0.0702,11792,20.0,195688.91,2.75,0.6034
4652,Cobb Ltd,False,NG,Lake Henry,HealthTech,2023,https://cobbltd.com,Save issue really drive receive rather.,19,cobb-ltd,2023,USD,792183,194836,597347,547770,49577,12553,37024,7921,15843,21181,16752,437155,214435,222720,66015.25,792183,10.0,10.0,0.0299,1688,39.09,41837.2,0.4,0.7541
4653,Crane Williams and Potter,False,BR,Lewisland,EdTech,2013,https://cranewilliamsandpotter.com,Show against rule the college.,26,crane-williams-and-potter,2023,USD,296912,133278,163634,38329,125305,24676,100629,2969,5938,94691,54162,279171,100953,178218,24742.67,296912,274.4,1162.61,0.016,698,35.42,6345.16,8.54,0.5511
4654,Foster Inc,False,EG,Phillipsville,SaaS,2013,https://fosterinc.com,Order development natural campaign late difference evidence state paper friend house.,22,foster-inc,2023,USD,476228,144137,332091,211244,120847,0,120847,4762,9524,111323,13506,293603,127377,166226,39685.67,476228,376.88,1732.79,0.0198,7937,5.0,35587.02,0.38,0.6973
4655,Roberts-Richards,False,FR,Port Donald,Energy,2016,https://roberts-richards.com,Cause charge road wrong score within will standard opportunity.,23,roberts-richards,2023,EUR,2755357,952855,1802502,1750150,52352,23047,29305,27553,55107,-25802,54440,1554436,490936,1063500,,2755357,1408.87,704.44,0.001,4875,47.1,161065.74,0.34,0.6542
4656,Ramirez-Stanley,False,AU,Harrishaven,AI/ML,2023,https://ramirez-stanley.com,Person company month your act station politics area simple send role.,15,ramirez-stanley,2023,USD,219157,103694,115463,95938,19525,1806,17719,2191,4383,13336,19942,171328,86834,84494,,219157,20.0,101.72,0.0527,138,131.68,1000.0,19.94,0.5269
4657,Smith-Trujillo,False,ZA,North Justin,Fintech,2012,https://smith-trujillo.com,Protect real eat both doctor design natural nature either.,18,smith-trujillo,2023,USD,5037204,251860,4785344,3091889,1693455,16664,1676791,50372,100744,1576047,572916,3207178,1083067,2124111,,5037204,928.3,3301.11,0.1181,6548,64.1,256682.46,2.23,0.95
4658,Ramirez Valdez and Aguilar,False,US,Bellland,Energy,2008,https://ramirezvaldezandaguilar.com,Citizen significant race night keep girl which significant.,19,ramirez-valdez-and-aguilar,2023,USD,1765176,644902,1120274,741116,379158,39590,339568,17651,35303,304265,23319,1054017,492699,561318,,1765176,541.27,2088.84,0.057,1627,90.41,73610.65,0.32,0.6347
4659,Bryant-Jones,False,ZA,East Michelle,HealthTech,2010,https://bryant-jones.com,Late unit sea administration administration draw dream.,28,bryant-jones,2023,USD,833663,242240,591423,429643,161780,279,161501,8336,16673,144828,178111,682481,180531,501950,69471.92,833663,91.68,427.67,0.0415,1625,42.73,48801.21,3.65,0.7094
4660,Collins-Rocha,False,GB,Lake Christopherbury,AI/ML,2024,https://collins-rocha.com,Official friend difference win country card professional.,24,collins-rocha,2023,USD,730947,412612,318335,383332,-64997,24385,-89382,7309,14618,-104000,13688,417692,247521,170171,,730947,662.48,2949.93,0.0994,173,350.41,43169.82,0.32,0.4355
4661,Williams-Austin,False,TN,East Yvonneland,Energy,2019,https://williams-austin.com,Final skill partner player federal over space east system.,12,williams-austin,2023,USD,2988611,613281,2375330,1856056,519274,0,519274,29886,59772,459502,49149,1627801,81390,1546411,,2988611,371.23,1229.32,0.0294,1629,152.88,148728.46,0.33,0.7948
4662,Hubbard Group,False,GB,Hickmanshire,Energy,2015,https://hubbardgroup.com,Attack theory data impact scene high son himself how certain.,23,hubbard-group,2023,USD,750747,90805,659942,345221,314721,6827,307894,7507,15014,292880,241894,681313,244940,436373,,750747,20.0,33.61,0.0051,1165,53.66,45818.62,5.28,0.879
4663,Lozano Skinner and Kennedy,False,ZA,Washingtonborough,AgriTech,2011,https://lozanoskinnerandkennedy.com,Support word much truth key chance simple.,15,lozano-skinner-and-kennedy,2023,USD,207618,59515,148103,72973,75130,19268,55862,2076,4152,51710,5541,131673,36090,95583,,207618,20.0,75.49,0.0739,108,160.01,26939.61,0.21,0.7133
4664,Morse-Bowman,False,CA,Pricefort,E-commerce,2011,https://morse-bowman.com,Worry decade rock positive by.,23,morse-bowman,2023,USD,393274,50395,342879,237724,105155,26130,79025,3932,7865,71160,3170,321084,101694,219390,,393274,1455.39,4297.94,0.1485,1638,20.0,49471.39,0.06,0.8719
4665,Barrera Smith and Sherman,False,ZA,North Ray,SaaS,2010,https://barrerasmithandsherman.com,Measure this talk current marriage watch or he why feeling.,13,barrera-smith-and-sherman,2023,USD,1407983,718859,689124,251805,437319,0,437319,14079,28159,409160,45217,870013,169699,700314,117331.92,1407983,10.0,74.31,0.001,2975,39.43,1000.0,45.22,0.4894
4666,Reid Johnson and Jenkins,False,ZA,South Jeffreystad,E-commerce,2022,https://reidjohnsonandjenkins.com,How first home thing perform walk.,18,reid-johnson-and-jenkins,2023,USD,1690025,529791,1160234,942862,217372,4857,212515,16900,33800,178715,154066,1076748,154129,922619,,1690025,20.0,75.34,0.056,7041,20.0,55338.08,2.78,0.6865
4667,Warner Velazquez and Brooks,False,TN,Port Jamesville,Marketplaces,2022,https://warnervelazquezandbrooks.com,Spend throughout phone voice.,19,warner-velazquez-and-brooks,2023,USD,1727848,873982,853866,819756,34110,8966,25144,17278,34556,-9412,26723,945223,404077,541146,,1727848,1435.51,717.76,0.0796,1011,142.34,73355.97,0.36,0.4942
4668,Petersen LLC,False,ZA,North Sheliaville,Energy,2017,https://petersenllc.com,Responsibility game another sound newspaper light house the century big.,19,petersen-llc,2023,USD,2801964,911281,1890683,1710676,180007,0,180007,28019,56039,123968,120336,1579997,643617,936380,,2801964,886.91,781.8,0.0486,1215,192.03,170075.81,0.71,0.6748
4669,Bell-Anderson,False,AU,West Ashleymouth,Mobility,2012,https://bell-anderson.com,Bad successful room dog many continue some.,27,bell-anderson,2023,USD,1695093,414017,1281076,1232578,48498,32927,15571,16950,33901,-18330,91497,964042,538040,426002,,1695093,573.05,2940.96,0.001,7062,20.0,85441.48,1.07,0.7558
4670,Hernandez-Nguyen,False,ZA,New Miamouth,HealthTech,2024,https://hernandez-nguyen.com,Three man finally yard bed mouth interest statement her treatment body.,18,hernandez-nguyen,2023,USD,1968152,972206,995946,799903,196043,12474,183569,19681,39363,144206,93675,1241184,697778,543406,164012.67,1968152,10.0,67.84,0.0489,2009,81.6,37295.01,2.51,0.506
4671,Johnson-Harris,False,FR,Emilyshire,HealthTech,2008,https://johnson-harris.com,Newspaper whatever field really trial call share reality green.,22,johnson-harris,2023,EUR,1756939,531699,1225240,572930,652310,14733,637577,17569,35138,602439,105200,994071,469237,524834,146411.58,1756939,10.0,61.15,0.0317,1929,75.87,34209.85,3.08,0.6974
4672,Pierce Walter and Shaw,False,KE,Port Jason,IoT,2019,https://piercewalterandshaw.com,Court product resource production charge chance activity.,20,pierce-walter-and-shaw,2023,USD,1350006,314184,1035822,645679,390143,0,390143,13500,27000,363143,84659,895635,452401,443234,,1350006,20.0,117.09,0.1391,443,253.74,46578.73,1.82,0.7673
4673,Rowe PLC,False,BR,West Evanchester,Marketplaces,2022,https://roweplc.com,Reason animal long community firm end manager a one kitchen.,14,rowe-plc,2023,USD,2476504,325495,2151009,515741,1635268,22013,1613255,24765,49530,1563725,244847,1614053,607699,1006354,,2476504,127.33,129.22,0.013,10318,20.0,44258.0,5.53,0.8686
4674,Gordon Murphy and Johnson,False,TN,Jonesland,E-commerce,2022,https://gordonmurphyandjohnson.com,Brother character building understand move reveal movement.,20,gordon-murphy-and-johnson,2023,USD,1320332,384988,935344,742290,193054,344,192710,13203,26406,166304,22071,710701,341966,368735,,1320332,1001.12,5123.35,0.0657,5501,20.0,49662.85,0.44,0.7084
4675,Nunez Sims and Hamilton,False,GB,South Robert,AI/ML,2016,https://nunezsimsandhamilton.com,Particularly live series cause they theory talk turn.,18,nunez-sims-and-hamilton,2023,USD,3717390,1237404,2479986,2825495,-345509,0,-345509,37173,74347,-419856,91350,2110776,719627,1391149,,3717390,20.0,10.0,0.1213,1489,207.95,272926.65,0.33,0.6671
4676,Middleton Mcpherson and Torres,False,AU,Ricardoland,Fintech,2015,https://middletonmcphersonandtorres.com,Nothing serve first order happy seat staff quite statement.,16,middleton-mcpherson-and-torres,2023,USD,1735527,724187,1011340,86776,924564,22434,902130,17355,34710,867420,57136,971762,221310,750452,,1735527,446.01,223.0,0.0334,7231,20.0,1000.0,57.14,0.5827
4677,Chan-Phillips,False,IN,Dawnport,Mobility,2018,https://chan-phillips.com,Guy court young election talk.,25,chan-phillips,2023,USD,673960,138431,535529,85259,450270,23508,426762,6739,13479,413283,148043,486251,51176,435075,,673960,1668.46,4796.1,0.0986,2808,20.0,1000.0,148.04,0.7946
4678,Ortega Hurst and Booth,False,US,North Robin,IoT,2024,https://ortegahurstandbooth.com,Character study money record sort space feeling.,23,ortega-hurst-and-booth,2023,USD,365378,114820,250558,155794,94764,0,94764,3653,7307,87457,4871,287091,41695,245396,,365378,20.0,10.0,0.0337,125,241.69,18841.46,0.26,0.6858
4679,Garcia Ward and Conley,False,NG,North Sandraberg,IoT,2024,https://garciawardandconley.com,Artist vote mention theory audience theory fact season turn.,29,garcia-ward-and-conley,2023,USD,490178,197379,292799,174423,118376,0,118376,4901,9803,108573,20254,464680,23234,441446,,490178,20.0,110.13,0.001,178,228.97,55841.07,0.36,0.5973
4680,Combs Roberts and Bolton,False,TN,West Andreaport,AgriTech,2018,https://combsrobertsandbolton.com,Get rich care theory year sit cell.,20,combs-roberts-and-bolton,2023,USD,950833,340917,609916,258984,350932,31138,319794,9508,19016,300778,113102,733418,168685,564733,,950833,1408.74,7386.43,0.0268,929,85.25,1000.0,113.1,0.6415
4681,Mcguire-English,False,TN,North Meganchester,E-commerce,2013,https://mcguire-english.com,Specific others class especially section somebody firm.,21,mcguire-english,2023,USD,116381,43331,73050,11135,61915,1138,60777,1163,2327,58450,11914,235776,108313,127463,,116381,20.0,109.85,0.08,484,20.0,13734.31,0.87,0.6277
4682,Morris Evans and Arnold,False,GB,Port Tamibury,SaaS,2014,https://morrisevansandarnold.com,Trip goal official cup eight skin.,31,morris-evans-and-arnold,2023,USD,1871781,582025,1289756,735604,554152,3095,551057,18717,37435,513622,62274,1134117,384077,750040,155981.75,1871781,492.31,1259.46,0.0039,1742,89.51,61458.53,1.01,0.6891
4683,Chan and Sons,False,TN,New Tracyfurt,AI/ML,2016,https://chanandsons.com,Education seat she it though party sell seek pick consider.,26,chan-and-sons,2023,USD,137427,44191,93236,63402,29834,0,29834,1374,2748,27086,12275,227974,46522,181452,,137427,374.45,336.76,0.001,44,256.07,1000.0,12.28,0.6784
4684,Lindsey Russell and Johnson,False,KE,West Taylor,IoT,2018,https://lindseyrussellandjohnson.com,Kind success authority behavior second industry institution pretty western billion.,22,lindsey-russell-and-johnson,2023,USD,2261955,986662,1275293,268395,1006898,0,1006898,22619,45239,961659,65312,1324950,264891,1060059,,2261955,20.0,56.84,0.0311,9424,20.0,45827.3,1.43,0.5638
4685,Hamilton Smith and Hernandez,False,FR,Lorishire,E-commerce,2017,https://hamiltonsmithandhernandez.com,Various let week small career great project.,19,hamilton-smith-and-hernandez,2023,EUR,1599851,750046,849805,1641435,-791630,20626,-812256,15998,31997,-844253,149666,1056722,52836,1003886,,1599851,20.0,73.82,0.0312,641,207.69,157460.64,0.95,0.5312
4686,Greene-Silva,False,GB,Edwardsville,Fintech,2017,https://greene-silva.com,Expect option economic dark development sell test pay staff it air.,21,greene-silva,2023,USD,2036058,1271690,764368,1045362,-280994,0,-280994,20360,40721,-321715,78368,1131900,364738,767162,,2036058,1544.69,7237.79,0.0452,2311,73.39,84649.82,0.93,0.3754
4687,Collins LLC,False,IN,Wilsonshire,Mobility,2022,https://collinsllc.com,Rather many step offer until event performance you pay bad.,25,collins-llc,2023,USD,1077517,302832,774685,160314,614371,3287,611084,10775,21550,589534,16254,695178,290784,404394,,1077517,642.76,2479.31,0.001,419,214.11,18937.89,0.86,0.719
4688,Mcdowell Group,False,DE,Meyersland,HealthTech,2017,https://mcdowellgroup.com,Example stop central herself state for throughout white career our.,21,mcdowell-group,2023,EUR,3288426,1704088,1584338,1447054,137284,23769,113515,32884,65768,47747,158825,1901381,1224823,676558,274035.5,3288426,73.71,82.55,0.0494,6906,39.68,100779.33,1.58,0.4818
4689,Taylor Group,False,IN,Matthewsfort,IoT,2011,https://taylorgroup.com,Receive arrive size Congress member everything.,23,taylor-group,2023,USD,52477,10350,42127,32678,9449,26927,-17478,524,1049,-18527,2522,84300,52926,31374,,52477,1062.18,3411.26,0.0204,218,20.0,1000.0,2.52,0.8028
4690,Walker Sandoval and Davis,False,DE,Williamsonmouth,Marketplaces,2016,https://walkersandovalanddavis.com,Of develop remain everyone politics coach remember.,21,walker-sandoval-and-davis,2023,EUR,300458,169455,131003,161695,-30692,8431,-39123,3004,6009,-45132,8052,308140,178032,130108,,300458,929.91,5801.85,0.0363,1251,20.0,43973.56,0.18,0.436
4691,Pope Holmes and Smith,False,GB,Kristifort,Fintech,2014,https://popeholmesandsmith.com,Argue team unit success next.,22,pope-holmes-and-smith,2023,USD,427665,153178,274487,56519,217968,14564,203404,4276,8553,194851,161426,558899,142168,416731,,427665,924.47,462.24,0.001,155,229.24,1000.0,161.43,0.6418
4692,Hayden-Lang,False,NG,Lake Donaldshire,AI/ML,2013,https://hayden-lang.com,Present agent generation impact east turn tax answer official.,17,hayden-lang,2023,USD,529959,232383,297576,188765,108811,2176,106635,5299,10599,96036,17089,435922,267456,168466,,529959,20.0,10.0,0.0653,258,170.83,25250.73,0.68,0.5615
4693,Thomas-Stephens,False,US,South Christopher,IoT,2009,https://thomas-stephens.com,Second newspaper computer series sing each.,18,thomas-stephens,2023,USD,1293048,696314,596734,609158,-12424,6125,-18549,12930,25860,-44409,41179,763222,494144,269078,,1293048,2186.96,5438.58,0.001,1552,69.4,81562.12,0.5,0.4615
4694,Dennis Group,False,NG,Velezstad,AI/ML,2014,https://dennisgroup.com,Another manage same much support morning senior.,14,dennis-group,2023,USD,2256246,1169397,1086849,809473,277376,18891,258485,22562,45124,213361,306401,1581872,881218,700654,,2256246,20.0,10.0,0.0241,1558,120.67,91672.63,3.34,0.4817
4695,Woodward Group,False,US,North Joshua,Mobility,2008,https://woodwardgroup.com,Style begin yourself magazine both lay.,25,woodward-group,2023,USD,4701080,2746471,1954609,1736704,217905,0,217905,47010,94021,123884,513401,2971544,384479,2587065,,4701080,380.26,190.13,0.0574,4089,95.79,132005.29,3.89,0.4158
4696,Phillips-Mcdowell,False,CA,Lake Timothy,EdTech,2017,https://phillips-mcdowell.com,With short country name next civil catch glass sit evening.,21,phillips-mcdowell,2023,USD,286784,119364,167420,45538,121882,8588,113294,2867,5735,107559,74398,307601,262288,45313,23898.67,286784,176.19,481.68,0.001,381,62.62,10288.66,7.23,0.5838
4697,Reyes Wall and Ramsey,False,KE,Port Jennifershire,Energy,2022,https://reyeswallandramsey.com,Democrat into fear answer particularly plan near new.,19,reyes-wall-and-ramsey,2023,USD,1457510,703682,753828,100387,653441,0,653441,14575,29150,624291,136126,906395,282060,624335,,1457510,2145.92,9451.94,0.0844,552,219.7,1000.0,136.13,0.5172
4698,Morgan-Miles,False,NG,South Deannaborough,HealthTech,2022,https://morgan-miles.com,Mr fast heavy myself purpose dog.,13,morgan-miles,2023,USD,507826,329102,178724,215950,-37226,35157,-72383,5078,10156,-82539,41798,391243,245481,145762,42318.83,507826,139.55,139.55,0.0648,8463,5.0,17532.07,2.38,0.3519
4699,Kirby PLC,False,IN,Lake Reginaland,Fintech,2011,https://kirbyplc.com,Nature central stop nation not.,21,kirby-plc,2023,USD,355956,83251,272705,148230,124475,16390,108085,3559,7119,100966,18837,372131,143456,228675,,355956,551.02,2068.79,0.0494,161,184.2,15914.7,1.18,0.7661
4700,Lewis LLC,False,EG,Ellisbury,Energy,2023,https://lewisllc.com,Himself single discuss method sure game.,19,lewis-llc,2023,USD,2497127,692158,1804969,2009309,-204340,0,-204340,24971,49942,-254282,123702,1463824,334778,1129046,,2497127,20.0,68.89,0.0939,1070,194.39,169956.6,0.73,0.7228
4701,Johnson Stephens and Freeman,False,IN,East Wesleyberg,Fintech,2012,https://johnsonstephensandfreeman.com,Real bit relate between imagine research since.,19,johnson-stephens-and-freeman,2023,USD,1248873,333840,915033,713484,201549,0,201549,12488,24977,176572,8995,691774,338283,353491,,1248873,20.0,47.25,0.001,486,213.73,58699.39,0.15,0.7327
4702,Powers-Hayes,False,IN,East Michael,Cybersecurity,2011,https://powers-hayes.com,East middle tonight share town close land yes.,18,powers-hayes,2023,USD,215696,56335,159361,126918,32443,32537,-94,2156,4313,-4407,13256,186096,58535,127561,,215696,938.18,4582.13,0.001,83,215.61,27335.54,0.48,0.7388
4703,Wilkerson Carpenter and Kennedy,False,CA,Tuckerton,Fintech,2015,https://wilkersoncarpenterandkennedy.com,Sport within often media traditional late just player defense much.,21,wilkerson-carpenter-and-kennedy,2023,USD,546144,195978,350166,65563,284603,0,284603,5461,10922,273681,8244,310773,174359,136414,,546144,474.14,237.07,0.0677,449,101.19,15724.11,0.52,0.6412
4704,Brown Beck and Kane,False,ZA,South Elizabeth,Fintech,2018,https://brownbeckandkane.com,Season because very sport heart candidate.,18,brown-beck-and-kane,2023,USD,515885,188532,327353,72505,254848,0,254848,5158,10317,244531,210528,512103,347872,164231,,515885,639.88,3928.89,0.001,2149,20.0,8590.05,24.51,0.6345
4705,Simon-Bradford,False,GB,Lake Gregoryburgh,AI/ML,2018,https://simon-bradford.com,Young play quality country professional employee building policy officer eight.,22,simon-bradford,2023,USD,335058,81210,253848,185830,68018,18580,49438,3350,6701,42737,20372,371027,177136,193891,,335058,20.0,102.13,0.026,76,363.0,45860.17,0.44,0.7576
4706,Rubio Newman and Mccall,False,IN,Erinville,Mobility,2024,https://rubionewmanandmccall.com,Former wait mean subject according power begin piece position big.,26,rubio-newman-and-mccall,2023,USD,1393287,652061,741226,499169,242057,7164,234893,13932,27865,207028,38560,749632,251402,498230,,1393287,479.31,1356.48,0.0819,5805,20.0,45471.26,0.85,0.532
4707,Harmon Gardner and Hudson,False,BR,Jonesport,Fintech,2018,https://harmongardnerandhudson.com,Child well near spend father discuss same organization six activity per.,29,harmon-gardner-and-hudson,2023,USD,338663,121001,217662,16933,200729,0,200729,3386,6773,193956,53163,376499,166931,209568,,338663,1342.11,671.06,0.0908,405,69.63,6058.09,8.78,0.6427
4708,Ortiz Group,False,US,South Nicole,Energy,2011,https://ortizgroup.com,Answer indicate full fill guess create raise street explain according.,21,ortiz-group,2023,USD,696397,278223,418174,196217,221957,7931,214026,6963,13927,200099,19590,566556,28327,538229,,696397,633.63,1441.79,0.0134,237,244.58,1000.0,19.59,0.6005
4709,Perez-Smith,False,ZA,Robertville,AI/ML,2018,https://perez-smith.com,End across over wife hair citizen late line.,21,perez-smith,2023,USD,315912,94838,221074,215928,5146,0,5146,3159,6318,-1172,20140,221470,51763,169707,,315912,467.67,1710.33,0.0322,396,66.45,1000.0,20.14,0.6998
4710,Bradford Kim and Mcfarland,False,DE,East Jennifer,AI/ML,2009,https://bradfordkimandmcfarland.com,Section include blue feeling indicate price couple.,13,bradford-kim-and-mcfarland,2023,EUR,1455777,438848,1016929,432963,583966,0,583966,14557,29115,554851,37829,919739,480987,438752,,1455777,85.06,182.05,0.0579,448,270.25,24350.5,1.55,0.6985
4711,Evans-Johnson,False,BR,Fosterfurt,Marketplaces,2008,https://evans-johnson.com,Summer edge accept actually play rest research less protect.,16,evans-johnson,2023,USD,1512041,830961,681080,425937,255143,0,255143,15120,30240,224903,189875,990570,263789,726781,,1512041,1013.06,4379.51,0.0042,778,161.91,30993.9,6.13,0.4504
4712,Simmons Cruz and George,False,DE,Jamesshire,HealthTech,2020,https://simmonscruzandgeorge.com,Age whether certainly total treat apply yard provide.,18,simmons-cruz-and-george,2023,EUR,625707,263340,362367,107336,255031,33976,221055,6257,12514,208541,48748,512892,197681,315211,52142.25,625707,31.87,167.77,0.0459,10428,5.0,9298.5,5.24,0.5791
4713,Howard-Moore,False,DE,Port Emmafurt,Marketplaces,2014,https://howard-moore.com,Continue fear law mouth could PM.,24,howard-moore,2023,EUR,815883,447526,368357,444698,-76341,0,-76341,8158,16317,-92658,18616,457946,129016,328930,,815883,1761.51,15360.94,0.043,3399,20.0,41305.32,0.45,0.4515
4714,Rose Jones and Fuller,False,IN,Crystalbury,Mobility,2012,https://rosejonesandfuller.com,Billion total response first mission here option season themselves.,20,rose-jones-and-fuller,2023,USD,4036404,2347751,1688653,670738,1017915,0,1017915,40364,80728,937187,46245,2171977,108598,2063379,,4036404,830.61,2595.97,0.1372,12952,25.97,26305.9,1.76,0.4184
4715,Luna LLC,False,EG,South Heathershire,HealthTech,2023,https://lunallc.com,From thank certain spend lay across important know fight.,14,luna-llc,2023,USD,3184850,1216112,1968738,1439905,528833,2337,526496,31848,63697,462799,66243,1799676,1061249,738427,265404.17,3184850,248.11,1772.88,0.001,5640,47.05,144576.69,0.46,0.6182
4716,Jones Lane and Gonzalez,False,IN,South Jameschester,HealthTech,2014,https://joneslaneandgonzalez.com,West even thank truth these yeah until join natural.,15,jones-lane-and-gonzalez,2023,USD,542867,184300,358567,255325,103242,0,103242,5428,10857,92385,2870,424308,64109,360199,45238.92,542867,10.0,40.92,0.001,9047,5.0,66095.85,0.04,0.6605
4717,Davis Young and Peterson,False,BR,Coxburgh,Fintech,2024,https://davisyoungandpeterson.com,Certain manage need price mean total purpose rich talk.,24,davis-young-and-peterson,2023,USD,644253,225186,419067,305029,114038,0,114038,6442,12885,101153,32936,513932,328559,185373,,644253,20.0,60.66,0.0625,248,216.34,34352.67,0.96,0.6505
4718,Lopez-Buchanan,False,ZA,New Benjamin,Cybersecurity,2014,https://lopez-buchanan.com,Spend major situation organization imagine newspaper left low.,18,lopez-buchanan,2023,USD,1131121,386836,744285,1054889,-310604,0,-310604,11311,22622,-333226,236919,851108,132847,718261,,1131121,397.2,704.3,0.001,4713,20.0,99015.12,2.39,0.658
4719,Russell Cannon and Jones,False,US,West Samanthaton,Energy,2010,https://russellcannonandjones.com,This pull official character produce develop time.,23,russell-cannon-and-jones,2023,USD,668299,266857,401442,218186,183256,0,183256,6682,13365,169891,15826,459208,22960,436248,,668299,1084.18,542.09,0.0633,2784,20.0,11447.72,1.38,0.6007
4720,Thomas Inc,False,EG,New Seth,AI/ML,2014,https://thomasinc.com,Above walk authority several magazine section amount north majority each.,23,thomas-inc,2023,USD,1922494,649313,1273181,939861,333320,21679,311641,19224,38449,273192,157266,1137764,275404,862360,,1922494,1303.81,651.9,0.0446,1732,92.45,90995.22,1.73,0.6623
4721,Mclean Hughes and Cooper,False,ZA,Brooksmouth,HealthTech,2009,https://mcleanhughesandcooper.com,Wrong yeah drug perhaps return community feeling western.,16,mclean-hughes-and-cooper,2023,USD,305797,119962,185835,131216,54619,0,54619,3057,6115,48504,9349,226604,137197,89407,25483.08,305797,10.0,30.79,0.0398,216,117.74,15250.88,0.61,0.6077
4722,Phillips PLC,False,TN,New Stephanie,Cybersecurity,2016,https://phillipsplc.com,Stand garden detail nearly person defense heart yeah.,25,phillips-plc,2023,USD,689621,123337,566284,471739,94545,11548,82997,6896,13792,69205,54167,501802,25090,476712,,689621,20.0,129.9,0.0781,461,124.62,32272.65,1.68,0.8212
4723,Stein LLC,False,KE,Birdfort,Energy,2015,https://steinllc.com,Go bar player quality might.,25,stein-llc,2023,USD,1579234,213773,1365461,1309708,55753,21256,34497,15792,31584,2913,46136,868316,408232,460084,,1579234,972.11,1124.01,0.001,6580,20.0,133357.12,0.35,0.8646
4724,White Freeman and Allen,False,BR,West Jennifer,E-commerce,2023,https://whitefreemanandallen.com,Ask heavy figure crime environment hard population job your rise now.,29,white-freeman-and-allen,2023,USD,506965,83049,423916,124672,299244,42658,256586,5069,10139,246447,11841,290258,101822,188436,,506965,20.0,25.58,0.0135,2112,20.0,1000.0,11.84,0.8362
4725,Smith-Miller,False,NG,South Martin,Marketplaces,2013,https://smith-miller.com,Skill ever minute church key or tough later control.,20,smith-miller,2023,USD,1015122,214907,800215,761712,38503,0,38503,10151,20302,18201,185766,734476,322867,411609,,1015122,1452.36,9996.95,0.0438,299,282.65,47582.94,3.9,0.7883
4726,Marshall Inc,False,IN,New Edwardfurt,EdTech,2017,https://marshallinc.com,Great fire strong piece day listen within water author.,23,marshall-inc,2023,USD,141108,95553,45555,116717,-71162,1407,-72569,1411,2822,-75391,21519,250011,52804,197207,11759.0,141108,442.41,906.45,0.024,183,63.95,14081.99,1.53,0.3228
4727,Flores Group,False,BR,New Stephenville,Mobility,2023,https://floresgroup.com,Finish month wife life data quite keep attention force.,13,flores-group,2023,USD,222166,70035,152131,134622,17509,42038,-24529,2221,4443,-28972,27561,205294,77555,127739,,222166,20.0,38.32,0.0831,109,168.54,34709.38,0.79,0.6848
4728,Hernandez-Donaldson,False,AU,Carpenterview,Marketplaces,2020,https://hernandez-donaldson.com,Drive reduce name fire father player specific less.,23,hernandez-donaldson,2023,USD,536865,178439,358426,297756,60670,0,60670,5368,10737,49933,18272,392360,19618,372742,,536865,20.0,48.36,0.1166,219,203.54,15865.31,1.15,0.6676
4729,Nelson-Glenn,False,KE,Kathleenside,E-commerce,2023,https://nelson-glenn.com,Picture old sea produce bed thousand military you partner.,17,nelson-glenn,2023,USD,205111,90849,114262,96160,18102,8184,9918,2051,4102,5816,14033,297553,190171,107382,,205111,865.92,2099.61,0.0948,252,67.56,1000.0,14.03,0.5571
4730,Hanna PLC,False,IN,West Erica,Fintech,2015,https://hannaplc.com,High improve project across individual building under I from various.,16,hanna-plc,2023,USD,889371,317427,571944,187052,384892,17903,366989,8893,17787,349202,28291,562192,161281,400911,,889371,1555.41,2372.09,0.1258,3705,20.0,34037.53,0.83,0.6431
4731,Gomez-Miller,False,FR,East Mariostad,AgriTech,2021,https://gomez-miller.com,Bill sure quality purpose rate seek indeed pressure green support.,15,gomez-miller,2023,EUR,576708,342807,233901,165522,68379,13843,54536,5767,11534,43002,20831,347013,17350,329663,,576708,20.0,41.8,0.0708,203,235.8,25948.87,0.8,0.4056
4732,Castillo-Salinas,False,EG,East Tamaratown,E-commerce,2015,https://castillo-salinas.com,Mr event result degree alone.,16,castillo-salinas,2023,USD,708922,315445,393477,293034,100443,541,99902,7089,14178,85724,95515,641025,171331,469694,,708922,20.0,62.04,0.0195,159,370.15,42528.27,2.25,0.555
4733,Strong Group,False,BR,Lake Chelsea,Energy,2011,https://stronggroup.com,Management case watch during one wear add.,17,strong-group,2023,USD,1883542,137648,1745894,923186,822708,0,822708,18835,37670,785038,136255,1113184,330263,782921,,1883542,20.0,19.38,0.0336,4243,36.99,130393.28,1.04,0.9269
4734,Oliver Vance and Bates,False,GB,Jacksonland,Mobility,2018,https://olivervanceandbates.com,Between himself prove read service those it before myself all.,17,oliver-vance-and-bates,2023,USD,1021514,92615,928899,630007,298892,0,298892,10215,20430,278462,18847,667455,36742,630713,,1021514,2060.13,13377.8,0.1266,520,163.68,90711.17,0.21,0.9093
4735,White-Nguyen,False,BR,Thomaston,Fintech,2019,https://white-nguyen.com,Party form last ball.,18,white-nguyen,2023,USD,528365,406531,121834,269984,-148150,0,-148150,5283,10567,-158717,8779,419530,155822,263708,,528365,20.0,61.33,0.1072,144,305.6,20821.32,0.42,0.2306
4736,Yoder Inc,False,ZA,Lake Jessicamouth,Energy,2012,https://yoderinc.com,Add though see later more activity yet present.,14,yoder-inc,2023,USD,2165295,1090683,1074612,1149239,-74627,0,-74627,21652,43305,-117932,123666,1366978,641897,725081,,2165295,664.09,5132.46,0.0817,737,244.81,122606.44,1.01,0.4963
4737,Lawrence LLC,False,AU,East David,Mobility,2023,https://lawrencellc.com,Professional they dark culture participant rather decision population.,21,lawrence-llc,2023,USD,4258115,1832430,2425685,1293124,1132561,8961,1123600,42581,85162,1038438,154200,2465717,481627,1984090,,4258115,1225.1,10248.29,0.0217,3206,110.65,140538.04,1.1,0.5697
4738,Livingston Ltd,False,KE,Jamestown,Energy,2015,https://livingstonltd.com,Former price tree east admit hundred.,13,livingston-ltd,2023,USD,2365475,1319843,1045632,1170810,-125178,22244,-147422,23654,47309,-194731,30195,1314410,656986,657424,,2365475,1971.88,5092.26,0.0124,1110,177.51,101645.42,0.3,0.442
4739,Allen and Sons,False,US,Englishshire,AgriTech,2016,https://allenandsons.com,Through state purpose low.,18,allen-and-sons,2023,USD,449840,130056,319784,176776,143008,0,143008,4498,8996,134012,14583,433028,56599,376429,,449840,92.4,455.48,0.0559,240,155.7,4664.53,3.13,0.7109
4740,Baker Crawford and Pena,False,NG,North Cassie,EdTech,2021,https://bakercrawfordandpena.com,Big stuff style know policy news southern structure maintain station.,17,baker-crawford-and-pena,2023,USD,455461,136646,318815,323756,-4941,18113,-23054,4554,9109,-32163,6665,305178,70122,235056,37955.08,455461,147.47,486.26,0.0344,583,65.0,23557.64,0.28,0.7
4741,Rose-Morgan,False,US,West Dana,AI/ML,2018,https://rose-morgan.com,Rock go simply mention despite always.,25,rose-morgan,2023,USD,2299105,654192,1644913,1230493,414420,0,414420,22991,45982,368438,86317,1287566,305679,981887,,2299105,20.0,72.12,0.0371,1289,148.54,129712.16,0.67,0.7155
4742,Shelton PLC,False,IN,East Jamesfurt,Marketplaces,2018,https://sheltonplc.com,Daughter defense relationship for instead.,17,shelton-plc,2023,USD,570402,212033,358369,179186,179183,29345,149838,5704,11408,138430,53723,476675,73381,403294,,570402,455.43,944.34,0.001,839,56.6,14597.58,3.68,0.6283
4743,Brown-Sanchez,False,TN,Connorville,Energy,2022,https://brown-sanchez.com,Door writer produce long senior style wonder government.,16,brown-sanchez,2023,USD,2325579,725150,1600429,1336504,263925,40571,223354,23255,46511,176843,36647,1297819,64890,1232929,,2325579,184.43,640.83,0.001,1257,154.16,78844.38,0.46,0.6882
4744,Garrett-Young,False,TN,West Pam,Energy,2016,https://garrett-young.com,Actually environment practice southern six about key.,15,garrett-young,2023,USD,1796584,593764,1202820,1203122,-302,28369,-28671,17965,35931,-64602,35345,942776,371280,571496,,1796584,802.05,3843.91,0.0321,509,293.58,59558.81,0.59,0.6695
4745,Lopez and Sons,False,US,Smallberg,AgriTech,2023,https://lopezandsons.com,Career military ago continue few add onto majority ball.,20,lopez-and-sons,2023,USD,153897,54976,98921,11711,87210,6688,80522,1538,3077,77445,4823,256903,12845,244058,,153897,1182.21,5710.22,0.0825,641,20.0,35065.75,0.14,0.6428
4746,Smith and Sons,False,ZA,New Crystal,EdTech,2018,https://smithandsons.com,Worker offer so include individual take newspaper.,18,smith-and-sons,2023,USD,1981392,879011,1102381,99069,1003312,0,1003312,19813,39627,963685,259432,1349824,87948,1261876,165116.0,1981392,456.17,622.38,0.0198,3089,53.45,42985.1,6.04,0.5564
4747,Welch-Hill,False,BR,Catherinehaven,SaaS,2017,https://welch-hill.com,Serve kid decision threat develop.,33,welch-hill,2023,USD,804856,324184,480672,343328,137344,30291,107053,8048,16097,90956,87332,525717,237194,288523,67071.33,804856,187.33,796.13,0.01,3915,17.13,39983.83,2.18,0.5972
4748,Thomas Castro and Evans,False,EG,North Jason,Energy,2015,https://thomascastroandevans.com,Say design behavior drug stock share this.,31,thomas-castro-and-evans,2023,USD,603441,239801,363640,305871,57769,0,57769,6034,12068,45701,87411,569704,140282,429422,,603441,20.0,37.0,0.031,2514,20.0,51471.13,1.7,0.6026
4749,Williams Dennis and Martin,False,KE,Nicholasborough,HealthTech,2014,https://williamsdennisandmartin.com,Sell other radio ok that.,14,williams-dennis-and-martin,2023,USD,2246234,669100,1577134,822209,754925,12582,742343,22462,44924,697419,1367876,2528675,599107,1929568,187186.17,2246234,10.0,33.68,0.001,2301,81.33,42153.66,32.45,0.7021
4750,May-Johnson,False,AU,Port Shawnberg,Marketplaces,2011,https://may-johnson.com,After reason for hotel deep.,16,may-johnson,2023,USD,2502733,846125,1656608,1979395,-322787,26273,-349060,25027,50054,-399114,45069,1469032,119281,1349751,,2502733,1029.83,3960.26,0.1209,10428,20.0,159343.41,0.28,0.6619
4751,Archer Smith and Mccarthy,False,KE,Port Dana,IoT,2018,https://archersmithandmccarthy.com,Enter money example discuss surface.,19,archer-smith-and-mccarthy,2023,USD,1373859,509635,864224,1000732,-136508,0,-136508,13738,27477,-163985,168321,1036172,463487,572685,,1373859,355.35,177.68,0.0365,4709,24.31,66373.37,2.54,0.629
4752,Bell LLC,False,GB,Andersonfort,IoT,2008,https://bellllc.com,Door alone only where high director significant cost.,9,bell-llc,2023,USD,808253,378527,429726,477802,-48076,20604,-68680,8082,16165,-84845,44464,487792,43246,444546,,808253,1148.25,2267.65,0.1112,530,126.98,36070.42,1.23,0.5317
4753,Ellis and Sons,False,ZA,Mckeefort,SaaS,2020,https://ellisandsons.com,Near become we behind chair account will.,20,ellis-and-sons,2023,USD,1633390,504805,1128585,810713,317872,3330,314542,16333,32667,281875,25792,846895,386916,459979,136115.83,1633390,341.27,2354.42,0.0316,3459,39.35,111429.82,0.23,0.6909
4754,Rowe-Gilbert,False,FR,Bryanport,Cybersecurity,2018,https://rowe-gilbert.com,Attorney father big operation night recognize final.,28,rowe-gilbert,2023,EUR,1580060,997265,582795,1285015,-702220,0,-702220,15800,31601,-733821,19000,858337,333599,524738,,1580060,1728.05,4907.87,0.0869,754,174.5,146948.3,0.13,0.3688
4755,Richardson Page and Harris,False,CA,Garciashire,AI/ML,2010,https://richardsonpageandharris.com,Thought send movie example society recently mouth.,21,richardson-page-and-harris,2023,USD,332744,74323,258421,222559,35862,28877,6985,3327,6654,331,53264,374091,53634,320457,,332744,217.68,1237.71,0.001,284,97.59,63388.25,0.84,0.7766
4756,Richardson Nunez and Shaw,False,BR,Lake Amy,SaaS,2024,https://richardsonnunezandshaw.com,Chance charge anything station politics identify value threat.,20,richardson-nunez-and-shaw,2023,USD,1302468,95390,1207078,327491,879587,0,879587,13024,26049,853538,670289,1374639,493816,880823,108539.0,1302468,10.0,28.45,0.0153,1181,91.88,49870.82,13.44,0.9268
4757,Ward Davis and Strong,False,DE,Ashleyfurt,E-commerce,2014,https://warddavisandstrong.com,Music local all thank career building leg.,21,ward-davis-and-strong,2023,EUR,1911671,511053,1400618,1325274,75344,0,75344,19116,38233,37111,63350,1158111,386999,771112,,1911671,574.38,780.12,0.0344,601,264.9,110747.68,0.57,0.7327
4758,Austin Ltd,False,GB,Lake Elizabethside,AI/ML,2020,https://austinltd.com,Might clearly discussion surface pay across safe attorney offer reason.,13,austin-ltd,2023,USD,1572955,767785,805170,244367,560803,16465,544338,15729,31459,512879,105404,956587,175176,781411,,1572955,20.0,10.0,0.0306,6553,20.0,7458.35,14.13,0.5119
4759,Arnold-Perez,False,ZA,Harrisfurt,EdTech,2017,https://arnold-perez.com,Central rate item contain investment hair.,20,arnold-perez,2023,USD,331520,142129,189391,234422,-45031,29273,-74304,3315,6630,-80934,21488,234837,81083,153754,27626.67,331520,186.43,506.78,0.0188,618,44.7,32972.7,0.65,0.5713
4760,Diaz Group,False,AU,Andersonbury,HealthTech,2019,https://diazgroup.com,Process surface wish car exactly read fast up.,20,diaz-group,2023,USD,725009,301162,423847,95068,328779,35397,293382,7250,14500,278882,28268,428090,21404,406686,60417.42,725009,206.8,1297.8,0.001,887,68.06,25122.36,1.13,0.5846
4761,Lopez Williams and Gomez,False,CA,Sandraview,Energy,2014,https://lopezwilliamsandgomez.com,Better difference difficult argue relationship expert fact safe.,19,lopez-williams-and-gomez,2023,USD,909465,339452,570013,514127,55886,0,55886,9094,18189,37697,108295,732379,36618,695761,,909465,204.31,522.04,0.0516,842,89.99,11062.1,9.79,0.6268
4762,Henderson Ltd,False,NG,Parkerland,Cybersecurity,2015,https://hendersonltd.com,History child medical true area rise.,17,henderson-ltd,2023,USD,3296398,718665,2577733,1802542,775191,8166,767025,32963,65927,701098,20117,1820538,543466,1277072,,3296398,238.59,323.85,0.043,3893,70.55,147710.01,0.14,0.782
4763,Sherman-Rodriguez,False,US,Dunlaphaven,SaaS,2008,https://sherman-rodriguez.com,Through certain create water pull.,18,sherman-rodriguez,2023,USD,613696,265638,348058,137417,210641,2346,208295,6136,12273,196022,59408,417459,214967,202492,51141.33,613696,10.0,35.41,0.0392,586,87.14,6896.75,8.61,0.5672
4764,Sanders Howell and Burton,False,AU,North Kiaraside,AI/ML,2011,https://sandershowellandburton.com,Expect feeling player financial rather.,16,sanders-howell-and-burton,2023,USD,1335244,530007,805237,111649,693588,45800,647788,13352,26704,621084,48138,719437,193780,525657,,1335244,20.0,69.25,0.0517,5563,20.0,47582.21,1.01,0.6031
4765,Baker-Lyons,False,NG,West Wanda,Energy,2023,https://baker-lyons.com,White out yard arrive she bank.,21,baker-lyons,2023,USD,2488992,623352,1865640,1237422,628218,2669,625549,24889,49779,575770,143980,1536322,301447,1234875,,2488992,639.64,1925.33,0.05,4532,45.76,131633.88,1.09,0.7496
4766,White Simon and Wells,False,US,Lake Kiara,HealthTech,2017,https://whitesimonandwells.com,Statement reach next issue military century sometimes process.,20,white-simon-and-wells,2023,USD,2011420,647393,1364027,1599530,-235503,0,-235503,20114,40228,-275731,96947,1171463,311913,859550,167618.33,2011420,431.08,431.08,0.001,2363,70.92,106154.5,0.91,0.6781
4767,Webb-Jordan,False,IN,Jenkinsstad,SaaS,2015,https://webb-jordan.com,Fact threat however last line political morning free rich understand.,20,webb-jordan,2023,USD,2348318,1185478,1162840,1752333,-589493,0,-589493,23483,46966,-636459,72979,1293560,499565,793995,195693.17,2348318,258.71,1874.36,0.0375,22834,8.57,177745.0,0.41,0.4952
4768,Carrillo PLC,False,BR,Dominguezport,Cybersecurity,2015,https://carrilloplc.com,Today morning kitchen up current long Mr lay week check.,20,carrillo-plc,2023,USD,2872722,805172,2067550,1660939,406611,3842,402769,28727,57454,345315,2329526,3851685,779645,3072040,,2872722,505.49,1425.22,0.084,914,261.78,133655.87,17.43,0.7197
4769,Saunders-Ramos,False,US,East Mary,AgriTech,2011,https://saunders-ramos.com,Body indicate from price past human answer reality card recognize.,31,saunders-ramos,2023,USD,155456,83165,72291,115958,-43667,18623,-62290,1554,3109,-65399,2507,186978,99480,87498,,155456,1274.86,3373.67,0.0937,105,123.24,23098.78,0.11,0.465
4770,Summers Meza and Ryan,False,AU,South Kyleshire,Energy,2020,https://summersmezaandryan.com,Report impact scientist everything political TV central gas.,26,summers-meza-and-ryan,2023,USD,399621,96217,303404,107274,196130,27889,168241,3996,7992,160249,16957,337300,141543,195757,,399621,20.0,72.11,0.0622,330,100.62,35257.3,0.48,0.7592
4771,Rodriguez Anderson and Byrd,False,GB,West Donnaland,Cybersecurity,2016,https://rodriguezandersonandbyrd.com,College speech minute garden talk whatever game.,18,rodriguez-anderson-and-byrd,2023,USD,6325328,2359253,3966075,3246046,720029,24319,695710,63253,126506,569204,1937128,5147948,605549,4542399,,6325328,1139.53,1959.21,0.0466,8485,62.12,285134.14,6.79,0.627
4772,Lara King and Torres,False,FR,West Bruce,Fintech,2010,https://larakingandtorres.com,Understand him pull tonight onto within give art economy simply.,19,lara-king-and-torres,2023,EUR,804332,242317,562015,213595,348420,16934,331486,8043,16086,315400,13840,446880,195973,250907,,804332,52.23,139.65,0.0411,3351,20.0,1000.0,13.84,0.6987
4773,Vargas-Walton,False,NG,Lake Veronica,Cybersecurity,2021,https://vargas-walton.com,Executive exist military good technology this.,20,vargas-walton,2023,USD,748788,290309,458479,217879,240600,24286,216314,7487,14975,201339,62486,581667,391570,190097,,748788,2314.67,5768.44,0.008,269,231.55,1000.0,62.49,0.6123
4774,Ramos Group,False,US,South Timothyland,SaaS,2012,https://ramosgroup.com,Over long factor discuss your blood this.,21,ramos-group,2023,USD,7356685,3328746,4027939,1182440,2845499,30964,2814535,73566,147133,2667402,452410,4266179,1156449,3109730,613057.08,7356685,288.26,288.26,0.0141,8244,74.36,81944.22,5.52,0.5475
4775,Williams Norman and Anderson,False,FR,East Jeremy,Cybersecurity,2020,https://williamsnormanandanderson.com,Writer weight lead whom wonder.,15,williams-norman-and-anderson,2023,EUR,2342034,1242147,1099887,392125,707762,0,707762,23420,46840,660922,79144,1377456,704308,673148,,2342034,482.58,2296.59,0.0769,1023,190.6,43862.15,1.8,0.4696
4776,Hines Ltd,False,DE,Lake Danielton,IoT,2017,https://hinesltd.com,Half explain teacher hour perform.,23,hines-ltd,2023,EUR,2026522,381953,1644569,452531,1192038,0,1192038,20265,40530,1151508,34920,1208795,837108,371687,,2026522,666.97,3113.22,0.1074,852,198.08,42168.7,0.83,0.8115
4777,Moore Group,False,AU,South Georgeton,E-commerce,2021,https://mooregroup.com,Public eye administration know alone tonight even yeah goal bring.,16,moore-group,2023,USD,1868953,790424,1078529,1513490,-434961,8482,-443443,18689,37379,-480822,126954,1154287,190845,963442,,1868953,349.16,848.03,0.0197,1978,78.7,140650.92,0.9,0.5771
4778,Ochoa Montgomery and Burns,False,NG,Joycechester,Cybersecurity,2008,https://ochoamontgomeryandburns.com,Generation present I suffer happy drive.,32,ochoa-montgomery-and-burns,2023,USD,2555079,667776,1887303,963038,924265,0,924265,25550,51101,873164,202598,1508499,328077,1180422,,2555079,822.02,2219.77,0.0278,1331,159.87,138297.8,1.46,0.7386
4779,Daniels Ross and Huerta,False,IN,Reidmouth,AgriTech,2022,https://danielsrossandhuerta.com,Expect food offer accept.,24,daniels-ross-and-huerta,2023,USD,4013243,1244906,2768337,227833,2540504,5347,2535157,40132,80264,2454893,127924,2296051,1122089,1173962,,4013243,927.56,4769.18,0.0177,2961,112.92,40051.62,3.19,0.6898
4780,Perry Lynn and Holmes,False,DE,South Virginia,Fintech,2016,https://perrylynnandholmes.com,Process maintain finally color picture attack your white who special available.,21,perry-lynn-and-holmes,2023,EUR,755103,190412,564691,361738,202953,0,202953,7551,15102,187851,67784,488527,24426,464101,,755103,20.0,91.0,0.074,3146,20.0,9308.78,7.28,0.7478
4781,Harris Zimmerman and Hall,False,BR,Jamesville,IoT,2023,https://harriszimmermanandhall.com,During brother reason rather major appear result.,22,harris-zimmerman-and-hall,2023,USD,476339,185584,290755,101773,188982,0,188982,4763,9526,179456,26082,457720,35326,422394,,476339,1315.42,657.71,0.1254,153,258.06,24574.27,1.06,0.6104
4782,Flores-Castillo,False,TN,Port Ashley,AgriTech,2021,https://flores-castillo.com,Stuff evidence official parent become dream rule difficult listen participant.,18,flores-castillo,2023,USD,298876,117541,181335,68642,112693,0,112693,2988,5977,106716,4697,160421,59252,101169,,298876,513.73,1598.09,0.001,234,106.03,1000.0,4.7,0.6067
4783,Jones-Palmer,False,FR,East Christinafurt,EdTech,2021,https://jones-palmer.com,Appear investment executive accept decide ahead senior loss international.,14,jones-palmer,2023,EUR,101568,31734,69834,62449,7385,35790,-28405,1015,2031,-30436,8981,79505,24658,54847,8464.0,101568,10.0,50.54,0.0163,1692,5.0,1000.0,8.98,0.6876
4784,Wong Carter and Smith,False,NG,South Andrew,AgriTech,2023,https://wongcarterandsmith.com,Exist newspaper Democrat writer exactly stage me produce.,11,wong-carter-and-smith,2023,USD,940339,195927,744412,383052,361360,19731,341629,9403,18806,322823,91894,692201,149275,542926,,940339,568.87,1617.42,0.1857,3918,20.0,46258.57,1.99,0.7916
4785,Ramos LLC,False,IN,Kellyland,Cybersecurity,2024,https://ramosllc.com,World money national candidate must Congress early.,18,ramos-llc,2023,USD,928184,173338,754846,519961,234885,0,234885,9281,18563,216322,15771,534452,202010,332442,,928184,307.98,1423.66,0.0203,877,88.17,30949.83,0.51,0.8133
4786,Bell Thomas and Perez,False,DE,East Amanda,Energy,2008,https://bellthomasandperez.com,Wrong himself beyond long over.,22,bell-thomas-and-perez,2023,EUR,832897,326613,506284,763780,-257496,17877,-275373,8328,16657,-292030,324154,788424,450891,337533,,832897,1526.08,8791.46,0.0511,294,235.44,67477.87,4.8,0.6079
4787,Williams Rosales and Clark,False,EG,North Alexborough,Cybersecurity,2020,https://williamsrosalesandclark.com,Able wall place spring goal.,16,williams-rosales-and-clark,2023,USD,495493,228834,266659,117659,149000,9652,139348,4954,9909,129439,42048,442146,209190,232956,,495493,266.53,1437.37,0.001,253,163.04,1170.3,35.93,0.5382
4788,Casey-Martinez,False,CA,Lake Josechester,AI/ML,2011,https://casey-martinez.com,Level technology its arrive vote drop task news son.,16,casey-martinez,2023,USD,2569320,815773,1753547,645153,1108394,32651,1075743,25693,51386,1024357,154428,1479804,484720,995084,,2569320,20.0,41.3,0.001,1463,146.26,57433.91,2.69,0.6825
4789,Greene Inc,False,EG,New Danielview,EdTech,2008,https://greeneinc.com,Return own bring high give age why while memory own.,17,greene-inc,2023,USD,971865,277398,694467,519717,174750,32450,142300,9718,19437,122863,90876,730379,461027,269352,80988.75,971865,10.0,10.0,0.1189,16197,5.0,18771.58,4.84,0.7146
4790,Howell-Austin,False,TN,Lake Paul,EdTech,2022,https://howell-austin.com,Tough own pick instead both party along.,16,howell-austin,2023,USD,792751,351001,441750,144877,296873,0,296873,7927,15855,281018,8313,443568,133235,310333,66062.58,792751,10.0,41.88,0.0213,559,118.16,28368.52,0.29,0.5572
4791,Meyer and Sons,False,CA,Lake Melanie,Mobility,2011,https://meyerandsons.com,Piece coach dream deep first quickly word let also partner.,25,meyer-and-sons,2023,USD,1656679,895639,761040,238272,522768,15811,506957,16566,33133,473824,425636,1365566,672227,693339,,1656679,1114.2,557.1,0.001,6902,20.0,27376.89,15.55,0.4594
4792,Stewart Curtis and Avery,False,BR,Hernandezchester,AgriTech,2018,https://stewartcurtisandavery.com,Husband tend still kid image wall side let tree mean but.,21,stewart-curtis-and-avery,2023,USD,77485,13023,64462,8846,55616,36670,18946,774,1549,17397,14833,245086,12254,232832,,77485,354.76,1950.4,0.0684,58,110.95,11588.11,1.28,0.8319
4793,Hunt LLC,False,GB,New Tyler,Marketplaces,2010,https://huntllc.com,Trouble hot interesting candidate.,14,hunt-llc,2023,USD,668994,263566,405428,320873,84555,0,84555,6689,13379,71176,84421,464522,187468,277054,,668994,923.79,3479.06,0.0305,736,75.68,1000.0,84.42,0.606
4794,Simmons-Elliott,False,FR,Gomezport,AI/ML,2013,https://simmons-elliott.com,Walk only sit drug let sport adult see note.,18,simmons-elliott,2023,EUR,412664,169366,243298,394569,-151271,0,-151271,4126,8253,-159524,4575,353878,110452,243426,,412664,1135.17,4274.95,0.0818,1719,20.0,53312.33,0.09,0.5896
4795,Snyder Howard and Smith,False,DE,Port Jenniferport,Mobility,2015,https://snyderhowardandsmith.com,Either themselves must because sure.,28,snyder-howard-and-smith,2023,EUR,465417,216255,249162,325147,-75985,486,-76471,4654,9308,-85779,63042,314336,101582,212754,,465417,20.0,112.12,0.0737,198,195.59,1000.0,63.04,0.5354
4796,Gomez Inc,False,FR,Port Michaelside,HealthTech,2020,https://gomezinc.com,He couple reach fly throughout fall.,26,gomez-inc,2023,EUR,825274,283619,541655,371160,170495,2520,167975,8252,16505,151470,128480,700777,198504,502273,68772.83,825274,10.0,45.39,0.0541,13754,5.0,39542.17,3.25,0.6563
4797,Rivera Group,False,KE,West Ruthland,Mobility,2024,https://riveragroup.com,Water feeling third tell later agreement similar season cup.,23,rivera-group,2023,USD,4308142,1582939,2725203,3170680,-445477,0,-445477,43081,86162,-531639,84328,2431913,121595,2310318,,4308142,403.68,201.84,0.0384,7260,49.45,258658.42,0.33,0.6326
4798,Woods-Duncan,False,ZA,Lake Patrickstad,IoT,2015,https://woods-duncan.com,Popular hand end risk set order series.,23,woods-duncan,2023,USD,320116,82166,237950,273181,-35231,17718,-52949,3201,6402,-59351,219142,415510,130878,284632,,320116,697.19,3184.77,0.0065,1333,20.0,12470.15,17.57,0.7433
4799,Williams-Wolf,False,US,West Ashley,Mobility,2016,https://williams-wolf.com,Again scientist quite report attention us TV somebody risk nice.,23,williams-wolf,2023,USD,481347,158326,323021,88785,234236,725,233511,4813,9626,223885,22832,288845,72771,216074,,481347,1710.88,8781.47,0.1327,135,296.57,1000.0,22.83,0.6711
4800,Miller Reese and Luna,False,TN,Lake Jacob,AgriTech,2018,https://millerreeseandluna.com,Threat gun Republican step find consumer opportunity.,13,miller-reese-and-luna,2023,USD,2099377,377117,1722260,778799,943461,0,943461,20993,41987,901474,78333,1256586,62829,1193757,,2099377,20.0,88.08,0.013,4193,41.72,84412.44,0.93,0.8204
4801,Jones Everett and Hawkins,False,GB,Douglasbury,SaaS,2018,https://joneseverettandhawkins.com,May billion any child high society career raise always lead from.,17,jones-everett-and-hawkins,2023,USD,1239714,401995,837719,593934,243785,19992,223793,12397,24794,198999,44744,688956,34447,654509,103309.5,1239714,651.68,3598.7,0.0226,2071,49.88,32658.21,1.37,0.6757
4802,Jones and Sons,False,ZA,Melindamouth,IoT,2021,https://jonesandsons.com,Position fight sometimes be.,27,jones-and-sons,2023,USD,3223797,700991,2522806,161189,2361617,0,2361617,32237,64475,2297142,303478,2017554,625004,1392550,,3223797,20.0,138.01,0.0646,2915,92.15,29050.06,10.45,0.7826
4803,Hicks-Hernandez,False,US,Port Tina,AgriTech,2014,https://hicks-hernandez.com,Thing pass mean newspaper they step.,23,hicks-hernandez,2023,USD,563203,188148,375055,248307,126748,22280,104468,5632,11264,93204,85286,518591,26155,492436,,563203,234.04,315.18,0.0505,560,83.76,25680.98,3.32,0.6659
4804,Clark-Mathis,False,AU,Adamsfurt,AI/ML,2023,https://clark-mathis.com,Myself great career professional.,18,clark-mathis,2023,USD,1236513,435159,801354,595126,206228,0,206228,12365,24730,181498,43952,793447,55524,737923,,1236513,445.08,1981.04,0.1115,5152,20.0,65066.25,0.68,0.6481
4805,Hodges LLC,False,NG,West Katherinebury,Mobility,2018,https://hodgesllc.com,Design number guess other five own business with.,21,hodges-llc,2023,USD,968827,357440,611387,102728,508659,26604,482055,9688,19376,462679,26443,655073,166465,488608,,968827,20.0,12.82,0.0916,254,316.79,1000.0,26.44,0.6311
4806,Ruiz and Sons,False,BR,Parkside,EdTech,2018,https://ruizandsons.com,Outside data create detail stage benefit thus consumer true.,17,ruiz-and-sons,2023,USD,596906,340503,256403,321637,-65234,0,-65234,5969,11938,-77172,33222,511475,161592,349883,49742.17,596906,206.18,1398.55,0.022,1658,30.0,24367.46,1.36,0.4296
4807,Mcdonald Ltd,False,EG,North Amandaview,Cybersecurity,2023,https://mcdonaldltd.com,Manager oil admit change beyond support face notice article while.,19,mcdonald-ltd,2023,USD,1695410,378943,1316467,1083431,233036,8638,224398,16954,33908,190490,168345,1148575,563206,585369,,1695410,449.09,1641.05,0.1113,550,256.57,110270.8,1.53,0.7765
4808,Ballard-Hickman,False,NG,Dixonmouth,AI/ML,2010,https://ballard-hickman.com,Current body deep conference tend all discuss service early.,25,ballard-hickman,2023,USD,139569,52461,87108,28172,58936,0,58936,1395,2791,56145,18426,142176,7108,135068,,139569,1118.72,2810.51,0.0225,78,147.99,1000.0,18.43,0.6241
4809,Reed Williams and Harrington,False,FR,East Gina,Energy,2010,https://reedwilliamsandharrington.com,Sing a win individual win student rate.,22,reed-williams-and-harrington,2023,EUR,2981550,1307210,1674340,1543287,131053,46479,84574,29815,59631,24943,332067,1928349,482900,1445449,,2981550,751.99,2116.52,0.0463,2697,92.1,111142.41,2.99,0.5616
4810,Navarro Beck and Wilkins,False,TN,Donovanbury,HealthTech,2008,https://navarrobeckandwilkins.com,Matter per herself media floor again.,16,navarro-beck-and-wilkins,2023,USD,577395,262588,314807,233356,81451,0,81451,5773,11547,69904,25475,445824,213502,232322,48116.25,577395,201.96,201.96,0.0631,1019,47.18,1000.0,25.48,0.5452
4811,Ware Shea and Reese,False,GB,Richardview,AI/ML,2011,https://waresheaandreese.com,Throw nor she day whom coach trip so hot west.,20,ware-shea-and-reese,2023,USD,1505212,796541,708671,1043320,-334649,19494,-354143,15052,30104,-384247,115110,1061053,53052,1008001,,1505212,1208.24,5232.87,0.0385,6271,20.0,77738.49,1.48,0.4708
4812,Jackson-Stewart,False,GB,North Carolland,EdTech,2022,https://jackson-stewart.com,Lot under Republican nor again who letter red activity.,21,jackson-stewart,2023,USD,725016,358041,366975,601737,-234762,0,-234762,7250,14500,-249262,7416,451309,340078,111231,60418.0,725016,293.23,1572.89,0.0056,1042,57.97,32905.55,0.23,0.5062
4813,White-Morris,False,FR,North Sharonfort,SaaS,2021,https://white-morris.com,Particularly let example national order within up current.,19,white-morris,2023,EUR,410407,126002,284405,235910,48495,16575,31920,4104,8208,23712,11822,222796,40905,181891,34200.58,410407,433.54,1093.57,0.001,708,48.28,8612.06,1.37,0.693
4814,Floyd Walker and Ibarra,False,EG,Daniellefort,HealthTech,2024,https://floydwalkerandibarra.com,Less risk picture information.,26,floyd-walker-and-ibarra,2023,USD,270623,83984,186639,212547,-25908,10465,-36373,2706,5412,-41785,26307,267514,123600,143914,22551.92,270623,540.72,3807.6,0.0488,4510,5.0,19259.74,1.37,0.6897
4815,Acosta Group,False,EG,Huangberg,HealthTech,2021,https://acostagroup.com,Day suffer some ten east audience believe rule foot.,21,acosta-group,2023,USD,955383,529270,426113,812712,-386599,0,-386599,9553,19107,-405706,28852,581262,271526,309736,79615.25,955383,584.71,1842.22,0.0481,15923,5.0,64774.85,0.45,0.446
4816,Huffman Taylor and Velasquez,False,TN,Gibbsville,SaaS,2017,https://huffmantaylorandvelasquez.com,Well raise range environmental audience part in Democrat address.,19,huffman-taylor-and-velasquez,2023,USD,3300459,950764,2349695,1479298,870397,23238,847159,33004,66009,781150,149155,1996354,846473,1149881,275038.25,3300459,642.8,1456.96,0.03,2267,121.29,100962.29,1.48,0.7119
4817,Johnson-Weaver,False,FR,Catherinehaven,Energy,2017,https://johnson-weaver.com,Different fish and their window personal player drug.,29,johnson-weaver,2023,EUR,1064709,404355,660354,295758,364596,0,364596,10647,21294,343302,20756,553200,96503,456697,,1064709,20.0,66.85,0.001,721,122.9,39703.02,0.52,0.6202
4818,Pace Ltd,False,ZA,Port Annafurt,Marketplaces,2016,https://paceltd.com,Everyone option truth agency care official first capital.,13,pace-ltd,2023,USD,2282748,679814,1602934,813432,789502,15228,774274,22827,45654,728620,148966,1448078,619877,828201,,2282748,313.58,890.01,0.0308,4672,40.71,77978.98,1.91,0.7022
4819,Austin-Mason,False,NG,Brownburgh,E-commerce,2019,https://austin-mason.com,Art team organization couple yet Republican small again.,20,austin-mason,2023,USD,1188884,501573,687311,864418,-177107,2186,-179293,11888,23777,-203070,136565,845907,399362,446545,,1188884,744.24,2541.03,0.0259,398,248.49,74409.41,1.84,0.5781
4820,Shepherd PLC,False,KE,Port Douglas,Marketplaces,2013,https://shepherdplc.com,Democrat special member front class born economy life.,16,shepherd-plc,2023,USD,209872,56917,152955,191135,-38180,18472,-56652,2098,4197,-60849,3276,220281,101829,118452,,209872,20.0,84.25,0.0373,874,20.0,18518.73,0.18,0.7288
4821,Morrow-Griffin,False,GB,Michellebury,AgriTech,2024,https://morrow-griffin.com,Help beat allow nearly both modern.,15,morrow-griffin,2023,USD,1422914,96773,1326141,364342,961799,21298,940501,14229,28458,912043,35851,811180,257759,553421,,1422914,1631.61,5865.0,0.2095,5928,20.0,36293.19,0.99,0.932
4822,Smith LLC,False,BR,Lake Davidmouth,EdTech,2019,https://smithllc.com,Drug they sense only hot.,19,smith-llc,2023,USD,533510,186780,346730,188117,158613,40784,117829,5335,10670,107159,34229,491008,257842,233166,44459.17,533510,473.49,998.53,0.0338,1150,38.64,23473.71,1.46,0.6499
4823,Lynch and Sons,False,NG,Robertsfort,IoT,2016,https://lynchandsons.com,Admit after factor help authority grow carry to check.,18,lynch-and-sons,2023,USD,1073217,266984,806233,686539,119694,15827,103867,10732,21464,82403,48568,611767,162129,449638,,1073217,20.0,72.56,0.1959,287,311.02,70425.48,0.69,0.7512
4824,Ross Inc,False,EG,Katherinestad,Mobility,2014,https://rossinc.com,Size fight production role economy enough off itself feeling tell.,27,ross-inc,2023,USD,2321555,1030980,1290575,363485,927090,0,927090,23215,46431,880659,173671,1353733,67686,1286047,,2321555,20.0,39.43,0.05,668,289.3,1000.0,173.67,0.5559
4825,Newton Thomas and Thomas,False,CA,Lake Christinahaven,Cybersecurity,2012,https://newtonthomasandthomas.com,Son idea until process term than know arm.,15,newton-thomas-and-thomas,2023,USD,649241,389318,259923,239538,20385,3173,17212,6492,12984,4228,8529,518194,25909,492285,,649241,1075.87,1778.27,0.1646,216,249.56,1000.0,8.53,0.4003
4826,Gonzales PLC,False,GB,North Robertside,AI/ML,2023,https://gonzalesplc.com,Check allow couple health it.,11,gonzales-plc,2023,USD,923810,381607,542203,368998,173205,0,173205,9238,18476,154729,42276,570100,115434,454666,,923810,1388.34,8451.9,0.0327,246,312.25,56142.77,0.75,0.5869
4827,Murray-Marsh,False,US,North Tracey,E-commerce,2021,https://murray-marsh.com,Crime people under personal safe feeling sit total.,26,murray-marsh,2023,USD,1521186,511683,1009503,930364,79139,9687,69452,15211,30423,39029,131044,955394,102318,853076,,1521186,708.27,2261.74,0.001,6338,20.0,81879.48,1.6,0.6636
4828,Hayes LLC,False,GB,Stephenhaven,HealthTech,2023,https://hayesllc.com,Best first he drop movement letter want wall race project.,25,hayes-llc,2023,USD,800599,287717,512882,465974,46908,0,46908,8005,16011,30897,83436,587309,266077,321232,66716.58,800599,36.43,221.37,0.0222,1599,41.7,77195.11,1.08,0.6406
4829,Anderson-Pennington,False,FR,South Juliaberg,SaaS,2017,https://anderson-pennington.com,Box ability court yes light degree.,20,anderson-pennington,2023,EUR,529605,120508,409097,177162,231935,9720,222215,5296,10592,211623,65851,459104,22955,436149,44133.75,529605,10.0,25.29,0.0221,612,72.05,44563.61,1.48,0.7725
4830,Smith-Rodriguez,False,ZA,Jacobbury,EdTech,2014,https://smith-rodriguez.com,Each seven board explain point almost.,20,smith-rodriguez,2023,USD,1250942,476156,774786,746273,28513,0,28513,12509,25018,3495,1004439,1636994,490284,1146710,104245.17,1250942,142.59,411.06,0.001,1196,87.13,43766.88,22.95,0.6194
4831,Freeman and Sons,False,ZA,Jeffreyport,Fintech,2022,https://freemanandsons.com,Address low ready field issue parent.,20,freeman-and-sons,2023,USD,2488913,490120,1998793,124445,1874348,5151,1869197,24889,49778,1819419,98984,1441278,601875,839403,,2488913,20.0,104.26,0.07,942,220.02,22883.09,4.33,0.8031
4832,Baldwin Inc,False,CA,Carlaborough,Fintech,2009,https://baldwininc.com,Type woman east crime high along.,17,baldwin-inc,2023,USD,728948,105051,623897,258148,365749,0,365749,7289,14578,351171,100251,514812,175537,339275,,728948,20.0,103.23,0.0528,762,79.7,20747.81,4.83,0.8559
4833,Wolfe-Hernandez,False,KE,Lake Shannonland,Mobility,2013,https://wolfe-hernandez.com,Guess public response majority whose.,21,wolfe-hernandez,2023,USD,1074963,420423,654540,53748,600792,6812,593980,10749,21499,572481,158229,764327,38216,726111,,1074963,1968.41,1530.95,0.0522,778,115.03,54906.34,2.88,0.6089
4834,Thompson Young and Boone,False,FR,Amandafurt,E-commerce,2015,https://thompsonyoungandboone.com,Water small remain television mean country within.,25,thompson-young-and-boone,2023,EUR,484386,274389,209997,452802,-242805,2037,-244842,4843,9687,-254529,9435,444623,193962,250661,,484386,20.0,63.48,0.0753,501,80.56,19316.64,0.49,0.4335
4835,Lewis Kim and Carpenter,False,CA,Ericborough,Marketplaces,2008,https://lewiskimandcarpenter.com,Account great series group authority stuff product.,7,lewis-kim-and-carpenter,2023,USD,786933,260698,526235,295275,230960,19459,211501,7869,15738,195763,35764,616989,281974,335015,,786933,1447.97,3572.9,0.0885,580,112.88,17657.05,2.03,0.6687
4836,Meyer Murillo and Moore,False,DE,Lake Lisaland,AgriTech,2017,https://meyermurilloandmoore.com,Medical pick part attention turn yourself.,23,meyer-murillo-and-moore,2023,EUR,283505,108339,175166,14891,160275,16351,143924,2835,5670,138254,16357,168160,86886,81274,,283505,184.59,417.5,0.1447,1181,20.0,6011.0,2.72,0.6179
4837,Harrison-Johnson,False,TN,Port Tony,IoT,2017,https://harrison-johnson.com,Lead from many forget plant.,18,harrison-johnson,2023,USD,326051,129861,196190,231399,-35209,0,-35209,3260,6521,-41730,31833,341218,101081,240137,,326051,418.42,1559.49,0.1139,374,72.5,7477.58,4.26,0.6017
4838,Montoya-Kim,False,CA,North Jennifer,IoT,2020,https://montoya-kim.com,Research scientist year election board study growth experience way.,21,montoya-kim,2023,USD,692741,104382,588359,156828,431531,0,431531,6927,13854,417677,7083,490523,233081,257442,,692741,1363.88,1574.22,0.1145,291,197.82,58792.37,0.12,0.8493
4839,Stafford-Rogers,False,IN,West Shelby,AI/ML,2014,https://stafford-rogers.com,Democratic understand small bring white.,22,stafford-rogers,2023,USD,608583,336382,272201,201428,70773,4224,66549,6085,12171,54378,19122,453405,105989,347416,,608583,270.0,135.0,0.0471,993,51.07,59568.59,0.32,0.4473
4840,Yu PLC,False,FR,Michaelview,IoT,2012,https://yuplc.com,First up foot hospital alone language recently.,20,yu-plc,2023,EUR,989524,384009,605515,806602,-201087,29388,-230475,9895,19790,-250265,34609,698625,249248,449377,,989524,713.86,1575.23,0.0764,4123,20.0,63512.2,0.54,0.6119
4841,Jefferson-Hebert,False,FR,East Danielview,Cybersecurity,2014,https://jefferson-hebert.com,Two he marriage area rock green edge evidence decision.,17,jefferson-hebert,2023,EUR,152321,66724,85597,99220,-13623,21626,-35249,1523,3046,-38295,8983,114973,66488,48485,,152321,20.0,85.96,0.001,73,172.69,51087.07,0.18,0.562
4842,Thompson Brown and Rice,False,IN,South Luis,HealthTech,2016,https://thompsonbrownandrice.com,Series effort control old if difference.,15,thompson-brown-and-rice,2023,USD,424896,109834,315062,21244,293818,0,293818,4248,8497,285321,13688,376441,27142,349299,35408.0,424896,125.87,538.38,0.001,530,66.73,14531.65,0.94,0.7415
4843,Johnson-Pena,False,KE,New Michaelland,Fintech,2012,https://johnson-pena.com,Step parent stage star quickly continue.,19,johnson-pena,2023,USD,535317,215248,320069,202858,117211,22266,94945,5353,10706,84239,27326,435690,21784,413906,,535317,20.0,87.35,0.0367,195,227.61,31411.28,0.87,0.5979
4844,Moore Ltd,False,AU,Garciaside,AI/ML,2020,https://mooreltd.com,Single girl base travel must thank realize.,19,moore-ltd,2023,USD,846979,239526,607453,391653,215800,20089,195711,8469,16939,178772,10523,546006,317983,228023,,846979,1398.74,1700.45,0.1313,3529,20.0,34734.45,0.3,0.7172
4845,Moore Inc,False,CA,Williamland,IoT,2016,https://mooreinc.com,Commercial lot make customer TV agreement.,16,moore-inc,2023,USD,229661,43006,186655,88567,98088,656,97432,2296,4593,92839,46277,332666,78978,253688,,229661,20.0,50.5,0.089,77,245.54,1000.0,46.28,0.8127
4846,Dickerson-Daniel,False,AU,West Margaretstad,Cybersecurity,2023,https://dickerson-daniel.com,Director I point keep present minute what.,19,dickerson-daniel,2023,USD,1088421,411874,676547,778306,-101759,11249,-113008,10884,21768,-134776,30926,760884,477093,283791,,1088421,546.83,3532.25,0.0205,798,113.66,90977.85,0.34,0.6216
4847,Hoffman and Sons,False,DE,South Jennymouth,HealthTech,2008,https://hoffmanandsons.com,Or it class under education technology.,24,hoffman-and-sons,2023,EUR,203817,51846,151971,43641,108330,0,108330,2038,4076,104254,26125,279744,96274,183470,16984.75,203817,10.0,75.13,0.0742,3323,5.11,13933.8,1.87,0.7456
4848,Pierce-Martinez,False,AU,South Cameron,EdTech,2014,https://pierce-martinez.com,Rather spend human outside late represent claim partner.,13,pierce-martinez,2023,USD,551842,72209,479633,101273,378360,0,378360,5518,11036,367324,29288,427810,258954,168856,45986.83,551842,47.75,326.73,0.0169,692,66.37,6358.25,4.61,0.8691
4849,Brown Harvey and Wilson,False,FR,North Devinland,IoT,2012,https://brownharveyandwilson.com,Too watch majority feel face.,24,brown-harvey-and-wilson,2023,EUR,765439,351420,414019,346722,67297,33407,33890,7654,15308,18582,25608,480792,73953,406839,,765439,20.0,12.17,0.097,288,221.33,1687.22,15.18,0.5409
4850,Stephens-Barrett,False,GB,Hallport,HealthTech,2023,https://stephens-barrett.com,Any career rise leg about another true north low we.,21,stephens-barrett,2023,USD,541148,178771,362377,284619,77758,0,77758,5411,10822,66936,126876,484427,110341,374086,45095.67,541148,10.0,52.54,0.0323,694,64.92,30753.52,4.13,0.6696
4851,Miller Shelton and Church,False,US,Andersonmouth,E-commerce,2010,https://millersheltonandchurch.com,War try store later born how true its than way.,16,miller-shelton-and-church,2023,USD,254405,97353,157052,37611,119441,0,119441,2544,5088,114353,27431,309188,223657,85531,,254405,20.0,10.0,0.0818,207,102.39,1000.0,27.43,0.6173
4852,Parks Group,False,US,South Josephmouth,HealthTech,2024,https://parksgroup.com,Woman standard several must expert place fine program expert around.,20,parks-group,2023,USD,343432,80200,263232,237037,26195,4038,22157,3434,6868,15289,54880,388688,48755,339933,28619.33,343432,302.91,817.85,0.0587,375,76.23,33859.19,1.62,0.7665
4853,Quinn-Francis,False,AU,Carterstad,Mobility,2021,https://quinn-francis.com,Maybe next writer fall blood indicate this.,26,quinn-francis,2023,USD,301507,123310,178197,25703,152494,7567,144927,3015,6030,138897,30033,296612,123890,172722,,301507,20.0,111.45,0.1433,571,43.96,1000.0,30.03,0.591
4854,Snow-Fisher,False,BR,Shepardbury,Mobility,2018,https://snow-fisher.com,Gas commercial study begin letter.,24,snow-fisher,2023,USD,759261,291456,467805,327506,140299,18270,122029,7592,15185,106844,47425,437380,102934,334446,,759261,20.0,44.08,0.0898,443,142.63,1000.0,47.42,0.6161
4855,Riddle Browning and Davis,False,IN,South Stephanie,AI/ML,2011,https://riddlebrowninganddavis.com,Need military agency yeah Democrat.,19,riddle-browning-and-davis,2023,USD,968267,338635,629632,732162,-102530,0,-102530,9682,19365,-121895,13635,669657,33482,636175,,968267,20.0,96.51,0.0312,310,259.55,83619.02,0.16,0.6503
4856,Maynard-Rose,False,DE,Robertshire,AI/ML,2020,https://maynard-rose.com,Truth as eye present heavy worry see never its.,14,maynard-rose,2023,EUR,1125732,456462,669270,353529,315741,0,315741,11257,22514,293227,167008,770415,316623,453792,,1125732,540.69,891.45,0.0532,4690,20.0,3467.45,48.16,0.5945
4857,Young Thompson and Torres,False,TN,West Christina,Energy,2023,https://youngthompsonandtorres.com,Themselves police activity administration career bank decide consider TV table.,22,young-thompson-and-torres,2023,USD,1022091,494298,527793,427779,100014,0,100014,10220,20441,79573,17355,579044,110833,468211,,1022091,278.06,139.03,0.0302,452,188.25,48655.64,0.36,0.5164
4858,Ferguson-Wiggins,False,CA,New Ivanland,AgriTech,2024,https://ferguson-wiggins.com,Either remember event want may else include get situation life soon.,18,ferguson-wiggins,2023,USD,363548,107721,255827,229446,26381,0,26381,3635,7270,19111,30810,237525,94938,142587,,363548,868.09,2702.57,0.0402,240,125.79,1000.0,30.81,0.7037
4859,Tate Group,False,CA,South Neil,AI/ML,2010,https://tategroup.com,Court total contain almost information both population partner development network generation.,12,tate-group,2023,USD,2120365,891095,1229270,106018,1123252,41470,1081782,21203,42407,1039375,211068,1416909,420406,996503,,2120365,737.69,1777.55,0.0775,8834,20.0,1000.0,211.07,0.5797
4860,Austin Ltd,False,KE,Stricklandside,EdTech,2013,https://austinltd.com,Collection responsibility discuss style.,28,austin-ltd,2023,USD,263482,76686,186796,116725,70071,8393,61678,2634,5269,56409,6733,209073,27267,181806,21956.83,263482,700.71,4926.59,0.0494,252,86.79,1000.0,6.73,0.709
4861,Allen PLC,False,BR,Erinchester,AgriTech,2012,https://allenplc.com,Soon Democrat program might hospital late on.,14,allen-plc,2023,USD,366756,173674,193082,196392,-3310,0,-3310,3667,7335,-10645,4569,382964,73841,309123,,366756,1104.68,2940.69,0.001,833,36.66,16632.48,0.27,0.5265
4862,Long PLC,False,TN,West Markchester,AI/ML,2022,https://longplc.com,Cover part sell anything provide.,12,long-plc,2023,USD,204285,50728,153557,22933,130624,1179,129445,2042,4085,125360,1980,105205,5260,99945,,204285,118.59,555.5,0.0341,268,63.51,16108.64,0.12,0.7517
4863,Lucas-Pruitt,False,EG,Port Cynthiaport,Cybersecurity,2016,https://lucas-pruitt.com,Environmental case which employee hear water.,15,lucas-pruitt,2023,USD,2262057,791222,1470835,1191601,279234,0,279234,22620,45241,233993,222767,1388936,186928,1202008,,2262057,1897.28,1367.45,0.001,9425,20.0,83158.69,2.68,0.6502
4864,Clark Sanchez and Lloyd,False,BR,Davischester,Fintech,2021,https://clarksanchezandlloyd.com,Situation growth meet there even past establish model television scientist.,15,clark-sanchez-and-lloyd,2023,USD,1013810,451944,561866,287008,274858,726,274132,10138,20276,253856,221539,841419,317808,523611,,1013810,20.0,61.24,0.0511,3212,26.3,21932.59,10.1,0.5542
4865,Kaufman-Harrison,False,BR,Mooretown,E-commerce,2013,https://kaufman-harrison.com,The marriage lead why father yard way raise soldier type apply.,14,kaufman-harrison,2023,USD,1292039,655654,636385,1234708,-598323,0,-598323,12920,25840,-624163,218825,1019943,518735,501208,,1292039,76.95,148.6,0.0619,1014,106.16,111167.37,1.97,0.4925
4866,Guzman-Garcia,False,US,Youngville,E-commerce,2022,https://guzman-garcia.com,With modern last gas establish guy treatment hospital tonight possible.,19,guzman-garcia,2023,USD,558340,223239,335101,339903,-4802,0,-4802,5583,11166,-15968,9471,391821,88794,303027,,558340,145.69,233.34,0.0811,200,232.33,56600.06,0.17,0.6002
4867,Mata Davis and Moss,False,AU,New Garymouth,Marketplaces,2019,https://matadavisandmoss.com,Piece vote five base walk bank case.,23,mata-davis-and-moss,2023,USD,1055527,249286,806241,97255,708986,0,708986,10555,21110,687876,189599,796162,204796,591366,,1055527,20.0,24.66,0.1207,4398,20.0,13688.51,13.85,0.7638
4868,Diaz Eaton and Buchanan,False,ZA,East John,Energy,2014,https://diazeatonandbuchanan.com,Seek seat why prove education.,27,diaz-eaton-and-buchanan,2023,USD,1476847,129420,1347427,569758,777669,0,777669,14768,29536,748133,37173,921608,699918,221690,,1476847,1069.45,3077.61,0.0647,6153,20.0,80630.78,0.46,0.9124
4869,Bray-Velez,False,KE,North Steventown,AI/ML,2014,https://bray-velez.com,Perform appear sometimes visit traditional level rate outside.,22,bray-velez,2023,USD,261889,162099,99790,108251,-8461,0,-8461,2618,5237,-13698,10056,334617,141936,192681,,261889,20.0,68.39,0.066,63,342.12,1000.0,10.06,0.381
4870,Gray PLC,False,TN,Navarroland,E-commerce,2013,https://grayplc.com,Policy total describe economy contain herself recognize.,22,gray-plc,2023,USD,818658,328091,490567,542524,-51957,0,-51957,8186,16373,-68330,66362,633059,47614,585445,,818658,1352.9,3744.98,0.001,721,94.52,20033.72,3.31,0.5992
4871,Cooper Ltd,False,ZA,Henryshire,SaaS,2014,https://cooperltd.com,Site coach listen cost five.,25,cooper-ltd,2023,USD,1562276,78113,1484163,256833,1227330,11376,1215954,15622,31245,1184709,821219,1721304,86065,1635239,130189.67,1562276,10.0,25.15,0.0652,7967,16.34,29955.27,27.41,0.95
4872,Smith-Marsh,False,EG,Patrickhaven,E-commerce,2024,https://smith-marsh.com,Specific agree east total inside address maintain.,26,smith-marsh,2023,USD,2667674,857366,1810308,316077,1494231,13741,1480490,26676,53353,1427137,65270,1524526,447515,1077011,,2667674,334.22,1355.06,0.001,6358,34.96,4053.9,16.1,0.6786
4873,Thornton-Brown,False,DE,Mccormickchester,SaaS,2017,https://thornton-brown.com,Go high election series real fine fund office east mother.,23,thornton-brown,2023,EUR,1398834,585671,813163,1185872,-372709,20748,-393457,13988,27976,-421433,81785,930711,615816,314895,116569.5,1398834,342.83,1020.14,0.055,1571,74.16,88086.45,0.93,0.5813
4874,James Flores and Russell,False,CA,North Davidtown,Fintech,2019,https://jamesfloresandrussell.com,Kitchen ever guy attention risk together health threat full industry rather.,28,james-flores-and-russell,2023,USD,1227599,724158,503441,314258,189183,0,189183,12275,24551,164632,152017,912856,413296,499560,,1227599,20.0,100.19,0.0817,5114,20.0,81448.0,1.87,0.4101
4875,Wells Anderson and Robinson,False,IN,Shellyville,AI/ML,2008,https://wellsandersonandrobinson.com,Nation drive start draw thank age.,20,wells-anderson-and-robinson,2023,USD,993798,181439,812359,313117,499242,15114,484128,9937,19875,464253,81529,588138,130599,457539,,993798,286.96,680.74,0.0198,622,133.14,38857.48,2.1,0.8174
4876,Peterson-Long,False,KE,Huntfort,AgriTech,2009,https://peterson-long.com,Direction others him participant country enjoy nearly participant.,13,peterson-long,2023,USD,786885,411084,375801,340252,35549,1953,33596,7868,15737,17859,86495,668825,101602,567223,,786885,1487.67,5144.52,0.0608,690,94.93,50554.42,1.71,0.4776
4877,Anderson Group,False,BR,Donovanland,AgriTech,2023,https://andersongroup.com,Where performance exactly bit build charge sister full.,26,anderson-group,2023,USD,125164,64927,60237,44326,15911,28162,-12251,1251,2503,-14754,53128,120876,20373,100503,,125164,983.82,491.91,0.0507,43,237.66,1000.0,53.13,0.4813
4878,Mcbride Group,False,TN,Aprilstad,SaaS,2016,https://mcbridegroup.com,Conference item appear help dinner message.,23,mcbride-group,2023,USD,252448,12622,239826,74008,165818,8281,157537,2524,5048,152489,8627,181843,63656,118187,21037.33,252448,163.29,720.6,0.0063,584,35.99,28528.32,0.3,0.95
4879,Warren Rose and Bell,False,IN,North Kim,Marketplaces,2009,https://warrenroseandbell.com,Particular painting economic son.,19,warren-rose-and-bell,2023,USD,2822662,1087066,1735596,1804808,-69212,0,-69212,28226,56453,-125665,21759,1539111,686227,852884,,2822662,747.14,593.43,0.001,3796,61.95,166429.91,0.13,0.6149
4880,Brown-Thornton,False,KE,Barbaraborough,SaaS,2023,https://brown-thornton.com,Shoulder according better main Congress daughter memory all.,14,brown-thornton,2023,USD,1124899,395788,729111,337611,391500,0,391500,11248,22497,369003,160526,807302,234536,572766,93741.58,1124899,10.0,48.7,0.0082,1844,50.82,13137.67,12.22,0.6482
4881,Jones-Allen,False,KE,Morganmouth,Marketplaces,2022,https://jones-allen.com,Industry wide both during art clear able main quickly next.,11,jones-allen,2023,USD,572111,216056,356055,170155,185900,14990,170910,5721,11442,159468,9816,322290,57684,264606,,572111,20.0,90.71,0.001,174,272.76,39490.33,0.25,0.6224
4882,Salazar-Baxter,False,EG,Katherineport,HealthTech,2023,https://salazar-baxter.com,Voice central plant major act above.,24,salazar-baxter,2023,USD,392115,119516,272599,268218,4381,19082,-14701,3921,7842,-22543,67175,447678,172518,275160,32676.25,392115,348.84,1900.01,0.001,371,88.07,29877.69,2.25,0.6952
4883,Roberts Joyce and Sanchez,False,ZA,Port Justinville,Marketplaces,2011,https://robertsjoyceandsanchez.com,Hear level until difference thus theory include television discussion always.,30,roberts-joyce-and-sanchez,2023,USD,710007,331428,378579,178263,200316,28865,171451,7100,14200,157251,10624,385174,100013,285161,,710007,20.0,101.57,0.0226,689,85.77,1000.0,10.62,0.5332
4884,Oneal Inc,False,US,West Stevenbury,E-commerce,2008,https://onealinc.com,Health cost wish box color determine but main industry case.,20,oneal-inc,2023,USD,905013,320244,584769,328448,256321,0,256321,9050,18100,238221,22866,557901,180342,377559,,905013,20.0,52.02,0.026,3770,20.0,42540.28,0.54,0.6461
4885,Perry Valentine and Bullock,False,KE,Lake Taylormouth,Cybersecurity,2012,https://perryvalentineandbullock.com,New behavior far can respond detail sport.,22,perry-valentine-and-bullock,2023,USD,1200341,282281,918060,798849,119211,16864,102347,12003,24006,78341,38493,787974,317467,470507,,1200341,20.0,70.95,0.0045,248,401.79,44783.02,0.86,0.7648
4886,Wade LLC,False,ZA,Williamsborough,Cybersecurity,2013,https://wadellc.com,Feeling speak support staff many turn.,27,wade-llc,2023,USD,2802722,1084148,1718574,1681368,37206,15484,21722,28027,56054,-34332,334879,1811531,836088,975443,,2802722,1346.17,8177.98,0.0817,1815,128.63,127281.26,2.63,0.6132
4887,Raymond Castillo and Bradley,False,GB,Millerstad,Fintech,2021,https://raymondcastilloandbradley.com,Say discover approach reflect report say later suggest.,28,raymond-castillo-and-bradley,2023,USD,1635340,505718,1129622,831176,298446,3825,294621,16353,32706,261915,74160,1001601,404972,596629,,1635340,809.93,404.96,0.0234,6813,20.0,85086.42,0.87,0.6908
4888,Camacho-Weaver,False,FR,New Troyport,SaaS,2022,https://camacho-weaver.com,Leader worry you likely power.,19,camacho-weaver,2023,EUR,1430061,313602,1116459,71503,1044956,6833,1038123,14300,28601,1009522,45161,810003,429420,380583,119171.75,1430061,428.17,428.17,0.0358,2827,42.14,1000.0,45.16,0.7807
4889,Gilbert and Sons,False,BR,Carlsonshire,Cybersecurity,2009,https://gilbertandsons.com,Scene think only forget man ahead anything.,20,gilbert-and-sons,2023,USD,1280061,428450,851611,344337,507274,0,507274,12800,25601,481673,52870,756414,37820,718594,,1280061,157.95,394.25,0.0249,880,121.14,28043.11,1.89,0.6653
4890,Martin-Brown,False,CA,North Mariahview,Fintech,2016,https://martin-brown.com,More become this summer someone onto will during deep.,14,martin-brown,2023,USD,9243302,4296591,4946711,462165,4484546,10368,4474178,92433,184866,4289312,472025,5116299,2198567,2917732,,9243302,68.01,366.36,0.0558,38513,20.0,41191.32,11.46,0.5352
4891,Gonzalez-Crane,False,DE,Baileyborough,Marketplaces,2008,https://gonzalez-crane.com,Receive reality care everything culture security born travel.,27,gonzalez-crane,2023,EUR,480905,160539,320366,75655,244711,0,244711,4809,9618,235093,8072,358292,195645,162647,,480905,999.21,4375.44,0.0564,1172,34.18,1000.0,8.07,0.6662
4892,Marshall and Sons,False,CA,Maryville,Marketplaces,2018,https://marshallandsons.com,Economic according size stage.,27,marshall-and-sons,2023,USD,716365,202747,513618,259521,254097,30630,223467,7163,14327,209140,196418,677379,33868,643511,,716365,1563.02,4676.65,0.0175,538,110.88,10734.02,18.3,0.717
4893,Hill-Williams,False,ZA,Anthonymouth,HealthTech,2019,https://hill-williams.com,Can book training after party everybody successful mean.,15,hill-williams,2023,USD,2826527,1302711,1523816,2033179,-509363,0,-509363,28265,56530,-565893,160712,1673461,946550,726911,235543.92,2826527,770.67,3815.35,0.0656,8201,28.72,140246.89,1.15,0.5391
4894,Rodriguez Ltd,False,NG,North Charlotte,SaaS,2020,https://rodriguezltd.com,Special college heart spend effect explain month seek attorney tough.,22,rodriguez-ltd,2023,USD,165160,77500,87660,80477,7183,0,7183,1651,3303,3880,13230,117570,14611,102959,13763.33,165160,215.28,1201.91,0.0415,122,111.92,1000.0,13.23,0.5308
4895,Dennis-Rowland,False,TN,West Lydiatown,Marketplaces,2009,https://dennis-rowland.com,Partner wall score travel history step available director develop full.,12,dennis-rowland,2023,USD,159813,52264,107549,116123,-8574,0,-8574,1598,3196,-11770,70161,310128,160255,149873,,159813,20.0,57.24,0.0429,665,20.0,8495.63,8.26,0.673
4896,Burke Inc,False,FR,Brendaberg,EdTech,2024,https://burkeinc.com,Position single debate region sure drug through long while significant.,21,burke-inc,2023,EUR,138797,59872,78925,131852,-52927,24389,-77316,1387,2775,-80091,42526,309144,109493,199651,11566.42,138797,591.85,1202.75,0.0442,193,59.81,11418.43,3.72,0.5686
4897,Jackson-Nelson,False,GB,Garciabury,Cybersecurity,2016,https://jackson-nelson.com,Behind fish while kitchen thus with tax upon accept little.,22,jackson-nelson,2023,USD,3497259,1616589,1880670,923232,957438,48953,908485,34972,69945,838540,478610,2415563,1186803,1228760,,3497259,812.73,6725.15,0.0703,5392,54.05,56656.55,8.45,0.5378
4898,Leonard Inc,False,FR,South Justin,HealthTech,2022,https://leonardinc.com,Actually read professor great work.,36,leonard-inc,2023,EUR,243850,78137,165713,152121,13592,0,13592,2438,4877,8715,5131,268934,115293,153641,20320.83,243850,125.42,608.66,0.001,296,68.62,11796.08,0.43,0.6796
4899,Smith-Fletcher,False,US,Caldwellmouth,AgriTech,2014,https://smith-fletcher.com,Hand ask certainly sea trip finish detail official worry.,20,smith-fletcher,2023,USD,104403,41179,63224,97157,-33933,6615,-40548,1044,2088,-42636,10476,109096,92900,16196,,104403,660.21,1016.3,0.001,35,244.29,1000.0,10.48,0.6056
4900,Fields LLC,False,ZA,Ryanview,AI/ML,2021,https://fieldsllc.com,Employee cultural all say happy.,17,fields-llc,2023,USD,515223,300687,214536,207298,7238,7254,-16,5152,10304,-10320,31882,344614,158466,186148,,515223,465.6,232.8,0.0319,2146,20.0,3898.44,8.18,0.4164
4901,Robinson PLC,False,GB,West Stacy,Marketplaces,2008,https://robinsonplc.com,Another clearly whether medical site cut even.,23,robinson-plc,2023,USD,1078441,167895,910546,750349,160197,29555,130642,10784,21568,109074,46680,672453,54401,618052,,1078441,20.0,56.9,0.0234,570,157.47,67967.26,0.69,0.8443
4902,Wood-Coleman,False,IN,New Lauraton,AgriTech,2019,https://wood-coleman.com,Interview fine apply see significant establish type while.,16,wood-coleman,2023,USD,175820,53588,122232,27295,94937,1271,93666,1758,3516,90150,19814,120837,55546,65291,,175820,873.92,2314.21,0.0483,85,171.52,1000.0,19.81,0.6952
4903,Collins-Jefferson,False,FR,West Stevenfort,E-commerce,2022,https://collins-jefferson.com,Charge discussion anyone world moment dark so official probably treatment.,27,collins-jefferson,2023,EUR,432409,176438,255971,243690,12281,6596,5685,4324,8648,-2963,11315,276678,37040,239638,,432409,710.28,794.07,0.0955,249,144.46,1961.42,5.77,0.592
4904,Shaffer-Rivera,False,KE,South Kyleburgh,Cybersecurity,2010,https://shaffer-rivera.com,Question center nation cultural maintain oil event air appear ask this.,19,shaffer-rivera,2023,USD,12223634,4956259,7267375,5519910,1747465,1610,1745855,122236,244472,1501383,344267,6487123,2703379,3783744,,12223634,2030.34,1977.31,0.001,42092,24.2,483922.63,0.71,0.5945
4905,Hamilton-Braun,False,KE,Wellston,Mobility,2010,https://hamilton-braun.com,Voice rich store tough participant fight care.,20,hamilton-braun,2023,USD,888981,381818,507163,225591,281572,0,281572,8889,17779,263793,78725,552149,27607,524542,,888981,1253.49,6105.36,0.0816,396,186.67,35167.31,2.24,0.5705
4906,Hernandez Harding and Colon,False,FR,Greerhaven,Fintech,2013,https://hernandezhardingandcolon.com,Somebody reason it main special whether oil subject matter view.,23,hernandez-harding-and-colon,2023,EUR,652706,368875,283831,369992,-86161,9092,-95253,6527,13054,-108307,21057,520933,202002,318931,,652706,345.92,1407.95,0.0959,400,135.93,48911.6,0.43,0.4349
4907,Reynolds Clay and Castaneda,False,ZA,Martinezborough,Fintech,2013,https://reynoldsclayandcastaneda.com,Firm similar public almost read.,25,reynolds-clay-and-castaneda,2023,USD,1044235,331340,712895,598758,114137,19766,94371,10442,20884,73487,47219,761619,335189,426430,,1044235,1747.43,11843.73,0.1213,432,201.27,49204.86,0.96,0.6827
4908,Watkins-Payne,False,CA,Stephenhaven,IoT,2008,https://watkins-payne.com,Yet along section fill least as.,13,watkins-payne,2023,USD,760532,298482,462050,265357,196693,0,196693,7605,15210,181483,12152,579646,241965,337681,,760532,1206.81,5845.23,0.0105,3168,20.0,10392.25,1.17,0.6075
4909,Mercer-Henry,False,AU,Gregoryside,HealthTech,2008,https://mercer-henry.com,Memory also arm sort space development talk.,10,mercer-henry,2023,USD,1875752,661338,1214414,1290084,-75670,1028,-76698,18757,37515,-114213,402458,1394500,69725,1324775,156312.67,1875752,10.0,24.76,0.0196,11561,13.52,108210.7,3.72,0.6474
4910,Snyder Schneider and Williams,False,DE,Kleinfort,Marketplaces,2019,https://snyderschneiderandwilliams.com,Right set something production state health around relate skill result.,17,snyder-schneider-and-williams,2023,EUR,1015490,403372,612118,667406,-55288,39203,-94491,10154,20309,-114800,76107,690131,443427,246704,,1015490,20.0,62.95,0.0898,281,300.68,32411.4,2.35,0.6028
4911,Chavez-Moore,False,EG,East John,Fintech,2015,https://chavez-moore.com,I already law grow century perhaps.,10,chavez-moore,2023,USD,2291838,688398,1603440,943656,659784,0,659784,22918,45836,613948,9402,1333051,294857,1038194,,2291838,1199.01,3740.41,0.054,659,289.79,60882.58,0.15,0.6996
4912,Fletcher Meyer and Friedman,False,IN,North Robin,Marketplaces,2014,https://fletchermeyerandfriedman.com,Off piece carry chance financial could per serious also industry region.,14,fletcher-meyer-and-friedman,2023,USD,392265,238753,153512,328406,-174894,39625,-214519,3922,7845,-222364,9012,301147,52379,248768,,392265,198.08,1378.75,0.0845,1634,20.0,34977.05,0.26,0.3913
4913,Carrillo-Sullivan,False,ZA,Thomashaven,Cybersecurity,2012,https://carrillo-sullivan.com,Look age religious resource product option fact fact.,19,carrillo-sullivan,2023,USD,3993284,1268282,2725002,3988231,-1263229,13960,-1277189,39932,79865,-1357054,171772,2261459,649501,1611958,,3993284,663.69,2287.27,0.0205,891,373.21,347440.76,0.49,0.6824
4914,Ramos Adams and Ruiz,False,IN,Lake Brianna,SaaS,2020,https://ramosadamsandruiz.com,Performance business section always miss.,22,ramos-adams-and-ruiz,2023,USD,995813,165294,830519,585213,245306,0,245306,9958,19916,225390,86650,707463,80130,627333,82984.42,995813,20.55,134.18,0.001,656,126.31,49253.06,1.76,0.834
4915,Tucker Inc,False,ZA,North Samuel,AgriTech,2013,https://tuckerinc.com,Police say sometimes drop beat most where.,19,tucker-inc,2023,USD,382739,143377,239362,266425,-27063,0,-27063,3827,7654,-34717,5274,235234,92038,143196,,382739,931.81,2818.42,0.0538,234,136.04,27218.16,0.19,0.6254
4916,Oneill-Griffin,False,IN,Whitakerstad,HealthTech,2018,https://oneill-griffin.com,Health article benefit husband end.,16,oneill-griffin,2023,USD,671060,166113,504947,363361,141586,0,141586,6710,13421,128165,79914,532277,194278,337999,55921.67,671060,264.0,379.37,0.0348,928,60.25,50246.5,1.59,0.7525
4917,Franklin-Taylor,False,TN,Darylland,EdTech,2014,https://franklin-taylor.com,Impact whom memory because pressure agree glass turn piece.,14,franklin-taylor,2023,USD,269800,84010,185790,201092,-15302,0,-15302,2698,5396,-20698,4957,320194,16009,304185,22483.33,269800,809.41,1943.9,0.054,308,72.91,32225.65,0.15,0.6886
4918,Mercado and Sons,False,IN,West Jeffrey,EdTech,2013,https://mercadoandsons.com,Form page guess our Congress shoulder work seek.,21,mercado-and-sons,2023,USD,787697,237760,549937,145145,404792,0,404792,7876,15753,389039,46071,607290,187026,420264,65641.42,787697,10.0,71.42,0.0582,4290,15.3,36999.82,1.25,0.6982
4919,Cabrera-Smith,False,IN,Ericksonport,AgriTech,2022,https://cabrera-smith.com,Able community central gun man east.,21,cabrera-smith,2023,USD,503417,249999,253418,212677,40741,20368,20373,5034,10068,10305,212196,640479,333441,307038,,503417,38.46,77.04,0.0367,343,122.08,47370.65,4.48,0.5034
4920,Ford-Williams,False,IN,North Paultown,Fintech,2023,https://ford-williams.com,Sea be discussion special difference.,16,ford-williams,2023,USD,1235880,282883,952997,61794,891203,12057,879146,12358,24717,854429,25120,711299,230827,480472,,1235880,20.0,10.0,0.074,1239,83.12,1000.0,25.12,0.7711
4921,Clark Ltd,False,CA,East Michael,IoT,2019,https://clarkltd.com,Difference read result else debate involve suffer.,21,clark-ltd,2023,USD,396320,239833,156487,273315,-116828,7292,-124120,3963,7926,-132046,13668,355193,36883,318310,,396320,1097.96,4117.0,0.0221,108,304.8,56344.12,0.24,0.3949
4922,Johnson-Taylor,False,CA,Bushville,Marketplaces,2024,https://johnson-taylor.com,Ball house whole close fire traditional.,23,johnson-taylor,2023,USD,1112070,384136,727934,1049119,-321185,27666,-348851,11120,22241,-371092,18236,757407,249591,507816,,1112070,609.4,4456.03,0.0015,911,101.7,101474.45,0.18,0.6546
4923,Jackson and Sons,False,EG,Thomasside,Marketplaces,2013,https://jacksonandsons.com,Design into say rest others open recently.,16,jackson-and-sons,2023,USD,719735,409622,310113,168416,141697,470,141227,7197,14394,126833,25019,389056,19452,369604,,719735,856.75,1051.7,0.001,561,106.78,9877.16,2.53,0.4309
4924,Aguilar-Carpenter,False,US,North Michaelville,IoT,2020,https://aguilar-carpenter.com,Picture scientist attorney tell view most back serious.,17,aguilar-carpenter,2023,USD,173884,57024,116860,64430,52430,2354,50076,1738,3477,46599,31561,282627,174314,108313,,173884,20.0,61.94,0.0319,114,126.65,36894.22,0.86,0.6721
4925,Gonzalez-Villarreal,False,GB,Jessicaland,AI/ML,2014,https://gonzalez-villarreal.com,Poor cut system artist pay next pressure down.,29,gonzalez-villarreal,2023,USD,559128,215311,343817,198098,145719,0,145719,5591,11182,134537,103446,499666,209672,289994,,559128,1636.44,5759.5,0.0665,1022,45.56,26145.16,3.96,0.6149
4926,Santos Ltd,False,ZA,Albertland,Energy,2019,https://santosltd.com,West color rock mouth address road indicate student.,24,santos-ltd,2023,USD,7047461,995634,6051827,6291984,-240157,0,-240157,70474,140949,-381106,168498,3888070,1069909,2818161,,7047461,20.0,98.13,0.0887,2841,206.71,503297.65,0.33,0.8587
4927,Martinez-Garrett,False,BR,Barrettshire,Marketplaces,2017,https://martinez-garrett.com,Deep take continue idea perform hundred entire television we turn.,19,martinez-garrett,2023,USD,1984351,768160,1216191,1795755,-579564,0,-579564,19843,39687,-619251,27955,1114683,139229,975454,,1984351,1993.16,11485.98,0.0053,508,325.35,148029.92,0.19,0.6129
4928,Harris-Rice,False,DE,Hicksville,E-commerce,2024,https://harris-rice.com,Report help return cover approach floor.,19,harris-rice,2023,EUR,597689,210895,386794,218568,168226,12581,155645,5976,11953,143692,24959,325627,127094,198533,,597689,20.0,10.0,0.0523,2490,20.0,9407.13,2.65,0.6471
4929,Powell-Schmitt,False,NG,Lake Keith,Cybersecurity,2016,https://powell-schmitt.com,Film score condition music today through choice.,22,powell-schmitt,2023,USD,1577092,414860,1162232,789824,372408,240,372168,15770,31541,340627,16530,848311,343373,504938,,1577092,20.0,43.32,0.0553,970,135.44,97107.96,0.17,0.7369
4930,Miller-Moore,False,FR,Gibbsland,AI/ML,2014,https://miller-moore.com,Possible consider keep paper television both its real news.,27,miller-moore,2023,EUR,1993789,979151,1014638,871376,143262,23968,119294,19937,39875,79419,67491,1224384,463554,760830,,1993789,882.74,3089.16,0.0313,8307,20.0,95159.32,0.71,0.5089
4931,Smith-Archer,False,IN,Perezchester,EdTech,2022,https://smith-archer.com,Suddenly bring Congress stock fast professor see decade.,17,smith-archer,2023,USD,190012,41811,148201,59212,88989,11741,77248,1900,3800,73448,4449,195374,92673,102701,15834.33,190012,157.19,526.25,0.0723,208,75.86,31188.66,0.14,0.78
4932,Clay Group,False,IN,Lake Emilyfort,SaaS,2011,https://claygroup.com,Customer matter lose perhaps mind.,12,clay-group,2023,USD,1963532,619181,1344351,719264,625087,12843,612244,19635,39270,572974,95110,1114792,526885,587907,163627.67,1963532,588.96,2249.11,0.0716,2364,69.19,60294.39,1.58,0.6847
4933,Johnson-Owens,False,NG,West Madisonberg,Marketplaces,2013,https://johnson-owens.com,Produce war interest identify father.,19,johnson-owens,2023,USD,369835,84626,285209,62264,222945,0,222945,3698,7396,215549,18074,260985,114339,146646,,369835,1169.13,584.57,0.0729,156,196.65,25729.69,0.7,0.7712
4934,Schmidt Lopez and Hale,False,EG,Johnland,HealthTech,2022,https://schmidtlopezandhale.com,Can page brother during follow spend.,16,schmidt-lopez-and-hale,2023,USD,363630,107113,256517,57233,199284,21259,178025,3636,7272,170753,40812,368923,75423,293500,30302.5,363630,10.0,66.62,0.0274,881,34.37,39138.37,1.04,0.7054
4935,Gordon Inc,False,KE,Karenside,E-commerce,2019,https://gordoninc.com,Town assume image catch hear per.,23,gordon-inc,2023,USD,1984494,872937,1111557,500418,611139,0,611139,19844,39689,571450,24837,1025202,362898,662304,,1984494,111.4,292.24,0.012,8268,20.0,47195.99,0.53,0.5601
4936,Thompson and Sons,False,KE,Alanhaven,Energy,2009,https://thompsonandsons.com,Play threat marriage off most enter bag.,19,thompson-and-sons,2023,USD,2319524,1059685,1259839,1870075,-610236,23991,-634227,23195,46390,-680617,70479,1391066,497561,893505,,2319524,20.0,65.27,0.0305,9664,20.0,153161.92,0.46,0.5431
4937,Beard and Sons,False,CA,Deborahberg,Cybersecurity,2011,https://beardandsons.com,Matter final threat cell both cultural carry long tax technology.,18,beard-and-sons,2023,USD,2148109,852093,1296016,1076844,219172,23852,195320,21481,42962,152358,596626,1828746,1134047,694699,,2148109,455.37,2723.94,0.0449,8950,20.0,72534.95,8.23,0.6033
4938,Krueger Flynn and Hart,False,BR,Marshhaven,E-commerce,2008,https://kruegerflynnandhart.com,Home voice town mention smile.,21,krueger-flynn-and-hart,2023,USD,1055343,532670,522673,623475,-100802,0,-100802,10553,21106,-121908,35963,695351,259214,436137,,1055343,20.0,10.0,0.0592,770,114.2,34088.69,1.05,0.4953
4939,Brown Austin and Hunter,False,GB,Parkville,Energy,2023,https://brownaustinandhunter.com,Radio follow with soon across later once size fast heart.,12,brown-austin-and-hunter,2023,USD,395653,155600,240053,247317,-7264,27065,-34329,3956,7913,-42242,12651,262846,94082,168764,,395653,1270.47,8149.34,0.0388,740,44.51,50388.83,0.25,0.6067
4940,Johnson-Wells,False,CA,New Mackenziemouth,E-commerce,2011,https://johnson-wells.com,Door life gun design organization really PM now wall fire trip.,21,johnson-wells,2023,USD,2036947,1224998,811949,271247,540702,0,540702,20369,40738,499964,183762,1378065,93726,1284339,,2036947,224.63,683.45,0.0187,6300,26.94,37645.78,4.88,0.3986
4941,Sanchez Browning and Lee,False,GB,Lake Joseph,E-commerce,2017,https://sanchezbrowningandlee.com,School world culture rest their hotel seem significant tell during rule.,20,sanchez-browning-and-lee,2023,USD,1539273,1099487,439786,178872,260914,0,260914,15392,30785,230129,204872,1026419,449342,577077,,1539273,20.0,75.97,0.116,700,183.15,18382.78,11.14,0.2857
4942,Smith Nguyen and Baker,False,GB,Lake Robertafort,Mobility,2013,https://smithnguyenandbaker.com,Above size help send necessary wrong why specific social ready.,9,smith-nguyen-and-baker,2023,USD,916712,538322,378390,396016,-17626,21243,-38869,9167,18334,-57203,39252,652241,446985,205256,,916712,47.88,212.1,0.0191,1436,53.19,26826.65,1.46,0.4128
4943,Robertson-Jackson,False,AU,Jenniferville,SaaS,2022,https://robertson-jackson.com,Lose thing science billion resource inside.,25,robertson-jackson,2023,USD,179711,37744,141967,8985,132982,0,132982,1797,3594,129388,3267,278129,84981,193148,14975.92,179711,205.09,753.03,0.0142,173,86.27,8991.4,0.36,0.79
4944,Huerta-Brandt,False,AU,Smithmouth,IoT,2022,https://huerta-brandt.com,Film important front free person student compare determine.,25,huerta-brandt,2023,USD,576821,113552,463269,28841,434428,24670,409758,5768,11536,398222,36519,464995,236186,228809,,576821,20.0,40.77,0.0819,2324,20.68,1000.0,36.52,0.8031
4945,Barnes Kaufman and Edwards,False,KE,Davidside,IoT,2021,https://barneskaufmanandedwards.com,Choice great method environment almost player.,27,barnes-kaufman-and-edwards,2023,USD,2099347,905529,1193818,1098327,95491,8721,86770,20993,41986,44784,31366,1172295,188375,983920,,2099347,415.92,3042.47,0.0789,8747,20.0,99843.46,0.31,0.5687
4946,Lambert PLC,False,ZA,West Austinport,Energy,2023,https://lambertplc.com,Run protect big figure fish read wish.,17,lambert-plc,2023,USD,1691753,882229,809524,878334,-68810,12124,-80934,16917,33835,-114769,216539,1118482,294562,823920,,1691753,1656.1,828.05,0.056,456,308.99,67769.22,3.2,0.4785
4947,Adkins Rodriguez and Chen,False,DE,Gravesmouth,AgriTech,2019,https://adkinsrodriguezandchen.com,Big make century couple remember ground indicate stuff.,20,adkins-rodriguez-and-chen,2023,EUR,2779282,1305361,1473921,992502,481419,30713,450706,27792,55585,395121,223095,1701232,1271819,429413,,2779282,287.23,921.4,0.059,1250,185.23,116107.28,1.92,0.5303
4948,Roberts Group,False,KE,Lake Jennifer,E-commerce,2023,https://robertsgroup.com,Various task ground material chance have building beat.,16,roberts-group,2023,USD,1855989,487747,1368242,863065,505177,2407,502770,18559,37119,465651,277633,1364486,585890,778596,,1855989,594.32,297.16,0.1648,1237,124.96,82925.14,3.35,0.7372
4949,Johnson and Sons,False,BR,Stoneshire,Energy,2017,https://johnsonandsons.com,Little there item building computer car staff I keep.,24,johnson-and-sons,2023,USD,3638369,1148848,2489521,2679868,-190347,6242,-196589,36383,72767,-269356,714989,2655546,663220,1992326,,3638369,20.0,106.73,0.0951,3639,83.3,203444.35,3.51,0.6842
4950,Reed-Ward,False,US,Deanport,EdTech,2024,https://reed-ward.com,Billion range country him high they before.,24,reed-ward,2023,USD,336921,92966,243955,236528,7427,266,7161,3369,6738,423,25334,321823,85438,236385,28076.75,336921,809.14,5202.8,0.0277,336,83.43,41408.68,0.61,0.7241
4951,Stokes and Sons,False,FR,Haroldbury,Energy,2021,https://stokesandsons.com,Huge television off bank live once third score range level.,26,stokes-and-sons,2023,EUR,3632710,2299665,1333045,2387388,-1054343,0,-1054343,36327,72654,-1126997,247960,2199553,446904,1752649,,3632710,1677.79,838.9,0.0237,15136,20.0,177506.6,1.4,0.367
4952,Ingram Odom and Gibson,False,AU,South Michael,AgriTech,2020,https://ingramodomandgibson.com,Describe sister sit minute here.,18,ingram-odom-and-gibson,2023,USD,397041,69703,327338,238033,89305,0,89305,3970,7940,81365,9084,349427,64431,284996,,397041,142.93,632.91,0.0124,551,59.96,37871.96,0.24,0.8244
4953,Ruiz and Sons,False,KE,Thomasmouth,SaaS,2013,https://ruizandsons.com,From PM appear one training early defense be continue design.,26,ruiz-and-sons,2023,USD,2160036,515356,1644680,1534986,109694,0,109694,21600,43200,66494,46260,1230124,95310,1134814,180003.0,2160036,381.07,2826.86,0.001,1340,134.33,129361.52,0.36,0.7614
4954,Evans-Russell,False,NG,Lake Lisa,HealthTech,2017,https://evans-russell.com,Any of lead choose tend however service entire.,25,evans-russell,2023,USD,1674863,264473,1410390,691051,719339,7483,711856,16748,33497,678359,47226,909856,114713,795143,139571.92,1674863,10.0,31.02,0.0368,1981,70.43,31870.53,1.48,0.8421
4955,Smith-Peterson,False,KE,East Thomastown,Cybersecurity,2024,https://smith-peterson.com,Together save a hair second everyone.,16,smith-peterson,2023,USD,339545,187663,151882,111356,40526,0,40526,3395,6790,33736,105402,450847,290204,160643,,339545,20.0,32.67,0.0797,1414,20.0,1000.0,105.4,0.4473
4956,Romero-Griffin,False,DE,East Jesseburgh,IoT,2012,https://romero-griffin.com,Light down major strategy million its charge including deep skill.,23,romero-griffin,2023,EUR,398369,64668,333701,127201,206500,0,206500,3983,7967,198533,14046,289889,77563,212326,,398369,20.0,41.71,0.0367,631,52.61,1000.0,14.05,0.8377
4957,Pena Brown and Edwards,False,GB,Millermouth,Marketplaces,2018,https://penabrownandedwards.com,These benefit moment maintain read moment people.,12,pena-brown-and-edwards,2023,USD,553555,226568,326987,341667,-14680,0,-14680,5535,11071,-25751,49380,418698,114302,304396,,553555,1913.44,6857.23,0.1776,202,228.02,1000.0,49.38,0.5907
4958,Norris LLC,False,AU,Lake Desireetown,SaaS,2010,https://norrisllc.com,News effort way hair.,27,norris-llc,2023,USD,3557616,1184079,2373537,2183230,190307,13496,176811,35576,71152,105659,161539,2038558,1451041,587517,296468.0,3557616,626.1,1794.68,0.0032,5274,56.21,180219.48,0.9,0.6672
4959,Perez Cooper and Duarte,False,IN,North Brandonfort,HealthTech,2019,https://perezcooperandduarte.com,So reveal physical agency tough.,23,perez-cooper-and-duarte,2023,USD,945973,405291,540682,391715,148967,34116,114851,9459,18919,95932,205924,795668,153524,642144,78831.08,945973,190.96,661.96,0.0697,1000,78.8,11753.39,17.52,0.5716
4960,Baker Finley and Walker,False,EG,Lake Lisamouth,Energy,2013,https://bakerfinleyandwalker.com,Exactly growth look series child be.,20,baker-finley-and-walker,2023,USD,500163,168985,331178,25008,306170,0,306170,5001,10003,296167,16976,307218,160618,146600,,500163,1463.51,6767.67,0.119,1845,22.59,12351.97,1.37,0.6621
4961,Medina and Sons,False,EG,North Chelsea,SaaS,2012,https://medinaandsons.com,Drop visit area senior tend music man.,25,medina-and-sons,2023,USD,1011023,467829,543194,340994,202200,0,202200,10110,20220,181980,24061,621039,393144,227895,84251.92,1011023,348.7,1306.94,0.001,814,103.41,33922.18,0.71,0.5373
4962,Bell Lopez and Dudley,False,DE,East Jessicatown,HealthTech,2017,https://belllopezanddudley.com,Up wide interest them keep.,21,bell-lopez-and-dudley,2023,EUR,945067,386782,558285,261293,296992,0,296992,9450,18901,278091,27004,655491,101789,553702,78755.58,945067,10.0,28.87,0.0114,3140,25.08,32612.93,0.83,0.5907
4963,Sutton-Palmer,False,IN,Port Alexaview,Fintech,2013,https://sutton-palmer.com,Series him tell family movement maybe.,23,sutton-palmer,2023,USD,652939,136446,516493,253286,263207,0,263207,6529,13058,250149,10326,375340,85338,290002,,652939,110.38,428.78,0.0076,236,230.43,28859.94,0.36,0.791
4964,Ho Franco and Christensen,False,DE,West Theresa,EdTech,2021,https://hofrancoandchristensen.com,Girl fish choice finish special expert model do company.,18,ho-franco-and-christensen,2023,EUR,102171,21750,80421,44961,35460,0,35460,1021,2043,33417,13543,87662,28762,58900,8514.25,102171,219.91,224.9,0.0134,1702,5.0,4023.12,3.37,0.7871
4965,Garcia-Owens,False,FR,South Marialand,Cybersecurity,2015,https://garcia-owens.com,Fund fear lead couple address prevent eye fight national reach.,18,garcia-owens,2023,EUR,1539224,531638,1007586,747003,260583,0,260583,15392,30784,229799,65736,946210,47310,898900,,1539224,368.93,1037.89,0.0396,2627,48.81,33783.02,1.95,0.6546
4966,Jones-Webster,False,GB,New Teresa,Marketplaces,2019,https://jones-webster.com,At job guess young hundred movie Mr rise.,23,jones-webster,2023,USD,2308830,482846,1825984,1570756,255228,25745,229483,23088,46176,183307,124553,1343618,991474,352144,,2308830,816.29,546.36,0.0116,9620,20.0,143113.57,0.87,0.7909
4967,Harrington Morris and Evans,False,US,Ortiztown,Mobility,2013,https://harringtonmorrisandevans.com,Wide stay religious turn sister theory various deep admit.,16,harrington-morris-and-evans,2023,USD,390036,110138,279898,129807,150091,12027,138064,3900,7800,130264,19369,298920,103315,195605,,390036,1814.52,5027.22,0.1597,1625,20.0,20287.3,0.95,0.7176
4968,Lopez Mann and Woods,False,CA,South Margaretborough,Fintech,2023,https://lopezmannandwoods.com,Society field truth lose song continue.,15,lopez-mann-and-woods,2023,USD,1651969,799444,852525,760597,91928,25532,66396,16519,33039,33357,39032,929167,382154,547013,,1651969,1432.61,4038.57,0.073,2263,60.83,94632.95,0.41,0.5161
4969,Wilson-Bailey,False,NG,Andrewside,Marketplaces,2020,https://wilson-bailey.com,One now address behavior us argue.,18,wilson-bailey,2023,USD,708044,356322,351722,127210,224512,0,224512,7080,14160,210352,26377,488363,219870,268493,,708044,683.65,414.85,0.0552,2950,20.0,36529.67,0.72,0.4968
4970,Sanchez-Choi,False,ZA,North Elizabethville,EdTech,2023,https://sanchez-choi.com,Old large do wear night news figure technology over interest.,16,sanchez-choi,2023,USD,247451,74466,172985,33395,139590,21153,118437,2474,4949,113488,4838,198444,37612,160832,20620.92,247451,672.63,3194.71,0.0056,1471,14.01,4178.32,1.16,0.6991
4971,Chavez Group,False,BR,New Sharonmouth,Energy,2022,https://chavezgroup.com,Specific organization answer employee area head.,12,chavez-group,2023,USD,3988033,967956,3020077,882486,2137591,9412,2128179,39880,79760,2048419,51575,2062887,444239,1618648,,3988033,835.07,4601.2,0.0475,3756,88.47,108511.68,0.48,0.7573
4972,Gordon Jackson and Williams,False,ZA,Johnnyfurt,EdTech,2011,https://gordonjacksonandwilliams.com,Expect stop debate piece too likely Congress food man yard.,22,gordon-jackson-and-williams,2023,USD,2568877,938138,1630739,1810784,-180045,0,-180045,25688,51377,-231422,441646,1733400,845542,887858,214073.08,2568877,705.47,2942.06,0.0358,3690,58.0,162252.33,2.72,0.6348
4973,Walker Parker and Schneider,False,TN,West Manuelhaven,HealthTech,2018,https://walkerparkerandschneider.com,Up culture collection democratic this attention.,20,walker-parker-and-schneider,2023,USD,571344,190143,381201,47732,333469,0,333469,5713,11426,322043,3903,323627,148291,175336,47612.0,571344,348.07,2111.98,0.0515,9522,5.0,5170.29,0.75,0.6672
4974,Robinson Rowe and Snow,False,AU,East Ray,HealthTech,2020,https://robinsonroweandsnow.com,East information ask them court better.,18,robinson-rowe-and-snow,2023,USD,2176524,660256,1516268,1033471,482797,8504,474293,21765,43530,430763,186616,1350110,656822,693288,181377.0,2176524,154.1,791.93,0.0349,1799,100.8,99496.5,1.88,0.6966
4975,Cervantes-Hughes,False,AU,Grantberg,E-commerce,2017,https://cervantes-hughes.com,Ground war decide audience mother sure resource.,21,cervantes-hughes,2023,USD,661269,356848,304421,338563,-34142,18036,-52178,6612,13225,-65403,26110,439388,218584,220804,,661269,616.95,2340.01,0.0418,2755,20.0,21124.57,1.24,0.4604
4976,Carter-Parker,False,BR,Greeneport,Cybersecurity,2021,https://carter-parker.com,Moment from current expect better understand network money blood stock.,28,carter-parker,2023,USD,1019915,365875,654040,818230,-164190,8352,-172542,10199,20398,-192940,59276,727802,280752,447050,,1019915,1212.96,5400.98,0.0364,357,237.73,94533.94,0.63,0.6413
4977,Miller-Nixon,False,KE,Fritzfurt,Energy,2010,https://miller-nixon.com,Employee how unit appear culture idea field bar.,15,miller-nixon,2023,USD,917849,365226,552623,161920,390703,0,390703,9178,18356,372347,18340,600820,254709,346111,,917849,1656.47,7696.76,0.1086,961,79.54,23014.14,0.8,0.6021
4978,Ruiz Inc,False,CA,Melissaland,Mobility,2008,https://ruizinc.com,Fish each sea spring.,24,ruiz-inc,2023,USD,1074434,303996,770438,411698,358740,0,358740,10744,21488,337252,251779,798521,48451,750070,,1074434,351.56,1398.49,0.0614,275,324.59,34019.89,7.4,0.7171
4979,Ramos PLC,False,DE,Lake Jose,IoT,2013,https://ramosplc.com,Picture record of skin particularly around threat their kid my.,14,ramos-plc,2023,EUR,4446489,778529,3667960,1519540,2148420,0,2148420,44464,88929,2059491,373136,2704622,722686,1981936,,4446489,755.32,2649.87,0.0706,18527,20.0,124596.61,2.99,0.8249
4980,Wu-Hunter,False,AU,Chelsealand,EdTech,2019,https://wu-hunter.com,Company open put brother team its strong onto investment around young.,18,wu-hunter,2023,USD,322739,143484,179255,101965,77290,0,77290,3227,6454,70836,15843,285095,198144,86951,26894.92,322739,198.15,425.93,0.001,297,90.28,3108.09,5.1,0.5554
4981,Kane Green and Burch,False,CA,Hernandezview,E-commerce,2024,https://kanegreenandburch.com,Skill return budget prepare appear mother again actually force.,19,kane-green-and-burch,2023,USD,150225,25582,124643,60703,63940,11875,52065,1502,3004,49061,35229,190921,112222,78699,,150225,1060.46,3477.98,0.0595,625,20.0,48206.98,0.73,0.8297
4982,Stephenson Ltd,False,US,Lake Victorfurt,IoT,2020,https://stephensonltd.com,Weight benefit whether effort rate.,23,stephenson-ltd,2023,USD,154564,76707,77857,32440,45417,0,45417,1545,3091,42326,9338,248471,79181,169290,,154564,810.51,2875.16,0.001,62,206.46,16926.13,0.55,0.5037
4983,Hayes-Hall,False,FR,Smithhaven,Marketplaces,2015,https://hayes-hall.com,House course wall public so heart.,13,hayes-hall,2023,EUR,951240,295990,655250,696344,-41094,3198,-44292,9512,19024,-63316,104413,706625,379167,327458,,951240,20.0,10.0,0.0356,1823,43.47,53884.96,1.94,0.6888
4984,Bates LLC,False,GB,Lake Sethmouth,Mobility,2014,https://batesllc.com,Cold nor study scene wall myself describe reach now.,18,bates-llc,2023,USD,1569699,310369,1259330,839844,419486,18403,401083,15696,31393,369690,292932,1190450,157796,1032654,,1569699,191.73,235.88,0.0589,710,184.08,88227.65,3.32,0.8023
4985,Jones PLC,False,US,Annetteton,EdTech,2017,https://jonesplc.com,At only gun force billion back fast realize them.,23,jones-plc,2023,USD,456305,211515,244790,358707,-113917,0,-113917,4563,9126,-123043,4724,265597,58017,207580,38025.42,456305,10.0,71.84,0.1194,609,62.42,4527.45,1.04,0.5365
4986,Thompson-Olsen,False,TN,Melaniefurt,Fintech,2018,https://thompson-olsen.com,Cut reason room she by his able summer key.,18,thompson-olsen,2023,USD,539705,192600,347105,196576,150529,0,150529,5397,10794,139735,5984,383569,146118,237451,,539705,901.75,1672.96,0.0922,158,282.87,1000.0,5.98,0.6431
4987,Maldonado Group,False,TN,West Joshuahaven,Marketplaces,2013,https://maldonadogroup.com,Husband thank above operation dark nice around drug.,23,maldonado-group,2023,USD,225407,105653,119754,42263,77491,4113,73378,2254,4508,68870,2432,279126,162315,116811,,225407,385.89,1915.04,0.0802,64,291.59,20297.95,0.12,0.5313
4988,Fowler-Clark,False,TN,North Cynthia,HealthTech,2017,https://fowler-clark.com,Return certain item wind may be save.,23,fowler-clark,2023,USD,906984,416476,490508,45349,445159,6062,439097,9069,18139,420958,313535,921212,412155,509057,75582.0,906984,341.91,1151.89,0.001,1222,61.84,1000.0,313.54,0.5408
4989,Parsons-Campos,False,IN,East Paulmouth,Energy,2023,https://parsons-campos.com,President game still than parent worker arrive thousand peace him.,19,parsons-campos,2023,USD,3927888,1118031,2809857,2031521,778336,5087,773249,39278,78557,694692,749161,2888195,1054023,1834172,,3927888,981.39,3846.31,0.0804,3633,90.09,191135.14,3.92,0.7154
4990,Anderson Boyd and Vasquez,False,US,New Trevor,AgriTech,2021,https://andersonboydandvasquez.com,Attack quite sea spend foreign much.,15,anderson-boyd-and-vasquez,2023,USD,665768,287133,378635,486571,-107936,16599,-124535,6657,13315,-137850,88068,468577,136899,331678,,665768,1060.93,1899.6,0.0131,2699,20.55,39992.8,2.2,0.5687
4991,Ramirez and Sons,False,GB,Port Jessicaburgh,HealthTech,2020,https://ramirezandsons.com,Realize technology rule Mrs security.,25,ramirez-and-sons,2023,USD,2858729,1794000,1064729,972209,92520,0,92520,28587,57174,35346,34792,1535079,654712,880367,238227.42,2858729,152.82,635.16,0.0206,9707,24.54,75263.38,0.46,0.3724
4992,Matthews LLC,False,BR,Lancemouth,AI/ML,2011,https://matthewsllc.com,Population floor western tree decide.,18,matthews-llc,2023,USD,706786,312979,393807,542813,-149006,3033,-152039,7067,14135,-166174,56210,592277,29613,562664,,706786,20.0,59.77,0.0284,2416,24.37,32728.19,1.72,0.5572
4993,Moore PLC,False,EG,Destinyport,Fintech,2019,https://mooreplc.com,Cell receive factor democratic particular community.,20,moore-plc,2023,USD,1182295,481701,700594,637815,62779,16568,46211,11822,23645,22566,84338,680867,193317,487550,,1182295,441.4,2464.53,0.0152,4926,20.0,41028.22,2.06,0.5926
4994,Robertson-Curtis,False,BR,Port Angeltown,Cybersecurity,2011,https://robertson-curtis.com,On realize others establish save season reach bar physical leave.,10,robertson-curtis,2023,USD,5841614,2204068,3637546,2778432,859114,10452,848662,58416,116832,731830,114747,3119702,1152222,1967480,,5841614,676.68,2846.16,0.0826,8089,60.18,243005.85,0.47,0.6227
4995,Randolph and Sons,False,BR,Richardsstad,Energy,2008,https://randolphandsons.com,Scene analysis describe hear fish.,27,randolph-and-sons,2023,USD,485403,85621,399782,24270,375512,11193,364319,4854,9708,354611,178568,538855,309087,229768,,485403,333.12,220.96,0.01,2022,20.0,29571.03,6.04,0.8236
4996,Roberts and Sons,False,GB,Rogershire,E-commerce,2012,https://robertsandsons.com,Author explain provide threat feeling believe everybody.,23,roberts-and-sons,2023,USD,2608020,728667,1879353,740764,1138589,32846,1105743,26080,52160,1053583,43651,1504563,462861,1041702,,2608020,2077.31,2573.59,0.001,1705,127.41,39000.41,1.12,0.7206
4997,Ortiz-Bauer,False,KE,North Abigailville,AI/ML,2020,https://ortiz-bauer.com,Bed specific across how father option son benefit.,23,ortiz-bauer,2023,USD,1687078,310707,1376371,1473027,-96656,0,-96656,16870,33741,-130397,11962,988528,368585,619943,,1687078,20.0,81.0,0.0088,1066,131.87,112999.79,0.11,0.8158
4998,Frost Meza and Martin,False,BR,Lake Renee,Mobility,2008,https://frostmezaandmartin.com,Shake hold myself born keep level image.,15,frost-meza-and-martin,2023,USD,1224176,399822,824354,703818,120536,27890,92646,12241,24483,68163,118939,791415,249811,541604,,1224176,525.94,1495.3,0.001,4040,25.25,73132.58,1.63,0.6734
4999,Frost-Harris,False,EG,Benjaminshire,Marketplaces,2020,https://frost-harris.com,Political unit leave give culture.,26,frost-harris,2023,USD,249246,90365,158881,164217,-5336,23605,-28941,2492,4984,-33925,9571,160680,11883,148797,,249246,741.91,3570.81,0.0211,1038,20.0,13488.76,0.71,0.6374
5000,Norman and Sons,False,TN,Crystaltown,SaaS,2017,https://normanandsons.com,Condition cold accept anything billion.,24,norman-and-sons,2023,USD,1036225,679611,356614,838612,-481998,0,-481998,10362,20724,-502722,80333,708670,427586,281084,86352.08,1036225,198.56,549.31,0.0135,4521,19.1,85214.42,0.94,0.3441
5001,Thornton LLC,False,TN,West Daniel,AgriTech,2011,https://thorntonllc.com,Rate travel we cause tend ten send he.,12,thornton-llc,2023,USD,68478,23974,44504,25736,18768,27775,-9007,684,1369,-10376,34368,94215,42622,51593,,68478,578.33,2562.29,0.0651,42,135.05,1000.0,34.37,0.6499
5002,Williams PLC,False,KE,Lake Cassandrashire,Mobility,2024,https://williamsplc.com,Unit hold soon over relate difficult how behind.,22,williams-plc,2023,USD,228582,144794,83788,80461,3327,0,3327,2285,4571,-1244,6114,161534,74463,87071,,228582,20.0,83.52,0.0938,407,46.73,18817.75,0.32,0.3666
5003,Camacho-Johnson,False,CA,West Emmaberg,Mobility,2018,https://camacho-johnson.com,Hot I or southern low film man administration lose outside.,26,camacho-johnson,2023,USD,4849370,2170105,2679265,2500053,179212,0,179212,48493,96987,82225,226171,2732112,843913,1888199,,4849370,20.0,80.94,0.1542,8340,48.45,185812.12,1.22,0.5525
5004,Rivera Taylor and Lawson,False,NG,Donnaside,E-commerce,2011,https://riverataylorandlawson.com,Kind three notice her another house eye realize for newspaper.,24,rivera-taylor-and-lawson,2023,USD,751684,233469,518215,357602,160613,5901,154712,7516,15033,139679,100332,549714,223540,326174,,751684,1165.15,5044.62,0.096,342,182.9,34060.25,2.95,0.6894
5005,Goodman Inc,False,AU,Davidstad,HealthTech,2021,https://goodmaninc.com,Serious individual serious from body.,24,goodman-inc,2023,USD,567564,245908,321656,77325,244331,0,244331,5675,11351,232980,14216,336802,144317,192485,47297.0,567564,236.13,603.48,0.0353,425,111.04,6572.7,2.16,0.5667
5006,Mccann Wallace and Duke,False,NG,Jeffreyview,Energy,2010,https://mccannwallaceandduke.com,Finish let third through popular message trouble.,25,mccann-wallace-and-duke,2023,USD,2154822,717527,1437295,1489227,-51932,0,-51932,21548,43096,-95028,213370,1391704,487168,904536,,2154822,1375.55,7316.77,0.0327,2246,79.95,170800.13,1.25,0.667
5007,Velazquez Peters and Fuller,False,GB,Sanchezberg,SaaS,2018,https://velazquezpetersandfuller.com,Serious decide current across movie pretty good.,16,velazquez-peters-and-fuller,2023,USD,1659938,608379,1051559,531495,520064,0,520064,16599,33198,486866,44686,893862,326013,567849,138328.17,1659938,103.8,495.05,0.0329,6968,19.85,48276.56,0.93,0.6335
5008,Martinez Group,False,ZA,Rebeccaville,IoT,2016,https://martinezgroup.com,Central seat person happy tree agency into including.,18,martinez-group,2023,USD,487275,121848,365427,24363,341064,4729,336335,4872,9745,326590,18780,336031,191801,144230,,487275,1065.04,7363.94,0.001,200,202.38,1000.0,18.78,0.7499
5009,Benson-Elliott,False,DE,East Natalie,AI/ML,2022,https://benson-elliott.com,Office should husband with deal.,17,benson-elliott,2023,EUR,924537,287166,637371,436066,201305,1581,199724,9245,18490,181234,62323,560245,28012,532233,,924537,349.16,174.58,0.0308,3852,20.0,45809.38,1.36,0.6894
5010,Schmidt Watson and George,False,TN,Port Alicia,SaaS,2022,https://schmidtwatsonandgeorge.com,Begin recognize keep resource society behavior media yourself.,14,schmidt-watson-and-george,2023,USD,821592,348613,472979,418667,54312,2522,51790,8215,16431,35359,50542,631014,31550,599464,68466.0,821592,646.94,3498.99,0.0075,1539,44.48,6208.93,8.14,0.5757
5011,Smith Ltd,False,IN,New Victorport,SaaS,2011,https://smithltd.com,Compare mouth old study four.,19,smith-ltd,2023,USD,287175,102415,184760,109029,75731,21288,54443,2871,5743,48700,49386,271934,68873,203061,23931.25,287175,164.02,791.95,0.0679,416,57.4,49885.55,0.99,0.6434
5012,Smith Doyle and Villa,False,EG,North Chelsey,Mobility,2019,https://smithdoyleandvilla.com,Firm news tax city model tend contain mention political green.,18,smith-doyle-and-villa,2023,USD,1134985,383490,751495,378736,372759,34950,337809,11349,22699,315110,241612,911828,71703,840125,,1134985,20.0,98.91,0.0315,542,174.2,28278.36,8.54,0.6621
5013,Gibson LLC,False,US,Williamsstad,IoT,2019,https://gibsonllc.com,Throw little meet behavior story produce hold open.,21,gibson-llc,2023,USD,937714,387262,550452,608525,-58073,0,-58073,9377,18754,-76827,13325,679878,58054,621824,,937714,20.0,38.6,0.001,3907,20.0,50865.56,0.26,0.587
5014,Franklin Hernandez and Alexander,False,IN,Lake Vincent,Energy,2018,https://franklinhernandezandalexander.com,Successful man left theory environment use second a.,15,franklin-hernandez-and-alexander,2023,USD,2678282,1140277,1538005,1049059,488946,4387,484559,26782,53565,430994,575183,2059917,224875,1835042,,2678282,400.76,1393.28,0.0099,1721,129.66,63998.54,8.99,0.5743
5015,Martin-Underwood,False,BR,Millerhaven,AgriTech,2008,https://martin-underwood.com,Keep impact still according fund its.,14,martin-underwood,2023,USD,521150,178204,342946,309128,33818,16091,17727,5211,10423,7304,52892,376962,253959,123003,,521150,1164.11,3667.94,0.0451,2171,20.0,58539.81,0.9,0.6581
5016,Tate PLC,False,NG,Ruizhaven,AgriTech,2013,https://tateplc.com,Standard film stand we recognize your.,20,tate-plc,2023,USD,397059,91973,305086,260835,44251,0,44251,3970,7941,36310,61878,393223,232156,161067,,397059,912.12,4769.25,0.0954,1654,20.0,12396.21,4.99,0.7684
5017,Mason-Meyers,False,IN,West Garyside,E-commerce,2021,https://mason-meyers.com,Memory other force now house key choice fast top.,24,mason-meyers,2023,USD,570872,167497,403375,471610,-68235,3746,-71981,5708,11417,-83398,27011,400541,287488,113053,,570872,1279.13,639.57,0.0632,2378,20.0,36895.14,0.73,0.7066
5018,Roberts-Martinez,False,US,Thomasfort,Mobility,2018,https://roberts-martinez.com,Color notice leg compare move not growth into share.,15,roberts-martinez,2023,USD,752854,236149,516705,369506,147199,0,147199,7528,15057,132142,30657,564411,197084,367327,,752854,20.0,10.0,0.1069,3136,20.0,30826.32,0.99,0.6863
5019,Bond-Escobar,False,IN,Ryanstad,Marketplaces,2009,https://bond-escobar.com,Onto director environmental writer organization organization generation citizen must them.,18,bond-escobar,2023,USD,1967244,306857,1660387,1363326,297061,3439,293622,19672,39344,254278,24609,1199604,59980,1139624,,1967244,501.77,3670.09,0.1357,1157,141.68,100385.82,0.25,0.844
5020,Rodriguez Ltd,False,KE,Yolandabury,Fintech,2019,https://rodriguezltd.com,Force memory unit she happy.,21,rodriguez-ltd,2023,USD,488869,174072,314797,109032,205765,0,205765,4888,9777,195988,12607,449470,176050,273420,,488869,414.91,1898.62,0.0462,131,308.91,1000.0,12.61,0.6439
5021,Clark Hall and Gordon,False,ZA,South Victorville,SaaS,2020,https://clarkhallandgordon.com,Expect hair bar teach international letter foreign in property.,22,clark-hall-and-gordon,2023,USD,1687320,422851,1264469,433971,830498,33091,797407,16873,33746,763661,332416,1368201,664692,703509,140610.0,1687320,10.0,34.72,0.07,3162,44.46,35440.64,9.38,0.7494
5022,Garcia-Wilkerson,False,DE,Riosberg,HealthTech,2010,https://garcia-wilkerson.com,Talk pull party record military blue some.,18,garcia-wilkerson,2023,EUR,284153,154420,129733,43573,86160,9128,77032,2841,5683,71349,16709,236712,21920,214792,23679.42,284153,672.01,3836.04,0.0572,365,64.8,20242.58,0.83,0.4566
5023,Osborn Khan and Elliott,False,NG,Saraview,Fintech,2012,https://osbornkhanandelliott.com,Hair three write father tell much group argue school investment.,11,osborn-khan-and-elliott,2023,USD,393027,168264,224763,144910,79853,28540,51313,3930,7860,43453,26542,368135,146564,221571,,393027,106.77,225.64,0.0424,129,253.35,1000.0,26.54,0.5719
5024,Smith Group,False,ZA,Johnfurt,HealthTech,2023,https://smithgroup.com,Style moment bar result floor member list.,19,smith-group,2023,USD,1399660,642734,756926,540102,216824,0,216824,13996,27993,188831,97985,957984,267705,690279,116638.33,1399660,65.93,65.93,0.0355,23327,5.0,83896.6,1.17,0.5408
5025,Carter Inc,False,TN,Angelabury,AgriTech,2019,https://carterinc.com,Report author woman listen kind like director probably star she.,18,carter-inc,2023,USD,102090,19219,82871,12846,70025,0,70025,1020,2041,67984,4132,158841,72911,85930,,102090,400.07,1675.72,0.0937,55,152.2,13039.15,0.32,0.8117
5026,Ramirez Inc,False,EG,South Crystal,Cybersecurity,2015,https://ramirezinc.com,Really sing month up road listen kid information street.,20,ramirez-inc,2023,USD,630625,236262,394363,218364,175999,30933,145066,6306,12612,132454,17697,433222,157874,275348,,630625,73.35,166.48,0.1198,196,267.41,20265.57,0.87,0.6254
5027,Ross Smith and Blackburn,False,ZA,Salinasburgh,AI/ML,2022,https://rosssmithandblackburn.com,General positive mouth think.,16,ross-smith-and-blackburn,2023,USD,616404,99883,516521,278204,238317,0,238317,6164,12328,225989,42029,532596,154668,377928,,616404,2536.32,4456.33,0.001,880,58.36,23928.41,1.76,0.838
5028,Brown Ltd,False,US,South Sheila,Fintech,2018,https://brownltd.com,Continue well business owner social strategy newspaper third.,13,brown-ltd,2023,USD,1226919,389099,837820,147326,690494,40570,649924,12269,24538,625386,78377,850775,160852,689923,,1226919,1159.47,3907.77,0.1086,221,462.21,24397.39,3.21,0.6829
5029,Simon Williams and Brown,False,CA,Frankberg,SaaS,2012,https://simonwilliamsandbrown.com,Save suddenly development exactly husband fund play enter.,25,simon-williams-and-brown,2023,USD,908441,444563,463878,667302,-203424,24268,-227692,9084,18168,-245860,29941,514001,92613,421388,75703.42,908441,10.0,45.46,0.0759,713,106.07,68686.22,0.44,0.5106
5030,Warner PLC,False,KE,Lindastad,Cybersecurity,2011,https://warnerplc.com,Center address artist direction poor force candidate line including energy.,18,warner-plc,2023,USD,2805719,632873,2172846,1553807,619039,19254,599785,28057,56114,543671,422977,2014965,738425,1276540,,2805719,1497.22,4914.31,0.1006,11690,20.0,151027.33,2.8,0.7744
5031,Brennan Cooper and Robinson,False,TN,Robertville,AI/ML,2010,https://brennancooperandrobinson.com,Sit staff read like buy garden success lose financial police.,25,brennan-cooper-and-robinson,2023,USD,1294602,518844,775758,1399878,-624120,27163,-651283,12946,25892,-677175,43047,842485,168561,673924,,1294602,20.0,110.95,0.0863,1126,95.76,126412.92,0.34,0.5992
5032,Hernandez-Mitchell,False,CA,Jessicahaven,Marketplaces,2017,https://hernandez-mitchell.com,Quickly military recognize wind especially position international.,24,hernandez-mitchell,2023,USD,5604827,465887,5138940,3424215,1714725,50166,1664559,56048,112096,1552463,98089,3029007,1007628,2021379,,5604827,20.0,55.23,0.0479,4071,114.73,246204.84,0.4,0.9169
5033,Armstrong Walker and Stuart,False,TN,South Ericafurt,Energy,2008,https://armstrongwalkerandstuart.com,Worry public PM movement short these election bring hand probably.,11,armstrong-walker-and-stuart,2023,USD,2377325,1012645,1364680,1967583,-602903,39054,-641957,23773,47546,-689503,35294,1282394,842269,440125,,2377325,399.14,1956.03,0.1527,4527,43.76,149806.95,0.24,0.574
5034,Reid LLC,False,GB,Smithport,Cybersecurity,2016,https://reidllc.com,Team magazine couple dinner.,23,reid-llc,2023,USD,147144,29853,117291,114064,3227,17499,-14272,1471,2942,-17214,3088,97838,58588,39250,,147144,192.67,1368.34,0.1295,613,20.0,38448.69,0.08,0.7971
5035,Willis-Davis,False,ZA,New Connie,Marketplaces,2010,https://willis-davis.com,Director seven miss decision fund.,25,willis-davis,2023,USD,4236383,2227521,2008862,1853172,155690,36077,119613,42363,84727,34886,142754,2316721,170669,2146052,,4236383,989.74,625.9,0.001,9105,38.77,97603.51,1.46,0.4742
5036,Johnson-Fisher,False,TN,South Christopherstad,Fintech,2014,https://johnson-fisher.com,Father college really foot case guess last party choice strategy.,26,johnson-fisher,2023,USD,5002270,2084217,2918053,1347112,1570941,10852,1560089,50022,100045,1460044,669198,3203248,1301921,1901327,,5002270,20.0,50.38,0.1144,5437,76.66,100315.43,6.67,0.5833
5037,Howard-Poole,False,KE,Deniseview,AgriTech,2017,https://howard-poole.com,About yeah room old nice choose production.,20,howard-poole,2023,USD,920878,505266,415612,64870,350742,29448,321294,9208,18417,302877,33838,619734,30986,588748,,920878,184.12,437.34,0.0611,685,111.93,16739.92,2.02,0.4513
5038,Roth Ltd,False,KE,Laurashire,AI/ML,2015,https://rothltd.com,Country activity dog recent long long price fund yourself.,26,roth-ltd,2023,USD,1100937,318334,782603,799521,-16918,0,-16918,11009,22018,-38936,38850,718171,245457,472714,,1100937,1583.31,841.08,0.001,3574,25.67,47776.54,0.81,0.7109
5039,Perez Castro and Chen,False,ZA,Johnshire,SaaS,2019,https://perezcastroandchen.com,Wrong condition home our scene.,16,perez-castro-and-chen,2023,USD,4534571,1228753,3305818,1902733,1403085,0,1403085,45345,90691,1312394,141820,2558934,1203400,1355534,377880.92,4534571,229.59,673.48,0.0377,7158,52.79,152534.85,0.93,0.729
5040,Vargas-Richardson,False,KE,Brittneyfort,Mobility,2014,https://vargas-richardson.com,Language tell face course.,16,vargas-richardson,2023,USD,1743854,712056,1031798,837814,193984,0,193984,17438,34877,159107,83202,1027490,587559,439931,,1743854,88.06,515.41,0.048,448,323.78,63341.67,1.31,0.5917
5041,Atkins Moore and Holland,False,AU,Anthonyville,Energy,2016,https://atkinsmooreandholland.com,Almost maybe really fly tree write figure defense moment.,25,atkins-moore-and-holland,2023,USD,1982432,316439,1665993,956189,709804,0,709804,19824,39648,670156,629551,1644796,319994,1324802,,1982432,523.19,261.6,0.001,8260,20.0,54015.79,11.65,0.8404
5042,Crawford-Hernandez,False,ZA,South Michael,Cybersecurity,2013,https://crawford-hernandez.com,Upon heavy these letter never attention study business discuss fill.,25,crawford-hernandez,2023,USD,369546,156761,212785,270060,-57275,0,-57275,3695,7390,-64665,2473,212083,83339,128744,,369546,752.54,1189.26,0.0743,344,89.34,10069.49,0.25,0.5758
5043,Li Perkins and Weber,False,IN,Lake Vincent,AI/ML,2009,https://liperkinsandweber.com,Enter mean college his easy heart.,16,li-perkins-and-weber,2023,USD,2012266,774655,1237611,1499055,-261444,14854,-276298,20122,40245,-316543,91822,1219215,691959,527256,,2012266,260.04,130.02,0.0123,2867,58.47,116459.48,0.79,0.615
5044,Rivera Zimmerman and Roberts,False,KE,North Loriview,Energy,2013,https://riverazimmermanandroberts.com,Main month learn time this voice moment happen.,29,rivera-zimmerman-and-roberts,2023,USD,543629,273916,269713,185504,84209,0,84209,5436,10872,73337,132552,489152,165081,324071,,543629,796.17,3043.52,0.0192,2265,20.0,1000.0,132.55,0.4961
5045,Ellis Edwards and Martinez,False,BR,West Steven,AgriTech,2016,https://ellisedwardsandmartinez.com,Will scientist security special affect.,15,ellis-edwards-and-martinez,2023,USD,310816,107757,203059,136800,66259,0,66259,3108,6216,60043,42785,243855,34215,209640,,310816,538.92,1859.31,0.0793,1295,20.0,48988.82,0.87,0.6533
5046,Johnson and Sons,False,US,North Johnberg,Energy,2014,https://johnsonandsons.com,Foot better play morning develop evidence fill subject manage.,17,johnson-and-sons,2023,USD,1538794,592046,946748,558341,388407,2013,386394,15387,30775,355619,90864,875375,43768,831607,,1538794,20.0,79.64,0.1538,6298,20.36,76371.86,1.19,0.6153
5047,Wagner Spence and Allen,False,US,Lake Emilyberg,Energy,2012,https://wagnerspenceandallen.com,Measure result record population run contain mean fast identify beyond.,24,wagner-spence-and-allen,2023,USD,3171679,1190043,1981636,2761224,-779588,0,-779588,31716,63433,-843021,79982,1829666,927892,901774,,3171679,20.0,43.71,0.0752,1099,240.33,250710.07,0.32,0.6248
5048,Jackson Chase and Johnson,False,IN,East Williefort,AgriTech,2022,https://jacksonchaseandjohnson.com,Box purpose rate early ability parent.,17,jackson-chase-and-johnson,2023,USD,237153,141188,95965,152708,-56743,18406,-75149,2371,4743,-79892,2091,313482,33019,280463,,237153,401.41,863.08,0.0464,988,20.0,11358.89,0.18,0.4047
5049,Allison-Andersen,False,KE,Kimberlyside,Marketplaces,2018,https://allison-andersen.com,One particular beautiful cover upon candidate impact compare woman.,16,allison-andersen,2023,USD,935515,223014,712501,335143,377358,1441,375917,9355,18710,357207,48207,583849,35536,548313,,935515,1178.65,2337.06,0.0755,1355,57.5,28930.95,1.67,0.7616
5050,Johnson Levine and Liu,False,FR,Jayhaven,EdTech,2015,https://johnsonlevineandliu.com,His deep somebody camera whose sea win western.,18,johnson-levine-and-liu,2023,EUR,194678,94463,100215,109996,-9781,0,-9781,1946,3893,-13674,10418,147007,32943,114064,16223.17,194678,10.0,39.97,0.0772,504,32.15,1000.0,10.42,0.5148
5051,Snow LLC,False,US,Port Yolanda,Cybersecurity,2018,https://snowllc.com,Admit experience spring story good nice decision table.,18,snow-llc,2023,USD,226251,61680,164571,58687,105884,7108,98776,2262,4525,94251,64705,314311,139433,174878,,226251,210.99,304.56,0.0531,220,85.52,9516.75,6.8,0.7274
5052,Mitchell Brown and Foley,False,DE,Cochranstad,Fintech,2017,https://mitchellbrownandfoley.com,Part this present treat.,23,mitchell-brown-and-foley,2023,EUR,6838556,2992806,3845750,2843949,1001801,42627,959174,68385,136771,822403,305288,3876970,1089770,2787200,,6838556,20.0,10.0,0.0375,28493,20.0,276197.04,1.11,0.5624
5053,Thompson Terry and Mcdaniel,False,ZA,South Carlos,Cybersecurity,2022,https://thompsonterryandmcdaniel.com,Base summer beautiful until practice those concern reach.,18,thompson-terry-and-mcdaniel,2023,USD,2981394,1472170,1509224,149069,1360155,0,1360155,29813,59627,1300528,218845,1829361,763515,1065846,,2981394,1357.83,3442.27,0.0566,12422,20.0,35719.63,6.13,0.5062
5054,Johnson-Thomas,False,KE,South Karen,Energy,2018,https://johnson-thomas.com,Democratic official six decade use.,24,johnson-thomas,2023,USD,782738,350408,432330,419481,12849,0,12849,7827,15654,-2805,140637,710321,35516,674805,,782738,1021.0,3728.61,0.1089,393,165.77,43089.16,3.26,0.5523
5055,Becker Klein and Guerra,False,NG,Tinaport,Energy,2023,https://beckerkleinandguerra.com,Believe teacher civil level prepare process who study.,17,becker-klein-and-guerra,2023,USD,1924022,386770,1537252,1116016,421236,36407,384829,19240,38480,346349,541672,1702117,85105,1617012,,1924022,1992.51,6204.78,0.001,8016,20.0,47653.05,11.37,0.799
5056,Barnes Smith and Griffin,False,NG,Robertsberg,SaaS,2018,https://barnessmithandgriffin.com,Tree also major discuss.,25,barnes-smith-and-griffin,2023,USD,407412,192777,214635,211316,3319,6198,-2879,4074,8148,-11027,26936,302749,63281,239468,33951.0,407412,679.96,1923.6,0.0482,899,37.76,31669.59,0.85,0.5268
5057,Wood Armstrong and Moore,False,CA,East Christopher,E-commerce,2019,https://woodarmstrongandmoore.com,Per matter bring meet involve quality their girl camera you.,17,wood-armstrong-and-moore,2023,USD,1260556,528172,732384,308813,423571,23271,400300,12605,25211,375089,156041,842196,322454,519742,,1260556,20.0,23.59,0.0923,440,238.64,39328.24,3.97,0.581
5058,Pena Group,False,EG,West Kimberly,HealthTech,2022,https://penagroup.com,Whom wide through exactly I management hit.,12,pena-group,2023,USD,687322,191570,495752,493490,2262,21381,-19119,6873,13746,-32865,26646,430753,146307,284446,57276.83,687322,651.46,1783.77,0.0052,2673,21.42,40865.88,0.65,0.7213
5059,Peterson-Cox,False,ZA,Dianeshire,Mobility,2014,https://peterson-cox.com,Discussion campaign everybody cell five across movie.,15,peterson-cox,2023,USD,1816874,787731,1029143,1144410,-115267,19116,-134383,18168,36337,-170720,557455,1618285,138831,1479454,,1816874,751.39,2163.88,0.0598,514,294.43,82472.88,6.76,0.5664
5060,Potter Brown and Ward,False,NG,Shannonstad,Cybersecurity,2013,https://potterbrownandward.com,Rather institution what he.,17,potter-brown-and-ward,2023,USD,533706,80470,453236,75195,378041,0,378041,5337,10674,367367,7184,367278,85511,281767,,533706,1193.04,962.46,0.051,2223,20.0,30086.71,0.24,0.8492
5061,Bridges-Peterson,False,BR,East Kathleen,Energy,2016,https://bridges-peterson.com,Age direction check able now positive reduce what eye night.,15,bridges-peterson,2023,USD,1695810,1051528,644282,972626,-328344,174,-328518,16958,33916,-362434,52722,1001355,490149,511206,,1695810,22.83,85.38,0.001,736,191.9,62366.72,0.85,0.3799
5062,Bryant-Coleman,False,TN,Caldwellborough,SaaS,2010,https://bryant-coleman.com,Serve clear between nearly lawyer ten.,24,bryant-coleman,2023,USD,2744257,849933,1894324,1111356,782968,23508,759460,27442,54885,704575,1569546,3100066,192653,2907413,228688.08,2744257,199.45,413.4,0.0525,5228,43.74,93907.33,16.71,0.6903
5063,Williams PLC,False,BR,Huffborough,Mobility,2019,https://williamsplc.com,Clear million war interesting world.,20,williams-plc,2023,USD,406428,161130,245298,123671,121627,0,121627,4064,8128,113499,19002,413269,325441,87828,,406428,787.18,2820.8,0.0347,240,140.96,6916.04,2.75,0.6035
5064,Golden Banks and Sanchez,False,FR,New Marilynshire,EdTech,2024,https://goldenbanksandsanchez.com,Government suggest let to price citizen enter hundred movie player.,30,golden-banks-and-sanchez,2023,EUR,1358901,429819,929082,600309,328773,25893,302880,13589,27178,275702,26861,860437,112781,747656,113241.75,1358901,160.9,740.68,0.001,1988,56.96,53395.56,0.5,0.6837
5065,Zimmerman Howard and Martinez,False,CA,Cristianshire,AgriTech,2017,https://zimmermanhowardandmartinez.com,Throw identify just any spend wait employee.,16,zimmerman-howard-and-martinez,2023,USD,380504,193751,186753,30959,155794,0,155794,3805,7610,148184,18739,254281,12714,241567,,380504,1244.14,2126.87,0.0813,729,43.45,15529.84,1.21,0.4908
5066,Smith Davis and Simon,False,AU,Port Travis,E-commerce,2022,https://smithdavisandsimon.com,Issue American senior become itself trip indeed.,21,smith-davis-and-simon,2023,USD,565132,226200,338932,257213,81719,5374,76345,5651,11302,65043,74896,398259,147989,250270,,565132,1534.53,3163.64,0.1154,1309,35.95,54101.56,1.38,0.5997
5067,Martinez Mclaughlin and Brown,False,BR,Amymouth,Mobility,2008,https://martinezmclaughlinandbrown.com,Reflect positive court owner skill then street military thing.,26,martinez-mclaughlin-and-brown,2023,USD,1891840,667863,1223977,1142457,81520,0,81520,18918,37836,43684,197977,1239746,378447,861299,,1891840,425.46,1014.33,0.0928,1382,114.0,126515.64,1.56,0.647
5068,Smith-Hogan,False,GB,Sullivanshire,IoT,2013,https://smith-hogan.com,Everybody enough beautiful forward blood box floor try.,23,smith-hogan,2023,USD,553403,145867,407536,137837,269699,28317,241382,5534,11068,230314,14139,316824,104967,211857,,553403,375.71,1812.14,0.0342,445,103.62,32119.32,0.44,0.7364
5069,Douglas-Garcia,False,KE,Lake Alan,E-commerce,2021,https://douglas-garcia.com,Purpose better should attorney mean knowledge.,18,douglas-garcia,2023,USD,630776,206053,424723,443296,-18573,24787,-43360,6307,12615,-55975,98285,585665,82211,503454,,630776,390.57,958.31,0.1206,2628,20.0,28702.35,3.42,0.6733
5070,Smith-Elliott,False,TN,Lake Aaronchester,SaaS,2017,https://smith-elliott.com,Wrong difficult reduce professor peace.,15,smith-elliott,2023,USD,2414426,981670,1432756,1821450,-388694,23137,-411831,24144,48288,-460119,165247,1569713,631860,937853,201202.17,2414426,215.74,1270.32,0.0115,3571,56.33,139673.41,1.18,0.5934
5071,Martinez-Mendoza,False,NG,Mooreville,Cybersecurity,2023,https://martinez-mendoza.com,Him eye throughout bad home concern nor cultural effort.,20,martinez-mendoza,2023,USD,255498,40078,215420,149769,65651,0,65651,2554,5109,60542,23419,327860,141742,186118,,255498,1132.61,4879.92,0.1065,87,243.13,30528.33,0.77,0.8431
5072,Gibson-Potter,False,DE,New Rachel,Energy,2012,https://gibson-potter.com,Maybe others value manager fly.,20,gibson-potter,2023,EUR,2688377,1287675,1400702,750972,649730,0,649730,26883,53767,595963,143713,1525037,880910,644127,,2688377,20.0,11.71,0.0282,11201,20.0,54670.13,2.63,0.521
5073,Whitney-Patterson,False,TN,Griffithside,IoT,2011,https://whitney-patterson.com,Surface prove admit figure unit send.,26,whitney-patterson,2023,USD,1236283,550470,685813,940704,-254891,10406,-265297,12362,24725,-290022,432340,1109804,412974,696830,,1236283,20.0,126.1,0.0744,1739,59.22,58803.06,7.35,0.5547
5074,Mcintyre and Sons,False,FR,Johnsonbury,Energy,2014,https://mcintyreandsons.com,Them resource good reduce huge score situation growth.,22,mcintyre-and-sons,2023,EUR,5821166,3726366,2094800,2428600,-333800,0,-333800,58211,116423,-450223,344164,3280581,411547,2869034,,5821166,887.62,3554.9,0.0601,5887,82.4,200981.23,1.71,0.3599
5075,Olsen and Sons,False,DE,Lake Paula,Fintech,2017,https://olsenandsons.com,Financial cultural foot line new range budget common.,20,olsen-and-sons,2023,EUR,3540690,940895,2599795,1288155,1311640,0,1311640,35406,70813,1240827,38368,1856620,971274,885346,,3540690,373.0,584.17,0.0971,1110,265.79,140029.49,0.27,0.7343
5076,Smith Phillips and Cruz,False,GB,West Willie,HealthTech,2020,https://smithphillipsandcruz.com,Could machine necessary enter out wrong represent idea hundred follow.,17,smith-phillips-and-cruz,2023,USD,858444,292992,565452,913803,-348351,15427,-363778,8584,17168,-380946,21502,504114,32081,472033,71537.0,858444,406.68,4022.72,0.0336,2500,28.61,89567.1,0.24,0.6587
5077,Miller Turner and Gomez,False,NG,East Jennifer,Energy,2019,https://millerturnerandgomez.com,Chance play yourself three not both.,16,miller-turner-and-gomez,2023,USD,1087645,413291,674354,226672,447682,13666,434016,10876,21752,412264,8001,720352,369133,351219,,1087645,366.23,183.12,0.001,588,154.14,39497.33,0.2,0.62
5078,Morrow-Freeman,False,AU,Lake Mark,EdTech,2021,https://morrow-freeman.com,Bill size here feel three my sound want learn continue.,17,morrow-freeman,2023,USD,310235,138741,171494,70171,101323,25952,75371,3102,6204,69167,92824,424900,110501,314399,25852.92,310235,427.37,1784.83,0.0426,445,58.03,1704.26,54.47,0.5528
5079,Wilson-Romero,False,KE,New Heather,AgriTech,2018,https://wilson-romero.com,Entire model floor adult modern term.,21,wilson-romero,2023,USD,37174,8601,28573,18310,10263,0,10263,371,743,9520,10667,80055,49773,30282,,37174,20.0,25.14,0.0031,44,70.17,1000.0,10.67,0.7686
5080,Hughes Group,False,AU,Smithhaven,E-commerce,2011,https://hughesgroup.com,Would without environmental meet camera Democrat stock plan appear.,24,hughes-group,2023,USD,803995,197383,606612,82709,523903,21619,502284,8039,16079,486205,152342,671396,57790,613606,,803995,20.0,70.56,0.0616,3349,20.0,36864.54,4.13,0.7545
5081,Lane Harrison and Hall,False,BR,Ericburgh,Marketplaces,2018,https://laneharrisonandhall.com,Management stay require hundred many at cold majority.,22,lane-harrison-and-hall,2023,USD,850266,218489,631777,542713,89064,0,89064,8502,17005,72059,49027,572407,215040,357367,,850266,647.48,1223.29,0.0342,756,93.71,20561.65,2.38,0.743
5082,Mcbride Group,False,NG,Hallville,AI/ML,2020,https://mcbridegroup.com,Forget soldier dinner know side pretty amount hotel speech.,12,mcbride-group,2023,USD,1855554,539859,1315695,1723338,-407643,0,-407643,18555,37111,-444754,141389,1173983,432229,741754,,1855554,878.88,2620.64,0.0091,1156,133.71,133953.25,1.06,0.7091
5083,Sawyer Allen and Cummings,False,DE,East Linda,Energy,2023,https://sawyerallenandcummings.com,Pressure why in available from blue natural work act realize.,22,sawyer-allen-and-cummings,2023,EUR,2145940,642131,1503809,576795,927014,9726,917288,21459,42918,874370,26117,1226059,167068,1058991,,2145940,520.32,1160.49,0.0139,1863,95.97,32835.88,0.8,0.7008
5084,Fuller Group,False,AU,Johnmouth,Mobility,2017,https://fullergroup.com,Organization nature wait magazine fill chance standard law toward movie.,20,fuller-group,2023,USD,2040568,870703,1169865,1352204,-182339,0,-182339,20405,40811,-223150,60771,1227744,319866,907878,,2040568,20.0,33.41,0.0268,8502,20.0,127445.03,0.48,0.5733
5085,Sexton Ltd,False,EG,Port Colton,HealthTech,2013,https://sextonltd.com,Thought pretty provide adult see trade beautiful relationship dream PM.,21,sexton-ltd,2023,USD,960634,413205,547429,711150,-163721,0,-163721,9606,19212,-182933,26107,666993,197451,469542,80052.83,960634,10.0,90.47,0.0067,1407,56.88,31816.79,0.82,0.5699
5086,Shepard Inc,False,TN,Lake Robert,AgriTech,2008,https://shepardinc.com,Take help continue me operation.,21,shepard-inc,2023,USD,211369,80161,131208,134017,-2809,0,-2809,2113,4227,-7036,46148,199795,76265,123530,,211369,20.0,75.88,0.0126,67,259.08,23807.86,1.94,0.6208
5087,Hall-Miller,False,NG,Port Alexishaven,E-commerce,2022,https://hall-miller.com,Around family store image as economic.,29,hall-miller,2023,USD,3029774,1000452,2029322,1581612,447710,25478,422232,30297,60595,361637,109449,1728488,497084,1231404,,3029774,1335.39,8140.78,0.0717,1213,208.02,107599.16,1.02,0.6698
5088,Hawkins Ltd,False,BR,Timothyton,HealthTech,2011,https://hawkinsltd.com,Head see painting service line.,13,hawkins-ltd,2023,USD,138443,42367,96076,55375,40701,10651,30050,1384,2768,27282,6002,269926,121050,148876,11536.92,138443,491.28,1367.31,0.001,2307,5.0,1000.0,6.0,0.694
5089,Perry Moore and Reynolds,False,TN,Port Jane,IoT,2021,https://perrymooreandreynolds.com,Provide image young pass another daughter.,22,perry-moore-and-reynolds,2023,USD,434123,247579,186544,107817,78727,44431,34296,4341,8682,25614,12952,238412,65320,173092,,434123,20.0,62.67,0.0876,1808,20.0,11032.52,1.17,0.4297
5090,Lowe Cortez and Shannon,False,TN,Hamiltonburgh,Energy,2014,https://lowecortezandshannon.com,Again attention lead example student nation decade only raise prevent.,28,lowe-cortez-and-shannon,2023,USD,10708843,3466638,7242205,4857537,2384668,31426,2353242,107088,214176,2139066,366531,5847119,2208843,3638276,,10708843,1529.14,2542.33,0.081,28447,31.37,383542.69,0.96,0.6763
5091,Contreras-Gray,False,BR,Port Tammy,SaaS,2015,https://contreras-gray.com,Raise company really act resource.,22,contreras-gray,2023,USD,146980,27469,119511,118813,698,50298,-49600,1469,2939,-52539,35425,218968,26181,192787,12248.33,146980,277.81,277.81,0.0288,135,90.35,21569.9,1.64,0.8131
5092,Barrett-Watts,False,GB,North Cody,IoT,2024,https://barrett-watts.com,Enjoy pull summer evidence member most.,23,barrett-watts,2023,USD,1141031,477394,663637,652411,11226,9651,1575,11410,22820,-21245,132467,866670,230746,635924,,1141031,20.0,10.0,0.0523,377,251.7,40847.04,3.24,0.5816
5093,Garcia-Kelley,False,FR,Lake Madeline,IoT,2021,https://garcia-kelley.com,Information chair listen tell as population adult establish.,24,garcia-kelley,2023,EUR,155815,91583,64232,35253,28979,0,28979,1558,3116,25863,7352,90231,47074,43157,,155815,20.0,26.63,0.1161,649,20.0,15165.01,0.48,0.4122
5094,Walker-Hill,False,US,South Gilbert,E-commerce,2015,https://walker-hill.com,Anyone now happy rather past prevent.,31,walker-hill,2023,USD,673777,178961,494816,316209,178607,0,178607,6737,13475,165132,35357,477160,228578,248582,,673777,755.6,1053.98,0.0593,1184,47.39,18899.01,1.87,0.7344
5095,Norton-Jones,False,GB,Eileenshire,IoT,2023,https://norton-jones.com,Important camera yet movie information each you draw move.,15,norton-jones,2023,USD,226727,74501,152226,79739,72487,6180,66307,2267,4534,61773,5171,119596,18108,101488,,226727,379.89,1479.38,0.0482,580,32.56,11295.3,0.46,0.6714
5096,Brown-Watson,False,BR,West Brianna,Fintech,2019,https://brown-watson.com,Word wide article career support plan.,20,brown-watson,2023,USD,597307,217628,379679,275922,103757,0,103757,5973,11946,91811,32123,506545,176471,330074,,597307,731.92,1416.43,0.0885,250,198.75,45646.21,0.7,0.6357
5097,Braun Ltd,False,US,Richardsonville,Cybersecurity,2020,https://braunltd.com,Attorney enjoy kid yard series drug example worry.,21,braun-ltd,2023,USD,359215,120834,238381,95510,142871,0,142871,3592,7184,135687,64286,372798,178952,193846,,359215,616.86,2385.68,0.0572,110,270.92,1000.0,64.29,0.6636
5098,Long-Barnes,False,NG,Howellport,AI/ML,2014,https://long-barnes.com,Issue friend present design group entire measure receive reflect structure fly.,19,long-barnes,2023,USD,1347052,397562,949490,318915,630575,0,630575,13470,26941,603634,228921,1031135,500408,530727,,1347052,1252.02,4858.15,0.001,645,173.97,3265.86,70.1,0.7049
5099,West Group,False,GB,Benjaminfurt,Mobility,2019,https://westgroup.com,East lawyer strong theory may.,15,west-group,2023,USD,454686,148232,306454,272413,34041,33139,902,4546,9093,-8191,73358,494027,233973,260054,,454686,20.0,10.0,0.0244,365,103.53,16545.45,4.43,0.674
5100,Franklin-Patton,False,ZA,Port Sabrina,EdTech,2013,https://franklin-patton.com,Political too thought car statement open white part write play reality.,17,franklin-patton,2023,USD,843857,281789,562068,250105,311963,303,311660,8438,16877,294783,2891,550401,180173,370228,70321.42,843857,10.0,21.25,0.0643,7394,9.51,17322.85,0.17,0.6661
5101,Young-Schmitt,False,EG,Port John,Cybersecurity,2014,https://young-schmitt.com,Significant attorney each determine also brother difference sport resource project.,23,young-schmitt,2023,USD,1163604,297923,865681,478217,387464,40003,347461,11636,23272,324189,16364,614630,154482,460148,,1163604,466.89,1479.93,0.1465,2128,45.56,59609.57,0.27,0.744
5102,Brewer-Brown,False,CA,New Williamfort,HealthTech,2017,https://brewer-brown.com,Road view political near sort at they pressure word while.,21,brewer-brown,2023,USD,1141301,473380,667921,861624,-193703,0,-193703,11413,22826,-216529,386988,1036601,296514,740087,95108.42,1141301,278.1,920.02,0.0351,1994,47.69,95088.69,4.07,0.5852
5103,Santos-Brown,False,FR,Patrickburgh,SaaS,2014,https://santos-brown.com,Campaign late event alone policy kind stage.,25,santos-brown,2023,EUR,665288,289120,376168,157184,218984,0,218984,6652,13305,205679,96016,457054,279833,177221,55440.67,665288,158.88,601.59,0.0414,717,77.22,51442.9,1.87,0.5654
5104,Winters White and Ford,False,KE,Huynhland,Mobility,2022,https://winterswhiteandford.com,Keep garden young specific news industry.,17,winters-white-and-ford,2023,USD,1262377,442605,819772,1064256,-244484,41218,-285702,12623,25247,-310949,21354,760377,102689,657688,,1262377,184.47,719.49,0.1081,1097,95.86,75027.29,0.28,0.6494
5105,Francis-Rodriguez,False,DE,South Joshua,Marketplaces,2022,https://francis-rodriguez.com,Off discuss heart word fire two walk third message wind.,24,francis-rodriguez,2023,EUR,808814,165160,643654,513160,130494,37019,93475,8088,16176,77299,46517,528810,328079,200731,,808814,1061.32,1587.88,0.0553,3370,20.0,50529.88,0.92,0.7958
5106,Booker Smith and Grimes,False,DE,Danielhaven,HealthTech,2022,https://bookersmithandgrimes.com,Upon newspaper tend house cold for economic energy attorney thank.,17,booker-smith-and-grimes,2023,EUR,951268,275928,675340,422145,253195,8488,244707,9512,19025,225682,22980,668768,57583,611185,79272.33,951268,10.0,74.88,0.0755,7213,10.99,40799.91,0.56,0.7099
5107,Haley and Sons,False,NG,North Charles,Marketplaces,2011,https://haleyandsons.com,Care in place of cause try themselves particularly country ability.,17,haley-and-sons,2023,USD,382540,135235,247305,93286,154019,25790,128229,3825,7650,120579,115700,473943,89243,384700,,382540,20.0,114.86,0.005,326,97.77,1000.0,115.7,0.6465
5108,Cross Savage and Mcintosh,False,AU,Sanchezberg,IoT,2018,https://crosssavageandmcintosh.com,Cultural win professor appear subject check data myself follow build.,22,cross-savage-and-mcintosh,2023,USD,1350794,651696,699098,834128,-135030,0,-135030,13507,27015,-162045,100930,924444,612864,311580,,1350794,1136.53,568.26,0.0551,5628,20.0,49339.31,2.05,0.5175
5109,Smith-Price,False,GB,East Joseph,EdTech,2022,https://smith-price.com,Where score if against especially talk range mean citizen.,14,smith-price,2023,USD,913269,316213,597056,249456,347600,0,347600,9132,18265,329335,41500,572376,188965,383411,76105.75,913269,490.71,490.71,0.0479,1003,75.84,22813.47,1.82,0.6538
5110,Vazquez-Lynch,False,ZA,New Alexis,Fintech,2008,https://vazquez-lynch.com,Less one parent against smile environmental.,21,vazquez-lynch,2023,USD,838251,208208,630043,96231,533812,37326,496486,8382,16765,479721,26666,594924,373024,221900,,838251,434.59,1266.34,0.0387,284,245.37,28183.06,0.95,0.7516
5111,Williams-Booker,False,ZA,North Mary,SaaS,2021,https://williams-booker.com,Similar she return you car necessary.,21,williams-booker,2023,USD,944408,502972,441436,786264,-344828,35070,-379898,9444,18888,-398786,33961,697082,232224,464858,78700.67,944408,10.0,34.3,0.0045,905,86.96,80870.65,0.42,0.4674
5112,Montgomery Martin and Navarro,False,NG,Jasonhaven,Mobility,2020,https://montgomerymartinandnavarro.com,Recently majority first kitchen appear section.,20,montgomery-martin-and-navarro,2023,USD,926255,343059,583196,141081,442115,8970,433145,9262,18525,414620,79124,573259,49608,523651,,926255,1682.49,4422.59,0.0895,322,239.7,1000.0,79.12,0.6296
5113,Daniels-Molina,False,FR,Port Reginastad,Energy,2016,https://daniels-molina.com,Fall central act smile forward performance whether brother write.,30,daniels-molina,2023,EUR,477014,164300,312714,215829,96885,0,96885,4770,9540,87345,49585,477754,53879,423875,,477014,1714.97,6581.21,0.1107,1112,35.74,3006.86,16.49,0.6556
5114,Allen Tate and Small,False,ZA,South Charlotte,AI/ML,2011,https://allentateandsmall.com,Piece first sign similar front down provide score.,17,allen-tate-and-small,2023,USD,303721,102814,200907,38842,162065,2155,159910,3037,6074,153836,9960,287604,152842,134762,,303721,20.0,80.14,0.1289,871,29.04,44803.68,0.22,0.6615
5115,Wilson-Franco,False,ZA,East Ryan,IoT,2008,https://wilson-franco.com,Indicate structure consider allow product.,13,wilson-franco,2023,USD,2346677,807434,1539243,527577,1011666,17153,994513,23466,46933,947580,109333,1406298,436181,970117,,2346677,653.71,3580.23,0.0581,9777,20.0,56810.22,1.92,0.6559
5116,Arnold Harper and Murray,False,EG,Lake Cynthia,Mobility,2009,https://arnoldharperandmurray.com,Federal certain address green challenge certainly yeah government including man million.,15,arnold-harper-and-murray,2023,USD,91093,50836,40257,88126,-47869,6133,-54002,910,1821,-55823,9634,89456,29469,59987,,91093,506.51,2442.13,0.1015,55,135.96,1000.0,9.63,0.4419
5117,Carr Smith and Hayes,False,IN,Ramseybury,Energy,2009,https://carrsmithandhayes.com,Place nature little himself produce professional.,21,carr-smith-and-hayes,2023,USD,1049244,299496,749748,615963,133785,65894,67891,10492,20984,46907,25368,627148,158351,468797,,1049244,794.2,1274.6,0.1184,405,215.55,56437.1,0.45,0.7146
5118,Morgan Love and Johnson,False,CA,Port Devin,Energy,2024,https://morganloveandjohnson.com,There thank show next news industry.,22,morgan-love-and-johnson,2023,USD,3861071,1178871,2682200,1310424,1371776,13104,1358672,38610,77221,1281451,24839,2024417,792651,1231766,,3861071,664.6,4738.83,0.1682,918,350.16,98659.66,0.25,0.6947
5119,Garcia-Woods,False,BR,Port Leetown,Marketplaces,2022,https://garcia-woods.com,Lot plan side writer mind contain.,19,garcia-woods,2023,USD,232512,69004,163508,145798,17710,17090,620,2325,4650,-4030,8896,168167,116221,51946,,232512,1114.06,2774.58,0.0931,968,20.0,21843.66,0.41,0.7032
5120,Brown Ltd,False,TN,East Brianaland,Fintech,2011,https://brownltd.com,Article any note community next.,17,brown-ltd,2023,USD,202564,76318,126246,59779,66467,10180,56287,2025,4051,52236,18036,130481,24944,105537,,202564,20.0,51.73,0.0718,844,20.0,19481.92,0.93,0.6232
5121,Rodriguez Inc,False,GB,Port Susan,AgriTech,2011,https://rodriguezinc.com,Loss black boy face let oil civil happen wish sometimes.,17,rodriguez-inc,2023,USD,1024371,397702,626669,551448,75221,10286,64935,10243,20487,44448,59382,657886,200709,457177,,1024371,1890.25,945.12,0.0203,460,185.55,28092.44,2.11,0.6118
5122,Thompson-Campbell,False,ZA,New Michael,HealthTech,2019,https://thompson-campbell.com,Happy develop lot now week become production city.,18,thompson-campbell,2023,USD,564522,203820,360702,103359,257343,3074,254269,5645,11290,242979,24816,403645,86130,317515,47043.5,564522,19.94,111.59,0.0454,914,51.43,32697.37,0.76,0.639
5123,Mora Ltd,False,TN,West Anaborough,Marketplaces,2018,https://moraltd.com,Remember dinner artist hear morning lot.,14,mora-ltd,2023,USD,530967,222793,308174,195550,112624,7268,105356,5309,10619,94737,16923,470073,212638,257435,,530967,120.1,192.95,0.0218,171,257.53,1000.0,16.92,0.5804
5124,Scott-Bishop,False,GB,East Joseph,EdTech,2023,https://scott-bishop.com,Young type hot around magazine out.,21,scott-bishop,2023,USD,271386,114396,156990,231266,-74276,15560,-89836,2713,5427,-95263,9499,228039,79917,148122,22615.5,271386,19.57,55.99,0.0222,3060,7.39,4464.19,2.13,0.5785
5125,Adams White and Johnson,False,DE,North Danielport,AgriTech,2011,https://adamswhiteandjohnson.com,Site better always attack political owner road.,26,adams-white-and-johnson,2023,EUR,216931,82716,134215,46898,87317,0,87317,2169,4338,82979,16208,279161,146818,132343,,216931,20.0,63.76,0.0996,80,223.76,1000.0,16.21,0.6187
5126,Jordan Banks and Scott,False,CA,North Ethan,Marketplaces,2010,https://jordanbanksandscott.com,We town pattern understand all.,22,jordan-banks-and-scott,2023,USD,2527453,801339,1726114,1503831,222283,0,222283,25274,50549,171734,115601,1510755,396959,1113796,,2527453,921.56,3702.34,0.0628,2062,102.1,123358.77,0.94,0.6829
5127,Burnett Watson and Pittman,False,EG,East Kim,Cybersecurity,2023,https://burnettwatsonandpittman.com,Exist green whatever serve window but dog star well.,23,burnett-watson-and-pittman,2023,USD,2839620,1167987,1671633,2856164,-1184531,0,-1184531,28396,56792,-1241323,188622,1733689,1540003,193686,,2839620,1238.59,4367.14,0.001,8667,27.3,243968.67,0.77,0.5887
5128,Daniels Palmer and Cox,False,AU,Scottbury,EdTech,2016,https://danielspalmerandcox.com,Save offer for less travel respond official black generation time.,21,daniels-palmer-and-cox,2023,USD,227484,58775,168709,117288,51421,23396,28025,2274,4549,23476,8925,210473,123784,86689,18957.0,227484,280.4,1244.49,0.0184,185,102.06,35838.05,0.25,0.7416
5129,Hernandez-Baldwin,False,CA,Pierceville,AgriTech,2022,https://hernandez-baldwin.com,Series interest right cost boy relate talk central doctor factor.,30,hernandez-baldwin,2023,USD,543234,141080,402154,263374,138780,0,138780,5432,10864,127916,18651,424381,190026,234355,,543234,180.9,90.45,0.1289,367,123.13,25711.98,0.73,0.7403
5130,Johnston Group,False,CA,Lake Kathy,Mobility,2016,https://johnstongroup.com,North charge guess figure rise save friend floor.,25,johnston-group,2023,USD,502520,250150,252370,190321,62049,0,62049,5025,10050,51999,15459,367674,104893,262781,,502520,674.95,2566.58,0.1271,367,113.84,11609.76,1.33,0.5022
5131,Cruz Parks and Miller,False,KE,South Andrew,AgriTech,2009,https://cruzparksandmiller.com,Simply with sea treatment investment stuff believe amount.,20,cruz-parks-and-miller,2023,USD,510416,215880,294536,148989,145547,13241,132306,5104,10208,122098,73360,368822,18441,350381,,510416,1034.92,4935.75,0.0468,2126,20.0,1000.0,73.36,0.5771
5132,Phillips-Kennedy,False,AU,Lake Tracyfort,HealthTech,2012,https://phillips-kennedy.com,Meet on money history ten minute marriage factor discuss still.,23,phillips-kennedy,2023,USD,1647242,713078,934164,407833,526331,47913,478418,16472,32944,445474,78826,983284,225353,757931,137270.17,1647242,427.5,427.5,0.0277,3803,36.09,36175.3,2.18,0.5671
5133,Day Tran and Jacobs,False,NG,Loriberg,AgriTech,2008,https://daytranandjacobs.com,Serve new around now huge claim coach your.,14,day-tran-and-jacobs,2023,USD,226444,48060,178384,129112,49272,26013,23259,2264,4528,18731,6114,244698,46967,197731,,226444,999.1,668.56,0.0212,943,20.0,1556.44,3.93,0.7878
5134,Keith-Johnson,False,DE,Lake Daniel,E-commerce,2019,https://keith-johnson.com,Determine section sort ask rock available green can.,29,keith-johnson,2023,EUR,874567,273376,601191,127516,473675,26741,446934,8745,17491,429443,29281,515748,25787,489961,,874567,20.0,38.33,0.1033,698,104.27,1000.0,29.28,0.6874
5135,Cummings-Cook,False,ZA,Rowlandland,AgriTech,2017,https://cummings-cook.com,Environment show water paper control TV improve bad onto.,21,cummings-cook,2023,USD,155798,78276,77522,93536,-16014,0,-16014,1557,3115,-19129,39646,275897,143015,132882,,155798,760.68,2470.27,0.1142,649,20.0,16828.51,2.36,0.4976
5136,Ayala-Vance,False,ZA,West Michaelburgh,HealthTech,2017,https://ayala-vance.com,Practice feeling food method interest hotel standard now two.,19,ayala-vance,2023,USD,2219854,268315,1951539,1806966,144573,23681,120892,22198,44397,76495,186515,1396950,659196,737754,184987.83,2219854,116.96,541.71,0.0393,2503,73.88,169836.4,1.1,0.8791
5137,Baker Morales and Benson,False,EG,South Aaronville,Cybersecurity,2022,https://bakermoralesandbenson.com,Machine project trade great.,22,baker-morales-and-benson,2023,USD,249963,61891,188072,150458,37614,0,37614,2499,4999,32615,12843,207245,34350,172895,,249963,376.41,1301.21,0.0757,84,246.56,36688.94,0.35,0.7524
5138,Randall Pace and Powell,False,BR,Bobhaven,AgriTech,2012,https://randallpaceandpowell.com,For begin technology seem Mrs adult style address.,16,randall-pace-and-powell,2023,USD,719928,312887,407041,208448,198593,0,198593,7199,14398,184195,118889,492381,198370,294011,,719928,823.61,788.13,0.0401,2999,20.0,39540.88,3.01,0.5654
5139,Wilson Phillips and Davis,False,ZA,Stevenmouth,Cybersecurity,2012,https://wilsonphillipsanddavis.com,Easy left day book training.,18,wilson-phillips-and-davis,2023,USD,634416,294225,340191,377348,-37157,18528,-55685,6344,12688,-68373,1799,484406,56247,428159,,634416,1017.72,4088.76,0.0168,2643,20.0,45330.57,0.04,0.5362
5140,Parker Anderson and Riggs,False,GB,Joneston,IoT,2017,https://parkerandersonandriggs.com,Industry history issue way its charge.,22,parker-anderson-and-riggs,2023,USD,1066735,329975,736760,276855,459905,45304,414601,10667,21334,393267,31905,643083,236104,406979,,1066735,321.4,1277.31,0.07,670,132.5,6129.49,5.21,0.6907
5141,Goodman Harvey and Grant,False,TN,Brandymouth,AgriTech,2015,https://goodmanharveyandgrant.com,Wide science hour play fund food yard option specific.,24,goodman-harvey-and-grant,2023,USD,993522,367823,625699,688461,-62762,35513,-98275,9935,19870,-118145,105581,622127,172217,449910,,993522,20.0,62.62,0.1388,4139,20.0,60199.43,1.75,0.6298
5142,Thompson-Stephenson,False,US,South Heather,EdTech,2017,https://thompson-stephenson.com,Part big source bit culture.,22,thompson-stephenson,2023,USD,146298,25318,120980,115379,5601,0,5601,1462,2925,2676,16225,236447,55612,180835,12191.5,146298,119.8,119.8,0.003,438,27.8,30825.67,0.53,0.8269
5143,Becker Conway and Scott,False,GB,Port Carl,IoT,2008,https://beckerconwayandscott.com,Determine worry stuff according final go.,22,becker-conway-and-scott,2023,USD,3606994,974584,2632410,2048525,583885,19584,564301,36069,72139,492162,143959,1976611,520862,1455749,,3606994,20.0,17.7,0.0469,1738,172.87,184790.12,0.78,0.7298
5144,Jackson Mccann and Rose,False,IN,East Larry,E-commerce,2024,https://jacksonmccannandrose.com,Her movement security rate nature size discover beautiful or cup meeting.,23,jackson-mccann-and-rose,2023,USD,2223249,954600,1268649,1099125,169524,11033,158491,22232,44464,114027,551491,1782397,1118474,663923,,2223249,1438.66,6330.98,0.0532,899,206.04,55462.49,9.94,0.5706
5145,Russell-Scott,False,ZA,Joshuaberg,AI/ML,2020,https://russell-scott.com,The society lot anything challenge.,21,russell-scott,2023,USD,550733,132431,418302,621401,-203099,33802,-236901,5507,11014,-247915,245447,640710,157202,483508,,550733,1257.54,7025.87,0.0858,2294,20.0,45592.39,5.38,0.7595
5146,Garrett Group,False,EG,Davidchester,IoT,2013,https://garrettgroup.com,Cultural address senior through.,8,garrett-group,2023,USD,254623,91192,163431,105068,58363,6100,52263,2546,5092,47171,16130,315104,139588,175516,,254623,219.83,596.95,0.0043,1060,20.0,5915.23,2.73,0.6419
5147,Duncan Moore and Salas,False,CA,Kylestad,Marketplaces,2012,https://duncanmooreandsalas.com,Find check easy one newspaper body boy friend manage actually.,26,duncan-moore-and-salas,2023,USD,766771,327888,438883,347138,91745,0,91745,7667,15335,76410,33536,575409,59963,515446,,766771,537.62,1063.08,0.0644,1215,52.58,55074.5,0.61,0.5724
5148,Lopez LLC,False,KE,Pattyborough,AI/ML,2018,https://lopezllc.com,Account central indeed dog to recently others later.,14,lopez-llc,2023,USD,574159,222768,351391,220952,130439,7377,123062,5741,11483,111579,8912,495017,142067,352950,,574159,428.73,785.43,0.001,130,366.39,55707.51,0.16,0.612
5149,Wright and Sons,False,NG,New Victoriamouth,E-commerce,2020,https://wrightandsons.com,This ability crime director heavy member simple yeah.,18,wright-and-sons,2023,USD,2709209,441702,2267507,385850,1881657,0,1881657,27092,54184,1827473,225269,1746475,661149,1085326,,2709209,957.07,2200.2,0.0867,11288,20.0,1000.0,225.27,0.837
5150,Garcia Pierce and Lewis,False,EG,Bauerstad,Marketplaces,2013,https://garciapierceandlewis.com,Reach current road right part easy purpose floor.,19,garcia-pierce-and-lewis,2023,USD,1039754,298170,741584,557288,184296,31060,153236,10397,20795,132441,13092,705547,293367,412180,,1039754,618.66,1214.0,0.0422,674,128.5,10009.93,1.31,0.7132
5151,Perry-Keith,False,NG,Cruzland,Mobility,2013,https://perry-keith.com,Entire news discuss why suffer establish start.,22,perry-keith,2023,USD,800789,395448,405341,120598,284743,26550,258193,8007,16015,242178,22210,561600,127138,434462,,800789,1120.9,5964.03,0.001,355,187.62,24685.58,0.9,0.5062
5152,King Davis and Jackson,False,EG,Lake Linda,Energy,2008,https://kingdavisandjackson.com,Ball star owner ground somebody fact their series.,13,king-davis-and-jackson,2023,USD,1415200,360272,1054928,555983,498945,17361,481584,14152,28304,453280,17585,809212,40460,768752,,1415200,852.36,3475.19,0.1241,5896,20.0,54183.55,0.32,0.7454
5153,Schneider Inc,False,BR,East Allisonberg,Fintech,2018,https://schneiderinc.com,Turn son politics white house community drop care.,25,schneider-inc,2023,USD,468714,276927,191787,242838,-51051,0,-51051,4687,9374,-60425,9657,295886,115108,180778,,468714,787.01,1345.26,0.1178,494,78.94,45741.1,0.21,0.4092
5154,Garner-Barnes,False,DE,Christopherborough,AgriTech,2014,https://garner-barnes.com,Local listen yeah over great group action message process.,23,garner-barnes,2023,EUR,247560,99245,148315,54737,93578,5825,87753,2475,4951,82802,33792,221574,86073,135501,,247560,20.0,46.27,0.0378,284,72.55,1000.0,33.79,0.5991
5155,Rodriguez and Sons,False,DE,Kyleview,HealthTech,2016,https://rodriguezandsons.com,Arm late view voice maybe present.,25,rodriguez-and-sons,2023,EUR,1154051,623036,531015,735257,-204242,0,-204242,11540,23081,-227323,160381,779058,449521,329537,96170.92,1154051,879.52,6658.78,0.0385,996,96.47,56797.01,2.82,0.4601
5156,Williams Group,False,KE,Shawberg,Cybersecurity,2011,https://williamsgroup.com,Mention might peace work throughout attack conference if perform.,22,williams-group,2023,USD,2609877,712213,1897664,2103707,-206043,0,-206043,26098,52197,-258240,79975,1454276,832588,621688,,2609877,20.0,36.56,0.001,10874,20.0,149732.38,0.53,0.7271
5157,Davis-Rich,False,BR,Port Mandyburgh,EdTech,2019,https://davis-rich.com,Serious few ago community against cut instead front main support.,24,davis-rich,2023,USD,101822,64775,37047,28670,8377,3622,4755,1018,2036,2719,6221,156975,43037,113938,8485.17,101822,10.0,40.91,0.0481,493,17.19,36398.09,0.17,0.3638
5158,Castro LLC,False,EG,East Tina,Mobility,2008,https://castrollc.com,Media practice similar sign available yard son.,12,castro-llc,2023,USD,497272,216738,280534,88691,191843,33320,158523,4972,9945,148578,43841,355147,40998,314149,,497272,20.0,63.52,0.001,359,115.39,2388.43,18.36,0.5641
5159,Meyers-Phillips,False,ZA,Jenniferberg,AI/ML,2015,https://meyers-phillips.com,Everybody from school stand movie law.,22,meyers-phillips,2023,USD,2185569,774632,1410937,1032591,378346,4853,373493,21855,43711,329782,359107,1633346,391892,1241454,,2185569,2109.65,3328.04,0.0258,1415,128.69,76122.19,4.72,0.6456
5160,Harrington Hawkins and Phillips,False,ZA,Floydshire,EdTech,2019,https://harringtonhawkinsandphillips.com,College international green no than seven.,19,harrington-hawkins-and-phillips,2023,USD,156516,31816,124700,88746,35954,0,35954,1565,3130,32824,9699,223098,39967,183131,13043.0,156516,158.02,887.17,0.0065,223,58.47,17069.5,0.57,0.7967
5161,Good Castillo and Moore,False,BR,Glennshire,SaaS,2020,https://goodcastilloandmoore.com,Hair argue difficult energy somebody show beat threat life suddenly.,27,good-castillo-and-moore,2023,USD,583004,73132,509872,205920,303952,5558,298394,5830,11660,286734,12764,398896,131833,267063,48583.67,583004,10.0,19.45,0.0304,9716,5.0,1000.0,12.76,0.8746
5162,Wright-Liu,False,BR,Christineton,Fintech,2018,https://wright-liu.com,Yourself there person usually article they dream way design.,16,wright-liu,2023,USD,3026043,1419634,1606409,1282942,323467,0,323467,30260,60520,262947,260554,1940624,501244,1439380,,3026043,2137.33,3898.96,0.1738,12608,20.0,89176.32,2.92,0.5309
5163,Waters PLC,False,NG,Port Beverlyborough,Fintech,2016,https://watersplc.com,Minute realize successful property model.,27,waters-plc,2023,USD,832017,452213,379804,237024,142780,0,142780,8320,16640,126140,15585,444003,71039,372964,,832017,1092.03,7101.67,0.0993,1846,37.54,2178.84,7.15,0.4565
5164,Johnston-Camacho,False,NG,Montgomeryfurt,AI/ML,2010,https://johnston-camacho.com,Which research discuss attack natural anyone old may.,20,johnston-camacho,2023,USD,1015418,482907,532511,168473,364038,574,363464,10154,20308,343156,4578,712282,236758,475524,,1015418,20.0,40.42,0.0435,1250,67.65,1000.0,4.58,0.5244
5165,Beasley and Sons,False,AU,Port Cody,SaaS,2022,https://beasleyandsons.com,Whose personal buy poor ask majority daughter together moment allow.,21,beasley-and-sons,2023,USD,2008797,805654,1203143,699177,503966,0,503966,20087,40175,463791,47020,1097608,319249,778359,167399.75,2008797,10.0,17.36,0.0612,3645,45.92,45533.78,1.03,0.5989
5166,Keith Gibson and Navarro,False,KE,Kellytown,AI/ML,2015,https://keithgibsonandnavarro.com,Pm very use how probably nature far majority value.,21,keith-gibson-and-navarro,2023,USD,982086,231529,750557,666759,83798,26935,56863,9820,19641,37222,413571,992792,342112,650680,,982086,1014.0,3226.24,0.1571,4092,20.0,43579.02,9.49,0.7642
5167,Brown Klein and Miller,False,DE,New Krystal,AgriTech,2013,https://brownkleinandmiller.com,Guy know must usually official task bed performance ask win.,21,brown-klein-and-miller,2023,EUR,507133,130699,376434,349983,26451,6118,20333,5071,10142,10191,19340,382060,175344,206716,,507133,1133.29,2637.42,0.0338,251,167.81,45280.78,0.43,0.7423
5168,Figueroa PLC,False,ZA,Paulshire,Marketplaces,2015,https://figueroaplc.com,Blood spend wear listen state protect cup member.,20,figueroa-plc,2023,USD,603206,208773,394433,168092,226341,3907,222434,6032,12064,210370,88440,568348,285505,282843,,603206,263.44,1131.42,0.0656,2513,20.0,2882.54,30.68,0.6539
5169,Myers LLC,False,DE,East Elizabethstad,Cybersecurity,2022,https://myersllc.com,Operation great teach everything arm product.,20,myers-llc,2023,EUR,1477477,776804,700673,903819,-203146,8989,-212135,14774,29549,-241684,83923,832945,320435,512510,,1477477,729.07,2640.2,0.0429,1521,80.93,49203.58,1.71,0.4742
5170,Francis-Rivera,False,GB,West Dennisville,SaaS,2016,https://francis-rivera.com,Result rich star read industry important boy.,16,francis-rivera,2023,USD,1345605,637708,707897,94731,613166,0,613166,13456,26912,586254,32305,749807,195381,554426,112133.75,1345605,108.15,460.02,0.0294,2153,52.08,21647.4,1.49,0.5261
5171,Keith Mejia and Leblanc,False,NG,Andrewfurt,AgriTech,2010,https://keithmejiaandleblanc.com,And official still item maintain store next.,33,keith-mejia-and-leblanc,2023,USD,75574,28117,47457,33467,13990,50031,-36041,755,1511,-37552,1412,171386,91590,79796,,75574,898.28,1222.33,0.0653,25,246.5,12905.64,0.11,0.628
5172,Lewis Group,False,ZA,North Andrew,EdTech,2010,https://lewisgroup.com,Provide music meet entire can build forward.,30,lewis-group,2023,USD,103912,40892,63020,67384,-4364,0,-4364,1039,2078,-6442,20531,207193,96145,111048,8659.33,103912,212.56,800.61,0.0239,92,93.25,2399.68,8.56,0.6065
5173,Morris and Sons,False,GB,New Allisonborough,AI/ML,2017,https://morrisandsons.com,Recognize degree reflect movie short left report admit.,26,morris-and-sons,2023,USD,631406,260914,370492,362023,8469,8572,-103,6314,12628,-12731,107779,526133,50551,475582,,631406,20.0,90.0,0.001,208,252.29,4185.39,25.75,0.5868
5174,Jordan-Martinez,False,US,North Kyle,EdTech,2015,https://jordan-martinez.com,Four my carry road statement.,17,jordan-martinez,2023,USD,564903,143851,421052,260571,160481,3097,157384,5649,11298,146086,48836,338950,162675,176275,47075.25,564903,242.84,647.05,0.0462,2029,23.2,54785.37,0.89,0.7454
5175,Moore-Shelton,False,DE,Ashleyview,IoT,2023,https://moore-shelton.com,Area tree build might standard officer company interest through should thing.,13,moore-shelton,2023,EUR,448996,287703,161293,55577,105716,0,105716,4489,8979,96737,25508,305721,196175,109546,,448996,20.0,104.07,0.0678,243,153.95,9610.8,2.65,0.3592
5176,Perez Campos and Cherry,False,EG,Coleton,Fintech,2009,https://perezcamposandcherry.com,Pressure happy year although some test condition garden region.,25,perez-campos-and-cherry,2023,USD,2418533,938659,1479874,1350699,129175,21648,107527,24185,48370,59157,23469,1346487,585326,761161,,2418533,20.0,49.14,0.0872,10077,20.0,119479.87,0.2,0.6119
5177,Johnson-Evans,False,CA,West Julie,Marketplaces,2010,https://johnson-evans.com,Establish little arrive out ready man.,35,johnson-evans,2023,USD,207074,121000,86074,112856,-26782,0,-26782,2070,4141,-30923,8888,287713,86766,200947,,207074,977.08,3211.56,0.0522,113,151.73,9134.54,0.97,0.4157
5178,Larson-Sanchez,False,DE,Acostaville,Mobility,2011,https://larson-sanchez.com,Group analysis suggest final recognize each expect know election get.,23,larson-sanchez,2023,EUR,560717,256280,304437,304361,76,3558,-3482,5607,11214,-14696,29036,368670,18433,350237,,560717,105.91,457.86,0.001,2336,20.0,43269.69,0.67,0.5429
5179,Campos-Patterson,False,EG,Lake Lisa,Fintech,2023,https://campos-patterson.com,Quite value but already computer agreement condition.,14,campos-patterson,2023,USD,1293376,251283,1042093,64668,977425,29126,948299,12933,25867,922432,61594,761771,156710,605061,,1293376,20.0,68.23,0.0375,479,224.76,33147.38,1.86,0.8057
5180,Torres PLC,False,DE,Susanberg,Fintech,2014,https://torresplc.com,Time else arm friend own.,21,torres-plc,2023,EUR,1767643,377991,1389652,771683,617969,9527,608442,17676,35352,573090,78509,1054834,70481,984353,,1767643,554.07,2638.41,0.0807,852,172.7,102297.47,0.77,0.7862
5181,Brown Group,False,KE,Derrickmouth,Mobility,2017,https://browngroup.com,Painting see picture adult head.,14,brown-group,2023,USD,593735,145041,448694,169723,278971,10473,268498,5937,11874,256624,94249,530309,337183,193126,,593735,1021.49,6803.61,0.001,416,118.93,19274.07,4.89,0.7557
5182,Valdez PLC,False,KE,Ellishaven,SaaS,2021,https://valdezplc.com,Throw three month remember month investment sometimes.,19,valdez-plc,2023,USD,704205,271837,432368,269489,162879,0,162879,7042,14084,148795,24988,407204,98857,308347,58683.75,704205,10.0,39.75,0.001,2761,21.25,10552.27,2.37,0.614
5183,Schroeder and Sons,False,FR,New Timothy,Cybersecurity,2022,https://schroederandsons.com,Point per bag whose kind culture would full consider sea black.,15,schroeder-and-sons,2023,EUR,968732,321663,647069,240378,406691,0,406691,9687,19374,387317,48193,595914,323021,272893,,968732,194.66,617.05,0.0391,359,224.66,19519.91,2.47,0.668
5184,Lee PLC,False,AU,New Victor,Marketplaces,2014,https://leeplc.com,Age decision skin site task.,17,lee-plc,2023,USD,256338,51167,205171,180275,24896,37657,-12761,2563,5126,-17887,13082,175894,53478,122416,,256338,20.0,10.0,0.1051,115,185.26,1000.0,13.08,0.8004
5185,Adams Inc,False,KE,West Michael,Marketplaces,2022,https://adamsinc.com,As day mention standard senior condition particular participant.,15,adams-inc,2023,USD,589256,164951,424305,402487,21818,39743,-17925,5892,11785,-29710,9570,343320,61822,281498,,589256,1706.37,5955.58,0.046,1362,36.04,24242.62,0.39,0.7201
5186,Floyd Wilson and Wood,False,US,Josephside,AgriTech,2021,https://floydwilsonandwood.com,Break series add next important.,23,floyd-wilson-and-wood,2023,USD,612732,178458,434274,143088,291186,0,291186,6127,12254,278932,28408,382621,169525,213096,,612732,739.4,5408.7,0.001,493,103.38,9205.21,3.09,0.7088
5187,Hutchinson Ramsey and Gardner,False,KE,Lake Davidhaven,AgriTech,2023,https://hutchinsonramseyandgardner.com,Federal low entire necessary fast.,21,hutchinson-ramsey-and-gardner,2023,USD,887045,243871,643174,121859,521315,43225,478090,8870,17740,460350,47813,642388,330957,311431,,887045,1221.64,5828.13,0.1087,669,110.42,5111.72,9.35,0.7251
5188,Rodriguez Inc,False,BR,Lisaport,HealthTech,2018,https://rodriguezinc.com,Traditional trouble shoulder cut value.,21,rodriguez-inc,2023,USD,271628,108394,163234,54125,109109,0,109109,2716,5432,103677,5440,294504,115222,179282,22635.67,271628,10.0,45.56,0.0128,4527,5.0,1000.0,5.44,0.6009
5189,Dodson Franco and Brown,False,NG,Williamsmouth,Mobility,2024,https://dodsonfrancoandbrown.com,Admit investment care man would need.,22,dodson-franco-and-brown,2023,USD,4471977,1372364,3099613,2172187,927426,0,927426,44719,89439,837987,28078,2436094,304409,2131685,,4471977,20.0,74.87,0.001,2205,168.95,179363.08,0.16,0.6931
5190,Holmes Herrera and Gonzalez,False,IN,South Troyburgh,Marketplaces,2017,https://holmesherreraandgonzalez.com,Apply pull safe certainly respond look film early.,22,holmes-herrera-and-gonzalez,2023,USD,330059,159864,170195,119139,51056,52563,-1507,3300,6601,-8108,44581,221061,70398,150663,,330059,1577.25,10440.38,0.0581,234,117.5,5764.15,7.73,0.5157
5191,Watson Brewer and Williamson,False,IN,Piercefurt,AI/ML,2015,https://watsonbrewerandwilliamson.com,Remember page night sign film.,20,watson-brewer-and-williamson,2023,USD,675965,225992,449973,480044,-30071,5303,-35374,6759,13519,-48893,28378,529980,99304,430676,,675965,20.0,43.6,0.0014,412,136.43,1000.0,28.38,0.6657
5192,Williamson-Brooks,False,CA,North Joel,AgriTech,2024,https://williamson-brooks.com,Anything what know hour almost step test foreign.,20,williamson-brooks,2023,USD,757970,283317,474653,167302,307351,9440,297911,7579,15159,282752,128827,592145,216427,375718,,757970,130.99,306.82,0.001,396,159.25,33920.59,3.8,0.6262
5193,Peters LLC,False,IN,Stricklandland,Marketplaces,2022,https://petersllc.com,Wish might stock per.,28,peters-llc,2023,USD,1135398,338742,796656,734628,62028,13737,48291,11353,22707,25584,97438,822524,42150,780374,,1135398,245.05,882.86,0.0583,796,118.85,63114.32,1.54,0.7017
5194,Lee-Jones,False,FR,Wrightmouth,HealthTech,2023,https://lee-jones.com,Eat bad upon build air eye.,14,lee-jones,2023,EUR,411143,111300,299843,136370,163473,24228,139245,4111,8222,131023,5922,393860,120170,273690,34261.92,411143,10.0,24.85,0.0023,486,70.46,1000.0,5.92,0.7293
5195,Conley-Ray,False,US,Elainebury,E-commerce,2024,https://conley-ray.com,Board act material against name.,19,conley-ray,2023,USD,453309,183684,269625,215822,53803,39031,14772,4533,9066,5706,32468,287192,181815,105377,,453309,92.11,232.54,0.001,123,306.24,35188.98,0.92,0.5948
5196,Gonzalez-Roberts,False,EG,North Andrewmouth,Mobility,2013,https://gonzalez-roberts.com,Care leg cold star.,20,gonzalez-roberts,2023,USD,428809,150153,278656,114420,164236,12711,151525,4288,8576,142949,2497,266320,60100,206220,,428809,1926.56,4208.47,0.0175,1786,20.0,4379.7,0.57,0.6498
5197,Holland-Flynn,False,GB,Maynardburgh,Fintech,2021,https://holland-flynn.com,Bar painting mother finally drug hit red whom couple.,28,holland-flynn,2023,USD,1207248,368785,838463,183757,654706,31986,622720,12072,24144,598576,179204,978665,407747,570918,,1207248,39.05,152.36,0.0355,709,141.84,34628.73,5.18,0.6945
5198,Hoffman-Lloyd,False,BR,West James,AgriTech,2011,https://hoffman-lloyd.com,That central try according smile forward herself view product deep.,17,hoffman-lloyd,2023,USD,728989,185126,543863,575411,-31548,47971,-79519,7289,14579,-94098,6544,551664,106213,445451,,728989,1226.26,2736.06,0.1052,288,210.37,56199.5,0.12,0.7461
5199,Young Inc,False,EG,Baldwinbury,E-commerce,2013,https://younginc.com,Son central mouth production want special wall three.,18,young-inc,2023,USD,776359,368520,407839,81214,326625,22058,304567,7763,15527,289040,51773,443771,251670,192101,,776359,421.47,2698.18,0.001,3234,20.0,31473.98,1.64,0.5253
5200,Rogers Group,False,DE,Crosbyton,Fintech,2015,https://rogersgroup.com,Movie hot stock glass stuff look central often start our.,10,rogers-group,2023,EUR,1200557,400832,799725,288843,510882,0,510882,12005,24011,486871,46506,701698,257930,443768,,1200557,20.0,125.72,0.0431,5002,20.0,26512.51,1.75,0.6661
5201,Williams LLC,False,DE,Claytonmouth,AgriTech,2024,https://williamsllc.com,Year concern benefit just human exist.,17,williams-llc,2023,EUR,112538,44305,68233,60249,7984,0,7984,1125,2250,5734,11099,255307,118813,136494,,112538,20.0,88.27,0.044,468,20.0,4271.79,2.6,0.6063
5202,Burton PLC,False,IN,Saraside,E-commerce,2024,https://burtonplc.com,Art improve enter set baby.,21,burton-plc,2023,USD,2575900,947154,1628746,1114625,514121,4245,509876,25759,51518,458358,244205,1729415,1106627,622788,,2575900,1610.82,8180.85,0.001,10732,20.0,56249.01,4.34,0.6323
5203,Johnson-Martin,False,EG,Port Melissaland,Fintech,2017,https://johnson-martin.com,Certain blood carry much thousand film.,27,johnson-martin,2023,USD,618088,379543,238545,327996,-89451,0,-89451,6180,12361,-101812,36727,461133,302092,159041,,618088,20.0,44.18,0.0381,163,315.58,39546.77,0.93,0.3859
5204,Saunders-Young,False,KE,Burnetthaven,EdTech,2012,https://saunders-young.com,Media too though seven impact TV administration.,21,saunders-young,2023,USD,874788,363083,511705,587738,-76033,0,-76033,8747,17495,-93528,44990,496846,135094,361752,72899.0,874788,202.63,1730.82,0.001,14579,5.0,8128.01,5.54,0.5849
5205,Jackson Inc,False,CA,East Nathanielmouth,HealthTech,2014,https://jacksoninc.com,Sister democratic recent consider stay fight bad seek age page.,15,jackson-inc,2023,USD,1199085,425172,773913,1185526,-411613,0,-411613,11990,23981,-435594,68836,751152,37557,713595,99923.75,1199085,538.38,2781.75,0.0258,5317,18.79,95832.42,0.72,0.6454
5206,Huffman Inc,False,AU,Richardtown,Energy,2013,https://huffmaninc.com,Perform order clearly budget agency fear fact turn.,23,huffman-inc,2023,USD,771926,236982,534944,880750,-345806,0,-345806,7719,15438,-361244,55808,560170,28851,531319,,771926,20.0,74.92,0.0611,488,131.71,95701.02,0.58,0.693
5207,Lambert Caldwell and Shepherd,False,GB,Lake Lisashire,IoT,2013,https://lambertcaldwellandshepherd.com,Current actually artist discuss sign trial use.,15,lambert-caldwell-and-shepherd,2023,USD,645625,196382,449243,268217,181026,38612,142414,6456,12912,129502,22522,506053,134853,371200,,645625,780.1,390.05,0.0925,377,142.62,49565.39,0.45,0.6958
5208,Guerra LLC,False,CA,Shawnmouth,AI/ML,2023,https://guerrallc.com,Reflect gun detail have mention level old.,26,guerra-llc,2023,USD,614059,164260,449799,218441,231358,0,231358,6140,12281,219077,19096,512140,205539,306601,,614059,369.21,1933.03,0.1219,461,110.91,26245.15,0.73,0.7325
5209,Diaz-Bell,False,BR,Vanessaview,IoT,2021,https://diaz-bell.com,Between mind poor beautiful figure.,16,diaz-bell,2023,USD,462321,153318,309003,148109,160894,40409,120485,4623,9246,111239,29006,401488,126193,275295,,462321,20.0,30.35,0.0778,1926,20.0,7320.75,3.96,0.6684
5210,Elliott Thompson and Frederick,False,AU,West Robert,Cybersecurity,2016,https://elliottthompsonandfrederick.com,Others city rest far difference ever.,24,elliott-thompson-and-frederick,2023,USD,937153,188206,748947,353520,395427,45407,350020,9371,18743,331277,99978,678312,154350,523962,,937153,1004.18,1758.22,0.0049,236,330.28,29206.45,3.42,0.7992
5211,Moran-Vargas,False,DE,Lopezborough,AgriTech,2023,https://moran-vargas.com,Mind hear toward from account choice range.,17,moran-vargas,2023,EUR,267854,51691,216163,84632,131531,40080,91451,2678,5357,86094,8405,162227,9604,152623,,267854,990.19,711.05,0.0595,223,99.89,1000.0,8.4,0.807
5212,Franklin Ltd,False,IN,Davidfurt,E-commerce,2012,https://franklinltd.com,Simple theory my her of carry mention perhaps especially.,23,franklin-ltd,2023,USD,298632,90651,207981,177742,30239,14674,15565,2986,5972,9593,17769,311196,59369,251827,,298632,20.0,52.48,0.001,1244,20.0,1000.0,17.77,0.6964
5213,Anderson-Hudson,False,IN,Wendybury,E-commerce,2019,https://anderson-hudson.com,Boy trial step responsibility share admit situation.,26,anderson-hudson,2023,USD,828647,302266,526381,325439,200942,0,200942,8286,16572,184370,29532,448896,130704,318192,,828647,20.0,16.53,0.1167,431,160.08,52246.75,0.57,0.6352
5214,Williams Inc,False,ZA,East Dillonbury,E-commerce,2022,https://williamsinc.com,Our need method option international most lot.,18,williams-inc,2023,USD,451657,120984,330673,221607,109066,0,109066,4516,9033,100033,15611,262876,91180,171696,,451657,2808.33,7459.11,0.0784,170,220.12,1532.32,10.19,0.7321
5215,Moss-Martinez,False,IN,Gailshire,Energy,2020,https://moss-martinez.com,Consumer time bank add cover.,16,moss-martinez,2023,USD,5007719,2175499,2832220,1771627,1060593,9258,1051335,50077,100154,951181,537800,3064551,1805635,1258916,,5007719,600.72,2662.97,0.1396,4630,90.12,173478.06,3.1,0.5656
5216,Conway Johnson and Stewart,False,AU,West Katherinechester,Energy,2008,https://conwayjohnsonandstewart.com,Recognize effort right through specific send employee.,19,conway-johnson-and-stewart,2023,USD,954503,394940,559563,1108183,-548620,0,-548620,9545,19090,-567710,40627,522356,394133,128223,,954503,471.89,2089.3,0.0038,3977,20.0,104312.61,0.39,0.5862
5217,Wong Ltd,False,AU,North Roberttown,Energy,2009,https://wongltd.com,Particular and growth plan also commercial similar so bed full place.,19,wong-ltd,2023,USD,4036442,1544937,2491505,2493378,-1873,37514,-39387,40364,80728,-120115,142293,2352214,520857,1831357,,4036442,94.25,157.56,0.001,6573,51.17,190580.49,0.75,0.6173
5218,Murray Johnson and Smith,False,TN,Joshuachester,E-commerce,2012,https://murrayjohnsonandsmith.com,Service without sound director officer often cell.,14,murray-johnson-and-smith,2023,USD,945681,273082,672599,47284,625315,48742,576573,9456,18913,557660,204979,807090,366459,440631,,945681,934.66,2706.59,0.1038,384,205.19,1000.0,204.98,0.7112
5219,Johnson-Jones,False,EG,Jessicafort,AgriTech,2008,https://johnson-jones.com,Animal position probably plant what despite media forward whom especially.,16,johnson-jones,2023,USD,485250,215774,269476,181705,87771,41680,46091,4852,9705,36386,17999,351830,168148,183682,,485250,981.81,1509.4,0.0802,2021,20.0,32698.77,0.55,0.5553
5220,Sanchez-Dixon,False,ZA,Port Scott,EdTech,2014,https://sanchez-dixon.com,Although ability probably not world which bill couple.,19,sanchez-dixon,2023,USD,336826,102100,234726,119963,114763,0,114763,3368,6736,108027,12649,286103,107265,178838,28068.83,336826,313.03,1624.61,0.0458,3418,8.21,29781.16,0.42,0.6969
5221,Johnson Pruitt and Finley,False,BR,Lake Robertfort,Cybersecurity,2016,https://johnsonpruittandfinley.com,Should unit physical shake similar spend pass.,14,johnson-pruitt-and-finley,2023,USD,1678207,746191,932016,1297225,-365209,0,-365209,16782,33564,-398773,72664,983632,274370,709262,,1678207,20.0,10.0,0.0771,757,184.6,117649.3,0.62,0.5554
5222,Fletcher Brown and Rhodes,False,IN,North Natasha,E-commerce,2008,https://fletcherbrownandrhodes.com,Dog group political stock memory simply reflect real style bed.,22,fletcher-brown-and-rhodes,2023,USD,588775,170121,418654,254853,163801,40045,123756,5887,11775,111981,46104,365143,60787,304356,,588775,20.0,10.0,0.001,515,95.21,13661.25,3.37,0.7111
5223,Bishop Ltd,False,CA,Justinmouth,Energy,2020,https://bishopltd.com,Attorney assume effort article team agree bring home better.,23,bishop-ltd,2023,USD,3725765,1576783,2148982,599340,1549642,15494,1534148,37257,74515,1459633,54547,2089837,1510235,579602,,3725765,418.53,209.26,0.1089,1996,155.52,82479.48,0.66,0.5768
5224,Daniels Nielsen and Ashley,False,CA,South Wendy,AI/ML,2014,https://danielsnielsenandashley.com,Increase agreement without the help.,15,daniels-nielsen-and-ashley,2023,USD,1330553,88801,1241752,642415,599337,13340,585997,13305,26611,559386,324584,1176596,96076,1080520,,1330553,1060.2,530.1,0.0903,1023,108.31,100840.94,3.22,0.9333
5225,Lopez Ltd,False,AU,Port Davidville,EdTech,2024,https://lopezltd.com,Loss well citizen much force weight poor move test.,19,lopez-ltd,2023,USD,87001,46214,40787,27525,13262,0,13262,870,1740,11522,5250,152609,68403,84206,7250.08,87001,609.9,3372.65,0.0053,85,85.13,1000.0,5.25,0.4688
5226,Floyd Ltd,False,EG,New Brittney,AgriTech,2011,https://floydltd.com,Important product necessary interest do.,21,floyd-ltd,2023,USD,199738,39906,159832,131258,28574,0,28574,1997,3994,24580,8006,127270,77853,49417,,199738,480.84,687.84,0.1255,186,89.23,1000.0,8.01,0.8002
5227,Woodward Kelly and Martinez,False,FR,Robertfurt,EdTech,2013,https://woodwardkellyandmartinez.com,Music particular wall fly scientist two but ball program.,20,woodward-kelly-and-martinez,2023,EUR,98870,22759,76111,16201,59910,0,59910,988,1977,57933,8773,201962,111408,90554,8239.17,98870,37.06,131.0,0.029,110,74.51,34989.6,0.25,0.7698
5228,Carlson-Davis,False,CA,Jaredtown,Cybersecurity,2023,https://carlson-davis.com,Certain fight interesting successful own performance product one.,17,carlson-davis,2023,USD,308414,71782,236632,112659,123973,0,123973,3084,6168,117805,45768,246702,26590,220112,,308414,20.0,129.02,0.0632,124,206.3,1000.0,45.77,0.7673
5229,Hudson-Nolan,False,ZA,Blackshire,IoT,2023,https://hudson-nolan.com,Anything level company south.,24,hudson-nolan,2023,USD,474509,141868,332641,263821,68820,11077,57743,4745,9490,48253,7935,363106,242351,120755,,474509,1527.02,9238.17,0.0665,123,319.2,15228.82,0.52,0.701
5230,Ross Inc,False,US,Dannybury,Marketplaces,2020,https://rossinc.com,Opportunity remember interest prove face not themselves loss decision.,23,ross-inc,2023,USD,229174,45167,184007,92843,91164,0,91164,2291,4583,86581,10395,176602,81341,95261,,229174,364.36,818.23,0.0275,89,214.01,1000.0,10.4,0.8029
5231,Torres Inc,False,ZA,North Nancy,Cybersecurity,2023,https://torresinc.com,Hard machine point loss attorney.,21,torres-inc,2023,USD,578285,122009,456276,289862,166414,16446,149968,5782,11565,138403,50226,449637,231071,218566,,578285,20.0,49.63,0.0953,2409,20.0,43951.12,1.14,0.789
5232,Smith Ltd,False,DE,Romerotown,AgriTech,2020,https://smithltd.com,Congress economy get add stuff perform turn TV agency.,20,smith-ltd,2023,EUR,879126,255670,623456,469010,154446,23091,131355,8791,17582,113773,24823,495244,188913,306331,,879126,1154.07,4680.8,0.1108,307,238.3,23524.53,1.06,0.7092
5233,Whitney and Sons,False,US,East Ashley,Fintech,2009,https://whitneyandsons.com,Power even east late do cup nice.,22,whitney-and-sons,2023,USD,530694,267438,263256,317561,-54305,13803,-68108,5306,10613,-78721,6706,425908,52066,373842,,530694,20.0,23.36,0.001,401,110.28,50547.95,0.13,0.4961
5234,Tucker-Sims,False,BR,East Laurafurt,E-commerce,2016,https://tucker-sims.com,World story reflect discussion have be prevent explain.,24,tucker-sims,2023,USD,4632939,2251065,2381874,2945285,-563411,40562,-603973,46329,92658,-696631,502452,2974120,571534,2402586,,4632939,711.45,3387.93,0.0508,2434,158.59,206990.26,2.43,0.5141
5235,James Chambers and Hamilton,False,NG,Padillachester,E-commerce,2022,https://jameschambersandhamilton.com,Entire bed evening eye scene politics stage determine.,19,james-chambers-and-hamilton,2023,USD,1206342,410219,796123,552386,243737,8210,235527,12063,24126,211401,9224,729948,204866,525082,,1206342,239.72,966.43,0.0766,497,202.27,5607.59,1.64,0.6599
5236,Murphy Watkins and Peterson,False,IN,Maryhaven,Fintech,2023,https://murphywatkinsandpeterson.com,Agent success discussion institution once.,15,murphy-watkins-and-peterson,2023,USD,3697424,985762,2711662,2801225,-89563,34473,-124036,36974,73948,-197984,296500,2274522,1716100,558422,,3697424,1237.57,5493.01,0.057,2732,112.76,237318.66,1.25,0.7334
5237,Allen Brown and Blanchard,False,GB,Lake Rachel,Cybersecurity,2010,https://allenbrownandblanchard.com,Keep to mind choice response.,23,allen-brown-and-blanchard,2023,USD,598192,144191,454001,246950,207051,0,207051,5981,11963,195088,54804,508238,183845,324393,,598192,208.07,770.79,0.0077,301,165.33,41188.43,1.33,0.759
5238,Williams Rogers and Thompson,False,CA,Lake Jill,Cybersecurity,2021,https://williamsrogersandthompson.com,Conference forward reveal heart night throw five.,25,williams-rogers-and-thompson,2023,USD,460698,186990,273708,126745,146963,8144,138819,4606,9213,129606,27777,455173,121956,333217,,460698,20.0,95.82,0.001,428,89.52,23798.77,1.17,0.5941
5239,Simmons Ltd,False,GB,Lake Brianfurt,HealthTech,2017,https://simmonsltd.com,Before pressure describe change share close child side.,23,simmons-ltd,2023,USD,434416,156652,277764,373265,-95501,13568,-109069,4344,8688,-117757,38555,429193,146924,282269,36201.33,434416,507.09,1171.01,0.0624,433,83.44,36263.89,1.06,0.6394
5240,Hines-Dixon,False,KE,Port Joshua,EdTech,2010,https://hines-dixon.com,Understand hit answer change almost tree national center first herself question.,28,hines-dixon,2023,USD,256553,113902,142651,173656,-31005,0,-31005,2565,5131,-36136,16051,326896,169107,157789,21379.42,256553,10.0,59.57,0.001,444,48.1,1000.0,16.05,0.556
5241,Guzman Mclaughlin and Pham,False,EG,Christopherhaven,EdTech,2018,https://guzmanmclaughlinandpham.com,Officer theory party street test letter back most.,29,guzman-mclaughlin-and-pham,2023,USD,281918,77147,204771,198632,6139,25674,-19535,2819,5638,-25173,26874,315144,29231,285913,23493.17,281918,235.23,735.63,0.0622,317,74.01,9035.25,2.97,0.7263
5242,Larson Inc,False,KE,Fergusonfort,AI/ML,2016,https://larsoninc.com,Information until effect region say world wear interview.,28,larson-inc,2023,USD,4907041,1730913,3176128,5506187,-2330059,0,-2330059,49070,98140,-2428199,171867,2650169,308581,2341588,,4907041,20.0,38.43,0.0506,4289,95.33,453877.39,0.38,0.6473
5243,Alexander Johnson and Miller,False,NG,South Lee,AI/ML,2017,https://alexanderjohnsonandmiller.com,Continue as dark knowledge owner dream.,21,alexander-johnson-and-miller,2023,USD,594069,80219,513850,320754,193096,6807,186289,5940,11881,174408,62919,541727,185434,356293,,594069,20.0,10.0,0.0548,218,226.64,47943.54,1.31,0.865
5244,Brewer-White,False,ZA,Brittanystad,SaaS,2012,https://brewer-white.com,Myself computer big commercial mention western morning decade.,16,brewer-white,2023,USD,1151760,500693,651067,451499,199568,0,199568,11517,23035,176533,31377,708330,346163,362167,95980.0,1151760,10.0,49.62,0.001,885,108.36,38556.57,0.81,0.5653
5245,Cabrera-Meyers,False,AU,Johnville,Fintech,2018,https://cabrera-meyers.com,Economy how them trial human time for source blood draw.,18,cabrera-meyers,2023,USD,1868477,746072,1122405,589387,533018,0,533018,18684,37369,495649,178117,1232506,650394,582112,,1868477,491.33,2144.18,0.1093,803,193.9,61301.29,2.91,0.6007
5246,Everett LLC,False,CA,North Amber,Mobility,2014,https://everettllc.com,Fly become sign color particular far head.,21,everett-llc,2023,USD,4560156,1973116,2587040,1635388,951652,11473,940179,45601,91203,848976,410857,2826976,819498,2007478,,4560156,1125.41,7109.86,0.0606,1101,344.94,168490.99,2.44,0.5673
5247,Sparks Graham and Miller,False,GB,East Michaelmouth,E-commerce,2022,https://sparksgrahamandmiller.com,Politics medical evidence include oil.,23,sparks-graham-and-miller,2023,USD,576807,220939,355868,217283,138585,11842,126743,5768,11536,115207,5215,366118,186016,180102,,576807,679.2,1860.79,0.0313,136,352.48,1000.0,5.22,0.617
5248,Kennedy PLC,False,DE,Thomasland,Mobility,2019,https://kennedyplc.com,Laugh participant own major small beat.,16,kennedy-plc,2023,EUR,737337,309907,427430,510842,-83412,484,-83896,7373,14746,-98642,60905,467126,141947,325179,,737337,1488.3,1826.58,0.0061,2949,20.83,57189.39,1.06,0.5797
5249,Warner Medina and Harris,False,CA,East Jason,EdTech,2016,https://warnermedinaandharris.com,Hair whole per sound late however drop garden religious.,18,warner-medina-and-harris,2023,USD,500861,214178,286683,288593,-1910,0,-1910,5008,10017,-11927,11885,356189,20562,335627,41738.42,500861,13.13,93.91,0.001,8347,5.0,26382.36,0.45,0.5724
5250,Wolfe and Sons,False,IN,Port Scott,IoT,2008,https://wolfeandsons.com,Between majority week agree beautiful common animal general rise.,17,wolfe-and-sons,2023,USD,568431,62264,506167,316842,189325,34566,154759,5684,11368,143391,7874,331243,37421,293822,,568431,20.0,81.53,0.0833,171,276.7,30763.72,0.26,0.8905
5251,Vazquez-Chavez,False,GB,Amyside,Fintech,2021,https://vazquez-chavez.com,Develop receive begin member item early few.,29,vazquez-chavez,2023,USD,936982,432061,504921,344213,160708,20371,140337,9369,18739,121598,75765,581118,230483,350635,,936982,547.36,512.12,0.0561,3904,20.0,26141.29,2.9,0.5389
5252,Taylor-Nguyen,False,TN,Hartmantown,Energy,2023,https://taylor-nguyen.com,Agency game film decade case parent any near.,19,taylor-nguyen,2023,USD,2209884,801952,1407932,2587220,-1179288,7776,-1187064,22098,44197,-1231261,71159,1271198,653014,618184,,2209884,174.13,694.25,0.0038,1609,114.45,215690.57,0.33,0.6371
5253,Meza-Pratt,False,AU,West Victorburgh,SaaS,2024,https://meza-pratt.com,Value about sign reflect town including check Mr computer.,18,meza-pratt,2023,USD,794078,213735,580343,186915,393428,3910,389518,7940,15881,373637,37873,559957,328670,231287,66173.17,794078,1099.6,4090.82,0.0907,13234,5.0,1000.0,37.87,0.7308
5254,Murphy LLC,False,US,New Peter,AI/ML,2019,https://murphyllc.com,Behavior cultural nice million enter yard.,16,murphy-llc,2023,USD,1865107,650799,1214308,417911,796397,24275,772122,18651,37302,734820,56394,992927,276234,716693,,1865107,1250.24,2291.83,0.0645,1068,145.41,33566.73,1.68,0.6511
5255,Baker Mills and Phillips,False,US,Josephburgh,IoT,2021,https://bakermillsandphillips.com,Environment spring film young matter.,7,baker-mills-and-phillips,2023,USD,613743,194718,419025,633875,-214850,17103,-231953,6137,12274,-244227,30757,345176,97483,247693,,613743,331.48,165.74,0.0124,2221,23.02,67858.79,0.45,0.6827
5256,Mcdonald West and Tate,False,US,Lake Melissa,AI/ML,2018,https://mcdonaldwestandtate.com,Stay because poor almost yet similar.,17,mcdonald-west-and-tate,2023,USD,2043871,654838,1389033,102193,1286840,0,1286840,20438,40877,1245963,103877,1320579,842980,477599,,2043871,756.47,2455.91,0.001,661,257.5,31573.9,3.29,0.6796
5257,Farmer Moore and Garza,False,AU,South Joshuahaven,AI/ML,2023,https://farmermooreandgarza.com,She population street part discussion career base involve.,25,farmer-moore-and-garza,2023,USD,1053607,303380,750227,645655,104572,1436,103136,10536,21072,82064,36582,602970,195746,407224,,1053607,739.74,3077.02,0.001,580,151.31,33100.71,1.11,0.7121
5258,Arroyo LLC,False,IN,Ronaldmouth,IoT,2018,https://arroyollc.com,Science keep authority lawyer case keep process.,9,arroyo-llc,2023,USD,305960,114859,191101,128434,62667,0,62667,3059,6119,56548,8392,207159,100177,106982,,305960,1355.21,5545.45,0.0121,119,213.3,15286.25,0.55,0.6246
5259,Baxter Miles and Chandler,False,BR,Sydneyfort,Fintech,2010,https://baxtermilesandchandler.com,Charge information happy live trouble along admit.,18,baxter-miles-and-chandler,2023,USD,2032495,522209,1510286,891144,619142,35262,583880,20324,40649,543231,1205110,2411257,1233335,1177922,,2032495,1218.31,2458.59,0.0476,1883,89.92,61802.4,19.5,0.7431
5260,Schwartz Inc,False,KE,West Alex,Fintech,2011,https://schwartzinc.com,Memory them wish despite Republican tend forget assume.,14,schwartz-inc,2023,USD,8199099,2565719,5633380,3190836,2442544,0,2442544,81990,163981,2278563,161278,4327924,1375300,2952624,,8199099,947.64,5143.39,0.0066,5261,129.85,264566.51,0.61,0.6871
5261,Little LLC,False,NG,Dianastad,HealthTech,2024,https://littlellc.com,Heart law eight nothing treatment door.,27,little-llc,2023,USD,757657,173523,584134,291539,292595,0,292595,7576,15153,277442,26849,568738,136215,432523,63138.08,757657,351.77,2531.15,0.0493,1831,34.47,2036.92,13.18,0.771
5262,Braun-Lopez,False,FR,East Andrea,IoT,2022,https://braun-lopez.com,Story still upon account pull decide by air field.,15,braun-lopez,2023,EUR,301025,88346,212679,249132,-36453,0,-36453,3010,6020,-42473,3113,161935,17495,144440,,301025,489.99,3242.82,0.0823,1236,20.29,3327.68,0.94,0.7065
5263,Smith-Johnson,False,KE,Michaelport,Marketplaces,2014,https://smith-johnson.com,Ever spend continue college while tough page.,22,smith-johnson,2023,USD,399316,89873,309443,48785,260658,26385,234273,3993,7986,226287,9349,281257,14062,267195,,399316,345.96,1350.79,0.0459,1663,20.0,1000.0,9.35,0.7749
5264,Mason Group,False,AU,South Gregory,Fintech,2021,https://masongroup.com,Culture life cold again tell mother relate.,13,mason-group,2023,USD,1921468,406972,1514496,720091,794405,0,794405,19214,38429,755976,66348,1040689,101872,938817,,1921468,1005.97,5598.68,0.0071,8006,20.0,67487.79,0.98,0.7882
5265,Allen-Colon,False,IN,Browningberg,Mobility,2022,https://allen-colon.com,Stand from happen page something explain clear smile many officer.,16,allen-colon,2023,USD,826701,393041,433660,311696,121964,0,121964,8267,16534,105430,170511,703336,35166,668170,,826701,373.24,981.69,0.001,1159,59.4,25400.41,6.71,0.5246
5266,Richardson-Arnold,False,ZA,Ayalashire,HealthTech,2018,https://richardson-arnold.com,West whole view about song quite stage.,18,richardson-arnold,2023,USD,656776,236776,420000,305289,114711,5033,109678,6567,13135,96543,36164,534311,153901,380410,54731.33,656776,395.22,1406.41,0.0732,10946,5.0,14270.16,2.53,0.6395
5267,Brown and Sons,False,FR,West Katrina,HealthTech,2018,https://brownandsons.com,Hour defense blue contain surface.,21,brown-and-sons,2023,EUR,373544,113522,260022,142652,117370,0,117370,3735,7470,109900,25304,257186,157723,99463,31128.67,373544,10.0,42.93,0.0658,1217,25.56,9791.09,2.58,0.6961
5268,Farrell Mckee and Houston,False,EG,Nunezshire,AI/ML,2021,https://farrellmckeeandhouston.com,Such human red public who I increase contain.,18,farrell-mckee-and-houston,2023,USD,538768,162848,375920,218493,157427,0,157427,5387,10775,146652,23732,361588,32986,328602,,538768,20.0,121.62,0.1194,224,200.3,46635.43,0.51,0.6977
5269,Snyder Ltd,False,US,West Lauren,Energy,2017,https://snyderltd.com,Bag total room ok born send least difficult.,26,snyder-ltd,2023,USD,3534421,1951675,1582746,1325925,256821,0,256821,35344,70688,186133,34640,1969771,585051,1384720,,3534421,401.73,200.86,0.0755,10856,27.13,127105.18,0.27,0.4478
5270,Boyd Cook and Castillo,False,US,Vickiport,IoT,2020,https://boydcookandcastillo.com,Shoulder eye fear job put.,19,boyd-cook-and-castillo,2023,USD,215528,100790,114738,81649,33089,320,32769,2155,4310,28459,680,256345,12817,243528,,215528,1029.44,5078.59,0.0498,174,102.66,1000.0,0.68,0.5324
5271,Walsh Walker and Michael,False,US,Thomasstad,SaaS,2015,https://walshwalkerandmichael.com,Peace bank mention film others game activity.,16,walsh-walker-and-michael,2023,USD,1227633,641243,586390,951097,-364707,0,-364707,12276,24552,-389259,27161,681335,138622,542713,102302.75,1227633,10.0,11.59,0.0235,3536,28.93,88622.19,0.31,0.4777
5272,Moore PLC,False,CA,Carlosside,Energy,2012,https://mooreplc.com,Product no just heavy be herself firm accept.,14,moore-plc,2023,USD,5054432,1807999,3246433,2205945,1040488,3377,1037111,50544,101088,936023,306445,2990254,1536098,1454156,,5054432,1502.21,4392.29,0.0189,10906,38.62,163470.88,1.87,0.6423
5273,Boyd Rodriguez and Larson,False,IN,Hendersonshire,EdTech,2018,https://boydrodriguezandlarson.com,Specific let never walk art room.,16,boyd-rodriguez-and-larson,2023,USD,1197757,555028,642729,71111,571618,15016,556602,11977,23955,532647,11878,773879,120219,653660,99813.08,1197757,10.0,36.54,0.0248,1554,64.22,1000.0,11.88,0.5366
5274,Cherry Pineda and Maynard,False,NG,New Elizabethberg,Mobility,2014,https://cherrypinedaandmaynard.com,Standard rock century effort administration somebody since down.,24,cherry-pineda-and-maynard,2023,USD,294918,80252,214666,198994,15672,4293,11379,2949,5898,5481,17437,280797,213976,66821,,294918,1442.81,721.4,0.0473,1228,20.0,1000.0,17.44,0.7279
5275,Waters Group,False,AU,Rebeccamouth,IoT,2019,https://watersgroup.com,Fast fly clearly smile have back image strong fear.,17,waters-group,2023,USD,573169,290845,282324,436113,-153789,1555,-155344,5731,11463,-166807,86725,531139,308098,223041,,573169,290.91,785.64,0.0081,722,66.15,31132.56,2.79,0.4926
5276,Young Burns and Vargas,False,ZA,Lindaberg,IoT,2012,https://youngburnsandvargas.com,Evening alone if eye strategy.,11,young-burns-and-vargas,2023,USD,186604,71770,114834,114365,469,0,469,1866,3732,-3263,10579,289391,69540,219851,,186604,897.9,2129.7,0.094,58,265.34,37522.63,0.28,0.6154
5277,Goodman Group,False,DE,Clairefort,HealthTech,2014,https://goodmangroup.com,Window vote fill physical traditional meet.,12,goodman-group,2023,EUR,581353,239604,341749,409130,-67381,6104,-73485,5813,11627,-85112,23278,423335,230233,193102,48446.08,581353,10.0,10.0,0.0183,438,110.56,45768.68,0.51,0.5879
5278,Ellis-Estes,False,IN,Andremouth,HealthTech,2011,https://ellis-estes.com,Guy seven offer growth culture per clear notice worry.,18,ellis-estes,2023,USD,1548217,598707,949510,896773,52737,27358,25379,15482,30964,-5585,211103,1018958,300445,718513,129018.08,1548217,10.0,60.54,0.0364,1808,71.33,76072.03,2.78,0.6133
5279,Rice Garrett and Curtis,False,US,New Jonathanstad,AI/ML,2009,https://ricegarrettandcurtis.com,May success including group common understand reflect.,17,rice-garrett-and-curtis,2023,USD,492797,164523,328274,93785,234489,21329,213160,4927,9855,203305,12263,458051,174672,283379,,492797,20.0,113.77,0.028,782,52.51,41755.62,0.29,0.6661
5280,Richards Lee and Boyd,False,AU,Amyborough,HealthTech,2019,https://richardsleeandboyd.com,Kitchen sport carry star tough.,28,richards-lee-and-boyd,2023,USD,1065857,303237,762620,373565,389055,0,389055,10658,21317,367738,21109,677338,33866,643472,88821.42,1065857,10.0,14.97,0.0197,779,113.96,51861.26,0.41,0.7155
5281,Huffman-Ross,False,FR,Port Joshua,E-commerce,2018,https://huffman-ross.com,Relationship behavior response seek me pass.,21,huffman-ross,2023,EUR,282453,112114,170339,143220,27119,0,27119,2824,5649,21470,3743,337573,122138,215435,,282453,1622.89,7483.28,0.1065,1176,20.0,1000.0,3.74,0.6031
5282,Oconnor LLC,False,DE,Lake Lauren,Marketplaces,2014,https://oconnorllc.com,Nice step final guy kind at want few.,29,oconnor-llc,2023,EUR,788705,122026,666679,137568,529111,7470,521641,7887,15774,505867,49223,542252,79243,463009,,788705,108.34,461.32,0.001,634,103.54,16520.2,2.98,0.8453
5283,Perez Ltd,False,DE,Julieview,AgriTech,2013,https://perezltd.com,Wrong score he return book apply stock.,23,perez-ltd,2023,EUR,355032,142752,212280,23985,188295,8341,179954,3550,7100,172854,5509,200703,10066,190637,,355032,128.03,774.77,0.0217,131,225.25,1000.0,5.51,0.5979
5284,Anderson-Hicks,False,TN,East Aaronville,AgriTech,2015,https://anderson-hicks.com,Either century gun wall media.,18,anderson-hicks,2023,USD,284767,56144,228623,222791,5832,0,5832,2847,5695,137,45480,333871,128164,205707,,284767,20.0,138.48,0.0743,1186,20.0,25289.45,1.8,0.8028
5285,Barker-Carter,False,DE,Smithburgh,E-commerce,2008,https://barker-carter.com,And cold rate buy pattern maybe from house.,23,barker-carter,2023,EUR,774378,328443,445935,523361,-77426,42154,-119580,7743,15487,-135067,38662,509790,304304,205486,,774378,412.72,384.74,0.0876,603,106.86,51859.94,0.75,0.5759
5286,Taylor-Waters,False,GB,South Billy,Mobility,2011,https://taylor-waters.com,Wall can nor should oil thousand upon edge.,26,taylor-waters,2023,USD,2297237,579426,1717811,847814,869997,0,869997,22972,45944,824053,217689,1562500,228469,1334031,,2297237,416.92,1387.63,0.001,9571,20.0,69711.22,3.12,0.7478
5287,Hayes PLC,False,TN,Port Alexander,SaaS,2022,https://hayesplc.com,Action middle wear woman street.,16,hayes-plc,2023,USD,767366,363084,404282,759912,-355630,0,-355630,7673,15347,-370977,36904,454118,96837,357281,63947.17,767366,392.19,1118.15,0.0593,5067,12.62,68410.84,0.54,0.5268
5288,Peterson LLC,False,ZA,Port Alanborough,Cybersecurity,2014,https://petersonllc.com,Protect wind until side room meeting sister pattern.,16,peterson-llc,2023,USD,1621170,577386,1043784,647000,396784,25251,371533,16211,32423,339110,23277,878922,336020,542902,,1621170,1904.04,4829.87,0.0804,6754,20.0,44365.82,0.52,0.6438
5289,Burgess-Vasquez,False,TN,Annemouth,SaaS,2022,https://burgess-vasquez.com,Product truth per hit seem rock plan bar present.,23,burgess-vasquez,2023,USD,1011917,226797,785120,576137,208983,21483,187500,10119,20238,167262,45782,676245,55025,621220,84326.42,1011917,370.56,1481.33,0.0077,3605,23.39,89503.63,0.51,0.7759
5290,Simon Jenkins and Estrada,False,EG,Reyesborough,Energy,2014,https://simonjenkinsandestrada.com,Itself development religious ball myself others.,21,simon-jenkins-and-estrada,2023,USD,1746938,749516,997422,392419,605003,2621,602382,17469,34938,567444,134639,1174069,656151,517918,,1746938,20.0,86.94,0.0611,848,171.49,90440.51,1.49,0.571
5291,Gordon-May,False,DE,Reyesberg,Energy,2011,https://gordon-may.com,Have point media five hour thousand view.,15,gordon-may,2023,EUR,2943900,844833,2099067,1333684,765383,0,765383,29439,58878,706505,330615,1961256,150418,1810838,,2943900,20.0,64.01,0.0433,1294,189.45,87389.26,3.78,0.713
5292,Walker-Gonzales,False,FR,Kennethhaven,HealthTech,2024,https://walker-gonzales.com,Form federal step write size including movement.,26,walker-gonzales,2023,EUR,6672100,2598059,4074041,333605,3740436,0,3740436,66721,133442,3606994,390483,3898482,3103673,794809,556008.33,6672100,10.0,58.15,0.0453,14194,39.17,36864.2,10.59,0.6106
5293,Wilson LLC,False,KE,North Elizabeth,Cybersecurity,2024,https://wilsonllc.com,Level prevent son allow couple late until.,20,wilson-llc,2023,USD,845358,178263,667095,356349,310746,0,310746,8453,16907,293839,41915,555550,206989,348561,,845358,593.27,1212.86,0.0406,249,281.8,18813.62,2.23,0.7891
5294,Evans-Smith,False,FR,Doughertyland,HealthTech,2014,https://evans-smith.com,Economic choose accept stand forward or.,19,evans-smith,2023,EUR,469789,128607,341182,90009,251173,7585,243588,4697,9395,234193,4201,304616,26549,278067,39149.08,469789,10.0,16.76,0.0574,553,70.74,1000.0,4.2,0.7262
5295,Johnson Ltd,False,FR,Lynchtown,Mobility,2019,https://johnsonltd.com,Power his state put benefit scientist here.,18,johnson-ltd,2023,EUR,458334,290495,167839,206278,-38439,17842,-56281,4583,9166,-65447,74434,495820,193227,302593,,458334,879.62,2866.57,0.0363,242,157.32,27965.19,2.66,0.3662
5296,Perry-Lee,False,ZA,Davidside,E-commerce,2021,https://perry-lee.com,Range chair writer than according recent believe change.,24,perry-lee,2023,USD,1615134,554486,1060648,376702,683946,27125,656821,16151,32302,624519,126540,987673,173400,814273,,1615134,101.33,50.66,0.0134,1338,100.53,1000.0,126.54,0.6567
5297,Perez and Sons,False,DE,Fitzgeraldfurt,EdTech,2010,https://perezandsons.com,Full side speech focus church science live majority result stuff.,26,perez-and-sons,2023,EUR,419973,153715,266258,172655,93603,9233,84370,4199,8399,75971,354033,643698,179960,463738,34997.75,419973,810.34,4360.07,0.0151,558,62.71,10627.4,33.31,0.634
5298,Jackson Inc,False,AU,West Teresaborough,AI/ML,2019,https://jacksoninc.com,Again early help soon but material source close bar not.,22,jackson-inc,2023,USD,964496,290502,673994,629048,44946,1147,43799,9644,19289,24510,22143,651785,356172,295613,,964496,987.84,493.92,0.0246,328,245.02,12422.77,1.78,0.6988
5299,Chang Brown and Mcdonald,False,EG,West Aaron,AgriTech,2024,https://changbrownandmcdonald.com,Left prove go actually.,22,chang-brown-and-mcdonald,2023,USD,142889,75451,67438,73294,-5856,0,-5856,1428,2857,-8713,2515,127028,14992,112036,,142889,20.0,41.47,0.0681,595,20.0,17841.79,0.14,0.472
5300,Lamb PLC,False,FR,Brandyton,Mobility,2008,https://lambplc.com,Read tell evening meet challenge per during to situation.,22,lamb-plc,2023,EUR,365791,112209,253582,121882,131700,12142,119558,3657,7315,112243,41058,352152,171453,180699,,365791,20.0,57.49,0.0389,1524,20.0,1000.0,41.06,0.6932
5301,Mcgrath-Davis,False,US,New Maryfort,Energy,2021,https://mcgrath-davis.com,Life community week create someone let.,19,mcgrath-davis,2023,USD,929039,453370,475669,261271,214398,0,214398,9290,18580,195818,68544,533882,107512,426370,,929039,816.74,714.3,0.0657,445,173.84,14584.22,4.7,0.512
5302,Briggs-Lopez,False,TN,Port Darrell,Fintech,2019,https://briggs-lopez.com,Option herself part glass guess fight organization away.,20,briggs-lopez,2023,USD,320841,91441,229400,175722,53678,0,53678,3208,6416,47262,121856,380090,19004,361086,,320841,399.09,2137.33,0.001,244,109.33,1000.0,121.86,0.715
5303,Pierce-Rush,False,CA,Rhondafort,AgriTech,2010,https://pierce-rush.com,Door buy relationship contain development top entire positive.,20,pierce-rush,2023,USD,104266,44390,59876,7124,52752,7526,45226,1042,2085,43141,61241,198129,21384,176745,,104266,319.39,1550.47,0.068,38,224.58,4705.24,13.02,0.5743
5304,Clark Hall and Robinson,False,TN,Lake Josephmouth,Marketplaces,2017,https://clarkhallandrobinson.com,Best call voice new again produce eat.,17,clark-hall-and-robinson,2023,USD,879191,109642,769549,597183,172366,0,172366,8791,17583,154783,9523,522440,261425,261015,,879191,1162.53,4281.46,0.1474,576,127.03,54358.17,0.18,0.8753
5305,Henson-Avila,False,DE,Jonathonmouth,Cybersecurity,2010,https://henson-avila.com,Want live age can leg machine common.,28,henson-avila,2023,EUR,10797420,3165202,7632218,1783525,5848693,461,5848232,107974,215948,5632284,342532,5920814,3773663,2147151,,10797420,601.9,365.98,0.001,16440,54.73,162761.01,2.1,0.7069
5306,Bond Hammond and Ellis,False,BR,Barberside,Marketplaces,2020,https://bondhammondandellis.com,Meet choice hold across teach daughter sea usually health.,20,bond-hammond-and-ellis,2023,USD,398082,78035,320047,107876,212171,8056,204115,3980,7961,196154,80931,460658,74511,386147,,398082,262.61,913.26,0.0294,1658,20.0,24272.47,3.33,0.804
5307,Palmer-Burgess,False,EG,South Robert,SaaS,2016,https://palmer-burgess.com,Dinner heavy both wish which single open culture.,25,palmer-burgess,2023,USD,1548663,759600,789063,998793,-209730,3102,-212832,15486,30973,-243805,53829,931188,547840,383348,129055.25,1548663,557.51,1442.92,0.05,3421,37.72,74638.34,0.72,0.5095
5308,Jones LLC,False,ZA,Jacobborough,Marketplaces,2018,https://jonesllc.com,Term subject visit full religious production bag along recent name.,17,jones-llc,2023,USD,1221226,261016,960210,672510,287700,0,287700,12212,24424,263276,124771,877057,266741,610316,,1221226,213.21,364.9,0.1171,442,230.16,59999.11,2.08,0.7863
5309,Williams-Webb,False,US,Buchananburgh,HealthTech,2015,https://williams-webb.com,Wall anyone newspaper born reason know thousand outside four among.,15,williams-webb,2023,USD,284468,114132,170336,182558,-12222,5002,-17224,2844,5689,-22913,11663,276521,129317,147204,23705.67,284468,10.0,63.53,0.0368,705,33.62,37339.73,0.31,0.5988
5310,Walker PLC,False,GB,North Juliebury,IoT,2008,https://walkerplc.com,Throughout discuss against house course manage.,14,walker-plc,2023,USD,84034,36183,47851,16037,31814,12259,19555,840,1680,17875,7581,66833,28357,38476,,84034,1074.07,1514.15,0.0875,350,20.0,18766.93,0.4,0.5694
5311,Bernard Hensley and Mooney,False,GB,Perkinstown,AI/ML,2012,https://bernardhensleyandmooney.com,Car right art like eat expert factor sport paper.,14,bernard-hensley-and-mooney,2023,USD,315539,155001,160538,211829,-51291,0,-51291,3155,6310,-57601,4463,343718,68900,274818,,315539,2247.27,4150.95,0.0478,304,86.38,13048.12,0.34,0.5088
5312,Smith Riley and Williams,False,GB,North Becky,Cybersecurity,2023,https://smithrileyandwilliams.com,Kind rule PM role measure staff establish.,20,smith-riley-and-williams,2023,USD,1026118,253412,772706,132205,640501,44544,595957,10261,20522,575435,63357,685748,262807,422941,,1026118,189.4,1167.63,0.001,4275,20.0,6209.57,10.2,0.753
5313,Smith-Snyder,False,AU,New Rhondashire,SaaS,2009,https://smith-snyder.com,Democratic people responsibility city computer that.,27,smith-snyder,2023,USD,459201,150895,308306,173366,134940,11072,123868,4592,9184,114684,7082,346936,209647,137289,38266.75,459201,336.2,2290.29,0.0027,7653,5.0,1000.0,7.08,0.6714
5314,Moody Brown and Parker,False,KE,Morenoton,EdTech,2017,https://moodybrownandparker.com,Follow another father tough despite better together phone.,19,moody-brown-and-parker,2023,USD,188261,64670,123591,86338,37253,0,37253,1882,3765,33488,24981,250393,174203,76190,15688.42,188261,357.2,1385.96,0.0351,3137,5.0,1000.0,24.98,0.6565
5315,Tucker-Mccormick,False,CA,East Ginaton,IoT,2021,https://tucker-mccormick.com,Finish war culture set whether radio cold early have.,14,tucker-mccormick,2023,USD,1528202,427742,1100460,76410,1024050,0,1024050,15282,30564,993486,35175,920445,512345,408100,,1528202,1580.65,5052.59,0.0564,1160,109.78,12078.42,2.91,0.7201
5316,Hebert Group,False,GB,Nathanview,Energy,2013,https://hebertgroup.com,Benefit player conference society financial figure bank sit free per.,18,hebert-group,2023,USD,6151352,3040711,3110641,4884284,-1773643,0,-1773643,61513,123027,-1896670,315706,3419975,1635377,1784598,,6151352,396.71,198.36,0.0559,1150,445.55,421520.14,0.75,0.5057
5317,Hunter LLC,False,GB,Morrisside,AI/ML,2012,https://hunterllc.com,Effect key development peace necessary nothing possible base.,11,hunter-llc,2023,USD,676560,270575,405985,207879,198106,22061,176045,6765,13531,162514,52423,544708,242632,302076,,676560,1034.82,2090.3,0.098,2819,20.0,18326.3,2.86,0.6001
5318,Wilson-White,False,ZA,Cantuberg,Marketplaces,2013,https://wilson-white.com,Congress can middle bag stay strong after.,20,wilson-white,2023,USD,282151,74484,207667,157721,49946,11223,38723,2821,5643,33080,3385,288775,51034,237741,,282151,587.52,2411.76,0.0584,172,136.24,3457.47,0.98,0.736
5319,Fisher PLC,False,CA,East Dustin,Fintech,2013,https://fisherplc.com,Thus born everything unit within decide.,27,fisher-plc,2023,USD,824793,285237,539556,369769,169787,13350,156437,8247,16495,139942,39169,534474,288419,246055,,824793,923.88,2449.72,0.001,820,83.81,11484.89,3.41,0.6542
5320,Davis LLC,False,US,Brownstad,Mobility,2014,https://davisllc.com,Say successful every statement tend certainly kind represent laugh.,16,davis-llc,2023,USD,2415242,1032179,1383063,1174115,208948,0,208948,24152,48304,160644,326359,1565021,358918,1206103,,2415242,995.92,1994.34,0.0771,879,228.96,109358.13,2.98,0.5726
5321,Sandoval Duncan and Lambert,False,IN,West Kayla,Energy,2019,https://sandovalduncanandlambert.com,Account who center mother campaign college ago.,23,sandoval-duncan-and-lambert,2023,USD,957009,317590,639419,599043,40376,30600,9776,9570,19140,-9364,28640,656027,265928,390099,,957009,210.96,1229.53,0.001,998,79.87,55365.36,0.52,0.6681
5322,Rivera Miller and Hickman,False,IN,Davidmouth,IoT,2018,https://riveramillerandhickman.com,Reality listen fast improve reveal represent wife dark ground station.,16,rivera-miller-and-hickman,2023,USD,235179,96189,138990,150919,-11929,25477,-37406,2351,4703,-42109,4397,305713,266355,39358,,235179,533.82,2014.58,0.0204,146,134.0,1000.0,4.4,0.591
5323,Gilmore Ltd,False,US,Hillport,SaaS,2018,https://gilmoreltd.com,Report hard its protect.,17,gilmore-ltd,2023,USD,1656292,504613,1151679,1001530,150149,0,150149,16562,33125,117024,43480,1068054,221665,846389,138024.33,1656292,106.46,106.46,0.002,1515,91.06,88796.21,0.49,0.6953
5324,Francis Group,False,US,Sloanberg,Mobility,2009,https://francisgroup.com,Attention buy several several open upon everything stock beautiful there how.,17,francis-group,2023,USD,627049,253249,373800,195431,178369,0,178369,6270,12540,165829,15302,498829,24941,473888,,627049,20.0,34.79,0.1259,2612,20.0,21782.07,0.7,0.5961
5325,Hayes Klein and Gordon,False,ZA,South Meganshire,HealthTech,2021,https://hayeskleinandgordon.com,Road surface within material line entire pick sometimes.,29,hayes-klein-and-gordon,2023,USD,1908015,823745,1084270,1251857,-167587,4136,-171723,19080,38160,-209883,197999,1268836,63441,1205395,159001.25,1908015,372.83,1575.65,0.0139,2547,62.41,88594.06,2.23,0.5683
5326,Patel-Harris,False,US,Millermouth,AI/ML,2020,https://patel-harris.com,Serious cover individual quickly main your.,19,patel-harris,2023,USD,934439,432311,502128,352634,149494,1654,147840,9344,18688,129152,93639,586618,148334,438284,,934439,20.0,18.08,0.0386,3893,20.0,3289.51,28.47,0.5374
5327,Garcia Robbins and Russell,False,AU,Jeremiahberg,IoT,2024,https://garciarobbinsandrussell.com,Save Congress charge north industry development.,20,garcia-robbins-and-russell,2023,USD,4311206,1717532,2593674,2965050,-371376,5970,-377346,43112,86224,-463570,241562,2436367,793344,1643023,,4311206,602.51,827.09,0.0835,2018,178.02,284109.71,0.85,0.6016
5328,Ortega-Stewart,False,GB,Lake Daniel,HealthTech,2011,https://ortega-stewart.com,Family recent bank stay president economic threat full heavy stuff.,24,ortega-stewart,2023,USD,845790,198338,647452,368815,278637,0,278637,8457,16915,261722,223998,664986,450135,214851,70482.5,845790,410.15,2341.43,0.0364,1071,65.76,25354.41,8.83,0.7655
5329,House Rivera and Daniel,False,US,Joshuaville,E-commerce,2015,https://houseriveraanddaniel.com,Lawyer investment production sense nice contain every recognize.,13,house-rivera-and-daniel,2023,USD,369949,110463,259486,136769,122717,0,122717,3699,7398,115319,6696,331236,158590,172646,,369949,946.9,5250.09,0.0992,343,89.75,10181.88,0.66,0.7014
5330,Brown Group,False,FR,Kaiserberg,Energy,2010,https://browngroup.com,Purpose surface talk risk change development popular.,20,brown-group,2023,EUR,1300807,590636,710171,575901,134270,0,134270,13008,26016,108254,126346,847196,418545,428651,,1300807,348.21,174.1,0.001,526,205.74,33458.0,3.78,0.5459
5331,Hawkins Livingston and Snyder,False,FR,Robinsonmouth,Mobility,2022,https://hawkinslivingstonandsnyder.com,Turn play would appear officer remain drug since example ground.,22,hawkins-livingston-and-snyder,2023,EUR,911223,378047,533176,539131,-5955,40673,-46628,9112,18224,-64852,25978,670090,111012,559078,,911223,433.08,1831.19,0.0657,298,254.33,63644.53,0.41,0.5851
5332,Harvey-Mccarty,False,TN,West Jorge,AI/ML,2022,https://harvey-mccarty.com,Say analysis third between eight add.,12,harvey-mccarty,2023,USD,1899258,595975,1303283,714085,589198,21571,567627,18992,37985,529642,614374,1666799,406121,1260678,,1899258,1410.39,3441.02,0.001,2145,73.77,46797.12,13.13,0.6862
5333,Diaz-Gonzales,False,GB,Lake Danielland,IoT,2008,https://diaz-gonzales.com,Service stand one not rule approach economic upon.,22,diaz-gonzales,2023,USD,705329,267656,437673,280550,157123,0,157123,7053,14106,143017,12912,402801,142086,260715,,705329,102.69,342.89,0.0209,373,157.16,19891.58,0.65,0.6205
5334,Martinez-Allen,False,IN,South Lisaside,Mobility,2023,https://martinez-allen.com,Test direction exist reflect high subject.,21,martinez-allen,2023,USD,1443781,260607,1183174,189944,993230,18077,975153,14437,28875,946278,31038,933415,46670,886745,,1443781,1772.0,5934.63,0.0224,642,187.32,34323.84,0.9,0.8195
5335,Hudson-Wright,False,IN,Laurenland,HealthTech,2018,https://hudson-wright.com,Tend they eye particularly herself hotel whether instead.,18,hudson-wright,2023,USD,1240581,565682,674899,212001,462898,21472,441426,12405,24811,416615,48173,853421,351383,502038,103381.75,1240581,10.0,62.76,0.001,2578,40.09,58246.19,0.83,0.544
5336,Harper PLC,False,BR,Parksborough,AI/ML,2019,https://harperplc.com,Same understand the example.,18,harper-plc,2023,USD,1556347,453295,1103052,751283,351769,3562,348207,15563,31126,317081,173580,1119932,614115,505817,,1556347,20.0,17.31,0.1071,1482,87.48,83262.16,2.08,0.7087
5337,Butler-Ball,False,KE,Erinberg,Marketplaces,2011,https://butler-ball.com,Same story skin speak magazine crime thing form.,22,butler-ball,2023,USD,1762139,482639,1279500,758577,520923,0,520923,17621,35242,485681,43719,1098459,338008,760451,,1762139,20.0,31.86,0.1208,491,298.81,73165.9,0.6,0.7261
5338,Foster Ltd,False,EG,Lake Tiffanyland,Mobility,2014,https://fosterltd.com,Position rise stay school thousand huge none fish you participant relate.,18,foster-ltd,2023,USD,2602176,1444709,1157467,405940,751527,1885,749642,26021,52043,697599,471961,1897020,637375,1259645,,2602176,20.0,107.83,0.022,1302,166.53,32029.89,14.74,0.4448
5339,Grimes Ltd,False,GB,Port Davidtown,EdTech,2024,https://grimesltd.com,Beat fine move husband top mission discussion read top ability.,18,grimes-ltd,2023,USD,703654,294633,409021,198090,210931,0,210931,7036,14073,196858,119453,501552,307947,193605,58637.83,703654,632.42,2156.73,0.0552,3352,17.49,2915.48,40.97,0.5813
5340,Austin-Holmes,False,GB,Rickeybury,HealthTech,2015,https://austin-holmes.com,Little another if something once change.,19,austin-holmes,2023,USD,464768,118197,346571,35638,310933,3153,307780,4647,9295,298485,90332,448879,168231,280648,38730.67,464768,10.0,52.49,0.0505,2551,15.18,1455.87,62.05,0.7457
5341,Drake Schneider and Vasquez,False,BR,West Taylor,Fintech,2011,https://drakeschneiderandvasquez.com,Spring girl process image economic understand quickly TV situation option.,9,drake-schneider-and-vasquez,2023,USD,447170,98372,348798,157264,191534,0,191534,4471,8943,182591,12311,408387,135165,273222,,447170,52.59,48.23,0.008,175,212.82,26234.7,0.47,0.78
5342,Rogers Rogers and Anderson,False,ZA,Davisville,Energy,2017,https://rogersrogersandanderson.com,Moment represent tend four news commercial section design very.,16,rogers-rogers-and-anderson,2023,USD,534283,249961,284322,330072,-45750,9805,-55555,5342,10685,-66240,15138,454818,101384,353434,,534283,20.0,10.0,0.0037,309,143.64,3841.21,3.94,0.5322
5343,Schwartz-Carter,False,KE,Lisaton,Fintech,2015,https://schwartz-carter.com,Recent term half sing wind spend establish part.,19,schwartz-carter,2023,USD,1090010,481398,608612,207221,401391,0,401391,10900,21800,379591,25214,632061,94901,537160,,1090010,20.0,177.23,0.087,1000,90.81,9457.97,2.67,0.5584
5344,Jacobs-Rogers,False,DE,Port Carlview,AgriTech,2013,https://jacobs-rogers.com,Thus bad need safe understand.,19,jacobs-rogers,2023,EUR,455667,232865,222802,442620,-219818,0,-219818,4556,9113,-228931,37886,464150,166424,297726,,455667,2185.51,4486.66,0.0574,176,215.17,53224.47,0.71,0.489
5345,Jackson Duncan and Smith,False,ZA,Shannonborough,Marketplaces,2017,https://jacksonduncanandsmith.com,Court camera heavy reality international open short rate rest.,24,jackson-duncan-and-smith,2023,USD,5769003,2848743,2920260,288450,2631810,32146,2599664,57690,115380,2484284,1429187,4378069,2578991,1799078,,5769003,20.0,11.27,0.068,3589,133.92,42784.75,33.4,0.5062
5346,Jones Moreno and Miranda,False,CA,East Bethanyfort,Cybersecurity,2022,https://jonesmorenoandmiranda.com,Relationship simple continue smile forget evidence worry.,21,jones-moreno-and-miranda,2023,USD,1012808,504813,507995,582775,-74780,5055,-79835,10128,20256,-100091,25017,684625,237506,447119,,1012808,1482.74,8363.08,0.0904,4220,20.0,58095.98,0.43,0.5016
5347,Simpson Inc,False,BR,Annettefort,IoT,2024,https://simpsoninc.com,Manager art way mouth magazine room indeed ahead law.,19,simpson-inc,2023,USD,135874,53497,82377,95752,-13375,6525,-19900,1358,2717,-22617,34818,167725,116706,51019,,135874,20.0,35.54,0.1264,566,20.0,51219.74,0.68,0.6063
5348,Silva PLC,False,NG,Brandonview,IoT,2016,https://silvaplc.com,Mother cell full history inside continue music various serve.,7,silva-plc,2023,USD,208790,92534,116256,164211,-47955,0,-47955,2087,4175,-52130,13159,158590,70415,88175,,208790,20.0,78.06,0.001,57,304.21,29406.25,0.45,0.5568
5349,Williams-Meyer,False,AU,Dennisberg,HealthTech,2018,https://williams-meyer.com,Police face while help material spring mouth knowledge effort.,26,williams-meyer,2023,USD,395449,117412,278037,283126,-5089,30057,-35146,3954,7908,-43054,7033,384002,101518,282484,32954.08,395449,73.93,376.27,0.0394,430,76.5,1000.0,7.03,0.7031
5350,Armstrong-Brewer,False,TN,South Jacquelinetown,E-commerce,2012,https://armstrong-brewer.com,Look trial politics market either course.,12,armstrong-brewer,2023,USD,992127,196755,795372,392506,402866,0,402866,9921,19842,383024,95157,743572,53868,689704,,992127,20.0,42.71,0.001,537,153.88,62580.66,1.52,0.8017
5351,Harmon LLC,False,KE,North Sydneyview,Cybersecurity,2009,https://harmonllc.com,Hope our season sport major everything.,25,harmon-llc,2023,USD,580395,89912,490483,253521,236962,21770,215192,5803,11607,203585,23828,320535,93036,227499,,580395,1805.59,929.12,0.0798,391,123.43,47148.78,0.51,0.8451
5352,Baker-Fleming,False,ZA,East Jason,Energy,2009,https://baker-fleming.com,Across year record economy simply kitchen once interview reach.,18,baker-fleming,2023,USD,4710432,2050339,2660093,3195561,-535468,10127,-545595,47104,94208,-639803,136555,2548716,1259979,1288737,,4710432,510.95,1746.54,0.0958,2226,176.31,247528.66,0.55,0.5647
5353,Moore Inc,False,AU,Davidshire,EdTech,2013,https://mooreinc.com,Of how season later along meet grow environmental.,20,moore-inc,2023,USD,457457,199879,257578,180432,77146,0,77146,4574,9149,67997,41750,466224,288741,177483,38121.42,457457,10.0,76.65,0.001,1823,20.91,1000.0,41.75,0.5631
5354,Dawson Castro and Taylor,False,US,Cassandratown,HealthTech,2009,https://dawsoncastroandtaylor.com,Economy reflect he film catch interesting degree service few Mrs.,20,dawson-castro-and-taylor,2023,USD,584811,175323,409488,118746,290742,21806,268936,5848,11696,257240,103064,530889,363977,166912,48734.25,584811,377.42,2408.31,0.0103,686,71.01,19968.3,5.16,0.7002
5355,Mitchell Smith and Barrett,False,AU,Jameshaven,EdTech,2013,https://mitchellsmithandbarrett.com,Us east security tell inside fast team although finally list.,22,mitchell-smith-and-barrett,2023,USD,481914,211749,270165,496591,-226426,29724,-256150,4819,9638,-265788,26210,404088,358142,45946,40159.5,481914,31.45,147.19,0.0089,622,64.48,42949.88,0.61,0.5606
5356,Duncan Wilson and Christensen,False,TN,South Caitlynfort,E-commerce,2008,https://duncanwilsonandchristensen.com,Likely development second ahead choice.,23,duncan-wilson-and-christensen,2023,USD,441453,196749,244704,121497,123207,3313,119894,4414,8829,111065,110637,418032,149636,268396,,441453,20.0,10.0,0.0119,292,125.72,37121.29,2.98,0.5543
5357,Romero Schmidt and Moore,False,KE,Lake Joseph,Mobility,2023,https://romeroschmidtandmoore.com,Style nor court he report.,20,romero-schmidt-and-moore,2023,USD,1820812,589476,1231336,629912,601424,0,601424,18208,36416,565008,96385,1019736,50986,968750,,1820812,1469.49,3538.14,0.0448,520,291.33,76079.87,1.27,0.6763
5358,Miller-Martinez,False,CA,New Williamberg,EdTech,2020,https://miller-martinez.com,Various who build certainly heart.,19,miller-martinez,2023,USD,5665893,1715048,3950845,4024149,-73304,12087,-85391,56658,113317,-198708,169715,3046430,827290,2219140,472157.75,5665893,422.21,1869.26,0.0294,4523,104.38,341362.33,0.5,0.6973
5359,Harris Ltd,False,EG,North Brandonville,EdTech,2022,https://harrisltd.com,Free these federal above point where education great design effect.,20,harris-ltd,2023,USD,812477,348086,464391,57508,406883,31722,375161,8124,16249,358912,34053,475343,54914,420429,67706.42,812477,248.17,542.67,0.001,1039,65.12,1000.0,34.05,0.5716
5360,Johnson-Ellis,False,KE,Harrisview,AgriTech,2022,https://johnson-ellis.com,Whole art compare hold give.,11,johnson-ellis,2023,USD,254553,85746,168807,12727,156080,54601,101479,2545,5091,96388,140680,329588,36926,292662,,254553,20.0,65.57,0.0733,73,288.33,1000.0,140.68,0.6632
5361,Garner PLC,False,FR,Yvetteport,Cybersecurity,2016,https://garnerplc.com,Bag role argue moment chance design maybe shake.,26,garner-plc,2023,EUR,1920327,487639,1432688,399896,1032792,51,1032741,19203,38406,994335,149556,1199896,526315,673581,,1920327,661.58,1271.4,0.001,848,188.55,42848.67,3.49,0.7461
5362,Alvarez and Sons,False,BR,North Williamland,AI/ML,2018,https://alvarezandsons.com,Will gas be loss president almost whole politics close yeah.,27,alvarez-and-sons,2023,USD,201232,15939,185293,152686,32607,0,32607,2012,4024,28583,9142,299841,181520,118321,,201232,595.6,3495.7,0.0615,53,313.57,1000.0,9.14,0.9208
5363,Green Ltd,False,CA,Mccormickside,HealthTech,2016,https://greenltd.com,Natural apply exactly audience whose.,33,green-ltd,2023,USD,1048248,324180,724068,596413,127655,36415,91240,10482,20964,70276,31577,573358,245111,328247,87354.0,1048248,800.39,3506.23,0.065,1392,62.74,21406.94,1.48,0.6907
5364,Fitzgerald Taylor and Williams,False,CA,Sweeneyshire,Mobility,2022,https://fitzgeraldtaylorandwilliams.com,Population down ask these eight popular every would pick table.,12,fitzgerald-taylor-and-williams,2023,USD,1096531,450033,646498,284584,361914,21645,340269,10965,21930,318339,17244,648634,252265,396369,,1096531,435.8,2149.16,0.0995,2701,33.83,38048.84,0.45,0.5896
5365,Grant Hubbard and Wilkerson,False,BR,West Robertside,Fintech,2018,https://granthubbardandwilkerson.com,Young accept score whose space guy industry industry full.,19,grant-hubbard-and-wilkerson,2023,USD,1455222,550316,904906,739699,165207,10147,155060,14552,29104,125956,57178,821927,117246,704681,,1455222,697.06,2442.31,0.0404,6063,20.0,97861.93,0.58,0.6218
5366,Bishop Inc,False,AU,Port Hannahberg,AI/ML,2016,https://bishopinc.com,Story economy mission process another you thank.,22,bishop-inc,2023,USD,2393337,1095508,1297829,801088,496741,0,496741,23933,47866,448875,115847,1397355,405611,991744,,2393337,20.0,47.12,0.0718,9972,20.0,31784.99,3.64,0.5423
5367,Hanson Porter and Bauer,False,FR,Youngshire,E-commerce,2021,https://hansonporterandbauer.com,Very peace up concern money building whatever according brother writer.,13,hanson-porter-and-bauer,2023,EUR,112427,58897,53530,67396,-13866,0,-13866,1124,2248,-16114,7908,221056,58746,162310,,112427,1079.01,5676.09,0.0812,468,20.0,14081.63,0.56,0.4761
5368,Gonzalez Ltd,False,BR,Nancymouth,SaaS,2012,https://gonzalezltd.com,Not by television former you.,19,gonzalez-ltd,2023,USD,11931694,4204684,7727010,5494190,2232820,0,2232820,119316,238633,1994187,1526310,7624896,3834285,3790611,994307.83,11931694,205.05,908.24,0.0503,198861,5.0,458796.07,3.33,0.6476
5369,Chavez-Davis,False,FR,Bradport,EdTech,2022,https://chavez-davis.com,Order lawyer marriage candidate describe.,15,chavez-davis,2023,EUR,239610,73650,165960,111753,54207,33828,20379,2396,4792,15587,67466,314306,201445,112861,19967.5,239610,358.09,358.09,0.0105,1740,11.47,1000.0,67.47,0.6926
5370,Dyer Inc,False,FR,Belindahaven,Fintech,2017,https://dyerinc.com,Also data yard voice responsibility since health PM try.,34,dyer-inc,2023,EUR,665181,203679,461502,438058,23444,22321,1123,6651,13303,-12180,34145,460369,220801,239568,,665181,507.33,2708.46,0.064,594,93.22,4947.55,6.9,0.6938
5371,Beck-Rosario,False,GB,Byrdville,E-commerce,2017,https://beck-rosario.com,Build decade beyond particular common painting decide.,25,beck-rosario,2023,USD,205884,73482,132402,20517,111885,23961,87924,2058,4117,83807,12271,251171,81226,169945,,205884,122.12,147.24,0.0305,86,197.52,1000.0,12.27,0.6431
5372,Simon PLC,False,EG,Kaitlynside,Energy,2010,https://simonplc.com,Statement American good trip into.,23,simon-plc,2023,USD,13776705,3459481,10317224,9430981,886243,0,886243,137767,275534,610709,1862619,8780286,2177803,6602483,,13776705,185.44,783.96,0.0816,5585,205.53,778932.36,2.39,0.7489
5373,Ward Group,False,NG,Clarkside,HealthTech,2020,https://wardgroup.com,Involve moment article as often table paper understand.,22,ward-group,2023,USD,1064764,182415,882349,280544,601805,0,601805,10647,21295,580510,34137,705664,112074,593590,88730.33,1064764,846.68,8910.39,0.0498,4504,19.7,44502.44,0.77,0.8287
5374,Rowe-Baker,False,NG,New Brandon,EdTech,2012,https://rowe-baker.com,Growth those man camera important how around.,20,rowe-baker,2023,USD,266267,131466,134801,213239,-78438,4653,-83091,2662,5325,-88416,6444,325832,179140,146692,22188.92,266267,639.6,3390.21,0.0505,216,102.29,30690.76,0.21,0.5063
5375,Hernandez-Kelly,False,BR,Hernandezborough,EdTech,2008,https://hernandez-kelly.com,Agency single wear financial professional Mr economy from must.,16,hernandez-kelly,2023,USD,495029,265485,229544,175735,53809,15504,38305,4950,9900,28405,10212,439503,227414,212089,41252.42,495029,394.54,3070.09,0.0406,512,80.52,36944.16,0.28,0.4637
5376,Davis Ltd,False,DE,Smithfurt,Cybersecurity,2019,https://davisltd.com,Person could across though left.,23,davis-ltd,2023,EUR,1733371,865734,867637,473712,393925,10388,383537,17333,34667,348870,92274,1094846,54742,1040104,,1733371,20.0,42.09,0.001,637,226.62,21092.87,4.37,0.5005
5377,Navarro-Larson,False,NG,Baileyport,IoT,2012,https://navarro-larson.com,Discussion share south rate to really cell still.,16,navarro-larson,2023,USD,149189,44958,104231,70985,33246,14359,18887,1491,2983,15904,1297,123301,31347,91954,,149189,203.45,380.57,0.101,47,263.57,36287.2,0.04,0.6987
5378,Watson Lowe and Hunt,False,KE,East Jennifermouth,AI/ML,2024,https://watsonloweandhunt.com,Perhaps really hear one owner live get serve.,19,watson-lowe-and-hunt,2023,USD,900995,417687,483308,359196,124112,12225,111887,9009,18019,93868,20773,499339,138385,360954,,900995,1405.73,4577.24,0.098,706,106.23,33964.73,0.61,0.5364
5379,Harper Kim and Miller,False,US,New Heather,AI/ML,2019,https://harperkimandmiller.com,Follow hard before move north president discover statement exactly data.,21,harper-kim-and-miller,2023,USD,251167,59779,191388,67881,123507,0,123507,2511,5023,118484,6521,310188,20171,290017,,251167,20.0,33.61,0.1245,1046,20.0,19917.55,0.33,0.762
5380,Jackson-Mckenzie,False,NG,Garyport,EdTech,2024,https://jackson-mckenzie.com,Thank baby resource around return get response save.,19,jackson-mckenzie,2023,USD,535186,182967,352219,513168,-160949,0,-160949,5351,10703,-171652,11694,469131,240883,228248,44598.83,535186,577.79,3272.01,0.0243,1608,27.73,62375.46,0.19,0.6581
5381,Reeves Lopez and Sloan,False,GB,Port Joshua,E-commerce,2013,https://reeveslopezandsloan.com,Certainly claim reality clearly pass Mrs season.,23,reeves-lopez-and-sloan,2023,USD,1524030,462170,1061860,1261244,-199384,6399,-205783,15240,30480,-236263,101801,907763,78722,829041,,1524030,757.93,3569.58,0.001,6350,20.0,117095.95,0.87,0.6967
5382,Stewart-Gilbert,False,FR,Morrisview,Marketplaces,2013,https://stewart-gilbert.com,Reality imagine according glass high perform cover role.,20,stewart-gilbert,2023,EUR,960041,533055,426986,651157,-224171,0,-224171,9600,19200,-243371,132715,641003,241921,399082,,960041,20.0,57.52,0.001,350,228.0,54174.64,2.45,0.4448
5383,Morton-Green,False,BR,Gilesfurt,Marketplaces,2015,https://morton-green.com,Run fund wide low who organization ok common anyone candidate thousand.,21,morton-green,2023,USD,462903,221026,241877,105636,136241,35998,100243,4629,9258,90985,27377,448495,119506,328989,,462903,1428.75,8040.01,0.0928,1928,20.0,1000.0,27.38,0.5225
5384,James Lee and Johnson,False,AU,South Kaylahaven,Cybersecurity,2012,https://jamesleeandjohnson.com,Agree assume toward write relate individual leg unit listen.,21,james-lee-and-johnson,2023,USD,1472456,556425,916031,435951,480080,10950,469130,14724,29449,439681,33449,914539,492817,421722,,1472456,2030.72,5020.37,0.0647,1010,121.45,33207.78,1.01,0.6221
5385,Taylor Harris and Munoz,False,NG,East Monicatown,IoT,2021,https://taylorharrisandmunoz.com,Plan lot program because themselves training.,18,taylor-harris-and-munoz,2023,USD,168609,72540,96069,76991,19078,0,19078,1686,3372,15706,5304,266102,72229,193873,,168609,253.82,995.2,0.043,114,123.01,21313.79,0.25,0.5698
5386,Reynolds Inc,False,DE,New Tracyborough,AgriTech,2009,https://reynoldsinc.com,Early heart condition shoulder claim music hundred also big.,29,reynolds-inc,2023,EUR,434456,117938,316518,262625,53893,0,53893,4344,8689,45204,4137,347035,135977,211058,,434456,831.51,6947.56,0.0053,1810,20.0,1000.0,4.14,0.7285
5387,Rangel Ltd,False,TN,Makaylaland,AgriTech,2020,https://rangelltd.com,Poor wrong without lay vote tend Mr eight.,15,rangel-ltd,2023,USD,1652499,421979,1230520,801793,428727,0,428727,16524,33049,395678,38375,972037,271542,700495,,1652499,921.2,7333.63,0.0713,6885,20.0,89729.59,0.43,0.7446
5388,Allen Gonzalez and Miller,False,NG,Maryport,Energy,2023,https://allengonzalezandmiller.com,Like enjoy hear specific single benefit federal hear final.,9,allen-gonzalez-and-miller,2023,USD,781667,378908,402759,167327,235432,15322,220110,7816,15633,204477,132833,596667,341010,255657,,781667,1425.67,5833.56,0.1444,330,197.07,1000.0,132.83,0.5153
5389,Bonilla Mills and Norton,False,EG,South Kevinbury,E-commerce,2012,https://bonillamillsandnorton.com,Draw house interesting expect both space town exactly partner good.,19,bonilla-mills-and-norton,2023,USD,551599,145768,405831,318458,87373,21004,66369,5515,11031,55338,17300,425798,172327,253471,,551599,20.0,21.56,0.1139,2298,20.0,22477.53,0.77,0.7357
5390,Ford-Gomez,False,ZA,Port Jessica,AgriTech,2008,https://ford-gomez.com,Range sort range finish accept future only concern.,20,ford-gomez,2023,USD,89160,48847,40313,35271,5042,0,5042,891,1783,3259,3462,155431,64335,91096,,89160,1846.42,7648.88,0.0867,371,20.0,1000.0,3.46,0.4521
5391,Holmes PLC,False,FR,West Daniel,AgriTech,2017,https://holmesplc.com,But dinner picture under indicate within difficult responsibility place organization.,25,holmes-plc,2023,EUR,270591,98420,172171,104668,67503,40780,26723,2705,5411,21312,4416,195783,14777,181006,,270591,20.0,60.29,0.001,1127,20.0,5213.95,0.85,0.6363
5392,Peterson Allen and Cabrera,False,DE,West Christina,Cybersecurity,2010,https://petersonallenandcabrera.com,Second technology let ground five team soldier region short.,18,peterson-allen-and-cabrera,2023,EUR,1490173,364795,1125378,1070050,55328,0,55328,14901,29803,25525,51767,832932,139775,693157,,1490173,515.58,2022.16,0.131,2292,54.17,112917.2,0.46,0.7552
5393,Cruz Wilson and Burns,False,US,North Williamhaven,Energy,2012,https://cruzwilsonandburns.com,Create company one bag successful.,17,cruz-wilson-and-burns,2023,USD,2757669,983741,1773928,1916018,-142090,0,-142090,27576,55153,-197243,144403,1714421,751863,962558,,2757669,514.36,2310.23,0.001,750,306.3,147645.46,0.98,0.6433
5394,Strickland Ltd,False,GB,Lake Krystal,Mobility,2013,https://stricklandltd.com,Name fight happen which cause doctor set own who model.,20,strickland-ltd,2023,USD,4090905,2052164,2038741,204545,1834196,5357,1828839,40909,81818,1747021,21161,2100380,933127,1167253,,4090905,1335.75,4755.34,0.0239,5992,56.89,28291.35,0.75,0.4984
5395,Fletcher-Dunn,False,AU,Lake Brian,EdTech,2020,https://fletcher-dunn.com,Modern Congress set fish forward social trial phone.,26,fletcher-dunn,2023,USD,746549,598148,148401,669321,-520920,8000,-528920,7465,14930,-543850,14585,491727,24586,467141,62212.42,746549,71.97,242.92,0.0799,1846,33.7,42540.23,0.34,0.1988
5396,Mcguire-Carey,False,AU,Valentinebury,HealthTech,2021,https://mcguire-carey.com,Get season music law personal get.,20,mcguire-carey,2023,USD,584866,226820,358046,90513,267533,7472,260061,5848,11697,248364,33655,456264,104852,351412,48738.83,584866,10.0,58.54,0.0326,1909,25.52,1000.0,33.66,0.6122
5397,Berg Ltd,False,TN,Lake Teresa,IoT,2014,https://bergltd.com,Manager politics they finally central research.,23,berg-ltd,2023,USD,455058,121969,333089,359138,-26049,41030,-67079,4550,9101,-76180,75160,329498,110891,218607,,455058,20.0,10.0,0.0519,252,149.94,55154.02,1.36,0.732
5398,Powers Inc,False,DE,Lake Joshuaberg,E-commerce,2010,https://powersinc.com,Process begin position because.,18,powers-inc,2023,EUR,435958,252939,183019,85535,97484,0,97484,4359,8719,88765,32342,290997,139422,151575,,435958,20.0,62.05,0.0887,183,197.58,1000.0,32.34,0.4198
5399,Sims Barnes and Walker,False,DE,New Joyfort,AgriTech,2012,https://simsbarnesandwalker.com,Red marriage high everyone per production certainly office.,13,sims-barnes-and-walker,2023,EUR,1516226,440708,1075518,1068924,6594,18823,-12229,15162,30324,-42553,38110,842898,297741,545157,,1516226,691.99,1086.59,0.0848,1403,90.05,65186.74,0.58,0.7093
5400,Lopez Ltd,False,TN,Petersenburgh,Fintech,2012,https://lopezltd.com,Chance painting become recently financial shake.,25,lopez-ltd,2023,USD,1328694,339190,989504,752585,236919,5245,231674,13286,26573,205101,254281,971849,48592,923257,,1328694,554.62,3127.48,0.045,5536,20.0,44100.17,5.77,0.7447
5401,Weaver Barnes and Evans,False,DE,South Susanmouth,Mobility,2012,https://weaverbarnesandevans.com,Back production it several your Republican.,23,weaver-barnes-and-evans,2023,EUR,4644684,232234,4412450,2933913,1478537,0,1478537,46446,92893,1385644,220384,2727901,136395,2591506,,4644684,1109.49,7120.28,0.0546,975,396.58,219016.04,1.01,0.95
5402,Watson Thompson and Hart,False,BR,West Brianna,AgriTech,2018,https://watsonthompsonandhart.com,Miss happen help kid individual painting law.,22,watson-thompson-and-hart,2023,USD,471909,69597,402312,237302,165010,0,165010,4719,9438,155572,13133,293831,128125,165706,,471909,840.7,1747.87,0.001,1966,20.0,20099.9,0.65,0.8525
5403,Richardson-Carter,False,US,East Javierhaven,Marketplaces,2011,https://richardson-carter.com,Hard attack possible air bag.,23,richardson-carter,2023,USD,296262,109486,186776,163482,23294,9303,13991,2962,5925,8066,17419,183948,72608,111340,,296262,1918.12,7820.08,0.0751,377,65.38,7863.75,2.22,0.6304
5404,Cook Soto and Blair,False,NG,North Melissaview,AgriTech,2024,https://cooksotoandblair.com,Smile federal society return case offer even.,17,cook-soto-and-blair,2023,USD,162029,57958,104071,87718,16353,0,16353,1620,3240,13113,38187,153414,67411,86003,,162029,20.0,45.22,0.133,177,76.09,19580.34,1.95,0.6423
5405,Doyle-Martinez,False,FR,Michellefurt,Marketplaces,2023,https://doyle-martinez.com,Culture administration crime meet from finish industry street.,12,doyle-martinez,2023,EUR,308420,96440,211980,33762,178218,21015,157203,3084,6168,151035,82073,303212,23273,279939,,308420,878.62,2913.67,0.0972,135,189.18,26430.11,3.11,0.6873
5406,Jones Davis and Jackson,False,DE,Deborahshire,Marketplaces,2022,https://jonesdavisandjackson.com,Fast among century case.,21,jones-davis-and-jackson,2023,EUR,297237,72802,224435,85513,138922,0,138922,2972,5944,132978,27843,266954,164626,102328,,297237,616.1,2398.98,0.0115,159,155.37,13983.77,1.99,0.7551
5407,Jennings-Austin,False,IN,Gomezberg,Fintech,2022,https://jennings-austin.com,News purpose cup network know glass pattern year government Congress.,22,jennings-austin,2023,USD,647329,265270,382059,210636,171423,9229,162194,6473,12946,149248,11916,367812,19743,348069,,647329,20.0,10.0,0.0398,442,121.94,1000.0,11.92,0.5902
5408,Kelly-Wells,False,GB,Wadeside,Fintech,2018,https://kelly-wells.com,Collection point than season laugh data.,26,kelly-wells,2023,USD,3100692,1174324,1926368,155034,1771334,0,1771334,31006,62013,1709321,467849,2089343,646514,1442829,,3100692,1299.34,2011.36,0.0682,3182,81.2,21547.81,21.71,0.6213
5409,Wallace James and Nolan,False,IN,South Geoffrey,SaaS,2020,https://wallacejamesandnolan.com,Article fire sound simply ground.,18,wallace-james-and-nolan,2023,USD,3025835,1251090,1774745,1313700,461045,0,461045,30258,60516,400529,30034,1659437,1019363,640074,252152.92,3025835,10.0,36.59,0.0245,3524,71.55,108056.66,0.28,0.5865
5410,Brown Jones and Arroyo,False,IN,South Jesse,Fintech,2022,https://brownjonesandarroyo.com,Apply box clear machine beautiful organization treat teach.,22,brown-jones-and-arroyo,2023,USD,721162,242333,478829,527982,-49153,14589,-63742,7211,14423,-78165,60328,575224,153502,421722,,721162,265.43,1346.6,0.0104,3004,20.0,37233.11,1.62,0.664
5411,Robinson Group,False,TN,East Jonathan,IoT,2013,https://robinsongroup.com,Center yard either source performance arm keep company certain room.,16,robinson-group,2023,USD,815571,272151,543420,737011,-193591,56191,-249782,8155,16311,-266093,70734,567929,263419,304510,,815571,20.0,20.37,0.0371,1053,64.52,67141.18,1.05,0.6663
5412,Moore LLC,False,ZA,Lake Alexander,Cybersecurity,2023,https://moorellc.com,Soon light charge source.,16,moore-llc,2023,USD,186004,62495,123509,151014,-27505,0,-27505,1860,3720,-31225,5699,178185,88087,90098,,186004,136.9,68.45,0.1256,775,20.0,62211.33,0.09,0.664
5413,Castaneda-Bowman,False,AU,Josephview,AgriTech,2015,https://castaneda-bowman.com,Art fund cup story thank plan much.,19,castaneda-bowman,2023,USD,944526,360725,583801,739786,-155985,3694,-159679,9445,18890,-178569,90011,666949,160675,506274,,944526,20.0,149.47,0.14,287,274.07,95993.85,0.94,0.6181
5414,Howard LLC,False,NG,North Michaelburgh,Fintech,2010,https://howardllc.com,She stage power effect past apply number now.,21,howard-llc,2023,USD,996747,382764,613983,662142,-48159,1715,-49874,9967,19934,-69808,125225,646353,380776,265577,,996747,417.91,1452.06,0.0061,2626,31.62,69960.95,1.79,0.616
5415,Martin Gonzalez and Houston,False,ZA,North Michael,IoT,2019,https://martingonzalezandhouston.com,Military than simple democratic charge any.,21,martin-gonzalez-and-houston,2023,USD,202236,78164,124072,157183,-33111,0,-33111,2022,4044,-37155,12582,303377,54996,248381,,202236,830.0,3556.12,0.001,842,20.0,20631.01,0.61,0.6135
5416,Perry Rodriguez and Arroyo,False,DE,Jacksonport,Marketplaces,2023,https://perryrodriguezandarroyo.com,Yes approach method leader kid prepare water development.,20,perry-rodriguez-and-arroyo,2023,EUR,1488409,886330,602079,447567,154512,19176,135336,14884,29768,105568,27909,883622,44181,839441,,1488409,882.9,441.45,0.0177,6201,20.0,21026.24,1.33,0.4045
5417,Booker Tucker and Pittman,False,ZA,Brianburgh,Energy,2021,https://bookertuckerandpittman.com,Energy people across support apply see director professor some.,21,booker-tucker-and-pittman,2023,USD,2655571,913203,1742368,2175474,-433106,16152,-449258,26555,53111,-502369,155810,1604142,584454,1019688,,2655571,256.52,704.06,0.001,11064,20.0,154428.04,1.01,0.6561
5418,Krueger Frey and Hobbs,False,US,Jeremybury,Marketplaces,2011,https://kruegerfreyandhobbs.com,Girl rich size politics dog.,21,krueger-frey-and-hobbs,2023,USD,325431,170899,154532,117384,37148,13325,23823,3254,6508,17315,16245,182269,52493,129776,,325431,20.0,152.73,0.0519,769,35.23,1000.0,16.24,0.4749
5419,Fry PLC,False,AU,Shannonberg,AgriTech,2016,https://fryplc.com,About daughter country heavy sister institution general nor or.,21,fry-plc,2023,USD,348740,167349,181391,193162,-11771,32419,-44190,3487,6974,-51164,16665,256700,93170,163530,,348740,355.85,2182.96,0.0181,147,197.59,47666.39,0.35,0.5201
5420,Bowers Group,False,IN,East Jeffreyville,Marketplaces,2024,https://bowersgroup.com,Should and money administration each career billion year weight.,22,bowers-group,2023,USD,2401052,1059484,1341568,1293755,47813,0,47813,24010,48021,-208,224752,1545410,601651,943759,,2401052,1467.21,4618.26,0.0181,10004,20.0,125499.52,1.79,0.5587
5421,Herring Group,False,CA,Davidburgh,Energy,2016,https://herringgroup.com,Soldier well month individual same.,18,herring-group,2023,USD,501860,220480,281380,375587,-94207,12681,-106888,5018,10037,-116925,20770,333697,31653,302044,,501860,20.0,10.0,0.0964,276,151.49,62064.56,0.33,0.5607
5422,Miller-Levine,False,CA,Christopherville,Fintech,2008,https://miller-levine.com,Outside red relate serve where throw.,19,miller-levine,2023,USD,2034495,542507,1491988,946974,545014,0,545014,20344,40689,504325,321019,1396110,405454,990656,,2034495,522.55,3483.3,0.0405,3471,48.84,67076.09,4.79,0.7333
5423,White-Abbott,False,FR,Hoganland,Cybersecurity,2023,https://white-abbott.com,Professional benefit stop establish laugh sometimes.,13,white-abbott,2023,EUR,703765,196968,506797,437214,69583,18442,51141,7037,14075,37066,86754,620117,355213,264904,,703765,20.0,106.01,0.0556,2932,20.0,31828.15,2.73,0.7201
5424,Porter-Harrison,False,DE,North Anthonyshire,IoT,2023,https://porter-harrison.com,Quite drug cup security class.,19,porter-harrison,2023,EUR,796822,367015,429807,736047,-306240,6277,-312517,7968,15936,-328453,130481,639139,432093,207046,,796822,740.73,370.36,0.0663,1448,45.84,89347.63,1.46,0.5394
5425,Burton-Chaney,False,DE,Melissaborough,IoT,2021,https://burton-chaney.com,History have various character focus.,21,burton-chaney,2023,EUR,1825105,634604,1190501,470051,720450,0,720450,18251,36502,683948,92788,1018288,398909,619379,,1825105,20.0,53.47,0.0057,491,309.56,53808.58,1.72,0.6523
5426,Dominguez Winters and Gamble,False,BR,West Amyberg,AgriTech,2011,https://dominguezwintersandgamble.com,Per admit action soon into.,21,dominguez-winters-and-gamble,2023,USD,545965,180770,365195,106997,258198,40485,217713,5459,10919,206794,56991,495426,284143,211283,,545965,582.32,1041.86,0.024,249,182.39,17447.85,3.27,0.6689
5427,Norton-Avery,False,AU,Lake Amyfort,Cybersecurity,2023,https://norton-avery.com,Detail lay particular smile sing various together.,20,norton-avery,2023,USD,1593791,561408,1032383,1103052,-70669,1627,-72296,15937,31875,-104171,88599,1046625,181818,864807,,1593791,20.0,129.48,0.0498,489,271.23,109776.35,0.81,0.6478
5428,Harris Warner and Clay,False,NG,South Mark,IoT,2020,https://harriswarnerandclay.com,Politics from identify fund those record pressure.,21,harris-warner-and-clay,2023,USD,1514520,371628,1142892,1064880,78012,0,78012,15145,30290,47722,30562,855020,352377,502643,,1514520,246.82,302.11,0.1182,960,131.4,93282.72,0.33,0.7546
5429,Alvarez-Wiley,False,KE,East Amanda,AI/ML,2020,https://alvarez-wiley.com,Recently choice trip edge bill education order woman officer.,22,alvarez-wiley,2023,USD,102754,20720,82034,53992,28042,0,28042,1027,2055,25987,11993,107418,28448,78970,,102754,20.0,82.43,0.0923,67,127.36,8502.88,1.41,0.7984
5430,Howe Rodriguez and Armstrong,False,US,Crosshaven,IoT,2011,https://howerodriguezandarmstrong.com,Cost both technology draw hair investment may laugh company.,18,howe-rodriguez-and-armstrong,2023,USD,796384,222178,574206,163821,410385,0,410385,7963,15927,394458,50594,610902,179625,431277,,796384,270.36,359.7,0.0528,179,370.65,1000.0,50.59,0.721
5431,Crawford-Johns,False,KE,East Anna,Marketplaces,2011,https://crawford-johns.com,Mention ball community when operation hair.,22,crawford-johns,2023,USD,906811,344047,562764,367437,195327,0,195327,9068,18136,177191,116183,756440,518975,237465,,906811,228.77,412.02,0.109,3778,20.0,29129.84,3.99,0.6206
5432,Carpenter-Smith,False,KE,Lake Anthonybury,Fintech,2011,https://carpenter-smith.com,Tonight beyond believe sometimes career either us idea decade arrive.,15,carpenter-smith,2023,USD,1371331,529166,842165,270779,571386,0,571386,13713,27426,543960,44006,899537,44976,854561,,1371331,20.0,42.65,0.001,691,165.35,39303.16,1.12,0.6141
5433,Griffin Greer and Bauer,False,AU,Brendaberg,EdTech,2019,https://griffingreerandbauer.com,See another cut son city authority charge decade part.,13,griffin-greer-and-bauer,2023,USD,1960152,662567,1297585,619674,677911,4707,673204,19601,39203,634001,263369,1346606,669833,676773,163346.0,1960152,360.9,1375.9,0.0293,32669,5.0,89703.92,2.94,0.662
5434,Preston Cannon and Ortiz,False,KE,Lisaton,Marketplaces,2021,https://prestoncannonandortiz.com,Before his number hand stage with do owner.,21,preston-cannon-and-ortiz,2023,USD,839475,331343,508132,76113,432019,0,432019,8394,16789,415230,13089,549078,34401,514677,,839475,20.0,35.12,0.0726,3497,20.0,1000.0,13.09,0.6053
5435,Taylor Williams and Haas,False,TN,Port Kayla,Cybersecurity,2009,https://taylorwilliamsandhaas.com,Daughter war change myself offer.,23,taylor-williams-and-haas,2023,USD,8130363,2799851,5330512,2995463,2335049,15995,2319054,81303,162607,2156447,965762,5191663,1074583,4117080,,8130363,20.0,55.95,0.0508,3741,181.09,205650.08,4.7,0.6556
5436,Herring Tran and Francis,False,CA,Jeffreystad,Marketplaces,2022,https://herringtranandfrancis.com,Fund report expect near important project some short.,17,herring-tran-and-francis,2023,USD,2407825,513884,1893941,1086182,807759,14221,793538,24078,48156,745382,23834,1368618,262578,1106040,,2407825,228.45,466.25,0.0484,1108,181.05,63269.24,0.38,0.7866
5437,Ward-Watkins,False,EG,East Rachelfurt,IoT,2024,https://ward-watkins.com,Evidence early PM long early life look industry.,25,ward-watkins,2023,USD,1001282,524063,477219,225747,251472,16251,235221,10012,20025,215196,415479,919825,611251,308574,,1001282,570.03,285.02,0.0711,552,150.9,8207.58,50.62,0.4766
5438,Sanchez Wells and Gonzalez,False,US,Brownbury,Energy,2021,https://sanchezwellsandgonzalez.com,Art interest some child which lawyer.,23,sanchez-wells-and-gonzalez,2023,USD,342855,135365,207490,53285,154205,0,154205,3428,6857,147348,12663,363867,162075,201792,,342855,20.0,13.64,0.001,1428,20.0,8508.15,1.49,0.6052
5439,Nelson and Sons,False,BR,Berrystad,SaaS,2014,https://nelsonandsons.com,Watch next customer sign view.,17,nelson-and-sons,2023,USD,8117579,2201976,5915603,1736061,4179542,0,4179542,81175,162351,4017191,487497,4565142,1107679,3457463,676464.92,8117579,22.77,60.97,0.0166,13461,50.25,153156.33,3.18,0.7287
5440,Bolton-Banks,False,KE,Parkerton,HealthTech,2008,https://bolton-banks.com,Strong kid class in name value reach born industry certain pressure.,27,bolton-banks,2023,USD,596306,138840,457466,276298,181168,29168,152000,5963,11926,140074,33489,337353,222310,115043,49692.17,596306,10.0,37.61,0.0242,743,66.82,8305.0,4.03,0.7672
5441,Stokes King and Perez,False,BR,Stewartland,E-commerce,2011,https://stokeskingandperez.com,Space little meeting fill worry hand analysis next item.,16,stokes-king-and-perez,2023,USD,508690,205596,303094,178057,125037,0,125037,5086,10173,114864,20674,467187,147803,319384,,508690,327.65,2266.2,0.001,2119,20.0,10265.06,2.01,0.5958
5442,Gordon Webb and Wallace,False,IN,New Phillipfort,Energy,2008,https://gordonwebbandwallace.com,Professor teacher law structure third him professional.,16,gordon-webb-and-wallace,2023,USD,976576,412550,564026,472681,91345,5450,85895,9765,19531,66364,81468,642058,72083,569975,,976576,20.0,15.53,0.0118,710,114.49,34054.22,2.39,0.5776
5443,Austin-Williams,False,ZA,Vincentstad,Mobility,2016,https://austin-williams.com,Base size arrive social character people think change.,19,austin-williams,2023,USD,1541715,755018,786697,1265523,-478826,0,-478826,15417,30834,-509660,76485,890317,457530,432787,,1541715,20.0,135.98,0.001,397,323.4,103552.11,0.74,0.5103
5444,Cook-Sparks,False,CA,Solisside,Marketplaces,2019,https://cook-sparks.com,Clear wait fill beyond.,22,cook-sparks,2023,USD,505779,219536,286243,118265,167978,0,167978,5057,10115,157863,92597,380938,88431,292507,,505779,616.31,2225.5,0.0858,654,64.43,31725.72,2.92,0.5659
5445,Cain-Stewart,False,CA,Melissaville,EdTech,2016,https://cain-stewart.com,Should fish old middle would program month behavior give.,13,cain-stewart,2023,USD,171054,88341,82713,34885,47828,24980,22848,1710,3421,19427,1234,170216,80887,89329,14254.5,171054,58.64,441.7,0.0471,2850,5.0,7259.76,0.17,0.4835
5446,Vargas LLC,False,EG,Parkerberg,SaaS,2018,https://vargasllc.com,Great idea contain yes media focus position far safe similar.,22,vargas-llc,2023,USD,1611720,507822,1103898,964141,139757,14501,125256,16117,32234,93022,89655,1082023,575700,506323,134310.0,1611720,10.0,37.7,0.0471,7553,17.78,134600.48,0.67,0.6849
5447,Hanna-Aguilar,False,EG,Torresfort,Cybersecurity,2016,https://hanna-aguilar.com,Activity news through sea use work involve nature data serious.,19,hanna-aguilar,2023,USD,1238624,349280,889344,1359880,-470536,15478,-486014,12386,24772,-510786,51054,832640,84141,748499,,1238624,1076.24,3437.31,0.0987,499,206.78,142587.85,0.36,0.718
5448,Pugh Forbes and Larsen,False,AU,South Beverlyville,HealthTech,2014,https://pughforbesandlarsen.com,Join support seat strong through yes few ahead.,18,pugh-forbes-and-larsen,2023,USD,614846,222356,392490,285819,106671,11350,95321,6148,12296,83025,66286,490029,280842,209187,51237.17,614846,647.5,2090.51,0.0298,394,129.96,22393.67,2.96,0.6384
5449,Love LLC,False,NG,Port Ruthhaven,AI/ML,2018,https://lovellc.com,Center identify else source sport vote apply truth represent.,26,love-llc,2023,USD,547901,287257,260644,265559,-4915,0,-4915,5479,10958,-15873,24857,313019,139545,173474,,547901,568.81,2508.12,0.0313,266,171.3,23821.28,1.04,0.4757
5450,Marsh-Reyes,False,ZA,South Stephenton,Energy,2019,https://marsh-reyes.com,Pm coach real thank pay page claim against before should everything.,19,marsh-reyes,2023,USD,1395198,232269,1162929,846605,316324,14773,301551,13951,27903,273648,110645,977748,518871,458877,,1395198,20.0,24.47,0.0562,5813,20.0,111238.88,0.99,0.8335
5451,Jones Group,False,AU,West Sally,HealthTech,2023,https://jonesgroup.com,A something pay direction campaign candidate learn.,23,jones-group,2023,USD,5109955,1819218,3290737,920065,2370672,3515,2367157,51099,102199,2264958,327707,2888871,412788,2476083,425829.58,5109955,293.37,636.21,0.019,13078,32.56,85988.08,3.81,0.644
5452,Hernandez-Turner,False,FR,West Ricardoshire,E-commerce,2019,https://hernandez-turner.com,War probably after population artist central cut around huge.,17,hernandez-turner,2023,EUR,1519451,483580,1035871,664930,370941,0,370941,15194,30389,340552,38573,997155,113327,883828,,1519451,293.05,1254.93,0.0288,6331,20.0,73106.89,0.53,0.6817
5453,Morrison Maldonado and Mitchell,False,KE,New Rachel,AI/ML,2015,https://morrisonmaldonadoandmitchell.com,Game education common hospital want protect boy them.,21,morrison-maldonado-and-mitchell,2023,USD,291303,104961,186342,229657,-43315,0,-43315,2913,5826,-49141,7544,192930,111508,81422,,291303,814.86,3331.77,0.001,229,105.81,34500.3,0.22,0.6397
5454,Hendrix-Murray,False,CA,North Mackenzieland,AgriTech,2011,https://hendrix-murray.com,About among television exactly leader run federal short analysis beautiful.,18,hendrix-murray,2023,USD,1483344,571816,911528,665618,245910,0,245910,14833,29666,216244,36058,802549,89674,712875,,1483344,973.86,2772.3,0.0336,762,162.17,45226.63,0.8,0.6145
5455,Meyer-Holmes,False,ZA,West William,Fintech,2020,https://meyer-holmes.com,Thousand should arm prepare pressure.,18,meyer-holmes,2023,USD,6249415,367190,5882225,1257358,4624867,39341,4585526,62494,124988,4460538,814555,3949221,303431,3645790,,6249415,1368.65,10282.54,0.1663,3246,160.42,113567.18,7.17,0.9412
5456,Martin-Roman,False,CA,Lake Charlesville,IoT,2023,https://martin-roman.com,Method future short idea time world that director Mrs.,16,martin-roman,2023,USD,759075,293603,465472,170879,294593,17383,277210,7590,15181,262029,6105,565488,107556,457932,,759075,349.63,1318.08,0.0539,648,97.5,69781.27,0.09,0.6132
5457,Murphy and Sons,False,BR,Bakerberg,HealthTech,2020,https://murphyandsons.com,Hospital little bring owner and create could this her chance.,23,murphy-and-sons,2023,USD,1020816,96865,923951,573779,350172,26905,323267,10208,20416,302851,205631,799356,269027,530329,85068.0,1020816,10.0,37.08,0.0287,1174,72.42,36855.06,5.58,0.9051
5458,Griffin Oconnor and Brown,False,DE,Johnsonshire,AgriTech,2023,https://griffinoconnorandbrown.com,Man trade gas value order run less.,24,griffin-oconnor-and-brown,2023,EUR,196411,83667,112744,96582,16162,0,16162,1964,3928,12234,6925,217667,89612,128055,,196411,521.92,260.96,0.1131,818,20.0,6486.5,1.07,0.574
5459,Johnson Cruz and Carey,False,CA,South Stephen,E-commerce,2022,https://johnsoncruzandcarey.com,Opportunity speech none somebody could board expert animal.,24,johnson-cruz-and-carey,2023,USD,785337,331691,453646,539090,-85444,1028,-86472,7853,15706,-102178,36662,447147,47393,399754,,785337,20.0,106.3,0.001,668,97.96,56390.08,0.65,0.5776
5460,Love Houston and Daniels,False,CA,Patricktown,HealthTech,2013,https://lovehoustonanddaniels.com,Early indeed others food affect bring might.,30,love-houston-and-daniels,2023,USD,945545,255173,690372,243537,446835,0,446835,9455,18910,427925,27923,544936,80159,464777,78795.42,945545,10.0,17.49,0.0327,645,121.98,23146.22,1.21,0.7301
5461,Nguyen LLC,False,CA,East Charles,SaaS,2011,https://nguyenllc.com,Them either reach business strategy drug fill radio.,22,nguyen-llc,2023,USD,817712,254840,562872,355571,207301,592,206709,8177,16354,190355,96344,589473,149445,440028,68142.67,817712,490.0,2918.38,0.001,1116,61.03,48122.43,2.0,0.6883
5462,Sherman Ltd,False,DE,Floresshire,IoT,2017,https://shermanltd.com,Hour knowledge situation indicate door my be exist fly require.,23,sherman-ltd,2023,EUR,459546,204278,255268,65115,190153,9347,180806,4595,9190,171616,4541,271957,67285,204672,,459546,20.0,109.83,0.001,302,126.44,1000.0,4.54,0.5555
5463,Mccall Potts and Booth,False,NG,Lake Robin,Cybersecurity,2017,https://mccallpottsandbooth.com,Meet line free huge house assume poor.,14,mccall-potts-and-booth,2023,USD,875137,219167,655970,446021,209949,0,209949,8751,17502,192447,43927,522682,150466,372216,,875137,20.0,109.25,0.0865,3646,20.0,48188.31,0.91,0.7496
5464,Williams-Bonilla,False,AU,Port Sharon,AI/ML,2013,https://williams-bonilla.com,Onto go develop a list.,23,williams-bonilla,2023,USD,737811,270173,467638,166216,301422,0,301422,7378,14756,286666,50356,568384,164788,403596,,737811,20.0,93.61,0.0504,393,156.25,26739.64,1.88,0.6338
5465,Tyler-Cox,False,TN,Abigailport,IoT,2010,https://tyler-cox.com,Court prevent ball finally admit husband firm defense relate technology.,25,tyler-cox,2023,USD,426122,144200,281922,417236,-135314,0,-135314,4261,8522,-143836,17141,303740,90792,212948,,426122,36.28,183.26,0.1061,1088,32.63,65086.02,0.26,0.6616
5466,Ball Murphy and Chapman,False,DE,West Alexander,Fintech,2010,https://ballmurphyandchapman.com,Military whose real outside usually what training.,24,ball-murphy-and-chapman,2023,EUR,1158130,499512,658618,593115,65503,0,65503,11581,23162,42341,41859,756382,210207,546175,,1158130,20.0,21.69,0.0799,411,234.64,70450.6,0.59,0.5687
5467,Fisher-Prince,False,ZA,Abigailtown,IoT,2020,https://fisher-prince.com,Save grow professor use child two feeling lose player.,22,fisher-prince,2023,USD,585151,245517,339634,457570,-117936,26905,-144841,5851,11703,-156544,18844,479635,239026,240609,,585151,985.29,5013.94,0.0049,1217,40.05,28041.3,0.67,0.5804
5468,Thomas Group,False,IN,Lake Cindy,HealthTech,2018,https://thomasgroup.com,Finish perhaps population base well every.,23,thomas-group,2023,USD,4376105,1226626,3149479,1066826,2082653,8757,2073896,43761,87522,1986374,131794,2380913,1097089,1283824,364675.42,4376105,518.33,2612.83,0.0453,18206,20.03,84433.56,1.56,0.7197
5469,Bennett Ltd,False,NG,Karenton,E-commerce,2020,https://bennettltd.com,Service above listen expect.,18,bennett-ltd,2023,USD,1287229,706604,580625,830548,-249923,18281,-268204,12872,25744,-293948,139410,841844,498253,343591,,1287229,20.0,82.7,0.0683,642,167.07,62025.66,2.25,0.4511
5470,Donovan Davis and Bishop,False,GB,North Margaret,Energy,2011,https://donovandavisandbishop.com,At blue itself trade these.,16,donovan-davis-and-bishop,2023,USD,1952885,688469,1264416,703147,561269,0,561269,19528,39057,522212,155114,1177885,545114,632771,,1952885,147.49,283.46,0.1302,8137,20.0,52193.55,2.97,0.6475
5471,Lopez Vazquez and Moss,False,ZA,Joanneview,AgriTech,2010,https://lopezvazquezandmoss.com,Themselves remain prevent prepare say.,17,lopez-vazquez-and-moss,2023,USD,195364,60122,135242,93557,41685,0,41685,1953,3907,37778,10224,126051,84395,41656,,195364,20.0,10.0,0.1182,712,22.84,12565.2,0.81,0.6923
5472,Kidd Hess and Lowe,False,CA,Smithfort,EdTech,2022,https://kiddhessandlowe.com,Whatever particularly community add the.,14,kidd-hess-and-lowe,2023,USD,1134554,278035,856519,262283,594236,0,594236,11345,22691,571545,12067,778041,255086,522955,94546.17,1134554,10.0,71.78,0.0299,11058,8.55,11687.61,1.03,0.7549
5473,Gutierrez-Douglas,False,US,New Emilyshire,EdTech,2012,https://gutierrez-douglas.com,Lose give coach test machine article move decision perform try.,27,gutierrez-douglas,2023,USD,4079635,991005,3088630,203981,2884649,0,2884649,40796,81592,2803057,396986,2493011,957699,1535312,339969.58,4079635,10.0,18.86,0.012,7381,46.06,8745.96,45.39,0.7571
5474,Nelson-Anderson,False,BR,Coreyberg,AgriTech,2008,https://nelson-anderson.com,Tax after would physical gun there.,21,nelson-anderson,2023,USD,241335,97774,143561,15097,128464,15102,113362,2413,4826,108536,547,145996,91969,54027,,241335,20.0,98.55,0.001,93,215.62,1000.0,0.55,0.5949
5475,Perkins Inc,False,EG,Johnsonport,EdTech,2015,https://perkinsinc.com,About pick my knowledge hundred those.,17,perkins-inc,2023,USD,664475,296524,367951,259872,108079,0,108079,6644,13289,94790,9772,449692,103917,345775,55372.92,664475,124.18,623.91,0.0831,600,92.19,13110.2,0.75,0.5537
5476,Wilson-Rodriguez,False,DE,South Lauren,EdTech,2022,https://wilson-rodriguez.com,Return film almost international while but.,18,wilson-rodriguez,2023,EUR,852581,419499,433082,164593,268489,12497,255992,8525,17051,238941,24653,635393,275114,360279,71048.42,852581,10.0,29.79,0.0158,14209,5.0,6787.36,3.63,0.508
5477,Harrison PLC,False,BR,South Adam,EdTech,2012,https://harrisonplc.com,Make and true range economy.,22,harrison-plc,2023,USD,216939,87252,129687,51970,77717,0,77717,2169,4338,73379,3499,296945,79495,217450,18078.25,216939,10.0,32.51,0.0112,209,86.47,32205.73,0.11,0.5978
5478,Barker and Sons,False,US,Kaylaside,AgriTech,2015,https://barkerandsons.com,Least until hear citizen only almost standard carry our attack.,10,barker-and-sons,2023,USD,1619683,467203,1152480,1075165,77315,293,77022,16196,32393,44629,296976,1284263,672319,611944,,1619683,186.43,209.7,0.001,552,244.19,111539.12,2.66,0.7115
5479,Wilkerson Castillo and Williams,False,US,East Vanessa,IoT,2023,https://wilkersoncastilloandwilliams.com,Leader week successful according cover fast similar another summer another.,20,wilkerson-castillo-and-williams,2023,USD,964496,254488,710008,583728,126280,3296,122984,9644,19289,103695,37183,628008,39317,588691,,964496,20.0,24.66,0.1058,421,190.58,75543.34,0.49,0.7361
5480,Morales-Williams,False,EG,Port Debra,Energy,2014,https://morales-williams.com,Heart heart court important teacher.,23,morales-williams,2023,USD,1015639,305847,709792,658044,51748,0,51748,10156,20312,31436,13122,619499,83138,536361,,1015639,686.04,2428.08,0.0694,4231,20.0,31647.49,0.41,0.6989
5481,Green-Walker,False,TN,Levyshire,HealthTech,2024,https://green-walker.com,Information middle now various close technology what effect.,16,green-walker,2023,USD,1182563,618411,564152,915874,-351722,20920,-372642,11825,23651,-396293,61471,782160,280900,501260,98546.92,1182563,50.63,93.1,0.0902,1227,80.26,51617.57,1.19,0.4771
5482,Ramos LLC,False,KE,Whitemouth,Energy,2020,https://ramosllc.com,Own man military interview skin capital arrive study free her cause.,21,ramos-llc,2023,USD,553034,170098,382936,173824,209112,3553,205559,5530,11060,194499,8707,483915,73124,410791,,553034,780.65,1728.99,0.001,1450,31.77,1000.0,8.71,0.6924
5483,Hall Inc,False,ZA,West Stephanie,AgriTech,2019,https://hallinc.com,Thing order organization page we might.,18,hall-inc,2023,USD,485658,216600,269058,45154,223904,3535,220369,4856,9713,210656,137283,548364,227039,321325,,485658,945.67,5778.65,0.1713,343,117.7,1000.0,137.28,0.554
5484,Taylor-Montes,False,AU,Zimmermantown,AgriTech,2021,https://taylor-montes.com,New effort trial nature than one.,23,taylor-montes,2023,USD,271260,100234,171026,121321,49705,0,49705,2712,5425,44280,9008,180354,58965,121389,,271260,20.0,75.9,0.0393,65,347.24,32106.15,0.28,0.6305
5485,Thompson Erickson and Sanchez,False,CA,Port Jamesshire,E-commerce,2015,https://thompsonericksonandsanchez.com,Then particularly soldier case artist picture resource technology culture.,26,thompson-erickson-and-sanchez,2023,USD,2355180,1040093,1315087,537743,777344,31974,745370,23551,47103,698267,77531,1410296,827392,582904,,2355180,1494.48,6632.59,0.001,9813,20.0,46941.27,1.65,0.5584
5486,West LLC,False,CA,Dominguezfurt,AI/ML,2019,https://westllc.com,Finally involve bit owner lay billion usually dinner produce they.,18,west-llc,2023,USD,952824,183264,769560,625865,143695,34245,109450,9528,19056,90394,19802,504449,130816,373633,,952824,20.0,58.65,0.0739,346,229.1,57316.19,0.35,0.8077
5487,Davis-Horn,False,FR,Wilsonfort,Cybersecurity,2012,https://davis-horn.com,Entire above each edge late PM.,23,davis-horn,2023,EUR,435427,126956,308471,369100,-60629,17787,-78416,4354,8708,-87124,21831,274628,120833,153795,,435427,970.84,2067.2,0.0454,333,108.64,38522.63,0.57,0.7084
5488,Perez Ltd,False,CA,South Corey,Cybersecurity,2015,https://perezltd.com,Face fish toward mouth trade manager.,21,perez-ltd,2023,USD,1491982,926174,565808,526178,39630,0,39630,14919,29839,9791,454496,1289577,578988,710589,,1491982,689.52,1587.95,0.0915,980,126.86,12551.98,36.21,0.3792
5489,Chung Peterson and Garza,False,AU,Fryetown,AI/ML,2012,https://chungpetersonandgarza.com,Decade time ask activity tax hit.,13,chung-peterson-and-garza,2023,USD,702761,222567,480194,283659,196535,16808,179727,7027,14055,165672,21564,446518,115967,330551,,702761,441.94,899.11,0.001,808,72.44,22317.22,0.97,0.6833
5490,Williams Olson and Munoz,False,FR,North Kathrynberg,AI/ML,2023,https://williamsolsonandmunoz.com,Firm politics role color doctor end since forward something.,19,williams-olson-and-munoz,2023,EUR,453008,120324,332684,22650,310034,19233,290801,4530,9060,281741,12102,269167,61873,207294,,453008,230.24,729.87,0.0302,205,183.73,18051.01,0.67,0.7344
5491,Barber and Sons,False,NG,Wrightview,E-commerce,2011,https://barberandsons.com,Difficult music price event wear form beautiful old serious ready.,28,barber-and-sons,2023,USD,997141,283338,713803,519247,194556,30634,163922,9971,19942,143980,2779,632323,252863,379460,,997141,412.45,1029.36,0.0832,977,85.01,46582.01,0.06,0.7158
5492,Miller Carter and Dunn,False,AU,Brianchester,IoT,2015,https://millercarteranddunn.com,Yes black baby consumer them.,22,miller-carter-and-dunn,2023,USD,2164246,958170,1206076,138026,1068050,21099,1046951,21642,43284,1003667,228551,1481450,243280,1238170,,2164246,20.0,64.71,0.0221,789,228.58,1000.0,228.55,0.5573
5493,Pope-Mcclure,False,ZA,North Amyfurt,E-commerce,2015,https://pope-mcclure.com,White address none anyone purpose there itself.,19,pope-mcclure,2023,USD,3127000,519292,2607708,2230609,377099,0,377099,31270,62540,314559,22162,1593919,413519,1180400,,3127000,20.0,106.06,0.001,13029,20.0,218992.46,0.1,0.8339
5494,Lee and Sons,False,EG,Port Davidshire,AgriTech,2009,https://leeandsons.com,Social leader effort PM summer down bill here card senior.,14,lee-and-sons,2023,USD,561963,230240,331723,149548,182175,10725,171450,5619,11239,160211,33174,339999,32024,307975,,561963,511.18,2040.21,0.001,373,125.31,13649.72,2.43,0.5903
5495,Campbell Group,False,EG,North Baileyfurt,IoT,2022,https://campbellgroup.com,Day service also although item pressure.,19,campbell-group,2023,USD,3331541,1113512,2218029,592417,1625612,0,1625612,33315,66630,1558982,128446,1838760,1249911,588849,,3331541,383.98,859.66,0.0908,1516,183.1,87282.94,1.47,0.6658
5496,Lucas Hernandez and Perez,False,EG,North Barbaraview,IoT,2021,https://lucashernandezandperez.com,Development tree bank indicate old fish possible instead.,29,lucas-hernandez-and-perez,2023,USD,884889,235105,649784,320285,329499,24278,305221,8848,17697,287524,27721,476321,283804,192517,,884889,871.77,435.88,0.1196,605,121.81,16030.51,1.73,0.7343
5497,Orozco Ltd,False,FR,West Jessicashire,HealthTech,2008,https://orozcoltd.com,Really network perhaps vote call.,23,orozco-ltd,2023,EUR,566340,151038,415302,213282,202020,0,202020,5663,11326,190694,13994,423778,234967,188811,47195.0,566340,256.34,518.4,0.023,832,56.68,21740.02,0.64,0.7333
5498,Wilkinson and Sons,False,NG,New Janetmouth,Mobility,2009,https://wilkinsonandsons.com,Rock involve whom prevent high including.,18,wilkinson-and-sons,2023,USD,2328466,865111,1463355,584119,879236,22196,857040,23284,46569,810471,37317,1383047,247949,1135098,,2328466,184.88,609.1,0.0278,9701,20.0,16192.89,2.3,0.6285
5499,Brooks Matthews and Gomez,False,CA,Hectorshire,Mobility,2012,https://brooksmatthewsandgomez.com,Never wonder clear present fish tonight field instead.,19,brooks-matthews-and-gomez,2023,USD,967657,272477,695180,107436,587744,0,587744,9676,19353,568391,49963,651478,32573,618905,,967657,20.0,137.24,0.0399,1290,62.48,28920.55,1.73,0.7184
5500,Flynn-Zamora,False,FR,Johnsonchester,Marketplaces,2019,https://flynn-zamora.com,Provide suddenly total person necessary remember.,18,flynn-zamora,2023,EUR,230026,157841,72185,28072,44113,0,44113,2300,4600,39513,9523,229969,99007,130962,,230026,978.98,2050.4,0.1056,425,45.02,15580.62,0.61,0.3138
5501,Ingram Preston and Torres,False,FR,South Victoriastad,Cybersecurity,2016,https://ingramprestonandtorres.com,Sure walk option thought face high successful here get great.,19,ingram-preston-and-torres,2023,EUR,927454,195856,731598,204279,527319,0,527319,9274,18549,508770,212516,856346,400200,456146,,927454,585.97,3248.98,0.1015,3864,20.0,59176.24,3.59,0.7888
5502,Robinson-Nunez,False,KE,Alexanderton,AgriTech,2008,https://robinson-nunez.com,Deal perhaps employee spring oil worry sport across story usually.,21,robinson-nunez,2023,USD,308683,173514,135169,188391,-53222,0,-53222,3086,6173,-59395,34899,337597,35995,301602,,308683,798.0,1542.6,0.0541,113,227.34,36326.08,0.96,0.4379
5503,Scott Martin and Sheppard,False,ZA,Jamesburgh,IoT,2023,https://scottmartinandsheppard.com,Pull west likely this maybe explain.,35,scott-martin-and-sheppard,2023,USD,1711211,583661,1127550,1688339,-560789,32361,-593150,17112,34224,-627374,145058,1055031,285816,769215,,1711211,402.62,3033.78,0.0301,505,282.16,142646.13,1.02,0.6589
5504,Leon Lopez and Mcguire,False,TN,North Brianmouth,Cybersecurity,2012,https://leonlopezandmcguire.com,Notice strong chair poor town couple process.,16,leon-lopez-and-mcguire,2023,USD,711512,151975,559537,136967,422570,0,422570,7115,14230,408340,28680,506882,58981,447901,,711512,1042.88,1015.4,0.001,376,157.55,33688.7,0.85,0.7864
5505,Ellis Martin and Lamb,False,TN,Patriciachester,EdTech,2022,https://ellismartinandlamb.com,Far stand painting economic ground heavy something party memory.,20,ellis-martin-and-lamb,2023,USD,523310,124992,398318,197755,200563,0,200563,5233,10466,190097,31287,393118,84807,308311,43609.17,523310,619.33,1190.49,0.0478,341,127.77,19537.73,1.6,0.7612
5506,White-Banks,False,IN,North Isabelmouth,AI/ML,2017,https://white-banks.com,Special that sport matter structure forward.,16,white-banks,2023,USD,2619782,713747,1906035,1105982,800053,9975,790078,26197,52395,737683,480753,1968462,1080450,888012,,2619782,272.6,752.75,0.0772,2554,85.46,117622.93,4.09,0.7276
5507,Hart-Robertson,False,CA,Hamiltonstad,EdTech,2024,https://hart-robertson.com,Chair might yeah within allow exist necessary into.,26,hart-robertson,2023,USD,241663,86755,154908,86866,68042,13132,54910,2416,4833,50077,11599,307145,44956,262189,20138.58,241663,10.0,63.22,0.0284,962,20.92,30316.49,0.38,0.641
5508,Cole Johnson and Roberson,False,TN,Lake Adrianstad,HealthTech,2018,https://colejohnsonandroberson.com,Heart state job current cost soldier.,20,cole-johnson-and-roberson,2023,USD,1324833,363115,961718,791616,170102,16570,153532,13248,26496,127036,46595,791360,129303,662057,110402.75,1324833,10.0,49.06,0.001,1705,64.72,56049.28,0.83,0.7259
5509,Wagner-Allison,False,US,Jonesberg,IoT,2009,https://wagner-allison.com,Wide must even find happy power information treat traditional system.,17,wagner-allison,2023,USD,263808,96796,167012,141994,25018,27809,-2791,2638,5276,-8067,6413,321767,16088,305679,,263808,20.0,85.4,0.0181,1099,20.0,8300.29,0.77,0.6331
5510,Johnson Hawkins and Jimenez,False,ZA,Tashafort,E-commerce,2011,https://johnsonhawkinsandjimenez.com,Worry current health sure six fact spend wind company property.,25,johnson-hawkins-and-jimenez,2023,USD,199362,47165,152197,60605,91592,0,91592,1993,3987,87605,7189,138553,49755,88798,,199362,389.71,1156.28,0.0206,62,266.36,9547.94,0.75,0.7634
5511,Bell LLC,False,AU,Mooreton,Fintech,2010,https://bellllc.com,Throw game majority form our herself green morning meeting.,17,bell-llc,2023,USD,3103204,600985,2502219,2796136,-293917,0,-293917,31032,62064,-355981,23874,1599360,696579,902781,,3103204,1062.46,3274.59,0.001,12930,20.0,196513.85,0.12,0.8063
5512,Downs Group,False,NG,Perkinsfurt,Energy,2013,https://downsgroup.com,Team picture remember buy important picture three plant.,18,downs-group,2023,USD,793003,327250,465753,172200,293553,19565,273988,7930,15860,258128,23343,613746,215033,398713,,793003,1672.95,5631.63,0.0517,1803,36.64,1000.0,23.34,0.5873
5513,Small-Diaz,False,ZA,West Laura,EdTech,2015,https://small-diaz.com,Learn possible him suffer any almost sort together speech color debate.,20,small-diaz,2023,USD,372147,75898,296249,189239,107010,6147,100863,3721,7442,93421,13671,236034,138906,97128,31012.25,372147,283.56,1739.75,0.0503,1151,26.94,39840.79,0.34,0.7961
5514,Allen and Sons,False,KE,Molinaland,HealthTech,2013,https://allenandsons.com,Why fine future peace cause health.,23,allen-and-sons,2023,USD,1352715,361870,990845,467148,523697,0,523697,13527,27054,496643,61105,897449,489015,408434,112726.25,1352715,629.9,2782.6,0.0054,3226,34.94,7475.84,8.17,0.7325
5515,Sanchez Ltd,False,US,East Madisonland,Marketplaces,2023,https://sanchezltd.com,Own up art experience this interview.,19,sanchez-ltd,2023,USD,1080571,460892,619679,523305,96374,9533,86841,10805,21611,65230,14477,587032,86139,500893,,1080571,20.0,80.75,0.001,4502,20.0,42747.21,0.34,0.5735
5516,Ellis-Lane,False,ZA,Meganmouth,Fintech,2018,https://ellis-lane.com,Sport class skin state analysis glass degree.,18,ellis-lane,2023,USD,904268,529306,374962,431959,-56997,1746,-58743,9042,18085,-76828,174160,719846,254201,465645,,904268,20.0,59.61,0.0871,324,232.53,62498.69,2.79,0.4147
5517,Malone Olson and Young,False,FR,North Cathy,Fintech,2020,https://maloneolsonandyoung.com,Ready result look science leg.,18,malone-olson-and-young,2023,EUR,1163821,408588,755233,608097,147136,24532,122604,11638,23276,99328,84068,668125,180320,487805,,1163821,20.0,97.91,0.0075,445,217.48,44385.79,1.89,0.6489
5518,Warren Group,False,KE,Shanebury,Cybersecurity,2020,https://warrengroup.com,Report area news operation thus whether myself Republican modern sometimes.,21,warren-group,2023,USD,615345,184995,430350,150028,280322,31271,249051,6153,12306,236745,1028,402465,174489,227976,,615345,707.9,1215.42,0.0541,387,132.28,13959.8,0.07,0.6994
5519,Thompson Campos and Hamilton,False,AU,Lake Jamestown,Energy,2020,https://thompsoncamposandhamilton.com,Generation commercial support kind pattern order TV.,13,thompson-campos-and-hamilton,2023,USD,725392,114806,610586,273539,337047,0,337047,7253,14507,322540,27374,467640,23382,444258,,725392,20.0,104.81,0.001,305,197.58,13883.08,1.97,0.8417
5520,Perry Best and Davis,False,ZA,East Timothyton,Mobility,2012,https://perrybestanddavis.com,Me whole summer best relationship.,19,perry-best-and-davis,2023,USD,1909468,643595,1265873,619701,646172,31682,614490,19094,38189,576301,243723,1314825,614037,700788,,1909468,1778.21,1382.52,0.0268,1041,152.78,47967.94,5.08,0.6629
5521,Bradford LLC,False,CA,Port Trevor,HealthTech,2011,https://bradfordllc.com,Happen build kitchen region able through reflect.,17,bradford-llc,2023,USD,586953,108558,478395,392744,85651,0,85651,5869,11739,73912,40917,524041,209982,314059,48912.75,586953,796.09,2811.32,0.0092,1257,38.89,31945.38,1.28,0.815
5522,Mason Nichols and Parker,False,IN,Sheppardmouth,E-commerce,2013,https://masonnicholsandparker.com,Practice part even get senior live kitchen rest military media.,25,mason-nichols-and-parker,2023,USD,1136862,377550,759312,872394,-113082,15157,-128239,11368,22737,-150976,57458,750732,347221,403511,,1136862,20.0,103.61,0.169,1800,52.62,83488.38,0.69,0.6679
5523,Evans Russell and Morgan,False,ZA,Colebury,Energy,2016,https://evansrussellandmorgan.com,Fill hit practice realize memory best.,24,evans-russell-and-morgan,2023,USD,464349,225517,238832,324229,-85397,0,-85397,4643,9286,-94683,29114,334613,91060,243553,,464349,832.03,2567.61,0.141,170,227.05,4685.07,6.21,0.5143
5524,Woods-Brown,False,EG,North Jamie,Fintech,2013,https://woods-brown.com,Its body buy past far establish back nor current morning.,19,woods-brown,2023,USD,1356589,67829,1288760,202543,1086217,34038,1052179,13565,27131,1025048,225414,975277,498011,477266,,1356589,20.0,32.18,0.001,426,265.06,1000.0,225.41,0.95
5525,King Tucker and Ryan,False,IN,New Evan,Energy,2014,https://kingtuckerandryan.com,Others knowledge picture move she at wait be.,18,king-tucker-and-ryan,2023,USD,2399335,251998,2147337,390731,1756606,3873,1752733,23993,47986,1704747,18400,1412587,815237,597350,,2399335,966.44,3949.74,0.0687,1845,108.35,51102.67,0.36,0.895
5526,Schultz-Harrison,False,DE,West Maryberg,E-commerce,2010,https://schultz-harrison.com,Beat parent a student year policy science cell stop bit.,21,schultz-harrison,2023,EUR,3292270,866921,2425349,2362235,63114,19479,43635,32922,65845,-22210,62381,1816409,553389,1263020,,3292270,20.0,55.81,0.0924,13717,20.0,173874.95,0.36,0.7367
5527,Neal-Gregory,False,CA,New Tracey,Mobility,2011,https://neal-gregory.com,Future quickly son full military you create.,24,neal-gregory,2023,USD,1738697,659648,1079049,825657,253392,0,253392,17386,34773,218619,20037,1049017,463478,585539,,1738697,2430.66,8588.52,0.1133,2011,72.03,62822.71,0.32,0.6206
5528,Shaw PLC,False,NG,Lake Tylerville,AgriTech,2008,https://shawplc.com,Sure reduce parent member century enough.,19,shaw-plc,2023,USD,129048,35742,93306,117700,-24394,9828,-34222,1290,2580,-36802,6493,157548,7877,149671,,129048,1750.28,8055.77,0.001,182,58.83,23310.32,0.28,0.723
5529,Figueroa Roberts and Best,False,KE,Port Jenniferchester,SaaS,2009,https://figueroarobertsandbest.com,Tell assume view boy dog modern particularly weight religious.,17,figueroa-roberts-and-best,2023,USD,604144,344501,259643,368543,-108900,0,-108900,6041,12082,-120982,17567,510625,174894,335731,50345.33,604144,10.0,21.17,0.0422,808,62.26,46500.94,0.38,0.4298
5530,Sims Vargas and Salazar,False,BR,Huntfort,E-commerce,2011,https://simsvargasandsalazar.com,Skin cultural manage finally police realize.,17,sims-vargas-and-salazar,2023,USD,987179,508627,478552,723590,-245038,25629,-270667,9871,19743,-290410,22078,671908,169691,502217,,987179,20.0,105.09,0.001,752,109.27,61952.6,0.36,0.4848
5531,Hamilton Group,False,GB,Davidstad,SaaS,2024,https://hamiltongroup.com,Drop level administration play value race TV kitchen data.,18,hamilton-group,2023,USD,348355,132174,216181,208009,8172,0,8172,3483,6967,1205,20827,322980,64377,258603,29029.58,348355,438.62,1320.28,0.001,262,110.42,39565.32,0.53,0.6206
5532,Rodgers-Dodson,False,US,Lake Robin,SaaS,2018,https://rodgers-dodson.com,Mother cell marriage office.,19,rodgers-dodson,2023,USD,427425,147674,279751,356780,-77029,14834,-91863,4274,8548,-100411,113033,329579,127195,202384,35618.75,427425,163.63,1199.35,0.001,478,74.49,14934.47,7.57,0.6545
5533,Bell and Sons,False,TN,Lake Tamaramouth,AgriTech,2008,https://bellandsons.com,Side state budget level help cultural finish spend position.,20,bell-and-sons,2023,USD,167661,33722,133939,60534,73405,25295,48110,1676,3353,44757,21258,293477,61928,231549,,167661,946.77,473.38,0.001,162,86.12,1000.0,21.26,0.7989
5534,Meyers-Mckenzie,False,AU,Williamshire,IoT,2019,https://meyers-mckenzie.com,Soon seek face democratic do special candidate race employee plan.,16,meyers-mckenzie,2023,USD,1332499,345966,986533,633309,353224,0,353224,13324,26649,326575,115840,812120,462171,349949,,1332499,527.66,2647.83,0.147,878,126.47,29651.55,3.91,0.7404
5535,Weeks Ltd,False,FR,Baxterbury,HealthTech,2014,https://weeksltd.com,Sister today capital window yourself under study study answer.,14,weeks-ltd,2023,EUR,2317671,1013593,1304078,574000,730078,16009,714069,23176,46353,667716,53106,1385642,543851,841791,193139.25,2317671,604.43,4222.75,0.0665,2450,78.81,11203.65,4.74,0.5627
5536,Hicks Ltd,False,BR,East Christopher,IoT,2023,https://hicksltd.com,Operation last parent position street fund.,19,hicks-ltd,2023,USD,185390,84915,100475,78663,21812,0,21812,1853,3707,18105,1791,107456,72603,34853,,185390,234.17,1213.67,0.0216,431,35.82,1000.0,1.79,0.542
5537,Hoover-Fields,False,GB,Estradachester,AI/ML,2014,https://hoover-fields.com,Rate pressure field meet dark itself despite memory.,19,hoover-fields,2023,USD,2690618,991119,1699499,1299500,399999,0,399999,26906,53812,346187,110191,1482181,1048535,433646,,2690618,472.74,1860.22,0.0184,2217,101.1,140542.23,0.78,0.6316
5538,Wright Walker and Meyers,False,CA,Fisherville,Fintech,2012,https://wrightwalkerandmeyers.com,Plan really mother never economy wife.,9,wright-walker-and-meyers,2023,USD,479302,175432,303870,347696,-43826,0,-43826,4793,9586,-53412,16096,257255,94890,162365,,479302,20.0,15.54,0.0478,1997,20.0,52138.32,0.31,0.634
5539,Gonzalez and Sons,False,KE,Newtonview,E-commerce,2013,https://gonzalezandsons.com,Product reduce myself kitchen place gun near protect.,20,gonzalez-and-sons,2023,USD,2028578,432836,1595742,805343,790399,6467,783932,20285,40571,743361,94609,1189368,354565,834803,,2028578,64.22,81.76,0.1111,8452,20.0,67509.92,1.4,0.7866
5540,Perry Inc,False,EG,Annafort,Cybersecurity,2013,https://perryinc.com,Agree science single they threat.,17,perry-inc,2023,USD,680468,272933,407535,563427,-155892,0,-155892,6804,13609,-169501,5582,366436,112503,253933,,680468,120.49,266.77,0.0707,2835,20.0,1730.41,3.23,0.5989
5541,Montgomery Wagner and Fowler,False,NG,West Deborah,HealthTech,2022,https://montgomerywagnerandfowler.com,Others onto light blue garden thus gas down.,21,montgomery-wagner-and-fowler,2023,USD,1084347,345104,739243,577615,161628,0,161628,10843,21686,139942,221412,884119,398849,485270,90362.25,1084347,10.0,49.24,0.0376,1407,64.19,34478.29,6.42,0.6817
5542,Morgan Brooks and Hicks,False,US,Deborahhaven,IoT,2009,https://morganbrooksandhicks.com,Throughout traditional price arrive strong may.,23,morgan-brooks-and-hicks,2023,USD,267606,138280,129326,77814,51512,0,51512,2676,5352,46160,9376,172560,68635,103925,,267606,474.19,883.2,0.0595,717,31.06,1000.0,9.38,0.4833
5543,Johnson-Ortega,False,NG,Christineton,Fintech,2017,https://johnson-ortega.com,Movement dog dinner blue sit prove friend where simply reflect.,23,johnson-ortega,2023,USD,6162547,2524847,3637700,459451,3178249,435,3177814,61625,123250,3054564,393629,3509680,175484,3334196,,6162547,264.58,556.81,0.0492,25677,20.0,50543.67,7.79,0.5903
5544,Matthews and Sons,False,IN,Waynebury,Fintech,2019,https://matthewsandsons.com,Yard office factor physical protect throughout able week sit.,13,matthews-and-sons,2023,USD,1076033,599243,476790,600021,-123231,0,-123231,10760,21520,-144751,20811,606019,482902,123117,,1076033,787.76,1267.69,0.0574,457,195.8,69199.08,0.3,0.4431
5545,Martin-Hicks,False,BR,Jasonshire,HealthTech,2024,https://martin-hicks.com,Represent let rich front speak defense successful entire economy catch.,23,martin-hicks,2023,USD,4774384,2584740,2189644,3151857,-962213,0,-962213,47743,95487,-1057700,124342,2658005,864786,1793219,397865.33,4774384,187.16,514.19,0.0618,3866,102.9,274466.1,0.45,0.4586
5546,Campbell-Smith,False,GB,North Christopherburgh,Fintech,2023,https://campbell-smith.com,Agree answer road season bar knowledge indicate trip until hotel.,20,campbell-smith,2023,USD,529191,157537,371654,243753,127901,28644,99257,5291,10583,88674,10202,461626,229732,231894,,529191,852.9,426.45,0.0754,250,176.36,41862.94,0.24,0.7023
5547,Joyce Inc,False,DE,Codyborough,IoT,2012,https://joyceinc.com,Safe son bit relationship card girl.,17,joyce-inc,2023,EUR,1259537,471596,787941,286135,501806,41995,459811,12595,25190,434621,41688,859823,429493,430330,,1259537,664.04,435.92,0.0452,301,348.27,18642.63,2.24,0.6256
5548,Mcgee Inc,False,KE,Port Brenda,E-commerce,2022,https://mcgeeinc.com,Available describe will need economic million carry same five.,28,mcgee-inc,2023,USD,197791,35829,161962,157764,4198,0,4198,1977,3955,243,72900,239984,74881,165103,,197791,810.44,3977.42,0.0305,66,249.13,11646.73,6.26,0.8189
5549,Casey Banks and Washington,False,BR,Woodsfurt,AI/ML,2020,https://caseybanksandwashington.com,Role city discover sort officer trouble.,27,casey-banks-and-washington,2023,USD,1888054,793715,1094339,1686326,-591987,24621,-616608,18880,37761,-654369,104662,1162940,235756,927184,,1888054,1430.21,3970.13,0.012,466,337.22,147231.15,0.71,0.5796
5550,Clements Smith and Brown,False,AU,West Elizabethhaven,Mobility,2011,https://clementssmithandbrown.com,Grow century field skin popular area.,21,clements-smith-and-brown,2023,USD,4254235,989077,3265158,1206205,2058953,0,2058953,42542,85084,1973869,153185,2429890,1539008,890882,,4254235,95.71,542.91,0.0499,17725,20.0,75485.55,2.03,0.7675
5551,Howard-Wolfe,False,BR,Lake James,AI/ML,2010,https://howard-wolfe.com,Animal born bill floor nor out these approach street.,22,howard-wolfe,2023,USD,1747320,502444,1244876,1201945,42931,48496,-5565,17473,34946,-40511,37886,999646,218354,781292,,1747320,301.96,1567.73,0.001,7280,20.0,129707.84,0.29,0.7124
5552,Villa-Garcia,False,CA,South Wendy,EdTech,2019,https://villa-garcia.com,Behind charge low ability boy.,21,villa-garcia,2023,USD,86645,11221,75424,53435,21989,7007,14982,866,1732,13250,30814,243034,22628,220406,7220.42,86645,117.54,302.81,0.037,169,42.63,1000.0,30.81,0.8705
5553,House Coleman and Townsend,False,GB,Adamsview,EdTech,2023,https://housecolemanandtownsend.com,Research first tough include be character student step law shoulder.,16,house-coleman-and-townsend,2023,USD,623909,270453,353456,387889,-34433,30115,-64548,6239,12478,-77026,6954,462165,48453,413712,51992.42,623909,28.93,94.78,0.0409,1152,45.11,33107.19,0.21,0.5665
5554,Martin Ltd,False,DE,Lake Donald,Energy,2009,https://martinltd.com,Miss agent material benefit camera save the a professor simply.,22,martin-ltd,2023,EUR,848075,207699,640376,118432,521944,3549,518395,8480,16961,501434,67368,576129,336634,239495,,848075,755.75,3791.37,0.001,704,100.26,14176.58,4.75,0.7551
5555,Brewer Group,False,CA,East Kathrynland,SaaS,2023,https://brewergroup.com,So democratic left town out.,21,brewer-group,2023,USD,2236187,1214563,1021624,1600657,-579033,0,-579033,22361,44723,-623756,321208,1543555,388426,1155129,186348.92,2236187,55.42,665.04,0.0373,5301,35.15,159509.26,2.01,0.4569
5556,Morrow Davis and Barker,False,AU,East Frankhaven,Marketplaces,2011,https://morrowdavisandbarker.com,Return from mention enough father environmental.,14,morrow-davis-and-barker,2023,USD,671659,245003,426656,66782,359874,23316,336558,6716,13433,323125,951235,1479593,1070657,408936,,671659,947.28,2520.64,0.0758,452,123.75,34476.31,27.59,0.6352
5557,Martinez Roberts and Ramirez,False,NG,Jacobhaven,Fintech,2018,https://martinezrobertsandramirez.com,Doctor stop second program back good pretty commercial season church.,16,martinez-roberts-and-ramirez,2023,USD,680240,301213,379027,294571,84456,0,84456,6802,13604,70852,11435,412250,62099,350151,,680240,20.0,78.07,0.04,2834,20.0,46422.04,0.25,0.5572
5558,Humphrey Harmon and Cox,False,NG,Annaburgh,IoT,2024,https://humphreyharmonandcox.com,Eye inside direction try commercial avoid pay.,25,humphrey-harmon-and-cox,2023,USD,188982,78138,110844,148109,-37265,28434,-65699,1889,3779,-69478,9508,104417,29377,75040,,188982,20.0,31.77,0.0336,94,167.1,1000.0,9.51,0.5865
5559,Olson-Jones,False,TN,South Mistybury,AI/ML,2014,https://olson-jones.com,High spend wrong require opportunity admit quite black system point.,25,olson-jones,2023,USD,108590,52525,56065,57172,-1107,33825,-34932,1085,2171,-37103,13665,157603,74414,83189,,108590,20.0,94.21,0.0952,38,235.93,3401.01,4.02,0.5163
5560,Chen-Hernandez,False,IN,Mosleystad,E-commerce,2012,https://chen-hernandez.com,International body describe thank animal job will various.,18,chen-hernandez,2023,USD,1107329,481649,625680,195635,430045,22803,407242,11073,22146,385096,19416,622900,313141,309759,,1107329,20.0,63.81,0.0601,4613,20.0,13135.89,1.48,0.565
5561,Cowan and Sons,False,EG,Port Davidtown,EdTech,2017,https://cowanandsons.com,Identify color join town onto western wife performance message.,22,cowan-and-sons,2023,USD,862502,365035,497467,184480,312987,0,312987,8625,17250,295737,10230,561093,155976,405117,71875.17,862502,664.26,2925.38,0.001,853,84.2,23179.53,0.44,0.5768
5562,Meyer Group,False,BR,Hannahchester,Energy,2020,https://meyergroup.com,By home eat front in popular since.,26,meyer-group,2023,USD,1977942,601811,1376131,723858,652273,0,652273,19779,39558,612715,120620,1137964,247899,890065,,1977942,674.55,4387.04,0.1367,2601,63.35,60541.64,1.99,0.6957
5563,Warren and Sons,False,TN,North Timothy,Energy,2010,https://warrenandsons.com,Ten it far opportunity various within decision reflect employee.,29,warren-and-sons,2023,USD,1951265,802757,1148508,956963,191545,0,191545,19512,39025,152520,120831,1210872,420384,790488,,1951265,20.0,46.22,0.0667,1285,126.54,80579.87,1.5,0.5886
5564,Miller Day and Cooper,False,EG,Thomasmouth,SaaS,2023,https://millerdayandcooper.com,Material natural high media help serious organization hope way rock.,22,miller-day-and-cooper,2023,USD,1156976,442367,714609,583240,131369,0,131369,11569,23139,108230,291968,914618,45730,868888,96414.67,1156976,617.59,1727.36,0.014,19282,5.0,39607.36,7.37,0.6177
5565,Webb Group,False,FR,Clarkfurt,E-commerce,2023,https://webbgroup.com,Difficult move especially show without production.,14,webb-group,2023,EUR,1023137,511908,511229,254882,256347,0,256347,10231,20462,235885,52823,740466,491897,248569,,1023137,224.24,436.31,0.0657,737,115.59,1000.0,52.82,0.4997
5566,Shea PLC,False,KE,Amandatown,Energy,2017,https://sheaplc.com,Painting way indeed industry design interview Congress.,15,shea-plc,2023,USD,1588302,385335,1202967,842463,360504,35369,325135,15883,31766,293369,44956,948140,229706,718434,,1588302,1443.6,8779.45,0.001,2594,51.02,78921.0,0.57,0.7574
5567,Frazier Inc,False,EG,West Kimberly,AgriTech,2009,https://frazierinc.com,Lose necessary lot experience identify character particular bring.,16,frazier-inc,2023,USD,34514,15557,18957,7997,10960,13716,-2756,345,690,-3446,18835,152177,15421,136756,,34514,1249.09,4489.05,0.0353,8,337.12,34507.37,0.55,0.5493
5568,Keller-Bryant,False,NG,Sextonberg,SaaS,2014,https://keller-bryant.com,Letter we I push blue truth.,20,keller-bryant,2023,USD,10665316,3411679,7253637,5201647,2051990,52448,1999542,106653,213306,1786236,200359,5710355,1081433,4628922,888776.33,10665316,560.67,657.53,0.0283,12128,73.28,466034.7,0.43,0.6801
5569,White-Green,False,FR,Martinezport,AgriTech,2013,https://white-green.com,International require marriage office every.,13,white-green,2023,EUR,568876,223952,344924,75359,269565,32778,236787,5688,11377,225410,15273,489701,104904,384797,,568876,20.0,44.83,0.1025,2370,20.0,1000.0,15.27,0.6063
5570,Oliver Harrington and Dunn,False,BR,Williamsview,E-commerce,2009,https://oliverharringtonanddunn.com,Dark series worry message trade state subject national business.,12,oliver-harrington-and-dunn,2023,USD,3249849,773237,2476612,681427,1795185,23233,1771952,32498,64996,1706956,86193,1850400,1119579,730821,,3249849,20.0,75.94,0.1072,2659,101.82,69434.76,1.24,0.7621
5571,Winters Johnson and Henderson,False,NG,Rileychester,SaaS,2009,https://wintersjohnsonandhenderson.com,Effect though strategy age relationship same start.,10,winters-johnson-and-henderson,2023,USD,1368719,438326,930393,212828,717565,17511,700054,13687,27374,672680,56296,877985,362114,515871,114059.92,1368719,10.0,36.52,0.0157,929,122.67,1000.0,56.3,0.6798
5572,Castro Collins and Estrada,False,IN,Lake Donald,Energy,2014,https://castrocollinsandestrada.com,Though mother day again situation require whole bar wait compare consider.,15,castro-collins-and-estrada,2023,USD,7226696,1603139,5623557,1705385,3918172,28196,3889976,72266,144533,3745443,459796,4192523,1227583,2964940,,7226696,20.0,59.57,0.0509,3945,152.64,129488.14,3.55,0.7782
5573,Cabrera Holloway and Acosta,False,CA,Lake Pamelastad,AI/ML,2009,https://cabrerahollowayandacosta.com,Take class market letter allow head space trip.,19,cabrera-holloway-and-acosta,2023,USD,1500097,506513,993584,211515,782069,0,782069,15000,30001,752068,42907,809325,329690,479635,,1500097,405.63,366.03,0.001,6250,20.0,26584.63,1.61,0.6623
5574,Calhoun Inc,False,BR,Port Ericafurt,Energy,2024,https://calhouninc.com,Film reason into race religious account.,16,calhoun-inc,2023,USD,1403344,407329,996015,1153006,-156991,0,-156991,14033,28066,-185057,26772,883415,109178,774237,,1403344,20.0,54.35,0.0564,1449,80.7,91400.48,0.29,0.7097
5575,Adams PLC,False,NG,Kellymouth,HealthTech,2024,https://adamsplc.com,Fact baby blue push now edge guess.,12,adams-plc,2023,USD,546614,208968,337646,190874,146772,0,146772,5466,10932,135840,9536,320960,144805,176155,45551.17,546614,200.48,608.46,0.0626,1094,41.63,22826.16,0.42,0.6177
5576,Cook-Wilkinson,False,CA,East Gregory,Marketplaces,2009,https://cook-wilkinson.com,Lay better reality put would.,22,cook-wilkinson,2023,USD,396603,81702,314901,181694,133207,16431,116776,3966,7932,108844,48668,251895,33982,217913,,396603,20.0,113.31,0.0542,396,83.46,5513.19,8.83,0.794
5577,Poole Ltd,False,DE,Scottstad,Fintech,2022,https://pooleltd.com,Avoid away address certain with show matter cause subject.,21,poole-ltd,2023,EUR,1486609,573162,913447,500625,412822,0,412822,14866,29732,383090,129730,895002,397976,497026,,1486609,338.12,1196.88,0.0289,3179,38.96,27728.99,4.68,0.6145
5578,Armstrong LLC,False,GB,Erinchester,EdTech,2018,https://armstrongllc.com,See common because central final deep pay between laugh throw.,25,armstrong-llc,2023,USD,669891,278240,391651,536775,-145124,13477,-158601,6698,13397,-171998,60808,507051,187606,319445,55824.25,669891,226.43,1332.92,0.0149,777,71.79,18587.88,3.27,0.5846
5579,Robinson PLC,False,FR,Jonesberg,Cybersecurity,2014,https://robinsonplc.com,Training executive write give show begin second line.,27,robinson-plc,2023,EUR,989612,403282,586330,359570,226760,0,226760,9896,19792,206968,70107,634921,104435,530486,,989612,20.0,97.07,0.001,4123,20.0,1000.0,70.11,0.5925
5580,Mitchell Ltd,False,EG,New Dylan,EdTech,2008,https://mitchellltd.com,Partner four game education herself that some cup relationship red.,16,mitchell-ltd,2023,USD,456572,107583,348989,30370,318619,17928,300691,4565,9131,291560,6736,247720,105220,142500,38047.67,456572,380.25,668.57,0.0478,2248,16.92,48269.76,0.14,0.7644
5581,Rose LLC,False,US,Lake Tasha,Energy,2014,https://rosellc.com,Evidence lose early have PM well mother glass wind young theory.,15,rose-llc,2023,USD,4182012,1496217,2685795,659022,2026773,11786,2014987,41820,83640,1931347,259658,2439784,545236,1894548,,4182012,20.0,52.54,0.0146,17425,20.0,54442.98,4.77,0.6422
5582,Chapman-Rhodes,False,ZA,Travisfurt,Fintech,2017,https://chapman-rhodes.com,Class different letter energy my course property open consider structure impact.,18,chapman-rhodes,2023,USD,1543283,598507,944776,986572,-41796,0,-41796,15432,30865,-72661,13890,935308,271685,663623,,1543283,909.58,4842.82,0.0868,621,206.93,84492.92,0.16,0.6122
5583,Huerta Perez and Snyder,False,US,South Regina,EdTech,2018,https://huertaperezandsnyder.com,Data statement when seat he light instead.,22,huerta-perez-and-snyder,2023,USD,105388,34825,70563,16344,54219,14163,40056,1053,2107,37949,23029,154984,64024,90960,8782.33,105388,10.0,44.92,0.0563,128,68.1,45220.22,0.51,0.6696
5584,Marks Cohen and Carter,False,GB,New Maryview,Energy,2015,https://markscohenandcarter.com,Small would teacher old score wonder after either nearly state part.,23,marks-cohen-and-carter,2023,USD,447469,140033,307436,161628,145808,0,145808,4474,8949,136859,31008,334670,77649,257021,,447469,1061.16,5455.63,0.0763,741,50.3,27249.68,1.14,0.6871
5585,Key Inc,False,CA,South Heather,Energy,2009,https://keyinc.com,Street watch close sense state writer claim become economy experience enter.,19,key-inc,2023,USD,2690994,1060728,1630266,1254481,375785,0,375785,26909,53819,321966,169901,1584847,79242,1505605,,2690994,20.0,37.41,0.1035,1840,121.87,131537.92,1.29,0.6058
5586,Schneider Rasmussen and Foster,False,GB,Port Ashley,HealthTech,2015,https://schneiderrasmussenandfoster.com,Blue body hospital minute cost.,26,schneider-rasmussen-and-foster,2023,USD,1365948,822437,543511,731770,-188259,21350,-209609,13659,27318,-236927,502295,1204799,556874,647925,113829.0,1365948,149.84,287.3,0.011,2203,51.65,70639.92,7.11,0.3979
5587,Brown Inc,False,KE,New Jack,Marketplaces,2016,https://browninc.com,Mrs card reach whether oil.,23,brown-inc,2023,USD,1088515,683197,405318,172474,232844,0,232844,10885,21770,211074,44060,679877,83982,595895,,1088515,20.0,101.18,0.001,306,295.96,1000.0,44.06,0.3724
5588,Baker-Goodman,False,TN,Andrewfort,Marketplaces,2017,https://baker-goodman.com,Agreement teach there idea author care purpose education.,20,baker-goodman,2023,USD,1397450,889957,507493,551584,-44091,9726,-53817,13974,27949,-81766,37300,821851,183704,638147,,1397450,261.28,1080.28,0.0269,374,311.04,62355.27,0.6,0.3632
5589,Ramirez Inc,False,DE,Simpsonchester,Marketplaces,2016,https://ramirezinc.com,Future how student ball film if really.,22,ramirez-inc,2023,EUR,66302,19451,46851,20467,26384,0,26384,663,1326,25058,21563,195876,53449,142427,,66302,20.0,49.85,0.1013,120,45.93,1000.0,21.56,0.7066
5590,Gibson Group,False,TN,Sellersshire,Cybersecurity,2008,https://gibsongroup.com,On performance both particular significant reflect reality year.,17,gibson-group,2023,USD,520067,134413,385654,411775,-26121,18663,-44784,5200,10401,-55185,8098,384531,66483,318048,,520067,566.79,2479.28,0.0462,2166,20.0,42412.97,0.19,0.7415
5591,Vazquez PLC,False,TN,Kaneborough,Energy,2020,https://vazquezplc.com,Front leader scientist lose benefit animal establish group worker lawyer.,19,vazquez-plc,2023,USD,542163,217039,325124,27108,298016,6698,291318,5421,10843,280475,66923,512932,179871,333061,,542163,597.36,1206.4,0.1012,551,81.89,8800.28,7.6,0.5997
5592,Hill Bryan and Mckenzie,False,IN,New Jeremy,EdTech,2023,https://hillbryanandmckenzie.com,Society draw able road add majority upon decide reason.,17,hill-bryan-and-mckenzie,2023,USD,754686,197733,556953,389499,167454,5404,162050,7546,15093,146957,11700,438829,109126,329703,62890.5,754686,22.52,100.31,0.0011,639,98.31,49265.19,0.24,0.738
5593,Carpenter Fuller and Moyer,False,IN,South Danielborough,IoT,2008,https://carpenterfullerandmoyer.com,Situation employee within thank relationship evidence various able.,28,carpenter-fuller-and-moyer,2023,USD,192244,45343,146901,49634,97267,10082,87185,1922,3844,83341,11354,160677,46940,113737,,192244,1068.86,680.78,0.0225,801,20.0,1000.0,11.35,0.7641
5594,Morrison Hopkins and Moore,False,BR,Port Michael,Cybersecurity,2020,https://morrisonhopkinsandmoore.com,Fly anything close represent pressure he suggest cold.,21,morrison-hopkins-and-moore,2023,USD,2189525,1433506,756019,1229272,-473253,17643,-490896,21895,43790,-534686,299534,1422702,1029514,393188,,2189525,272.8,1304.05,0.0717,9123,20.0,104722.62,2.86,0.3453
5595,Hansen White and Guerrero,False,US,North Kyle,Cybersecurity,2022,https://hansenwhiteandguerrero.com,Candidate military product now onto reach community administration.,20,hansen-white-and-guerrero,2023,USD,1434881,607782,827099,387452,439647,0,439647,14348,28697,410950,100575,915865,107619,808246,,1434881,1140.17,987.15,0.077,837,142.85,29617.7,3.4,0.5764
5596,Brewer Inc,False,GB,Lauraville,Marketplaces,2015,https://brewerinc.com,Give under individual top notice describe place simple language.,22,brewer-inc,2023,USD,5339191,1278022,4061169,6899864,-2838695,1136,-2839831,53391,106783,-2946614,145048,2882503,1132052,1750451,,5339191,381.79,982.84,0.0334,2486,178.97,575700.39,0.25,0.7606
5597,Nichols Juarez and Barrera,False,FR,New David,Marketplaces,2011,https://nicholsjuarezandbarrera.com,Onto himself time change keep might watch specific program travel.,22,nichols-juarez-and-barrera,2023,EUR,1601175,591495,1009680,1023463,-13783,0,-13783,16011,32023,-45806,251450,1088049,628937,459112,,1601175,155.38,77.69,0.0225,6671,20.0,121527.75,2.07,0.6306
5598,Miller Henderson and Livingston,False,FR,New Meganstad,HealthTech,2023,https://millerhendersonandlivingston.com,Option itself draw option conference play national partner begin.,15,miller-henderson-and-livingston,2023,EUR,305338,132366,172972,154818,18154,8718,9436,3053,6106,3330,47077,311682,99927,211755,25444.83,305338,128.52,309.71,0.016,331,76.65,43804.74,1.07,0.5665
5599,Hughes Adams and Clark,False,FR,Lake Rachelville,HealthTech,2018,https://hughesadamsandclark.com,Research anything range crime month.,20,hughes-adams-and-clark,2023,EUR,3259539,1560435,1699104,1085648,613456,0,613456,32595,65190,548266,64914,1753628,540337,1213291,271628.25,3259539,108.25,722.53,0.0133,4929,55.1,87882.79,0.74,0.5213
5600,Rogers-Harris,False,GB,South Cynthiafurt,Cybersecurity,2016,https://rogers-harris.com,Prepare president son fund never else speak cut.,32,rogers-harris,2023,USD,1364646,624793,739853,68232,671621,15132,656489,13646,27292,629197,34758,859593,289643,569950,,1364646,782.82,391.41,0.001,5686,20.0,11855.07,2.93,0.5422
5601,Flowers Parker and Johnson,False,BR,Sullivanchester,Cybersecurity,2020,https://flowersparkerandjohnson.com,Whose represent candidate myself tell above use.,17,flowers-parker-and-johnson,2023,USD,1036353,460661,575692,810325,-234633,0,-234633,10363,20727,-255360,124820,723389,200282,523107,,1036353,131.3,65.65,0.0451,4318,20.0,63288.63,1.97,0.5555
5602,Clark Group,False,IN,Perkinsshire,AI/ML,2017,https://clarkgroup.com,Good around guy eight really today government.,26,clark-group,2023,USD,1387870,581692,806178,437599,368579,22450,346129,13878,27757,318372,20776,744022,482569,261453,,1387870,68.95,268.61,0.0852,629,183.63,38068.16,0.55,0.5809
5603,Hernandez King and Stark,False,IN,Hannaport,IoT,2016,https://hernandezkingandstark.com,Center guess measure yet too skill.,23,hernandez-king-and-stark,2023,USD,645834,339252,306582,115086,191496,4499,186997,6458,12916,174081,11257,424881,119745,305136,,645834,1139.5,5179.96,0.0784,1629,33.03,1000.0,11.26,0.4747
5604,Waters-Bailey,False,FR,East Adamshire,Fintech,2020,https://waters-bailey.com,Push what charge stand line watch not.,19,waters-bailey,2023,EUR,2010624,100531,1910093,1486451,423642,39537,384105,20106,40212,343893,125872,1240283,384691,855592,,2010624,627.49,1518.2,0.0139,5312,31.54,119894.31,1.05,0.95
5605,Joseph LLC,False,DE,Port Hunterberg,Fintech,2023,https://josephllc.com,Success all building sound see simple what focus similar.,23,joseph-llc,2023,EUR,1974124,886198,1087926,1345367,-257441,27218,-284659,19741,39482,-324141,743600,1886161,241975,1644186,,1974124,176.57,681.09,0.0792,8225,20.0,132973.72,5.59,0.5511
5606,Santos-Patterson,False,DE,Whitneymouth,HealthTech,2024,https://santos-patterson.com,Another source open drop prevent left very.,24,santos-patterson,2023,EUR,1080414,421595,658819,833699,-174880,21253,-196133,10804,21608,-217741,74234,802823,309203,493620,90034.5,1080414,10.0,10.0,0.0584,7117,12.65,58316.74,1.27,0.6098
5607,Harrison-Rodriguez,False,US,Port Gabriel,Mobility,2023,https://harrison-rodriguez.com,Prepare put them five interest in piece leave defense.,13,harrison-rodriguez,2023,USD,7278748,978957,6299791,3527721,2772070,0,2772070,72787,145574,2626496,370674,4041318,1155319,2885999,,7278748,113.4,782.88,0.0631,30328,20.0,324110.24,1.14,0.8655
5608,Jones Landry and Gray,False,FR,Juanfurt,Fintech,2015,https://joneslandryandgray.com,Foot appear better current ability majority sort data.,13,jones-landry-and-gray,2023,EUR,4509121,1235388,3273733,2422561,851172,17467,833705,45091,90182,743523,962275,3328110,166405,3161705,,4509121,200.64,1241.34,0.046,18788,20.0,199164.28,4.83,0.726
5609,Rodriguez-Hale,False,US,Billyton,Energy,2013,https://rodriguez-hale.com,Born lose tend many boy because better effect hope.,27,rodriguez-hale,2023,USD,1029038,456279,572759,727232,-154473,18602,-173075,10290,20580,-193655,150762,828884,601695,227189,,1029038,20.0,91.54,0.1645,334,256.54,46170.3,3.27,0.5566
5610,Thomas Cantrell and Barrett,False,FR,Port Daniel,Cybersecurity,2010,https://thomascantrellandbarrett.com,Collection cause hot produce leave skin success common economic see condition.,20,thomas-cantrell-and-barrett,2023,EUR,1771249,309323,1461926,1189358,272568,0,272568,17712,35424,237144,50346,990779,49538,941241,,1771249,139.46,155.86,0.0453,5741,25.71,86142.86,0.58,0.8254
5611,Snyder-Harris,False,DE,East Susanshire,Energy,2019,https://snyder-harris.com,Standard necessary voice sort senior raise.,21,snyder-harris,2023,EUR,2709072,627168,2081904,852545,1229359,42121,1187238,27090,54181,1133057,212107,1651777,578188,1073589,,2709072,20.0,28.41,0.001,5142,43.9,72546.53,2.92,0.7685
5612,Miller Inc,False,EG,Brewerberg,Cybersecurity,2012,https://millerinc.com,Its participant short affect that.,25,miller-inc,2023,USD,2210430,945573,1264857,1515143,-250286,3934,-254220,22104,44208,-298428,112288,1395200,655764,739436,,2210430,382.46,496.8,0.0126,1502,122.62,112466.43,1.0,0.5722
5613,Randall-Jones,False,EG,East Mark,IoT,2009,https://randall-jones.com,Fight thought size year wife matter conference.,23,randall-jones,2023,USD,231763,92588,139175,105966,33209,0,33209,2317,4635,28574,13520,237005,36873,200132,,231763,152.56,855.07,0.0638,965,20.0,25121.1,0.54,0.6005
5614,Anderson Mcdowell and Miller,False,BR,Robertland,AI/ML,2014,https://andersonmcdowellandmiller.com,When upon away employee suddenly system box ask prepare expert.,21,anderson-mcdowell-and-miller,2023,USD,1282008,397577,884431,236355,648076,23391,624685,12820,25640,599045,17377,824171,102892,721279,,1282008,734.24,1970.39,0.0558,5341,20.0,45032.74,0.39,0.6899
5615,Dickerson Group,False,AU,New Brittanyfort,EdTech,2018,https://dickersongroup.com,Couple finish draw nor store soldier rate power ten rest.,29,dickerson-group,2023,USD,325258,82445,242813,28753,214060,24873,189187,3252,6505,182682,22428,257615,104896,152719,27104.83,325258,146.05,510.88,0.001,1328,20.41,1000.0,22.43,0.7465
5616,Lawrence-Wood,False,US,East Jacobtown,IoT,2008,https://lawrence-wood.com,Model degree surface energy yard most middle energy.,22,lawrence-wood,2023,USD,1536779,925282,611497,836625,-225128,36936,-262064,15367,30735,-292799,101568,1053636,599134,454502,,1536779,307.25,1077.06,0.0177,6403,20.0,75722.26,1.34,0.3979
5617,Sherman Group,False,GB,Fowlerberg,E-commerce,2016,https://shermangroup.com,Prevent imagine day about over federal.,17,sherman-group,2023,USD,1737915,600809,1137106,719961,417145,21284,395861,17379,34758,361103,70300,1096476,626329,470147,,1737915,20.0,67.6,0.1075,2840,50.99,45413.12,1.55,0.6543
5618,White-Smith,False,GB,New Christianstad,E-commerce,2022,https://white-smith.com,Direction play college animal if rich skin discussion way.,20,white-smith,2023,USD,1391913,440354,951559,400693,550866,0,550866,13919,27838,523028,118549,887397,736535,150862,,1391913,564.73,596.89,0.001,1964,59.05,34404.52,3.45,0.6836
5619,Barnes LLC,False,DE,West Robert,Marketplaces,2009,https://barnesllc.com,Adult section head data create during huge art serious.,16,barnes-llc,2023,EUR,346227,140163,206064,179971,26093,9141,16952,3462,6924,10028,7760,182762,32287,150475,,346227,437.24,752.28,0.0259,176,163.44,35845.78,0.22,0.5952
5620,Miller-Allen,False,TN,Jessicamouth,Energy,2012,https://miller-allen.com,Size value even far effort peace lose attack process.,26,miller-allen,2023,USD,1983283,797958,1185325,1564246,-378921,22716,-401637,19832,39665,-441302,318381,1483151,655548,827603,,1983283,253.36,914.66,0.1258,8263,20.0,112156.39,2.84,0.5977
5621,Olson Inc,False,IN,Rollinsside,AI/ML,2010,https://olsoninc.com,Enjoy at service improve into.,20,olson-inc,2023,USD,246277,97726,148551,77598,70953,0,70953,2462,4925,66028,38725,184129,73409,110720,,246277,639.31,1411.68,0.0154,418,48.99,27063.15,1.43,0.6032
5622,Kelley LLC,False,DE,Cameronport,HealthTech,2014,https://kelleyllc.com,Natural road wrong project foot drug treat alone there design.,16,kelley-llc,2023,EUR,210617,102985,107632,72857,34775,0,34775,2106,4212,30563,12890,149889,84057,65832,17551.42,210617,211.16,1155.84,0.0254,282,62.09,42338.93,0.3,0.511
5623,Ibarra Ltd,False,CA,Gonzalezchester,Marketplaces,2022,https://ibarraltd.com,Some a require when weight.,27,ibarra-ltd,2023,USD,681083,387024,294059,409441,-115382,0,-115382,6810,13621,-129003,12655,457536,237887,219649,,681083,20.0,10.0,0.0999,222,255.19,44890.75,0.28,0.4318
5624,Morrow Shea and Olson,False,US,New Shellyshire,Mobility,2010,https://morrowsheaandolson.com,Wear fish maybe door travel forget this.,27,morrow-shea-and-olson,2023,USD,376725,162389,214336,143704,70632,0,70632,3767,7534,63098,9662,390389,171380,219009,,376725,20.0,65.14,0.0627,292,107.4,1000.0,9.66,0.5689
5625,Wheeler Smith and Good,False,DE,West Glennberg,IoT,2024,https://wheelersmithandgood.com,Keep follow every not shake station.,25,wheeler-smith-and-good,2023,EUR,467516,150414,317102,119228,197874,19163,178711,4675,9350,169361,9536,361991,18099,343892,,467516,944.45,1796.33,0.0124,186,208.92,1000.0,9.54,0.6783
5626,Webb Perry and Camacho,False,IN,Daniellefurt,AI/ML,2013,https://webbperryandcamacho.com,Church where south relationship difference real.,17,webb-perry-and-camacho,2023,USD,640818,185072,455746,417486,38260,15175,23085,6408,12816,10269,26944,347992,93900,254092,,640818,671.02,1682.42,0.044,1396,38.23,47605.21,0.57,0.7112
5627,Moses-Chavez,False,GB,South Cristinabury,AI/ML,2018,https://moses-chavez.com,Call huge live will fast middle.,16,moses-chavez,2023,USD,3484426,1666121,1818305,1500118,318187,0,318187,34844,69688,248499,579103,2368124,713404,1654720,,3484426,20.0,51.96,0.0331,997,291.16,135704.0,4.27,0.5218
5628,Carson Ltd,False,US,Odommouth,Fintech,2010,https://carsonltd.com,Film herself oil own that finally her computer attention throughout.,26,carson-ltd,2023,USD,593552,275679,317873,523821,-205948,0,-205948,5935,11871,-217819,45428,520976,168339,352637,,593552,176.55,629.53,0.1188,172,286.68,18898.36,2.4,0.5355
5629,Chambers Inc,False,TN,West Jacobton,AI/ML,2008,https://chambersinc.com,Attorney director shake positive certainly thought shoulder here seat teacher.,26,chambers-inc,2023,USD,8306274,928583,7377691,3494244,3883447,17564,3865883,83062,166125,3699758,963042,5305145,4239990,1065155,,8306274,20.0,89.46,0.001,6599,104.89,338431.18,2.85,0.8882
5630,Turner Leon and Giles,False,KE,South Zacharytown,Cybersecurity,2013,https://turnerleonandgiles.com,Easy successful drug option trouble soon.,21,turner-leon-and-giles,2023,USD,2636481,1031704,1604777,924632,680145,13328,666817,26364,52729,614088,184278,1560012,618629,941383,,2636481,203.11,662.9,0.0556,1582,138.85,56914.84,3.24,0.6087
5631,Riley-Simmons,False,ZA,Lake Scottmouth,E-commerce,2019,https://riley-simmons.com,Admit thought room four Mrs.,18,riley-simmons,2023,USD,399769,196548,203221,158889,44332,26570,17762,3997,7995,9767,23243,246143,12307,233836,,399769,458.58,1814.78,0.0913,366,90.93,5734.6,4.05,0.5083
5632,Sanchez Hernandez and Davis,False,US,Hodgetown,HealthTech,2011,https://sanchezhernandezanddavis.com,Meeting certainly baby walk easy determine.,19,sanchez-hernandez-and-davis,2023,USD,4255269,1799638,2455631,1740138,715493,0,715493,42552,85105,630388,555395,2788248,852040,1936208,354605.75,4255269,10.0,50.8,0.0144,3338,106.23,141233.43,3.93,0.5771
5633,Armstrong Miller and Jones,False,BR,North Erikville,EdTech,2008,https://armstrongmillerandjones.com,Anyone art consider through never close reason such experience personal join.,20,armstrong-miller-and-jones,2023,USD,263268,77255,186013,172284,13729,0,13729,2632,5265,8464,30080,196155,9807,186348,21939.0,263268,10.0,63.9,0.0304,4387,5.0,36271.39,0.83,0.7066
5634,Gomez Mckenzie and Murphy,False,TN,Lake Ray,SaaS,2009,https://gomezmckenzieandmurphy.com,From though follow single sing study raise stage.,15,gomez-mckenzie-and-murphy,2023,USD,108674,51521,57153,37000,20153,0,20153,1086,2173,17980,7112,70275,31001,39274,9056.17,108674,49.56,146.76,0.0241,96,93.89,1000.0,7.11,0.5259
5635,Reeves Edwards and Riley,False,TN,Lorihaven,IoT,2011,https://reevesedwardsandriley.com,Door my as develop order yourself alone process under.,20,reeves-edwards-and-riley,2023,USD,2443715,411901,2031814,122185,1909629,38364,1871265,24437,48874,1822391,527997,1850529,640969,1209560,,2443715,2196.77,3281.19,0.105,1478,137.72,9694.04,54.47,0.8314
5636,Rodriguez Boyle and Williams,False,DE,Lorettamouth,Marketplaces,2009,https://rodriguezboyleandwilliams.com,Thus teach local because scientist throughout.,28,rodriguez-boyle-and-williams,2023,EUR,1066967,290028,776939,300647,476292,0,476292,10669,21339,454953,12290,736472,117242,619230,,1066967,354.17,177.08,0.0325,4445,20.0,26485.61,0.46,0.7282
5637,Poole Smith and Baker,False,KE,South Joseph,AI/ML,2010,https://poolesmithandbaker.com,Bad moment enter three design food affect.,23,poole-smith-and-baker,2023,USD,75364,25299,50065,58195,-8130,0,-8130,753,1507,-9637,12601,231825,59272,172553,,75364,20.0,10.0,0.0337,74,84.07,1000.0,12.6,0.6643
5638,Hunt-Hobbs,False,US,Amybury,Marketplaces,2023,https://hunt-hobbs.com,Raise think cup near option with pay drive let tree.,25,hunt-hobbs,2023,USD,366093,199719,166374,128294,38080,6553,31527,3660,7321,24206,6278,191954,26997,164957,,366093,20.0,78.59,0.0929,1525,20.0,47453.75,0.13,0.4545
5639,Anderson-Deleon,False,KE,Wallacetown,Marketplaces,2020,https://anderson-deleon.com,Discussion health PM high public technology music hit place.,22,anderson-deleon,2023,USD,3458146,1324274,2133872,2087302,46570,24128,22442,34581,69162,-46720,205707,1984620,667584,1317036,,3458146,20.0,54.55,0.0047,4287,67.22,177648.81,1.16,0.6171
5640,Dawson PLC,False,IN,Atkinsonfort,Marketplaces,2020,https://dawsonplc.com,Class conference politics majority choice note under maybe various.,17,dawson-plc,2023,USD,1447371,226275,1221096,679284,541812,1711,540101,14473,28947,511154,110335,907859,182434,725425,,1447371,1591.97,6434.05,0.0655,1344,89.73,83640.23,1.32,0.8437
5641,Obrien Davis and Taylor,False,EG,Marcusstad,Cybersecurity,2015,https://obriendavisandtaylor.com,Resource television know exactly child war participant.,22,obrien-davis-and-taylor,2023,USD,1730707,633482,1097225,86535,1010690,24519,986171,17307,34614,951557,148118,1045198,319301,725897,,1730707,20.0,10.0,0.0639,422,341.17,8372.57,17.69,0.634
5642,Marquez George and Gutierrez,False,BR,Erictown,Mobility,2016,https://marquezgeorgeandgutierrez.com,Week lot production leader minute begin morning myself read.,18,marquez-george-and-gutierrez,2023,USD,1520744,859794,660950,932639,-271689,41041,-312730,15207,30414,-343144,21989,809710,568872,240838,,1520744,20.0,88.03,0.0484,665,190.3,88671.04,0.25,0.4346
5643,Hernandez Group,False,CA,West Raymond,Marketplaces,2022,https://hernandezgroup.com,Group behavior former finally energy rule image various.,22,hernandez-group,2023,USD,755151,340276,414875,135888,278987,0,278987,7551,15103,263884,21509,584868,325666,259202,,755151,182.47,368.64,0.0687,3146,20.0,32814.13,0.66,0.5494
5644,Gallegos Henry and Hunter,False,EG,Lake Ashley,HealthTech,2022,https://gallegoshenryandhunter.com,Shake system character memory billion.,21,gallegos-henry-and-hunter,2023,USD,1835502,976577,858925,911549,-52624,23613,-76237,18355,36710,-112947,360568,1306197,535163,771034,152958.5,1835502,188.68,711.35,0.0264,2812,54.38,71570.63,5.04,0.468
5645,Castro Inc,False,NG,East Melaniehaven,E-commerce,2015,https://castroinc.com,Gun central indeed future case.,21,castro-inc,2023,USD,303398,85410,217988,227823,-9835,42957,-52792,3033,6067,-58859,45754,355838,168242,187596,,303398,61.81,402.92,0.1242,1264,20.0,17726.21,2.58,0.7185
5646,Wright-Adams,False,GB,Melissaside,AgriTech,2013,https://wright-adams.com,Air throw late sit computer lead teacher lot task scene.,26,wright-adams,2023,USD,94240,19686,74554,60065,14489,5008,9481,942,1884,7597,4383,146118,82226,63892,,94240,953.73,2527.18,0.0937,58,134.63,1000.0,4.38,0.7911
5647,Wells Ltd,False,TN,Johnland,AgriTech,2013,https://wellsltd.com,Line coach discuss see knowledge.,22,wells-ltd,2023,USD,643186,217097,426089,80922,345167,32711,312456,6431,12863,299593,224277,713545,532134,181411,,643186,20.0,10.0,0.0346,690,77.61,25332.16,8.85,0.6625
5648,Riley PLC,False,CA,Port Dana,Cybersecurity,2008,https://rileyplc.com,Seven account threat more our parent money marriage young character.,16,riley-plc,2023,USD,669506,348241,321265,577854,-256589,15844,-272433,6695,13390,-285823,37471,548266,158561,389705,,669506,20.0,10.0,0.0935,318,175.36,14689.37,2.55,0.4799
5649,Garcia-Atkinson,False,TN,Escobarfort,AgriTech,2012,https://garcia-atkinson.com,Result more knowledge many gas.,19,garcia-atkinson,2023,USD,90174,30538,59636,43001,16635,35420,-18785,901,1803,-20588,22411,67833,31008,36825,,90174,20.0,109.67,0.0888,375,20.0,30453.41,0.74,0.6613
5650,Wilson Black and Adkins,False,US,Sandersshire,Mobility,2021,https://wilsonblackandadkins.com,Pretty of edge large particular image bring son sign.,21,wilson-black-and-adkins,2023,USD,590719,168409,422310,276444,145866,24813,121053,5907,11814,109239,85492,386386,172101,214285,,590719,234.74,228.69,0.1394,577,85.31,2506.77,34.1,0.7149
5651,White Group,False,ZA,Donaldsonbury,AI/ML,2015,https://whitegroup.com,Operation anyone several summer.,14,white-group,2023,USD,554486,165878,388608,164555,224053,11670,212383,5544,11089,201294,62930,376121,182592,193529,,554486,20.0,65.18,0.1182,252,183.19,23739.93,2.65,0.7008
5652,Freeman-Cross,False,TN,Michaelborough,HealthTech,2019,https://freeman-cross.com,Open cut production road finish.,21,freeman-cross,2023,USD,1063097,408611,654486,180815,473671,0,473671,10630,21261,452410,82537,732147,363115,369032,88591.42,1063097,732.22,6141.75,0.0539,1435,61.72,9859.23,8.37,0.6156
5653,Roberts-Bradford,False,DE,Grayport,Energy,2021,https://roberts-bradford.com,Article page human hot expect where.,25,roberts-bradford,2023,EUR,10844609,1441013,9403596,8403858,999738,7831,991907,108446,216892,775015,246125,5716179,456383,5259796,,10844609,678.54,2539.64,0.0101,9121,99.08,721539.97,0.34,0.8671
5654,Gonzales Group,False,TN,North Tiffany,Mobility,2022,https://gonzalesgroup.com,Fill return clear ago public.,25,gonzales-group,2023,USD,1377773,330263,1047510,754506,293004,3367,289637,13777,27555,262082,71758,792713,190272,602441,,1377773,1171.55,4786.11,0.0174,5740,20.0,53555.74,1.34,0.7603
5655,Navarro Dudley and Mccoy,False,EG,Kennedyport,Energy,2022,https://navarrodudleyandmccoy.com,Herself become different cup follow senior.,25,navarro-dudley-and-mccoy,2023,USD,2912403,787754,2124649,1069346,1055303,30564,1024739,29124,58248,966491,219497,1717456,769837,947619,,2912403,741.05,2843.19,0.0311,9035,26.86,90198.92,2.43,0.7295
5656,Smith-Meyer,False,CA,Lake Mary,E-commerce,2018,https://smith-meyer.com,Room radio free simple speak effect contain evening yourself American.,15,smith-meyer,2023,USD,7211354,1888159,5323195,3094150,2229045,10845,2218200,72113,144227,2073973,1513224,5174673,2770213,2404460,,7211354,20.0,82.82,0.001,2964,202.69,281255.5,5.38,0.7382
5657,Lowe Group,False,BR,East Markborough,Energy,2012,https://lowegroup.com,Young record quickly start right wind marriage later between wife.,18,lowe-group,2023,USD,3723935,813723,2910212,1518287,1391925,0,1391925,37239,74478,1317447,308713,2256423,1499332,757091,,3723935,639.6,3130.08,0.0897,1329,233.35,168309.68,1.83,0.7815
5658,Morrison White and Church,False,ZA,Port Tracey,AI/ML,2014,https://morrisonwhiteandchurch.com,Own occur meet road term hair line example bit have.,25,morrison-white-and-church,2023,USD,607417,294966,312451,30370,282081,0,282081,6074,12148,269933,26231,348000,98827,249173,,607417,20.0,57.16,0.0903,1826,27.72,12649.79,2.07,0.5144
5659,Kramer Jackson and Lee,False,DE,Robertmouth,EdTech,2014,https://kramerjacksonandlee.com,Rise traditional between they fire develop include down sense first.,19,kramer-jackson-and-lee,2023,EUR,1242311,244629,997682,966280,31402,26843,4559,12423,24846,-20287,12824,715001,317193,397808,103525.92,1242311,265.98,265.98,0.001,3300,31.37,53405.14,0.24,0.8031
5660,White-Bell,False,KE,East Nataliebury,EdTech,2019,https://white-bell.com,Move natural tree rate speak cup boy environment.,15,white-bell,2023,USD,628417,279565,348852,218040,130812,22806,108006,6284,12568,95438,24868,403835,218387,185448,52368.08,628417,10.0,40.58,0.0296,649,80.67,1000.0,24.87,0.5551
5661,Moody-Munoz,False,EG,New Heather,AI/ML,2021,https://moody-munoz.com,Short picture many artist someone.,18,moody-munoz,2023,USD,580087,191455,388632,389550,-918,0,-918,5800,11601,-12519,12536,471653,308260,163393,,580087,1895.51,6449.65,0.011,131,367.65,38060.52,0.33,0.67
5662,Diaz Douglas and Smith,False,CA,West Connor,Marketplaces,2017,https://diazdouglasandsmith.com,Performance trouble section PM edge.,27,diaz-douglas-and-smith,2023,USD,1360155,548505,811650,708873,102777,0,102777,13601,27203,75574,59696,865341,234458,630883,,1360155,20.0,94.81,0.001,5667,20.0,86683.47,0.69,0.5967
5663,Vaughn-Blackburn,False,DE,North Jodi,Energy,2012,https://vaughn-blackburn.com,Job same foot hear central bring attorney writer evening main.,17,vaughn-blackburn,2023,EUR,439061,69099,369962,178495,191467,1706,189761,4390,8781,180980,38837,430334,21516,408818,,439061,1052.91,2951.94,0.1198,559,65.37,28682.55,1.35,0.8426
5664,Simpson-Warner,False,EG,West Ashleytown,Fintech,2022,https://simpson-warner.com,Natural type figure create whose by I save system.,18,simpson-warner,2023,USD,228376,106885,121491,187016,-65525,34981,-100506,2283,4567,-105073,10231,312960,167236,145724,,228376,1902.41,9062.59,0.0605,128,147.93,20837.08,0.49,0.532
5665,Brown and Sons,False,IN,Andreabury,IoT,2021,https://brownandsons.com,Ten responsibility him near training pull argue wall.,18,brown-and-sons,2023,USD,587032,259035,327997,54631,273366,13679,259687,5870,11740,247947,14415,331947,25912,306035,,587032,1153.78,576.89,0.0024,778,62.85,6530.91,2.21,0.5587
5666,Rodgers Ltd,False,US,Port Justin,EdTech,2014,https://rodgersltd.com,Who at majority type study dinner traditional identify notice.,18,rodgers-ltd,2023,USD,707182,170566,536616,316898,219718,826,218892,7071,14143,204749,75583,566187,28309,537878,58931.83,707182,607.39,3294.16,0.0035,1001,58.84,82337.67,0.92,0.7588
5667,Hayes Jenkins and Campbell,False,CA,North Jacqueline,AI/ML,2013,https://hayesjenkinsandcampbell.com,Every push herself necessary again pay quite how.,16,hayes-jenkins-and-campbell,2023,USD,142781,46468,96313,7139,89174,0,89174,1427,2855,86319,1828,92478,18428,74050,,142781,20.0,92.47,0.0305,32,360.99,18027.98,0.1,0.6746
5668,Campbell LLC,False,BR,New Amberville,Energy,2024,https://campbellllc.com,Simple challenge admit site size.,20,campbell-llc,2023,USD,4904358,2545289,2359069,3721842,-1362773,7497,-1370270,49043,98087,-1468357,517262,3093728,1806793,1286935,,4904358,315.95,2393.42,0.068,3636,112.39,293291.25,1.76,0.481
5669,Gonzales Ltd,False,TN,West Adam,HealthTech,2022,https://gonzalesltd.com,Should it reveal quite street prove.,21,gonzales-ltd,2023,USD,410779,109198,301581,187601,113980,19637,94343,4107,8215,86128,5940,310515,91383,219132,34231.58,410779,476.04,2939.48,0.0449,774,44.2,56796.16,0.1,0.7342
5670,Hardin PLC,False,US,West Robertfurt,Cybersecurity,2014,https://hardinplc.com,Help bag nothing each however with national somebody minute.,20,hardin-plc,2023,USD,5193169,2675911,2517258,3423801,-906543,29513,-936056,51931,103863,-1039919,301901,3075716,438009,2637707,,5193169,1710.36,11695.7,0.1159,1669,259.21,291014.57,1.04,0.4847
5671,Finley Becker and Olson,False,TN,New Calvin,IoT,2013,https://finleybeckerandolson.com,Note heart yard make indicate produce.,29,finley-becker-and-olson,2023,USD,514014,273934,240080,304215,-64135,0,-64135,5140,10280,-74415,14159,362484,138344,224140,,514014,44.13,49.76,0.0684,381,112.23,31679.54,0.45,0.4671
5672,Olsen Nelson and Davis,False,IN,West Ricky,Cybersecurity,2012,https://olsennelsonanddavis.com,Clear over high movement.,20,olsen-nelson-and-davis,2023,USD,3366594,1557304,1809290,1913492,-104202,23683,-127885,33665,67331,-195216,68977,1942188,761379,1180809,,3366594,20.0,10.0,0.0188,14027,20.0,173203.79,0.4,0.5374
5673,Simmons-Dougherty,False,BR,South Josephshire,Energy,2014,https://simmons-dougherty.com,Try record boy despite radio.,18,simmons-dougherty,2023,USD,1128079,447912,680167,807282,-127115,6399,-133514,11280,22561,-156075,78807,793956,184945,609011,,1128079,1638.93,819.46,0.001,2657,35.37,75312.17,1.05,0.6029
5674,Washington Ibarra and Mccullough,False,GB,East Debbie,Energy,2018,https://washingtonibarraandmccullough.com,State possible probably region beautiful interview shake look suffer.,25,washington-ibarra-and-mccullough,2023,USD,541350,152312,389038,396134,-7096,0,-7096,5413,10827,-17923,48222,360154,97516,262638,,541350,958.94,663.86,0.0457,416,108.4,26465.24,1.82,0.7186
5675,Duran and Sons,False,EG,Saundersland,EdTech,2012,https://duranandsons.com,Second business up safe system you consider.,13,duran-and-sons,2023,USD,383274,156851,226423,39110,187313,39568,147745,3832,7665,140080,49138,258460,12923,245537,31939.5,383274,159.33,1078.67,0.0251,404,78.89,1000.0,49.14,0.5908
5676,Turner Perez and Medina,False,AU,Port Mary,Mobility,2018,https://turnerperezandmedina.com,Traditional when whose within prove whether.,21,turner-perez-and-medina,2023,USD,585453,218206,367247,29272,337975,0,337975,5854,11709,326266,44672,480409,116126,364283,,585453,85.29,490.55,0.0948,257,189.47,14548.29,3.07,0.6273
5677,Ramos LLC,False,KE,Crosstown,IoT,2024,https://ramosllc.com,Lot nor they even city help campaign.,22,ramos-llc,2023,USD,4171916,1796147,2375769,2659018,-283249,0,-283249,41719,83438,-366687,144398,2321511,836370,1485141,,4171916,1177.91,4397.33,0.029,889,390.82,204109.62,0.71,0.5695
5678,Gonzales Hayes and Richardson,False,ZA,East Robert,Marketplaces,2009,https://gonzaleshayesandrichardson.com,Side his let art increase until hit black between environment.,23,gonzales-hayes-and-richardson,2023,USD,743397,312465,430932,291815,139117,0,139117,7433,14867,124250,63412,503486,132252,371234,,743397,907.79,2831.47,0.001,1844,33.59,1000.0,63.41,0.5797
5679,Kirby-Taylor,False,BR,West Kathrynmouth,Fintech,2010,https://kirby-taylor.com,Billion thus group important however.,14,kirby-taylor,2023,USD,193438,57016,136422,42482,93940,26036,67904,1934,3868,64036,24602,152643,52522,100121,,193438,20.0,10.0,0.0977,805,20.0,2327.74,10.57,0.7052
5680,Harris Group,False,FR,Linbury,SaaS,2008,https://harrisgroup.com,Themselves follow expect live forward when might carry foreign two church.,27,harris-group,2023,EUR,1272140,531982,740158,432852,307306,27791,279515,12721,25442,254073,105742,880290,198356,681934,106011.67,1272140,58.69,60.61,0.0242,21202,5.0,50273.18,2.1,0.5818
5681,Davenport Oneill and Martinez,False,US,Debraland,E-commerce,2010,https://davenportoneillandmartinez.com,Mouth level main administration southern event exactly involve voice.,22,davenport-oneill-and-martinez,2023,USD,568367,123368,444999,426706,18293,0,18293,5683,11367,6926,6554,419177,167797,251380,,568367,365.94,516.22,0.0585,171,276.01,35731.7,0.18,0.7829
5682,Steele Walker and Powell,False,CA,Wilsonstad,E-commerce,2014,https://steelewalkerandpowell.com,Expect argue Mrs deep condition reason grow country movement.,18,steele-walker-and-powell,2023,USD,2327235,800046,1527189,1144727,382462,35331,347131,23272,46544,300587,240217,1559424,779856,779568,,2327235,1262.74,6922.93,0.0512,9696,20.0,102259.14,2.35,0.6562
5683,Rowland PLC,False,ZA,South Kaylaville,HealthTech,2014,https://rowlandplc.com,Tough appear start your rock anyone husband.,12,rowland-plc,2023,USD,423815,129548,294267,52452,241815,16365,225450,4238,8476,216974,18284,244814,92619,152195,35317.92,423815,257.34,2365.64,0.0735,1738,20.32,1000.0,18.28,0.6943
5684,Spencer Group,False,IN,East Johnmouth,Fintech,2019,https://spencergroup.com,Prove shake Democrat myself majority.,19,spencer-group,2023,USD,151678,39428,112250,48130,64120,0,64120,1516,3033,61087,1001,249968,86039,163929,,151678,902.85,4502.93,0.0297,289,43.6,1000.0,1.0,0.7401
5685,Wright Inc,False,KE,Port Devinbury,E-commerce,2022,https://wrightinc.com,Either then already sister offer between.,20,wright-inc,2023,USD,160015,47903,112112,89992,22120,3362,18758,1600,3200,15558,8789,259083,72445,186638,,160015,20.0,96.07,0.0909,203,65.59,16184.94,0.54,0.7006
5686,Williams Small and Benton,False,EG,East Tonyashire,E-commerce,2013,https://williamssmallandbenton.com,Radio politics change exactly staff somebody attention large consumer.,20,williams-small-and-benton,2023,USD,770049,241780,528269,350051,178218,19209,159009,7700,15400,143609,59146,503309,52306,451003,,770049,602.97,3345.93,0.0163,3208,20.0,73596.86,0.8,0.686
5687,Beck Group,False,IN,Johnnyside,AgriTech,2011,https://beckgroup.com,Both approach ability call sell seem some protect.,16,beck-group,2023,USD,216290,53643,162647,105421,57226,21497,35729,2162,4325,31404,22992,207326,104825,102501,,216290,300.26,982.9,0.001,87,206.31,31157.59,0.74,0.752
5688,Sosa-Cole,False,AU,West Sherichester,AI/ML,2013,https://sosa-cole.com,Easy type finish could usually message fly race.,19,sosa-cole,2023,USD,457633,111041,346592,230093,116499,33905,82594,4576,9152,73442,31062,367595,189723,177872,,457633,1152.19,2508.8,0.0184,1906,20.0,12635.24,2.46,0.7574
5689,Beck-Zamora,False,GB,Ryanmouth,HealthTech,2021,https://beck-zamora.com,Really ok job city dog style interview feel number lead there.,19,beck-zamora,2023,USD,4482919,736441,3746478,2710306,1036172,24492,1011680,44829,89658,922022,401118,2672059,1754864,917195,373576.58,4482919,118.11,593.44,0.0073,3247,115.03,233991.48,1.71,0.8357
5690,Moore Moore and Collins,False,FR,Mcphersonborough,AI/ML,2021,https://mooremooreandcollins.com,Receive worker table letter detail well catch budget account wrong.,21,moore-moore-and-collins,2023,EUR,2926709,1183828,1742881,1608956,133925,0,133925,29267,58534,75391,24499,1673402,515031,1158371,,2926709,20.0,84.57,0.013,995,244.93,118638.45,0.21,0.5955
5691,Perez-Rogers,False,GB,North Scottshire,AI/ML,2023,https://perez-rogers.com,Change machine hard local summer.,17,perez-rogers,2023,USD,696148,310019,386129,165891,220238,7571,212667,6961,13922,198745,10400,471074,23553,447521,,696148,555.98,2755.31,0.001,1075,53.95,9358.1,1.11,0.5547
5692,Gillespie Group,False,ZA,Johnsonland,AgriTech,2015,https://gillespiegroup.com,Loss sport sense sure successful town power.,21,gillespie-group,2023,USD,258720,141113,117607,159797,-42190,7597,-49787,2587,5174,-54961,31372,238280,81818,156462,,258720,20.0,38.02,0.001,1078,20.0,1000.0,31.37,0.4546
5693,Tran Norman and Harris,False,FR,Dianeshire,Marketplaces,2012,https://trannormanandharris.com,But especially four reason food could large.,22,tran-norman-and-harris,2023,EUR,714767,43640,671127,462053,209074,15947,193127,7147,14295,178832,68808,625993,74005,551988,,714767,970.1,1368.03,0.0121,502,118.63,1000.0,68.81,0.9389
5694,Simpson-Peters,False,EG,Washingtonchester,Fintech,2009,https://simpson-peters.com,Quite occur mind without.,23,simpson-peters,2023,USD,454136,163071,291065,164989,126076,35728,90348,4541,9082,81266,17428,396170,19808,376362,,454136,524.53,1510.68,0.1015,1104,34.25,1000.0,17.43,0.6409
5695,Gibson Jensen and Potter,False,GB,Port Zachary,Energy,2023,https://gibsonjensenandpotter.com,Require move focus stop whatever position society.,15,gibson-jensen-and-potter,2023,USD,3440739,738631,2702108,1873343,828765,32928,795837,34407,68814,727023,86171,1833532,636382,1197150,,3440739,470.75,416.73,0.1631,6875,41.7,133168.72,0.65,0.7853
5696,Smith LLC,False,TN,North Nicholas,Mobility,2013,https://smithllc.com,Reality account anyone teach central test education teacher price.,26,smith-llc,2023,USD,889442,318745,570697,49662,521035,0,521035,8894,17788,503247,5117,634491,182910,451581,,889442,243.85,272.59,0.0592,757,97.84,32440.31,0.16,0.6416
5697,Kirk-Graham,False,AU,Smithfurt,SaaS,2019,https://kirk-graham.com,And heavy him letter never senior interesting.,23,kirk-graham,2023,USD,1994042,643795,1350247,669741,680506,14999,665507,19940,39880,625627,55612,1251687,623243,628444,166170.17,1994042,512.67,1301.08,0.0286,2504,66.36,68595.34,0.81,0.6771
5698,Black Inc,False,EG,East Dale,IoT,2013,https://blackinc.com,Happen read mean leave hold key goal drive body.,19,black-inc,2023,USD,393935,158943,234992,28145,206847,6267,200580,3939,7878,192702,33031,240226,56236,183990,,393935,874.71,3541.72,0.0122,728,45.06,9350.28,3.53,0.5965
5699,Vega Davis and Chapman,False,EG,Stephanieberg,SaaS,2023,https://vegadavisandchapman.com,Into enough project power open measure reach personal impact by.,12,vega-davis-and-chapman,2023,USD,486666,124533,362133,217661,144472,0,144472,4866,9733,134739,29998,455552,79297,376255,40555.5,486666,984.93,3778.44,0.015,6793,5.97,14617.4,2.05,0.7441
5700,Wilson Harris and Howard,False,BR,Jerryton,IoT,2019,https://wilsonharrisandhoward.com,Environment probably bad step process food worry growth.,27,wilson-harris-and-howard,2023,USD,127832,51864,75968,41141,34827,33071,1756,1278,2556,-800,5422,216563,38883,177680,,127832,779.5,2347.39,0.0941,195,54.59,20976.74,0.26,0.5943
5701,Brown Li and Atkins,False,CA,Port Tylerhaven,Fintech,2019,https://brownliandatkins.com,Others local push sense mouth watch short it.,19,brown-li-and-atkins,2023,USD,1363858,422612,941246,536428,404818,4657,400161,13638,27277,372884,30834,801266,312016,489250,,1363858,779.35,4421.92,0.0695,5682,20.0,49028.5,0.63,0.6901
5702,Garcia-Jones,False,FR,West Toni,HealthTech,2012,https://garcia-jones.com,No dog write you foreign follow article ago.,11,garcia-jones,2023,EUR,250992,83081,167911,155441,12470,2991,9479,2509,5019,4460,21874,285015,175094,109921,20916.0,250992,389.98,2179.34,0.0272,275,75.81,12516.84,1.75,0.669
5703,Hamilton Miller and Williams,False,KE,New Amandafurt,AgriTech,2020,https://hamiltonmillerandwilliams.com,Culture back if something get different laugh.,30,hamilton-miller-and-williams,2023,USD,271928,120380,151548,108861,42687,0,42687,2719,5438,37249,8011,167123,137361,29762,,271928,20.0,105.08,0.0085,200,113.12,3940.41,2.03,0.5573
5704,Williams-Johnson,False,GB,New Bobby,Fintech,2014,https://williams-johnson.com,Believe others may race current by Congress federal.,22,williams-johnson,2023,USD,1281757,505327,776430,658581,117849,18769,99080,12817,25635,73445,451710,1109989,349318,760671,,1281757,20.0,60.29,0.0561,1393,76.64,75602.94,5.97,0.6058
5705,Wiggins-Maynard,False,BR,East Joshua,E-commerce,2017,https://wiggins-maynard.com,Charge yourself left give you red.,19,wiggins-maynard,2023,USD,1565778,734718,831060,501232,329828,0,329828,15657,31315,298513,38239,917253,357445,559808,,1565778,20.0,10.0,0.006,756,172.43,83781.38,0.46,0.5308
5706,Davis-Mercado,False,ZA,New Misty,Fintech,2019,https://davis-mercado.com,Next oil great mission risk become will.,23,davis-mercado,2023,USD,2428683,581156,1847527,469522,1378005,0,1378005,24286,48573,1329432,794205,2068275,1040018,1028257,,2428683,299.82,358.23,0.0456,835,242.27,15921.6,49.88,0.7607
5707,Schultz-Franklin,False,KE,East Davidbury,Mobility,2008,https://schultz-franklin.com,Institution how traditional plant population wide right receive doctor fill.,13,schultz-franklin,2023,USD,248079,102893,145186,60852,84334,0,84334,2480,4961,79373,17190,337502,25648,311854,,248079,20.0,56.53,0.0717,1033,20.0,10918.93,1.57,0.5852
5708,Porter Flores and Yang,False,KE,East Biancatown,IoT,2021,https://porterfloresandyang.com,Citizen admit story marriage him particularly business.,21,porter-flores-and-yang,2023,USD,566464,332919,233545,152207,81338,28198,53140,5664,11329,41811,35860,347246,94401,252845,,566464,20.0,42.64,0.0139,729,64.68,1000.0,35.86,0.4123
5709,Evans-Clark,False,GB,Harriston,E-commerce,2016,https://evans-clark.com,Opportunity hundred peace weight son.,21,evans-clark,2023,USD,168308,65327,102981,73005,29976,7898,22078,1683,3366,18712,2343,137294,6864,130430,,168308,20.0,24.41,0.0608,701,20.0,21866.82,0.11,0.6119
5710,Perez Williams and Garcia,False,DE,Rebeccaton,AI/ML,2016,https://perezwilliamsandgarcia.com,Discussion both letter house dark any partner image.,19,perez-williams-and-garcia,2023,EUR,660055,245269,414786,439390,-24604,18280,-42884,6600,13201,-56085,29072,473066,145344,327722,,660055,20.0,10.0,0.1657,468,117.39,42159.53,0.69,0.6284
5711,Jones-Jensen,False,NG,West Annastad,SaaS,2023,https://jones-jensen.com,Three mind industry yes letter hospital.,18,jones-jensen,2023,USD,3673693,869560,2804133,784975,2019158,0,2019158,36736,73473,1945685,210720,2089294,998120,1091174,306141.08,3673693,10.0,16.5,0.0759,4980,61.47,67158.66,3.14,0.7633
5712,Lara Ltd,False,CA,Matthewberg,HealthTech,2009,https://laraltd.com,Risk campaign bit across walk avoid.,13,lara-ltd,2023,USD,679071,409784,269287,513882,-244595,0,-244595,6790,13581,-258176,46968,450285,31525,418760,56589.25,679071,247.1,816.92,0.0344,1403,40.33,39426.62,1.19,0.3966
5713,Peck-Adams,False,BR,Jonberg,EdTech,2017,https://peck-adams.com,Different popular positive consider long wide seat write especially.,18,peck-adams,2023,USD,148419,46894,101525,57132,44393,10450,33943,1484,2968,30975,2862,102480,35399,67081,12368.25,148419,616.66,845.92,0.001,203,60.71,1000.0,2.86,0.684
5714,Price Martin and Arias,False,IN,West Melissa,Mobility,2021,https://pricemartinandarias.com,Four by strategy star lead leader.,21,price-martin-and-arias,2023,USD,974496,382776,591720,528030,63690,56780,6910,9744,19489,-12579,7542,548936,233353,315583,,974496,522.62,753.32,0.001,1646,49.33,61040.77,0.12,0.6072
5715,Trevino Washington and Foster,False,CA,Port Nicolechester,SaaS,2016,https://trevinowashingtonandfoster.com,Then great rule turn of PM personal entire.,22,trevino-washington-and-foster,2023,USD,969978,351468,618510,248351,370159,12639,357520,9699,19399,338121,56959,641965,152345,489620,80831.5,969978,319.27,590.54,0.003,1745,46.31,16266.88,3.5,0.6377
5716,Morgan Ware and Chavez,False,ZA,Phillipsport,Marketplaces,2022,https://morganwareandchavez.com,Drive lose network most value south information according argue true.,27,morgan-ware-and-chavez,2023,USD,1543403,583979,959424,638401,321023,10222,310801,15434,30868,279933,73218,965585,347670,617915,,1543403,239.48,1148.62,0.001,288,445.31,87007.92,0.84,0.6216
5717,Wright Medina and Thomas,False,BR,Ariaschester,Fintech,2018,https://wrightmedinaandthomas.com,Where these learn born deep score left trade member mention.,23,wright-medina-and-thomas,2023,USD,868151,264685,603466,496936,106530,8674,97856,8681,17363,80493,8768,474857,23742,451115,,868151,20.0,49.31,0.1469,271,266.23,49170.44,0.18,0.6951
5718,Hernandez Inc,False,NG,North Sally,SaaS,2012,https://hernandezinc.com,Factor unit value who money million picture important.,23,hernandez-inc,2023,USD,2258938,593981,1664957,466860,1198097,18486,1179611,22589,45178,1134433,190625,1457661,72883,1384778,188244.83,2258938,34.41,79.65,0.0465,3539,53.18,41853.18,4.55,0.7371
5719,Washington-Jenkins,False,KE,West Lorihaven,SaaS,2008,https://washington-jenkins.com,Eight per seem since.,20,washington-jenkins,2023,USD,679573,263824,415749,501846,-86097,0,-86097,6795,13591,-99688,23705,541634,241983,299651,56631.08,679573,10.0,61.3,0.001,2680,21.13,43849.13,0.54,0.6118
5720,Ellison Frazier and Miller,False,IN,Housechester,Energy,2014,https://ellisonfrazierandmiller.com,Free accept feel wrong plan decide anything market watch.,20,ellison-frazier-and-miller,2023,USD,337970,37262,300708,56658,244050,0,244050,3379,6759,237291,48621,358860,171533,187327,,337970,1473.45,736.72,0.0949,76,366.48,25366.31,1.92,0.8897
5721,Bates-Williams,False,EG,New Stephanie,Energy,2020,https://bates-williams.com,Scene note animal sing tough movement while memory prove.,17,bates-williams,2023,USD,2277805,613977,1663828,876307,787521,16122,771399,22778,45556,725843,38407,1281748,550329,731419,,2277805,870.35,6056.67,0.0763,9490,20.0,33915.75,1.13,0.7305
5722,Cook Mendoza and Parker,False,US,Hansontown,Cybersecurity,2016,https://cookmendozaandparker.com,Three sit fund author represent movie require.,26,cook-mendoza-and-parker,2023,USD,1209083,421062,788021,383734,404287,0,404287,12090,24181,380106,97557,876823,789140,87683,,1209083,623.58,3022.48,0.001,573,175.79,23900.63,4.08,0.6518
5723,Pierce-Collins,False,ZA,Williamsstad,Energy,2018,https://pierce-collins.com,Cause author message possible particularly south glass.,12,pierce-collins,2023,USD,838091,220469,617622,479443,138179,47942,90237,8380,16761,73476,23536,530498,139528,390970,,838091,235.44,959.6,0.001,1445,48.32,51971.82,0.45,0.7369
5724,Vasquez PLC,False,CA,Jeremyshire,AI/ML,2021,https://vasquezplc.com,Pretty produce world send paper usually big bag.,19,vasquez-plc,2023,USD,197583,88331,109252,111174,-1922,35218,-37140,1975,3951,-41091,11068,273592,102567,171025,,197583,1428.45,1345.39,0.0528,823,20.0,1000.0,11.07,0.5529
5725,Dennis Ingram and Rice,False,TN,West Tara,Cybersecurity,2018,https://dennisingramandrice.com,Interesting government think that occur would.,20,dennis-ingram-and-rice,2023,USD,443683,167068,276615,159733,116882,42848,74034,4436,8873,65161,14941,286008,29369,256639,,443683,20.0,119.19,0.0613,107,345.4,1000.0,14.94,0.6235
5726,Whitney-West,False,GB,Lake Elizabethmouth,E-commerce,2016,https://whitney-west.com,Maintain nice answer sea blood American keep who establish.,19,whitney-west,2023,USD,1895741,420937,1474804,94787,1380017,2105,1377912,18957,37914,1339998,111595,1089965,706038,383927,,1895741,480.44,3269.14,0.0786,524,301.41,8736.84,12.77,0.778
5727,Smith Inc,False,NG,Maysfurt,EdTech,2023,https://smithinc.com,Baby rock rise of culture together.,21,smith-inc,2023,USD,435197,146687,288510,126226,162284,0,162284,4351,8703,153581,4410,246882,12344,234538,36266.42,435197,188.58,188.58,0.0114,7253,5.0,1000.0,4.41,0.6629
5728,Ward-Green,False,IN,Lake John,AgriTech,2010,https://ward-green.com,Painting whether walk PM check real.,18,ward-green,2023,USD,144272,61224,83048,76905,6143,13412,-7269,1442,2885,-10154,6937,105167,29551,75616,,144272,248.22,1082.12,0.0411,29,407.0,39505.86,0.18,0.5756
5729,Beltran-Coleman,False,EG,Jamieside,Marketplaces,2010,https://beltran-coleman.com,Wrong class federal right parent particularly policy.,23,beltran-coleman,2023,USD,147815,33243,114572,94902,19670,16251,3419,1478,2956,463,3780,236503,63531,172972,,147815,20.0,150.24,0.001,156,78.84,1000.0,3.78,0.7751
5730,Rodriguez-Marshall,False,AU,Sarahville,Marketplaces,2018,https://rodriguez-marshall.com,Myself treat Congress million day standard dark small some weight.,19,rodriguez-marshall,2023,USD,4103965,1908061,2195904,2524153,-328249,0,-328249,41039,82079,-410328,141553,2368443,802207,1566236,,4103965,308.5,1206.03,0.0838,6127,55.81,237444.21,0.6,0.5351
5731,Martinez-Garcia,False,NG,Josephhaven,Fintech,2008,https://martinez-garcia.com,Must parent among know sing history young arrive people.,20,martinez-garcia,2023,USD,641924,244427,397497,208647,188850,20052,168798,6419,12838,155960,113460,435387,205461,229926,,641924,340.2,1561.38,0.0485,1441,37.1,20092.57,5.65,0.6192
5732,James Riddle and Robinson,False,AU,Lowebury,HealthTech,2011,https://jamesriddleandrobinson.com,Write agent check consumer them.,20,james-riddle-and-robinson,2023,USD,734408,226719,507689,603864,-96175,52724,-148899,7344,14688,-163587,23772,470258,99105,371153,61200.67,734408,277.45,801.27,0.0295,1284,47.64,48863.31,0.49,0.6913
5733,Martinez LLC,False,DE,New Vanessaport,Fintech,2013,https://martinezllc.com,Information bed better bad design friend state show task general.,30,martinez-llc,2023,EUR,1536771,357904,1178867,423330,755537,31971,723566,15367,30735,692831,59302,921433,410304,511129,,1536771,1860.69,4584.5,0.0733,6403,20.0,41394.26,1.43,0.7671
5734,Warren Pace and Campbell,False,CA,Mitchellbury,Fintech,2012,https://warrenpaceandcampbell.com,General treatment more politics material look back specific.,14,warren-pace-and-campbell,2023,USD,4171714,1660741,2510973,3283194,-772221,28800,-801021,41717,83434,-884455,84029,2346572,1498623,847949,,4171714,20.0,24.0,0.0177,3860,90.06,274060.25,0.31,0.6019
5735,Turner LLC,False,KE,Stevensside,EdTech,2010,https://turnerllc.com,Dog bar series off think wide there hard artist.,18,turner-llc,2023,USD,225399,40031,185368,49862,135506,0,135506,2253,4507,130999,3329,154229,9454,144775,18783.25,225399,205.72,1025.74,0.0515,1029,18.25,1000.0,3.33,0.8224
5736,Reeves Greer and Gonzalez,False,FR,Port Tylerfort,SaaS,2008,https://reevesgreerandgonzalez.com,Defense effect strong describe official.,17,reeves-greer-and-gonzalez,2023,EUR,3154928,985827,2169101,205828,1963273,0,1963273,31549,63098,1900175,198442,1787787,416718,1371069,262910.67,3154928,310.14,726.48,0.001,4224,62.23,11791.2,16.83,0.6875
5737,Hernandez Jenkins and Bradley,False,ZA,New Samantha,E-commerce,2010,https://hernandezjenkinsandbradley.com,Toward produce letter owner scientist discussion.,20,hernandez-jenkins-and-bradley,2023,USD,308332,95133,213199,73387,139812,11604,128208,3083,6166,122042,4280,301067,157069,143998,,308332,123.6,368.64,0.001,1284,20.0,1000.0,4.28,0.6915
5738,Contreras-Williams,False,GB,Cookton,IoT,2022,https://contreras-williams.com,Police figure source but system manager throw all pull position.,24,contreras-williams,2023,USD,243561,43074,200487,74158,126329,0,126329,2435,4871,121458,2142,312776,42014,270762,,243561,20.0,69.64,0.0405,121,167.13,25462.73,0.08,0.8231
5739,Cohen Mcdaniel and Cook,False,BR,Kathleenbury,E-commerce,2011,https://cohenmcdanielandcook.com,Technology he total really other.,30,cohen-mcdaniel-and-cook,2023,USD,635933,253202,382731,235495,147236,12288,134948,6359,12718,122230,51490,553334,404850,148484,,635933,1417.37,2127.35,0.0463,2649,20.0,9494.31,5.42,0.6018
5740,Flores-Miller,False,KE,Johnnymouth,Fintech,2009,https://flores-miller.com,For they occur road usually partner series her technology sea.,27,flores-miller,2023,USD,400827,158837,241990,193255,48735,224,48511,4008,8016,40495,4725,403159,105379,297780,,400827,20.0,101.71,0.014,127,260.98,21347.34,0.22,0.6037
5741,Vaughan Robertson and Bridges,False,ZA,Mcclainside,HealthTech,2014,https://vaughanrobertsonandbridges.com,Yes white financial why analysis right style without.,15,vaughan-robertson-and-bridges,2023,USD,237298,75575,161723,83428,78295,18532,59763,2372,4745,55018,1856,298279,54960,243319,19774.83,237298,10.0,36.35,0.0168,215,91.86,1000.0,1.86,0.6815
5742,Shields Vega and Young,False,ZA,Danieltown,Fintech,2013,https://shieldsvegaandyoung.com,Make but item little above grow word.,18,shields-vega-and-young,2023,USD,554465,27723,526742,183620,343122,0,343122,5544,11089,332033,11365,343896,93942,249954,,554465,107.91,462.13,0.0329,2310,20.0,8770.6,1.3,0.95
5743,Thompson-White,False,FR,West Christopher,Cybersecurity,2010,https://thompson-white.com,Because speak provide bar ever project left daughter.,21,thompson-white,2023,EUR,1057375,513118,544257,347093,197164,17675,179489,10573,21147,158342,63921,718203,338565,379638,,1057375,20.0,10.0,0.0453,914,96.36,53678.13,1.19,0.5147
5744,Hamilton Jones and Flores,False,US,Davidshire,Energy,2015,https://hamiltonjonesandflores.com,Adult then quickly human need reality list think.,26,hamilton-jones-and-flores,2023,USD,1957403,692587,1264816,194952,1069864,24656,1045208,19574,39148,1006060,88541,1127867,555561,572306,,1957403,758.96,496.58,0.001,656,248.55,30861.81,2.87,0.6462
5745,Walsh-Logan,False,DE,Curtisshire,SaaS,2010,https://walsh-logan.com,Voice population until simple young guy.,23,walsh-logan,2023,EUR,1022677,145949,876728,136569,740159,0,740159,10226,20453,719706,291711,998848,583094,415754,85223.08,1022677,967.14,3505.71,0.001,1326,64.26,7910.71,36.88,0.8573
5746,Stevens Carter and Chavez,False,TN,Kathleenmouth,E-commerce,2024,https://stevenscarterandchavez.com,Before leader ten task kid leader true at soon.,19,stevens-carter-and-chavez,2023,USD,1258765,421838,836927,533018,303909,0,303909,12587,25175,278734,6901,683396,141586,541810,,1258765,20.0,100.3,0.1278,678,154.62,55633.76,0.12,0.6649
5747,May Thompson and Lowe,False,DE,South Adamside,Mobility,2014,https://maythompsonandlowe.com,Republican sister party admit theory measure often debate hear series.,15,may-thompson-and-lowe,2023,EUR,3348830,629259,2719571,2345901,373670,37006,336664,33488,66976,269688,265886,1970014,960623,1009391,,3348830,723.42,2162.78,0.001,2023,137.91,171559.36,1.55,0.8121
5748,Jackson LLC,False,ZA,Escobarhaven,Mobility,2013,https://jacksonllc.com,Address sea card cell plant enter eight include son.,22,jackson-llc,2023,USD,1902215,459325,1442890,416497,1026393,20735,1005658,19022,38044,967614,300351,1450555,857260,593295,,1902215,943.66,2592.55,0.0612,1090,145.38,28693.63,10.47,0.7585
5749,Garcia-Coleman,False,EG,Lake Omarview,AgriTech,2009,https://garcia-coleman.com,Nothing media serious ahead ever democratic onto brother.,11,garcia-coleman,2023,USD,138178,59726,78452,70399,8053,39430,-31377,1381,2763,-34140,1069,126144,73890,52254,,138178,1510.2,5973.86,0.066,85,134.84,18898.42,0.06,0.5678
5750,Mcdaniel-Green,False,EG,East Tiffany,HealthTech,2024,https://mcdaniel-green.com,Likely decision either husband child interesting author tonight project budget.,22,mcdaniel-green,2023,USD,5522775,820111,4702664,958576,3744088,15356,3728732,55227,110455,3618277,81123,3031721,1213298,1818423,460231.25,5522775,316.91,857.22,0.0019,5616,81.94,81191.63,1.0,0.8515
5751,Young Myers and Gaines,False,US,Port Zachary,Fintech,2013,https://youngmyersandgaines.com,Attention into child six upon resource.,21,young-myers-and-gaines,2023,USD,1733894,890686,843208,698758,144450,0,144450,17338,34677,109773,93494,991032,372388,618644,,1733894,1316.71,985.6,0.0151,7224,20.0,66066.28,1.42,0.4863
5752,Jones-Hendricks,False,DE,Richardfort,AgriTech,2012,https://jones-hendricks.com,Well visit raise network activity job.,28,jones-hendricks,2023,EUR,336386,143515,192871,166899,25972,43107,-17135,3363,6727,-23862,28967,310708,66694,244014,,336386,157.28,206.54,0.1545,104,268.19,49800.83,0.58,0.5734
5753,Finley and Sons,False,NG,South Ginamouth,IoT,2014,https://finleyandsons.com,Control outside challenge development next rule east challenge take.,23,finley-and-sons,2023,USD,833143,227931,605212,404247,200965,0,200965,8331,16662,184303,9089,469263,292390,176873,,833143,20.0,10.0,0.0073,1970,35.23,51399.3,0.18,0.7264
5754,Webb Brooks and Jimenez,False,ZA,Dennisborough,Fintech,2010,https://webbbrooksandjimenez.com,Offer Mr writer after able think fight population message.,25,webb-brooks-and-jimenez,2023,USD,1228330,465462,762868,774585,-11717,10569,-22286,12283,24566,-46852,138475,833621,41681,791940,,1228330,936.67,4335.66,0.0393,722,141.71,64251.24,2.16,0.6211
5755,Hoffman-Wilson,False,DE,Wheelerside,HealthTech,2018,https://hoffman-wilson.com,Decision capital property collection notice.,25,hoffman-wilson,2023,EUR,670925,205014,465911,33546,432365,6407,425958,6709,13418,412540,129006,558146,275924,282222,55910.42,670925,10.0,54.57,0.0294,1084,51.56,14181.33,9.1,0.6944
5756,Lee-Chambers,False,AU,East Ericborough,EdTech,2013,https://lee-chambers.com,Blue everything success protect general toward well or show.,23,lee-chambers,2023,USD,794272,228462,565810,39713,526097,0,526097,7942,15885,510212,104803,597715,158659,439056,66189.33,794272,10.0,29.73,0.009,2463,26.87,1000.0,104.8,0.7124
5757,White Olson and Patton,False,TN,Port Kelly,Marketplaces,2017,https://whiteolsonandpatton.com,Table important industry argue teacher station pretty.,24,white-olson-and-patton,2023,USD,952442,146248,806194,521460,284734,19534,265200,9524,19048,246152,52840,601701,206358,395343,,952442,20.0,109.72,0.001,448,176.84,24861.27,2.13,0.8464
5758,Palmer Ltd,False,KE,East Gary,Energy,2024,https://palmerltd.com,Movie nature hot realize group political better kitchen include.,13,palmer-ltd,2023,USD,1337215,875022,462193,1211392,-749199,0,-749199,13372,26744,-775943,51628,725989,199800,526189,,1337215,20.0,102.64,0.1054,562,198.25,80567.67,0.64,0.3456
5759,Reynolds-Price,False,BR,East Matthewfurt,AgriTech,2014,https://reynolds-price.com,North event him man ok.,21,reynolds-price,2023,USD,897555,307789,589766,417609,172157,5691,166466,8975,17951,148515,64207,692705,352751,339954,,897555,975.71,557.26,0.001,357,209.13,32584.66,1.97,0.6571
5760,Williams-Scott,False,TN,Deanberg,AgriTech,2019,https://williams-scott.com,Card large we pattern imagine policy population chair.,30,williams-scott,2023,USD,302862,122432,180430,54650,125780,13065,112715,3028,6057,106658,40713,389421,105221,284200,,302862,20.0,39.78,0.001,113,223.2,36983.23,1.1,0.5957
5761,Castro-Cline,False,ZA,New Rachelberg,EdTech,2024,https://castro-cline.com,At media technology maintain however name though while how successful.,21,castro-cline,2023,USD,522028,298906,223122,122108,101014,21751,79263,5220,10440,68823,10799,317339,102360,214979,43502.33,522028,705.76,4944.31,0.0687,454,95.61,4520.52,2.39,0.4274
5762,Kelley Pierce and Moore,False,US,Perezfort,Marketplaces,2016,https://kelleypierceandmoore.com,Two ever box ball doctor.,18,kelley-pierce-and-moore,2023,USD,289420,98049,191371,258401,-67030,0,-67030,2894,5788,-72818,14715,319606,124266,195340,,289420,992.88,4638.51,0.0594,88,274.03,34753.97,0.42,0.6612
5763,Miller Group,False,IN,Reynoldsfurt,HealthTech,2010,https://millergroup.com,Benefit minute growth live.,16,miller-group,2023,USD,776788,135203,641585,577372,64213,0,64213,7767,15535,48678,62017,614363,346325,268038,64732.33,776788,12.95,87.41,0.0321,12144,5.33,71025.35,0.87,0.8259
5764,Hill Martinez and Dickerson,False,US,Lake Morganfort,Fintech,2023,https://hillmartinezanddickerson.com,Attention half tell test growth.,20,hill-martinez-and-dickerson,2023,USD,1224481,413398,811083,1074926,-263843,17861,-281704,12244,24489,-306193,31276,708931,380010,328921,,1224481,462.38,1378.6,0.1562,891,114.5,77929.83,0.4,0.6624
5765,Mitchell PLC,False,CA,Mariafort,Cybersecurity,2009,https://mitchellplc.com,Writer fish condition receive job effort attention their.,17,mitchell-plc,2023,USD,1127993,234428,893565,972492,-78927,19524,-98451,11279,22559,-121010,168077,833576,264856,568720,,1127993,56.36,197.58,0.0303,1493,62.95,106036.41,1.59,0.7922
5766,Ellis-Buchanan,False,KE,New Brettmouth,Energy,2010,https://ellis-buchanan.com,Night evidence player left up with type need away moment.,24,ellis-buchanan,2023,USD,341750,20510,321240,292847,28393,10769,17624,3417,6835,10789,114765,304833,84770,220063,,341750,1354.37,4334.91,0.128,1423,20.0,1000.0,114.76,0.94
5767,King Inc,False,BR,New Markborough,Cybersecurity,2022,https://kinginc.com,None south represent develop present specific why student model surface future.,14,king-inc,2023,USD,675306,225686,449620,340173,109447,0,109447,6753,13506,95941,40311,545086,129898,415188,,675306,1212.16,3053.4,0.1031,513,109.5,50931.3,0.79,0.6658
5768,Bentley Jenkins and Kirk,False,US,Copelandstad,Cybersecurity,2010,https://bentleyjenkinsandkirk.com,Involve could talk produce important ever reason oil how continue.,18,bentley-jenkins-and-kirk,2023,USD,1684586,358823,1325763,518458,807305,0,807305,16845,33691,773614,282642,1260193,63009,1197184,,1684586,1253.84,871.75,0.0527,1066,131.63,31474.63,8.98,0.787
5769,Little Group,False,CA,Bakerborough,IoT,2019,https://littlegroup.com,Whom support three chair realize kid play six exist return.,22,little-group,2023,USD,1574646,563875,1010771,907407,103364,0,103364,15746,31492,71872,81625,925370,175609,749761,,1574646,20.0,55.37,0.0468,1635,80.23,83143.54,0.98,0.6419
5770,Mathis LLC,False,ZA,Scottland,Marketplaces,2010,https://mathisllc.com,Whole or husband green chair Mr condition large item.,16,mathis-llc,2023,USD,702582,130601,571981,549367,22614,25274,-2660,7025,14051,-16711,23333,475033,125926,349107,,702582,20.0,90.85,0.0594,2927,20.0,1539.9,15.15,0.8141
5771,Taylor-Jones,False,KE,North Ellenville,AgriTech,2018,https://taylor-jones.com,Skin tax training left shoulder generation TV however as tell.,16,taylor-jones,2023,USD,413190,154162,259028,267792,-8764,0,-8764,4131,8263,-17027,7173,326729,216961,109768,,413190,20.0,66.88,0.001,306,112.35,14361.26,0.5,0.6269
5772,Johnson Rodriguez and Bowman,False,EG,Port Philip,E-commerce,2023,https://johnsonrodriguezandbowman.com,According rest by near network remain.,32,johnson-rodriguez-and-bowman,2023,USD,902990,288936,614054,597076,16978,0,16978,9029,18059,-1081,53763,621410,419733,201677,,902990,927.82,4025.68,0.0899,696,108.02,61938.01,0.87,0.68
5773,Cantu LLC,False,CA,Lake Kimberlyshire,Mobility,2017,https://cantullc.com,Glass shake they artist bring too heart her may.,19,cantu-llc,2023,USD,828158,227811,600347,341456,258891,19940,238951,8281,16563,222388,48682,515127,293212,221915,,828158,708.25,869.42,0.0121,519,132.76,38951.59,1.25,0.7249
5774,Thompson-Parker,False,AU,Palmerland,Mobility,2018,https://thompson-parker.com,Morning far where much nature week sell center.,21,thompson-parker,2023,USD,813805,211128,602677,219190,383487,0,383487,8138,16276,367211,19038,448030,141316,306714,,813805,457.44,908.29,0.0391,1397,48.54,28801.8,0.66,0.7406
5775,Griffin-Sandoval,False,NG,Carlsonmouth,Cybersecurity,2014,https://griffin-sandoval.com,Pull cup section feel sure morning answer whole eight look.,18,griffin-sandoval,2023,USD,1145353,638644,506709,643569,-136860,21478,-158338,11453,22907,-181245,60243,809300,346722,462578,,1145353,202.15,694.84,0.0042,1969,48.45,57857.51,1.04,0.4424
5776,Smith-Skinner,False,DE,Goodmouth,IoT,2013,https://smith-skinner.com,Remember state lawyer rule take then I expert as conference statement.,18,smith-skinner,2023,EUR,381590,99902,281688,22446,259242,8476,250766,3815,7631,243135,1932,363230,83414,279816,,381590,282.39,396.3,0.001,199,159.4,1000.0,1.93,0.7382
5777,Lopez Lin and Hicks,False,US,New Angela,Cybersecurity,2019,https://lopezlinandhicks.com,Because information second white movement television lay prepare.,9,lopez-lin-and-hicks,2023,USD,1604976,521405,1083571,951560,132011,18155,113856,16049,32099,81757,66984,1014621,455719,558902,,1604976,1203.49,7109.79,0.051,6687,20.0,118658.26,0.56,0.6751
5778,Figueroa Group,False,TN,Buchananview,Mobility,2022,https://figueroagroup.com,Star structure anyone care do.,20,figueroa-group,2023,USD,1730788,815380,915408,901208,14200,0,14200,17307,34615,-20415,184342,1073202,230201,843001,,1730788,1123.76,6192.29,0.0369,2439,59.13,42881.33,4.3,0.5289
5779,Nelson-Montgomery,False,CA,North Donna,Energy,2022,https://nelson-montgomery.com,Do at age design machine after say party according top many.,32,nelson-montgomery,2023,USD,13805731,3341812,10463919,7600838,2863081,19434,2843647,138057,276114,2567533,538816,7585215,1428846,6156369,,13805731,754.39,1355.61,0.029,9308,123.6,634059.55,0.85,0.7579
5780,Frye Warner and Flores,False,EG,New Mollystad,Mobility,2012,https://fryewarnerandflores.com,Music financial explain article ever street.,18,frye-warner-and-flores,2023,USD,383440,81364,302076,156436,145640,8144,137496,3834,7668,129828,6344,282067,123333,158734,,383440,688.3,1500.63,0.001,314,101.6,5671.76,1.12,0.7878
5781,Burns Mcdonald and Weaver,False,GB,Whitneyshire,Cybersecurity,2020,https://burnsmcdonaldandweaver.com,Defense risk usually moment next.,22,burns-mcdonald-and-weaver,2023,USD,414899,199285,215614,232371,-16757,19008,-35765,4148,8297,-44062,17610,416040,161939,254101,,414899,574.87,313.94,0.1441,227,152.25,31938.02,0.55,0.5197
5782,Nguyen Smith and Smith,False,TN,Heidishire,SaaS,2012,https://nguyensmithandsmith.com,Others debate government bar media decide TV thought.,16,nguyen-smith-and-smith,2023,USD,1188074,243271,944803,99107,845696,0,845696,11880,23761,821935,68771,773607,549075,224532,99006.17,1188074,578.57,2651.2,0.0451,4001,24.74,2321.09,29.63,0.7952
5783,Blankenship Larson and Simmons,False,AU,Brittanymouth,E-commerce,2020,https://blankenshiplarsonandsimmons.com,Doctor inside imagine else current teacher.,22,blankenship-larson-and-simmons,2023,USD,371589,141887,229702,204674,25028,0,25028,3715,7431,17597,5522,386086,181579,204507,,371589,20.0,97.3,0.001,203,151.86,1000.0,5.52,0.6182
5784,Bradford-Jones,False,BR,Stephaniemouth,HealthTech,2020,https://bradford-jones.com,Open discover recent crime more cell hospital season letter minute.,20,bradford-jones,2023,USD,833004,70144,762860,233186,529674,31457,498217,8330,16660,481557,100050,600638,137478,463160,69417.0,833004,239.53,2116.02,0.001,713,97.34,45767.44,2.19,0.9158
5785,Jacobs and Sons,False,CA,Port Sarahport,SaaS,2021,https://jacobsandsons.com,Unit their reason sea paper life hospital probably dream cell.,15,jacobs-and-sons,2023,USD,3601694,937236,2664458,2910548,-246090,0,-246090,36016,72033,-318123,262473,2114386,810209,1304177,300141.17,3601694,202.28,700.22,0.001,2516,119.25,280691.65,0.94,0.7398
5786,Harrison Gray and Campbell,False,AU,Kimberlytown,Marketplaces,2013,https://harrisongrayandcampbell.com,Career purpose sit call American one soldier nothing network would choice.,32,harrison-gray-and-campbell,2023,USD,676891,268399,408492,429986,-21494,6634,-28128,6768,13537,-41665,23902,412471,195556,216915,,676891,689.91,344.96,0.0424,2820,20.0,29651.94,0.81,0.6035
5787,Young Richardson and Wright,False,GB,Sarahport,IoT,2013,https://youngrichardsonandwright.com,Use prove chair few wide low market someone computer.,28,young-richardson-and-wright,2023,USD,928403,295253,633150,550139,83011,45712,37299,9284,18568,18731,10490,626653,148036,478617,,928403,20.0,103.96,0.0115,342,226.09,19756.93,0.53,0.682
5788,Howard Stewart and Vincent,False,DE,West Haleyhaven,Fintech,2008,https://howardstewartandvincent.com,Down act thus during start change industry.,27,howard-stewart-and-vincent,2023,EUR,933451,471260,462191,290019,172172,37880,134292,9334,18669,115623,242086,783050,305678,477372,,933451,151.6,911.8,0.0722,623,124.72,42845.72,5.65,0.4951
5789,Moore-Williams,False,TN,Annstad,Mobility,2012,https://moore-williams.com,Situation east prepare smile hear work smile.,22,moore-williams,2023,USD,776989,354805,422184,263887,158297,0,158297,7769,15539,142758,166848,749137,176906,572231,,776989,2107.95,2438.9,0.001,540,119.73,38356.17,4.35,0.5434
5790,Copeland Davenport and Coleman,False,IN,West Kristin,E-commerce,2014,https://copelanddavenportandcoleman.com,Feel garden throw property Mrs structure population four control fast.,12,copeland-davenport-and-coleman,2023,USD,3805034,1642966,2162068,2058974,103094,11406,91688,38050,76100,15588,60840,2133650,1347139,786511,,3805034,1036.9,2189.06,0.1037,6832,46.41,159153.29,0.38,0.5682
5791,Bryant-Chambers,False,US,Thomasfurt,Mobility,2020,https://bryant-chambers.com,Human way show simply example surface baby tough eye.,17,bryant-chambers,2023,USD,1696090,421691,1274399,645549,628850,3947,624903,16960,33921,590982,28957,879955,201048,678907,,1696090,875.42,2334.95,0.062,7067,20.0,57671.41,0.5,0.7514
5792,Blake LLC,False,GB,Aliciatown,AgriTech,2016,https://blakellc.com,Throw clearly wear man never suffer next.,21,blake-llc,2023,USD,119577,30542,89035,11965,77070,1649,75421,1195,2391,73030,4050,79661,45317,34344,,119577,748.56,1305.2,0.0743,52,190.97,5006.75,0.81,0.7446
5793,Jones-Bell,False,DE,West Richardberg,EdTech,2023,https://jones-bell.com,Which hospital risk appear with edge forward cost member leave.,24,jones-bell,2023,EUR,789798,394219,395579,246567,149012,40994,108018,7897,15795,92223,32271,506699,302743,203956,65816.5,789798,356.92,1019.82,0.001,846,77.76,36291.62,0.89,0.5009
5794,Cook-Thomas,False,KE,Port Ashley,Cybersecurity,2023,https://cook-thomas.com,Maintain continue store place again mother level.,14,cook-thomas,2023,USD,1319642,693021,626621,650468,-23847,11143,-34990,13196,26392,-61382,4051,743265,457976,285289,,1319642,20.0,113.16,0.0026,5498,20.0,24936.15,0.16,0.4748
5795,Allison-Contreras,False,TN,West William,Energy,2013,https://allison-contreras.com,Opportunity financial gas history shoulder way fall.,21,allison-contreras,2023,USD,954318,542056,412262,437601,-25339,0,-25339,9543,19086,-44425,7368,641627,340123,301504,,954318,405.21,202.6,0.099,182,436.52,46267.22,0.16,0.432
5796,Miller Garcia and Berger,False,EG,East Ashleyville,Marketplaces,2009,https://millergarciaandberger.com,Hundred cut end program page.,34,miller-garcia-and-berger,2023,USD,265770,60892,204878,174193,30685,0,30685,2657,5315,25370,5029,185572,76020,109552,,265770,373.78,186.89,0.0048,304,72.67,2341.14,2.15,0.7709
5797,Marks-Thompson,False,CA,North Gregory,Fintech,2010,https://marks-thompson.com,Environmental trial can most part yet environment radio.,25,marks-thompson,2023,USD,379593,123603,255990,186112,69878,22088,47790,3795,7591,40199,1565,280145,19042,261103,,379593,390.77,1947.05,0.001,1581,20.0,12915.35,0.12,0.6744
5798,Ryan-Petersen,False,CA,Ramirezberg,Cybersecurity,2023,https://ryan-petersen.com,Pressure name term here call risk over center key.,17,ryan-petersen,2023,USD,1084771,598666,486105,423232,62873,0,62873,10847,21695,41178,165476,897185,345408,551777,,1084771,20.0,64.15,0.078,966,93.56,46967.04,3.52,0.4481
5799,Cox PLC,False,KE,Jessicastad,AgriTech,2012,https://coxplc.com,Technology despite else put within body.,20,cox-plc,2023,USD,121164,22283,98881,40547,58334,0,58334,1211,2423,55911,4912,104772,11905,92867,,121164,20.0,57.48,0.0594,26,377.27,1000.0,4.91,0.8161
5800,Martin-Sullivan,False,DE,Clarkville,AI/ML,2023,https://martin-sullivan.com,Often one particular evening bed.,26,martin-sullivan,2023,EUR,2454458,1333918,1120540,1230707,-110167,0,-110167,24544,49089,-159256,215959,1626330,431622,1194708,,2454458,727.42,4183.51,0.0464,10226,20.0,118779.04,1.82,0.4565
5801,Willis-Diaz,False,AU,New Pamelaville,EdTech,2021,https://willis-diaz.com,Single oil opportunity statement entire.,20,willis-diaz,2023,USD,48156,18047,30109,34888,-4779,0,-4779,481,963,-5742,5003,51189,8187,43002,4013.0,48156,375.82,1695.31,0.0247,104,38.53,19765.01,0.25,0.6252
5802,Patterson LLC,False,EG,North Kimland,SaaS,2017,https://pattersonllc.com,Reach debate effect interest administration minute nothing business summer.,21,patterson-llc,2023,USD,2452192,498443,1953749,1468521,485228,0,485228,24521,49043,436185,430065,1829699,657869,1171830,204349.33,2452192,10.0,31.99,0.0063,1682,121.49,125491.06,3.43,0.7967
5803,Rodriguez-Hester,False,BR,New Brianchester,HealthTech,2018,https://rodriguez-hester.com,South different enter parent blood system.,28,rodriguez-hester,2023,USD,1128634,321977,806657,677478,129179,11609,117570,11286,22572,94998,23739,750074,472257,277817,94052.83,1128634,245.29,1206.81,0.001,1642,57.25,69065.42,0.34,0.7147
5804,Walker and Sons,False,BR,Chanville,AgriTech,2021,https://walkerandsons.com,Support bag fine almost view likely ever them tell.,21,walker-and-sons,2023,USD,316435,73403,243032,64788,178244,0,178244,3164,6328,171916,8038,170992,70530,100462,,316435,528.47,2016.68,0.0112,917,28.73,1000.0,8.04,0.768
5805,Sharp Jones and Meadows,False,KE,East Anthony,Fintech,2012,https://sharpjonesandmeadows.com,Ahead light director stock guy.,22,sharp-jones-and-meadows,2023,USD,1955390,488848,1466542,746528,720014,8137,711877,19553,39107,672770,342284,1462234,601437,860797,,1955390,20.0,64.6,0.0602,8147,20.0,70405.04,4.86,0.75
5806,Palmer-Marks,False,NG,Port Andrewberg,AgriTech,2018,https://palmer-marks.com,Claim staff other both sense.,11,palmer-marks,2023,USD,571168,231258,339910,455578,-115668,17352,-133020,5711,11423,-144443,12039,435073,99090,335983,,571168,1263.46,5206.12,0.119,2379,20.0,19601.01,0.61,0.5951
5807,Johnson-Duncan,False,ZA,Allenchester,E-commerce,2012,https://johnson-duncan.com,Society age reflect weight statement per deal window.,15,johnson-duncan,2023,USD,731368,268738,462630,368463,94167,0,94167,7313,14627,79540,172024,542076,189906,352170,,731368,1034.6,2141.34,0.1648,796,76.54,35437.22,4.85,0.6326
5808,Fisher Preston and Munoz,False,CA,South Peterfurt,IoT,2023,https://fisherprestonandmunoz.com,Game rise area newspaper identify central foreign from cultural.,23,fisher-preston-and-munoz,2023,USD,1828791,659406,1169385,1338279,-168894,34119,-203013,18287,36575,-239588,121957,1110747,545631,565116,,1828791,470.13,1479.03,0.1048,3085,49.4,143400.14,0.85,0.6394
5809,Fleming PLC,False,FR,West Erichaven,SaaS,2022,https://flemingplc.com,However near behind each list whatever past special.,20,fleming-plc,2023,EUR,1192825,672496,520329,968867,-448538,0,-448538,11928,23856,-472394,181906,801700,135694,666006,99402.08,1192825,437.59,1485.33,0.0497,1574,63.12,91191.26,1.99,0.4362
5810,Nguyen-King,False,CA,Aliceland,Energy,2015,https://nguyen-king.com,Discover TV certainly short wall term give.,23,nguyen-king,2023,USD,3455534,1034594,2420940,1433086,987854,0,987854,34555,69110,918744,84900,1828053,279827,1548226,,3455534,20.0,63.44,0.0383,3418,84.23,122394.72,0.69,0.7006
5811,Carroll Baxter and Washington,False,DE,Ortegachester,E-commerce,2015,https://carrollbaxterandwashington.com,Property important receive move year form.,19,carroll-baxter-and-washington,2023,EUR,799805,355381,444424,375395,69029,0,69029,7998,15996,53033,16276,441471,264288,177183,,799805,20.0,39.23,0.0117,873,76.32,57070.75,0.29,0.5557
5812,Cameron-Smith,False,CA,Tranville,Marketplaces,2023,https://cameron-smith.com,Hold term across page every try call meeting write.,17,cameron-smith,2023,USD,1334506,525185,809321,897659,-88338,25819,-114157,13345,26690,-140847,125927,965071,452429,512642,,1334506,561.69,1571.96,0.001,4464,24.91,76405.86,1.65,0.6065
5813,Delgado-Nichols,False,AU,South Josephmouth,AgriTech,2018,https://delgado-nichols.com,Statement statement once discussion well win majority boy most list.,14,delgado-nichols,2023,USD,143827,58671,85156,58635,26521,12985,13536,1438,2876,10660,4399,114369,32055,82314,,143827,635.08,2366.3,0.0711,85,139.84,15447.12,0.28,0.5921
5814,Dixon Bentley and Thompson,False,KE,Danielchester,E-commerce,2014,https://dixonbentleyandthompson.com,Smile he home art.,25,dixon-bentley-and-thompson,2023,USD,210254,75935,134319,107229,27090,6687,20403,2102,4205,16198,10621,309333,15466,293867,,210254,20.0,52.09,0.0739,116,150.65,1000.0,10.62,0.6388
5815,Smith Lucero and Gordon,False,GB,Eileenshire,E-commerce,2015,https://smithluceroandgordon.com,Choice hard free future memory.,16,smith-lucero-and-gordon,2023,USD,2449666,947010,1502656,667298,835358,0,835358,24496,48993,786365,71273,1454287,762260,692027,,2449666,689.04,797.1,0.116,10206,20.0,46207.04,1.54,0.6134
5816,Wilson Baird and Ryan,False,ZA,Ashleyberg,IoT,2015,https://wilsonbairdandryan.com,Operation believe article between short whole table out participant social.,17,wilson-baird-and-ryan,2023,USD,434872,137057,297815,247901,49914,0,49914,4348,8697,41217,15056,292443,113896,178547,,434872,457.94,912.75,0.0815,1811,20.0,20354.91,0.74,0.6848
5817,Matthews Ltd,False,DE,Michaelmouth,Mobility,2023,https://matthewsltd.com,Federal specific allow factor seek oil story table day system.,17,matthews-ltd,2023,EUR,557858,229229,328629,46734,281895,9568,272327,5578,11157,261170,293701,688513,398770,289743,,557858,1877.18,938.59,0.0996,2324,20.0,17593.42,16.69,0.5891
5818,Reyes PLC,False,US,New Gregorymouth,E-commerce,2024,https://reyesplc.com,Show movie hard significant ready form.,16,reyes-plc,2023,USD,1989734,731961,1257773,475378,782395,0,782395,19897,39794,742601,56922,1104647,188336,916311,,1989734,624.9,1632.26,0.001,1506,110.06,22182.48,2.57,0.6321
5819,Richardson-Lowe,False,FR,Bradyton,Energy,2012,https://richardson-lowe.com,Really prevent design sing here paper.,17,richardson-lowe,2023,EUR,1619936,515796,1104140,960725,143415,17990,125425,16199,32398,93027,26362,920912,226658,694254,,1619936,20.0,50.79,0.0913,1276,105.75,95615.6,0.28,0.6816
5820,Williams Smith and Camacho,False,KE,South Angelastad,E-commerce,2010,https://williamssmithandcamacho.com,Prove finally vote girl thousand trade bank up woman product.,16,williams-smith-and-camacho,2023,USD,598772,269850,328922,242804,86118,18968,67150,5987,11975,55175,41912,510824,153726,357098,,598772,958.62,2946.38,0.1226,343,145.13,49295.92,0.85,0.5493
5821,Curry Harris and Elliott,False,NG,Lake Jeremy,Mobility,2022,https://curryharrisandelliott.com,I pay perhaps manage realize feel cost research trip.,25,curry-harris-and-elliott,2023,USD,386372,133383,252989,43946,209043,4717,204326,3863,7727,196599,12655,276533,96387,180146,,386372,288.36,696.22,0.1062,352,91.31,12796.55,0.99,0.6548
5822,Carroll LLC,False,KE,New Brian,Cybersecurity,2016,https://carrollllc.com,Individual parent half partner recently.,27,carroll-llc,2023,USD,445258,173200,272058,235124,36934,0,36934,4452,8905,28029,56758,347099,152816,194283,,445258,1136.69,3020.04,0.001,1855,20.0,27051.96,2.1,0.611
5823,Snyder Fuentes and Walls,False,FR,Marioville,Mobility,2020,https://snyderfuentesandwalls.com,Man house blue health win girl exist draw from concern.,20,snyder-fuentes-and-walls,2023,EUR,226878,104531,122347,191452,-69105,0,-69105,2268,4537,-73642,5119,222685,79518,143167,,226878,20.0,10.0,0.067,55,342.27,18845.69,0.27,0.5393
5824,Barrera Inc,False,AU,West Natalie,EdTech,2016,https://barrerainc.com,Area exactly design may draw message.,11,barrera-inc,2023,USD,174948,94545,80403,108380,-27977,36779,-64756,1749,3498,-68254,15337,235301,72800,162501,14579.0,174948,476.7,2463.92,0.0313,880,16.55,1000.0,15.34,0.4596
5825,Tran Group,False,ZA,West Jesse,HealthTech,2019,https://trangroup.com,Eight black dog key available name guess make gas himself.,16,tran-group,2023,USD,3745739,1405247,2340492,702046,1638446,46324,1592122,37457,74914,1517208,148714,2166222,1060477,1105745,312144.92,3745739,343.05,1688.17,0.0529,10657,29.29,85092.57,1.75,0.6248
5826,Abbott PLC,False,AU,Thomasview,SaaS,2023,https://abbottplc.com,Decision size increase large or week.,16,abbott-plc,2023,USD,1701594,572199,1129395,455081,674314,0,674314,17015,34031,640283,86403,1006279,335566,670713,141799.5,1701594,323.24,1682.77,0.0084,2118,66.93,41481.17,2.08,0.6637
5827,Cook Ltd,False,DE,Kanefort,EdTech,2008,https://cookltd.com,Religious travel officer once north move also.,14,cook-ltd,2023,EUR,102623,39579,63044,5131,57913,0,57913,1026,2052,55861,19867,213092,67510,145582,8551.92,102623,10.0,30.83,0.001,91,93.51,1000.0,19.87,0.6143
5828,Mcdonald Inc,False,CA,Kimberlybury,E-commerce,2023,https://mcdonaldinc.com,Hand nothing system perhaps treatment.,25,mcdonald-inc,2023,USD,1178823,455454,723369,58941,664428,7031,657397,11788,23576,633821,126387,781848,222523,559325,,1178823,20.0,80.67,0.001,1070,91.79,14265.24,8.86,0.6136
5829,Mason Alvarez and Adams,False,NG,New Carl,HealthTech,2016,https://masonalvarezandadams.com,Economic defense than mean second recognize animal prove board reveal.,22,mason-alvarez-and-adams,2023,USD,1192067,328929,863138,59603,803535,13260,790275,11920,23841,766434,14202,667067,348486,318581,99338.92,1192067,304.33,605.31,0.0205,1080,91.92,1000.0,14.2,0.7241
5830,Harmon-Everett,False,CA,Christopherfurt,Mobility,2018,https://harmon-everett.com,Society production east risk who major into draw author box.,23,harmon-everett,2023,USD,118156,48161,69995,31674,38321,0,38321,1181,2363,35958,15113,125297,44579,80718,,118156,609.25,304.62,0.001,60,163.41,1000.0,15.11,0.5924
5831,Hartman-Jackson,False,KE,New Johnland,AI/ML,2014,https://hartman-jackson.com,Also Mr feel speak generation mission risk need.,19,hartman-jackson,2023,USD,1813511,918647,894864,234303,660561,34517,626044,18135,36270,589774,28356,976476,301462,675014,,1813511,526.27,860.1,0.0252,7556,20.0,33011.01,0.86,0.4934
5832,Lewis-Morgan,False,AU,Kathleenmouth,Marketplaces,2014,https://lewis-morgan.com,She quickly laugh general analysis fly.,16,lewis-morgan,2023,USD,182812,82070,100742,57367,43375,30437,12938,1828,3656,9282,8331,135044,108742,26302,,182812,20.0,15.26,0.001,57,267.25,30384.7,0.27,0.5511
5833,Nielsen-Castro,False,KE,Lake Matthewborough,IoT,2011,https://nielsen-castro.com,Five many participant look find national.,14,nielsen-castro,2023,USD,1769882,686707,1083175,1768160,-684985,0,-684985,17698,35397,-720382,103936,1057317,427405,629912,,1769882,951.3,4436.76,0.001,7374,20.0,153337.2,0.68,0.612
5834,Mckenzie Washington and Long,False,IN,Vanceport,Cybersecurity,2009,https://mckenziewashingtonandlong.com,Condition always field six production partner.,14,mckenzie-washington-and-long,2023,USD,1408783,556655,852128,199943,652185,14537,637648,14087,28175,609473,19997,828383,248701,579682,,1408783,20.0,12.7,0.1586,1011,116.07,9439.16,2.12,0.6049
5835,Moran Ltd,False,ZA,Ayalaberg,EdTech,2024,https://moranltd.com,Air where within window teach lot Mrs.,20,moran-ltd,2023,USD,231631,69897,161734,27368,134366,0,134366,2316,4632,129734,49313,201890,148456,53434,19302.58,231631,10.0,12.8,0.096,132,145.54,1000.0,49.31,0.6982
5836,Nguyen Hickman and Hernandez,False,AU,Grantchester,AI/ML,2017,https://nguyenhickmanandhernandez.com,Side boy usually back it house water sure become.,18,nguyen-hickman-and-hernandez,2023,USD,1005045,190393,814652,269441,545211,0,545211,10050,20100,525111,708976,1302161,363591,938570,,1005045,20.0,82.01,0.0191,757,110.54,38913.55,18.22,0.8106
5837,Holland Hawkins and Nguyen,False,DE,North Cynthiaside,Energy,2021,https://hollandhawkinsandnguyen.com,Wrong chance pick interest affect such magazine.,19,holland-hawkins-and-nguyen,2023,EUR,371650,167929,203721,204788,-1067,0,-1067,3716,7433,-8500,9515,297841,99009,198832,,371650,20.0,57.32,0.0013,130,237.54,5345.64,1.78,0.5482
5838,Holmes-Taylor,False,ZA,Lake Thomasshire,SaaS,2017,https://holmes-taylor.com,Chance blue tree character anything marriage gas place.,22,holmes-taylor,2023,USD,1422170,324644,1097526,138667,958859,0,958859,14221,28443,930416,146986,1046649,684999,361650,118514.17,1422170,54.64,323.04,0.0727,1012,117.09,17412.67,8.44,0.7717
5839,Garcia Mccormick and Wallace,False,IN,Ortizchester,EdTech,2012,https://garciamccormickandwallace.com,Treatment also know air where region check.,15,garcia-mccormick-and-wallace,2023,USD,3023245,665455,2357790,2403915,-46125,0,-46125,30232,60464,-106589,434595,2081161,387727,1693434,251937.08,3023245,360.17,360.17,0.0538,50387,5.0,209675.75,2.07,0.7799
5840,Dickerson Wood and Calderon,False,IN,Lake Amanda,SaaS,2008,https://dickersonwoodandcalderon.com,Floor pattern bill boy light good anything figure hour apply.,22,dickerson-wood-and-calderon,2023,USD,621682,192061,429621,417773,11848,3525,8323,6216,12433,-4110,11414,489103,102569,386534,51806.83,621682,152.36,434.02,0.0164,10361,5.0,43127.49,0.26,0.6911
5841,Gardner Velasquez and Bush,False,BR,New Krystalberg,Marketplaces,2021,https://gardnervelasquezandbush.com,History often community lay usually.,19,gardner-velasquez-and-bush,2023,USD,637204,59382,577822,158372,419450,8795,410655,6372,12744,397911,37757,477766,142640,335126,,637204,1213.1,4595.61,0.001,398,133.2,18346.01,2.06,0.9068
5842,Underwood-Alexander,False,FR,South Markbury,E-commerce,2022,https://underwood-alexander.com,Successful agreement build lay movie.,26,underwood-alexander,2023,EUR,1378671,348555,1030116,571028,459088,28132,430956,13786,27573,403383,42198,886935,383931,503004,,1378671,947.91,4922.14,0.001,724,158.5,47338.61,0.89,0.7472
5843,Hood Torres and Wood,False,AU,Lake Michellefort,HealthTech,2022,https://hoodtorresandwood.com,Detail dark road member development.,21,hood-torres-and-wood,2023,USD,731058,63081,667977,589478,78499,0,78499,7310,14621,63878,57938,523241,239424,283817,60921.5,731058,201.69,657.4,0.0462,1590,38.31,25797.86,2.25,0.9137
5844,Cervantes Inc,False,BR,West Angelaview,Energy,2013,https://cervantesinc.com,Television analysis discuss as evidence need.,22,cervantes-inc,2023,USD,1255461,525113,730348,62773,667575,14863,652712,12554,25109,627603,34702,786861,39343,747518,,1255461,1609.78,7705.18,0.001,665,157.26,1000.0,34.7,0.5817
5845,White-Anderson,False,KE,Nelsonshire,Mobility,2018,https://white-anderson.com,Station force feeling bring direction model establish bring figure push.,19,white-anderson,2023,USD,627241,216715,410526,188367,222159,27468,194691,6272,12544,182147,12076,375237,79582,295655,,627241,1942.62,4966.4,0.0541,2613,20.0,3087.27,3.91,0.6545
5846,Smith Torres and Moreno,False,FR,North Cherylmouth,AgriTech,2022,https://smithtorresandmoreno.com,Discussion wife picture hospital three series wonder serious ahead.,20,smith-torres-and-moreno,2023,EUR,606565,231395,375170,226618,148552,0,148552,6065,12131,136421,21503,451742,96023,355719,,606565,778.13,3539.34,0.0767,591,85.47,44693.73,0.48,0.6185
5847,Burton Ibarra and Rubio,False,IN,Derrickland,EdTech,2022,https://burtonibarraandrubio.com,Green while vote this take now quite.,22,burton-ibarra-and-rubio,2023,USD,253269,84274,168995,103764,65231,0,65231,2532,5065,60166,15276,191948,69771,122177,21105.75,253269,198.69,801.36,0.0038,370,57.0,34815.74,0.44,0.6673
5848,Blevins Miller and Lopez,False,IN,Port Brucetown,HealthTech,2012,https://blevinsmillerandlopez.com,Could miss national true president read world measure.,21,blevins-miller-and-lopez,2023,USD,350425,133199,217226,158185,59041,0,59041,3504,7008,52033,18809,287784,133993,153791,29202.08,350425,358.46,1598.98,0.0192,290,100.52,12337.27,1.52,0.6199
5849,Alexander-Johnston,False,CA,New Phillipfurt,SaaS,2011,https://alexander-johnston.com,Education strategy country for power.,13,alexander-johnston,2023,USD,3607567,2127967,1479600,1589840,-110240,6918,-117158,36075,72151,-189309,329943,2263412,453838,1809574,300630.58,3607567,10.0,41.7,0.001,10424,28.84,126947.44,2.6,0.4101
5850,Cochran Group,False,US,North Matthewborough,E-commerce,2023,https://cochrangroup.com,Ground shake today option walk study.,25,cochran-group,2023,USD,1797423,865185,932238,144451,787787,22059,765728,17974,35948,729780,102225,1114290,460675,653615,,1797423,102.89,51.44,0.0948,410,365.32,17758.22,5.76,0.5187
5851,Flynn Mcpherson and Snyder,False,CA,North Adrian,HealthTech,2018,https://flynnmcphersonandsnyder.com,Tough more decision let each thank today when decision else control.,24,flynn-mcpherson-and-snyder,2023,USD,421976,113197,308779,247338,61441,25792,35649,4219,8439,27210,26748,250247,84011,166236,35164.67,421976,219.45,1185.63,0.0172,7032,5.0,30953.83,0.86,0.7317
5852,Wallace Meyer and Sanchez,False,ZA,Thomasborough,Energy,2008,https://wallacemeyerandsanchez.com,Language bit western foreign.,24,wallace-meyer-and-sanchez,2023,USD,1397061,535848,861213,918857,-57644,0,-57644,13970,27941,-85585,24032,916957,467997,448960,,1397061,1127.14,6593.91,0.0581,590,197.06,93935.15,0.26,0.6164
5853,Wu Chambers and Myers,False,BR,Lambertside,Energy,2018,https://wuchambersandmyers.com,Do worker crime father someone second range score Republican.,18,wu-chambers-and-myers,2023,USD,376788,141006,235782,119630,116152,2337,113815,3767,7535,106280,43167,260361,106855,153506,,376788,2717.71,10057.84,0.1154,142,220.59,27744.62,1.56,0.6258
5854,Williams-Sharp,False,TN,Diazside,HealthTech,2018,https://williams-sharp.com,Hit standard unit century key daughter career.,30,williams-sharp,2023,USD,157650,36152,121498,89659,31839,0,31839,1576,3153,28686,3268,154678,76809,77869,13137.5,157650,302.98,1644.13,0.001,225,58.33,1000.0,3.27,0.7707
5855,Williams-Perez,False,KE,South Maxwell,SaaS,2017,https://williams-perez.com,Dog up thus tax move anything want through Congress.,13,williams-perez,2023,USD,1137118,404454,732664,896736,-164072,3559,-167631,11371,22742,-190373,28385,708518,39110,669408,94759.83,1137118,1004.31,8834.99,0.0369,7040,13.46,133328.22,0.21,0.6443
5856,Bailey Ltd,False,CA,Colleenburgh,IoT,2009,https://baileyltd.com,Message less foreign bring draw.,22,bailey-ltd,2023,USD,432575,193261,239314,178688,60626,38085,22541,4325,8651,13890,11605,253501,49539,203962,,432575,20.0,39.35,0.0684,1802,20.0,45559.5,0.25,0.5532
5857,Carrillo Torres and Lewis,False,NG,Woodshire,SaaS,2012,https://carrillotorresandlewis.com,Sense determine market together society.,23,carrillo-torres-and-lewis,2023,USD,833612,299953,533659,445831,87828,0,87828,8336,16672,71156,40699,630644,484039,146605,69467.67,833612,10.0,27.7,0.0312,1103,62.96,61042.18,0.67,0.6402
5858,Gilbert Kim and Black,False,EG,West Debraborough,Fintech,2010,https://gilbertkimandblack.com,Sister every me have couple store whose these which.,26,gilbert-kim-and-black,2023,USD,1266637,620507,646130,793086,-146956,0,-146956,12666,25332,-172288,46500,755254,352271,402983,,1266637,633.61,971.44,0.042,944,111.75,62053.96,0.75,0.5101
5859,Krueger Ltd,False,GB,Jamesland,HealthTech,2011,https://kruegerltd.com,Growth meeting Republican there name event.,22,krueger-ltd,2023,USD,3229540,1099388,2130152,1165136,965016,8110,956906,32295,64590,892316,50796,1833955,1222519,611436,269128.33,3229540,806.0,3625.1,0.0067,1385,194.22,88469.83,0.57,0.6596
5860,Hull-Hopkins,False,NG,Angelburgh,HealthTech,2015,https://hull-hopkins.com,Order step protect south perhaps sense own sing article box movie.,19,hull-hopkins,2023,USD,907814,318056,589758,430612,159146,3235,155911,9078,18156,137755,6089,567784,179439,388345,75651.17,907814,10.0,44.33,0.0286,4133,18.3,1000.0,6.09,0.6496
5861,Cook Johnson and Jackson,False,FR,Sarahshire,E-commerce,2019,https://cookjohnsonandjackson.com,Return analysis choose activity office range media.,22,cook-johnson-and-jackson,2023,EUR,319723,56267,263456,64708,198748,0,198748,3197,6394,192354,92540,260596,61117,199479,,319723,1646.87,14154.42,0.0421,648,41.11,8918.59,10.38,0.824
5862,Lucero-Snyder,False,CA,New Wendyport,Fintech,2021,https://lucero-snyder.com,Imagine ever place suffer knowledge school nearly article.,20,lucero-snyder,2023,USD,1920956,819281,1101675,1797956,-696281,1496,-697777,19209,38419,-736196,156460,1260768,366414,894354,,1920956,799.59,2794.59,0.0826,2864,55.89,141943.32,1.1,0.5735
5863,Clark Johnson and Lewis,False,CA,Stoutville,Fintech,2023,https://clarkjohnsonandlewis.com,Anything child late evening child soon list time program.,13,clark-johnson-and-lewis,2023,USD,1622978,627577,995401,559972,435429,19294,416135,16229,32459,383676,26407,892885,423538,469347,,1622978,1289.91,5952.65,0.0043,2065,65.49,34505.32,0.77,0.6133
5864,Mcdonald Pace and Skinner,False,TN,Heatherland,AI/ML,2009,https://mcdonaldpaceandskinner.com,Simply college religious bed ball responsibility nation wide meet different.,26,mcdonald-pace-and-skinner,2023,USD,287534,41173,246361,191770,54591,0,54591,2875,5750,48841,2158,256358,99744,156614,,287534,461.33,2383.12,0.102,79,301.95,11336.21,0.19,0.8568
5865,Lewis LLC,False,NG,Thomaschester,Energy,2020,https://lewisllc.com,Center action almost recent start everything college.,16,lewis-llc,2023,USD,1257317,445609,811708,276952,534756,7376,527380,12573,25146,502234,31659,845111,456617,388494,,1257317,20.0,19.76,0.001,967,108.29,1000.0,31.66,0.6456
5866,Garcia Vazquez and Stanton,False,ZA,New James,HealthTech,2010,https://garciavazquezandstanton.com,Those defense little always international safe role.,17,garcia-vazquez-and-stanton,2023,USD,1179565,418191,761374,1054006,-292632,0,-292632,11795,23591,-316223,349620,1044089,566580,477509,98297.08,1179565,10.0,34.16,0.0375,1176,83.58,98890.59,3.54,0.6455
5867,Fleming PLC,False,DE,Lauratown,Mobility,2013,https://flemingplc.com,Carry standard who fine no far stock kitchen.,30,fleming-plc,2023,EUR,373348,156071,217277,173532,43745,27216,16529,3733,7466,9063,40022,385645,139437,246208,,373348,707.74,2383.3,0.0623,649,47.87,34055.7,1.18,0.582
5868,Rodriguez Johnson and Wallace,False,FR,Grantside,AgriTech,2015,https://rodriguezjohnsonandwallace.com,Two loss market build who its people by.,21,rodriguez-johnson-and-wallace,2023,EUR,453800,226007,227793,344905,-117112,32710,-149822,4538,9076,-158898,33348,323710,201212,122498,,453800,528.25,1518.19,0.0846,401,94.16,11260.2,2.96,0.502
5869,Hogan-Weaver,False,DE,Wigginsmouth,SaaS,2008,https://hogan-weaver.com,Popular top line win theory democratic.,25,hogan-weaver,2023,EUR,680190,183496,496694,48057,448637,15466,433171,6801,13603,419568,11541,357519,240636,116883,56682.5,680190,57.85,293.75,0.0268,667,84.9,32607.15,0.35,0.7302
5870,Martin-Daniels,False,US,South Katherine,Marketplaces,2015,https://martin-daniels.com,Stuff play blood whether tend push peace team.,18,martin-daniels,2023,USD,440617,123178,317439,344913,-27474,0,-27474,4406,8812,-36286,13426,251846,131375,120471,,440617,20.0,97.08,0.141,1304,28.14,70965.32,0.19,0.7204
5871,Jones and Sons,False,EG,New Nicolas,SaaS,2009,https://jonesandsons.com,Last church those exist identify.,16,jones-and-sons,2023,USD,829754,279538,550216,600793,-50577,4510,-55087,8297,16595,-71682,5205,517835,246539,271296,69146.17,829754,209.27,976.07,0.0361,1014,68.15,94118.86,0.06,0.6631
5872,Walter Ponce and Moore,False,DE,East Mark,EdTech,2012,https://walterponceandmoore.com,Heart sort start peace their crime where.,18,walter-ponce-and-moore,2023,EUR,572501,258044,314457,214122,100335,13999,86336,5725,11450,74886,32401,361410,122905,238505,47708.42,572501,368.02,2792.91,0.047,9541,5.0,7764.12,4.17,0.5493
5873,Dominguez Gray and Cunningham,False,GB,Hughesshire,AI/ML,2018,https://dominguezgrayandcunningham.com,Culture cultural consider explain begin seven per else.,20,dominguez-gray-and-cunningham,2023,USD,347184,173080,174104,137089,37015,0,37015,3471,6943,30072,10814,253407,58238,195169,,347184,20.0,10.0,0.1187,248,116.54,11389.54,0.95,0.5015
5874,Lawrence-Ellis,False,CA,Amandaport,Energy,2020,https://lawrence-ellis.com,Blood right I head hold professor shake guy international.,14,lawrence-ellis,2023,USD,5793313,2379756,3413557,671894,2741663,0,2741663,57933,115866,2625797,610181,3548055,618201,2929854,,5793313,639.22,2774.39,0.055,6812,70.87,60236.8,10.13,0.5892
5875,Krause Wright and Levine,False,US,New Latashahaven,AI/ML,2017,https://krausewrightandlevine.com,Sell nearly for appear here fall spring democratic return great.,23,krause-wright-and-levine,2023,USD,804826,363083,441743,285921,155822,3889,151933,8048,16096,135837,362111,788600,105143,683457,,804826,20.0,92.73,0.0622,505,132.76,16393.19,22.09,0.5489
5876,Maldonado-Patterson,False,EG,Erikaton,SaaS,2021,https://maldonado-patterson.com,Good tonight future yard bed send over lawyer worry rate.,27,maldonado-patterson,2023,USD,387155,126348,260807,29133,231674,1985,229689,3871,7743,221946,55270,341639,35931,305708,32262.92,387155,10.0,47.82,0.0241,417,77.21,1000.0,55.27,0.6737
5877,Garcia Rollins and Fitzgerald,False,NG,Christinechester,Fintech,2009,https://garciarollinsandfitzgerald.com,Food his bag indicate leave.,20,garcia-rollins-and-fitzgerald,2023,USD,725365,265989,459376,652864,-193488,17475,-210963,7253,14507,-225470,1999,404910,42539,362371,,725365,20.0,47.7,0.1421,761,79.34,56914.94,0.04,0.6333
5878,Navarro Mahoney and Carlson,False,DE,Gibsonbury,IoT,2009,https://navarromahoneyandcarlson.com,Fight begin enter majority world opportunity.,20,navarro-mahoney-and-carlson,2023,EUR,1010608,358426,652182,86939,565243,4203,561040,10106,20212,540828,36356,724989,254563,470426,,1010608,20.0,77.17,0.0321,2180,38.63,1000.0,36.36,0.6453
5879,Williams-Lambert,False,DE,Lake Ericton,EdTech,2023,https://williams-lambert.com,Until as laugh cause agent edge push take.,20,williams-lambert,2023,EUR,193696,61438,132258,44027,88231,0,88231,1936,3873,84358,3865,243595,89356,154239,16141.33,193696,10.0,23.98,0.0162,249,64.7,1000.0,3.86,0.6828
5880,Dean Johnson and Lewis,False,US,South James,E-commerce,2010,https://deanjohnsonandlewis.com,Eat for involve analysis popular help generation radio.,20,dean-johnson-and-lewis,2023,USD,2318822,1019431,1299391,761418,537973,17090,520883,23188,46376,474507,239759,1465717,999470,466247,,2318822,20.0,79.91,0.0722,1151,167.78,71522.11,3.35,0.5604
5881,Campbell-Knapp,False,KE,North Kristinville,E-commerce,2024,https://campbell-knapp.com,Any well mother by bit blood local event production.,17,campbell-knapp,2023,USD,281612,58452,223160,78543,144617,0,144617,2816,5632,138985,19227,236579,52539,184040,,281612,889.05,1110.22,0.0313,140,167.13,13812.33,1.39,0.7924
5882,Chapman Hamilton and Foster,False,GB,Donaldmouth,Energy,2014,https://chapmanhamiltonandfoster.com,Again smile audience pay price cold name national.,24,chapman-hamilton-and-foster,2023,USD,312715,155427,157288,308846,-151558,0,-151558,3127,6254,-157812,3713,337179,187854,149325,,312715,124.75,128.62,0.1346,1302,20.0,15103.97,0.25,0.503
5883,Sanchez Ltd,False,GB,Port Willie,AI/ML,2008,https://sanchezltd.com,Economic character might oil age house field suggest.,20,sanchez-ltd,2023,USD,577239,257371,319868,254091,65777,33201,32576,5772,11544,21032,23242,315109,81819,233290,,577239,1063.04,6283.15,0.0813,292,164.73,37509.75,0.62,0.5541
5884,Holland LLC,False,BR,North Mark,Cybersecurity,2017,https://hollandllc.com,Even data assume third thank soldier against.,19,holland-llc,2023,USD,2381455,1388248,993207,1166468,-173261,0,-173261,23814,47629,-220890,150264,1368599,467459,901140,,2381455,101.57,360.3,0.0079,9922,20.0,91522.44,1.64,0.4171
5885,Sharp-Byrd,False,IN,Payneshire,AI/ML,2019,https://sharp-byrd.com,Situation evidence serve list watch perhaps enter day away.,24,sharp-byrd,2023,USD,2123353,1221194,902159,643095,259064,16119,242945,21233,42467,200478,141620,1222265,692844,529421,,2123353,630.82,2037.39,0.192,3848,45.98,49320.06,2.87,0.4249
5886,Flowers Fisher and Berger,False,NG,New Ian,Energy,2013,https://flowersfisherandberger.com,Deep piece wide eat subject story threat visit worry.,21,flowers-fisher-and-berger,2023,USD,1782728,553760,1228968,1029116,199852,12158,187694,17827,35654,152040,187909,1268614,258898,1009716,,1782728,1550.35,6456.17,0.1584,7428,20.0,123410.85,1.52,0.6894
5887,Campbell LLC,False,DE,Olsonside,IoT,2016,https://campbellllc.com,Worker practice organization police report option either.,27,campbell-llc,2023,EUR,566591,114349,452242,488430,-36188,15495,-51683,5665,11331,-63014,72452,519687,59296,460391,,566591,395.12,2040.92,0.0161,1890,24.98,36766.49,1.97,0.7982
5888,Robinson Reed and Flynn,False,CA,South Nicole,EdTech,2018,https://robinsonreedandflynn.com,Hear course away hour summer argue total with success.,15,robinson-reed-and-flynn,2023,USD,262348,76401,185947,138132,47815,44794,3021,2623,5246,-2225,16876,250483,62981,187502,21862.33,262348,365.99,3462.43,0.0298,635,34.41,6781.01,2.49,0.7088
5889,Roberts Graham and Orozco,False,IN,Lake Danielmouth,Energy,2011,https://robertsgrahamandorozco.com,Become character argue site member choice voice suddenly somebody.,22,roberts-graham-and-orozco,2023,USD,1059011,292130,766881,420971,345910,41451,304459,10590,21180,283279,30207,669886,231088,438798,,1059011,675.41,4759.39,0.0592,4412,20.0,26536.11,1.14,0.7241
5890,Lewis and Sons,False,BR,East Jenniferberg,AgriTech,2022,https://lewisandsons.com,Lose close impact computer first most brother those.,13,lewis-and-sons,2023,USD,102422,20369,82053,11822,70231,0,70231,1024,2048,68183,7661,148756,68125,80631,,102422,783.01,2485.83,0.0108,90,94.28,17073.19,0.45,0.8011
5891,Baldwin PLC,False,US,North Monica,Mobility,2024,https://baldwinplc.com,Benefit outside movie gun talk.,24,baldwin-plc,2023,USD,1600638,309582,1291056,998634,292422,20890,271532,16006,32012,239520,120279,1077416,668584,408832,,1600638,304.15,152.07,0.0988,786,169.62,105847.01,1.14,0.8066
5892,Poole-Fitzgerald,False,AU,Josephland,Energy,2014,https://poole-fitzgerald.com,Up face natural item thus reach.,14,poole-fitzgerald,2023,USD,1189739,330995,858744,142263,716481,10380,706101,11897,23794,682307,39890,771406,156083,615323,,1189739,20.0,98.91,0.0084,555,178.43,1000.0,39.89,0.7218
5893,Morgan Group,False,GB,North Joseph,Fintech,2009,https://morgangroup.com,Left prove film mention or right responsibility speech idea.,24,morgan-group,2023,USD,1136880,368598,768282,759414,8868,13188,-4320,11368,22737,-27057,31677,685019,234137,450882,,1136880,1234.72,1450.75,0.015,4737,20.0,76597.13,0.41,0.6758
5894,Nichols-Anderson,False,TN,North Davidshire,Fintech,2014,https://nichols-anderson.com,Area long goal major total while.,19,nichols-anderson,2023,USD,353858,93887,259971,17692,242279,2809,239470,3538,7077,232393,28646,314662,188163,126499,,353858,991.98,3357.77,0.0527,1474,20.0,17935.45,1.6,0.7347
5895,Harrison Lee and Lewis,False,DE,Robertmouth,IoT,2017,https://harrisonleeandlewis.com,Stuff onto hope business change year.,14,harrison-lee-and-lewis,2023,EUR,7952380,1870593,6081787,6261011,-179224,0,-179224,79523,159047,-338271,4526208,8506103,932851,7573252,,7952380,20.0,74.1,0.1181,2760,240.1,533527.85,8.48,0.7648
5896,Watts Green and Lopez,False,ZA,Haynesbury,Marketplaces,2014,https://wattsgreenandlopez.com,May energy room whatever only seat any.,16,watts-green-and-lopez,2023,USD,151886,52477,99409,100007,-598,38619,-39217,1518,3037,-42254,8732,227724,68878,158846,,151886,398.27,888.18,0.0553,79,158.39,15180.66,0.58,0.6545
5897,White Durham and Hanson,False,KE,Allenborough,AgriTech,2019,https://whitedurhamandhanson.com,Plant research parent question arrive night realize money take generation.,21,white-durham-and-hanson,2023,USD,205627,47555,158072,66645,91427,0,91427,2056,4112,87315,9075,269956,61134,208822,,205627,20.0,88.66,0.064,116,147.59,12114.07,0.75,0.7687
5898,Castro-Howell,False,EG,Lake Jamiemouth,SaaS,2015,https://castro-howell.com,Huge idea gas challenge mind least game.,29,castro-howell,2023,USD,31374,3521,27853,20010,7843,42794,-34951,313,627,-35578,4094,169148,66767,102381,2614.5,31374,10.0,26.67,0.0522,29,89.99,15343.52,0.27,0.8878
5899,Higgins PLC,False,KE,Hoffmanchester,AgriTech,2014,https://higginsplc.com,At will together fund purpose.,20,higgins-plc,2023,USD,331991,67885,264106,256145,7961,3275,4686,3319,6639,-1953,2991,227938,156674,71264,,331991,1276.48,1525.99,0.0974,93,295.44,7424.83,0.4,0.7955
5900,Fox Oliver and Rodgers,False,NG,Curryshire,SaaS,2017,https://foxoliverandrodgers.com,Summer simple exist might off particular teach wind cultural candidate.,16,fox-oliver-and-rodgers,2023,USD,225066,78404,146662,209904,-63242,6574,-69816,2250,4501,-74317,17851,290973,70597,220376,18755.5,225066,188.62,634.74,0.0587,732,25.61,4723.71,3.78,0.6516
5901,Ford-Estes,False,US,Port Markstad,EdTech,2013,https://ford-estes.com,Yeah name create energy near.,28,ford-estes,2023,USD,145363,51513,93850,31315,62535,13877,48658,1453,2907,45751,845,96164,58518,37646,12113.58,145363,147.91,785.02,0.0423,2422,5.0,31854.24,0.03,0.6456
5902,Clark and Sons,False,CA,Marcusport,EdTech,2023,https://clarkandsons.com,Lot story mother out according cold while.,19,clark-and-sons,2023,USD,150315,48810,101505,82354,19151,0,19151,1503,3006,16145,5239,99317,53364,45953,12526.25,150315,268.08,1417.6,0.0388,101,123.97,5410.02,0.97,0.6753
5903,Boyd-Hebert,False,ZA,East Ebonyville,Energy,2018,https://boyd-hebert.com,First tend four stage own turn turn sit successful have.,18,boyd-hebert,2023,USD,371357,147190,224167,222150,2017,0,2017,3713,7427,-5410,9791,239020,79782,159238,,371357,1673.99,10067.37,0.001,654,47.27,8236.45,1.19,0.6036
5904,Weaver Newton and Wall,False,EG,Margaretstad,Energy,2013,https://weavernewtonandwall.com,Five hour defense system accept traditional.,22,weaver-newton-and-wall,2023,USD,1020127,315093,705034,654538,50496,0,50496,10201,20402,30094,52638,718189,519154,199035,,1020127,1137.02,2606.06,0.0607,567,149.79,30508.8,1.73,0.6911
5905,Young PLC,False,EG,North Kayleemouth,Mobility,2017,https://youngplc.com,Tough community present answer stand become development.,13,young-plc,2023,USD,562081,136100,425981,294603,131378,39139,92239,5620,11241,80998,69363,538256,383426,154830,,562081,814.98,2355.99,0.0725,1078,43.43,16839.5,4.12,0.7579
5906,Fox Group,False,AU,New Jasmine,Marketplaces,2015,https://foxgroup.com,Rate field present example later him single woman if situation hit.,15,fox-group,2023,USD,666958,243293,423665,409279,14386,0,14386,6669,13339,1047,24338,447530,242528,205002,,666958,305.97,908.48,0.001,400,138.76,40035.35,0.61,0.6352
5907,Jimenez and Sons,False,FR,Walkerland,IoT,2011,https://jimenezandsons.com,Hundred dinner friend hair shoulder site activity today place matter.,21,jimenez-and-sons,2023,EUR,282101,128100,154001,169653,-15652,22734,-38386,2821,5642,-44028,16731,262142,123930,138212,,282101,2308.98,11802.39,0.0401,65,359.41,27661.54,0.6,0.5459
5908,Collins-Ramos,False,US,New Sandra,SaaS,2009,https://collins-ramos.com,Order upon note body make interview bank friend maybe light bar.,30,collins-ramos,2023,USD,849878,289429,560449,293802,266647,0,266647,8498,16997,249650,3595,523693,130859,392834,70823.17,849878,266.97,801.8,0.0413,1635,43.31,42380.18,0.08,0.6594
5909,Chambers-Keller,False,US,Lake John,AgriTech,2008,https://chambers-keller.com,Care within college Republican cultural consider alone picture.,22,chambers-keller,2023,USD,343346,94122,249224,262203,-12979,3754,-16733,3433,6866,-23599,24728,321842,16092,305750,,343346,869.72,3266.29,0.1566,155,184.4,38832.73,0.64,0.7259
5910,Lopez Group,False,IN,Catherinebury,Mobility,2020,https://lopezgroup.com,Bad over way scene significant benefit behavior mention sell single.,27,lopez-group,2023,USD,355297,137388,217909,92068,125841,0,125841,3552,7105,118736,5270,354120,173306,180814,,355297,566.39,2842.43,0.05,196,150.71,3345.31,1.58,0.6133
5911,Simpson Gates and Green,False,ZA,Phillipfort,IoT,2013,https://simpsongatesandgreen.com,Piece record simple power clearly huge story walk wait.,13,simpson-gates-and-green,2023,USD,1304358,467582,836776,820369,16407,1453,14954,13043,26087,-11133,107416,773254,373490,399764,,1304358,542.58,1066.42,0.0581,800,135.77,90759.07,1.18,0.6415
5912,Patel and Sons,False,FR,Careyhaven,SaaS,2019,https://patelandsons.com,Speak fish charge my old.,24,patel-and-sons,2023,EUR,4147543,1770995,2376548,1480298,896250,23244,873006,41475,82950,790056,58520,2246971,1255298,991673,345628.58,4147543,408.67,608.21,0.0207,3224,107.19,143971.89,0.41,0.573
5913,Butler Stark and Kelley,False,DE,Beckyland,Marketplaces,2014,https://butlerstarkandkelley.com,Nature white low station power bring us painting use reveal.,17,butler-stark-and-kelley,2023,EUR,2523791,1060971,1462820,1193761,269059,12686,256373,25237,50475,205898,259460,1706805,567928,1138877,,2523791,220.98,610.25,0.0727,4282,49.11,82360.59,3.15,0.5796
5914,Smith-Hayes,False,TN,Jeffreyview,Cybersecurity,2019,https://smith-hayes.com,Physical medical teach beat too letter role new not.,25,smith-hayes,2023,USD,841573,384137,457436,266102,191334,14022,177312,8415,16831,160481,88738,631917,31595,600322,,841573,1448.22,1932.03,0.001,466,150.35,30638.91,2.9,0.5435
5915,Cox-Smith,False,FR,Davidsonport,AgriTech,2021,https://cox-smith.com,Civil card environmental fight share mission total oil have relate close.,22,cox-smith,2023,EUR,186176,60818,125358,108048,17310,0,17310,1861,3723,13587,10615,248891,142835,106056,,186176,102.62,400.32,0.1045,186,83.06,1000.0,10.62,0.6733
5916,Ray Lynn and Mitchell,False,BR,Lake Brett,SaaS,2017,https://raylynnandmitchell.com,Activity check PM mother represent factor computer outside bed return.,28,ray-lynn-and-mitchell,2023,USD,1711310,604364,1106946,1459643,-352697,32394,-385091,17113,34226,-419317,317575,1185921,460474,725447,142609.17,1711310,10.0,36.62,0.0677,893,159.62,150457.77,2.11,0.6468
5917,Lin-Johnson,False,AU,Taylorview,SaaS,2011,https://lin-johnson.com,Body wish set throw could writer million.,21,lin-johnson,2023,USD,770453,94429,676024,180294,495730,19621,476109,7704,15409,460700,20871,600636,332701,267935,64204.42,770453,484.22,1767.18,0.001,998,64.33,1000.0,20.87,0.8774
5918,Harding Mccormick and Flores,False,IN,North Mark,HealthTech,2016,https://hardingmccormickandflores.com,Particularly open maintain morning first way major cold six.,18,harding-mccormick-and-flores,2023,USD,1858940,981596,877344,495806,381538,0,381538,18589,37178,344360,146600,1205905,337869,868036,154911.67,1858940,183.35,995.52,0.0349,3137,49.37,50221.97,2.92,0.472
5919,Mejia PLC,False,EG,Butlertown,EdTech,2011,https://mejiaplc.com,Sense house international job agency.,23,mejia-plc,2023,USD,308295,120084,188211,147538,40673,14020,26653,3082,6165,20488,51203,354904,64530,290374,25691.25,308295,10.0,39.03,0.0052,235,109.06,17467.73,2.93,0.6105
5920,Phillips-Ortega,False,BR,Port Jennifer,Cybersecurity,2008,https://phillips-ortega.com,Bag top fact front.,20,phillips-ortega,2023,USD,4159601,1472044,2687557,2265109,422448,0,422448,41596,83192,339256,189694,2300530,697626,1602904,,4159601,2243.77,3453.81,0.001,17331,20.0,212650.2,0.89,0.6461
5921,Jones-Williams,False,EG,Kimberlyville,HealthTech,2008,https://jones-williams.com,Maintain forget vote middle help power down head thus.,18,jones-williams,2023,USD,945584,297397,648187,372927,275260,17045,258215,9455,18911,239304,41255,532443,95327,437116,78798.67,945584,104.38,565.35,0.0366,3617,21.78,21893.81,1.88,0.6855
5922,Mason Cameron and Gray,False,FR,South Cheyenne,Fintech,2015,https://masoncameronandgray.com,Be then tonight drive clearly hold side health just its.,18,mason-cameron-and-gray,2023,EUR,1432110,622274,809836,189228,620608,0,620608,14321,28642,591966,85669,979388,108001,871387,,1432110,498.56,1709.39,0.0296,1623,73.5,50088.77,1.71,0.5655
5923,Walter Inc,False,EG,Lake Connieville,IoT,2016,https://walterinc.com,Security network parent money thousand eat responsibility care.,22,walter-inc,2023,USD,462482,175913,286569,151332,135237,961,134276,4624,9249,125027,82690,499882,89143,410739,,462482,925.27,3047.82,0.0312,137,280.97,1000.0,82.69,0.6196
5924,Coleman PLC,False,IN,Amandaview,SaaS,2023,https://colemanplc.com,Back well management focus social Democrat unit lot behind fact.,27,coleman-plc,2023,USD,757188,249441,507747,345867,161880,32601,129279,7571,15143,114136,40191,575654,97801,477853,63099.0,757188,10.0,48.62,0.0496,700,90.02,17720.01,2.27,0.6706
5925,Williams-Johnson,False,FR,Willieburgh,Cybersecurity,2012,https://williams-johnson.com,Father show pick several water lot discussion.,13,williams-johnson,2023,EUR,746562,289360,457202,503359,-46157,38058,-84215,7465,14931,-99146,94566,502232,284872,217360,,746562,939.63,2667.7,0.066,612,101.51,92036.03,1.03,0.6124
5926,Ochoa Inc,False,DE,West Melissashire,Fintech,2020,https://ochoainc.com,Serve base financial the serious wife tend act.,21,ochoa-inc,2023,EUR,2490112,776956,1713156,1023775,689381,10462,678919,24901,49802,629117,31719,1343629,94431,1249198,,2490112,20.0,76.79,0.1084,10375,20.0,89297.98,0.36,0.688
5927,Mckee Baker and Pacheco,False,BR,South Mary,Energy,2008,https://mckeebakerandpacheco.com,Exist end together central chance.,23,mckee-baker-and-pacheco,2023,USD,2386280,437066,1949214,1028399,920815,0,920815,23862,47725,873090,20655,1259913,724915,534998,,2386280,226.35,435.81,0.001,1474,134.82,112763.17,0.18,0.8168
5928,Hill Lopez and Conrad,False,US,West Johnport,Mobility,2021,https://hilllopezandconrad.com,Among station find over finish.,21,hill-lopez-and-conrad,2023,USD,2515935,1174364,1341571,1376232,-34661,0,-34661,25159,50318,-84979,252495,1621883,771029,850854,,2515935,1620.51,6634.14,0.1406,5564,37.68,106928.59,2.36,0.5332
5929,Foster Norris and Jenkins,False,EG,Hayleyborough,Energy,2013,https://fosternorrisandjenkins.com,Thing development relationship ability improve dream.,18,foster-norris-and-jenkins,2023,USD,2872805,965586,1907219,1378313,528906,19586,509320,28728,57456,451864,302065,1915934,991889,924045,,2872805,529.56,264.78,0.001,3591,66.65,138060.71,2.19,0.6639
5930,Phillips-Hammond,False,US,New Kathleenburgh,IoT,2009,https://phillips-hammond.com,Meet candidate also size do across.,22,phillips-hammond,2023,USD,621757,234932,386825,500126,-113301,29558,-142859,6217,12435,-155294,15432,438093,84233,353860,,621757,1158.68,579.34,0.0414,2590,20.0,77224.74,0.2,0.6221
5931,Hughes and Sons,False,BR,North Sherri,Fintech,2016,https://hughesandsons.com,Tree toward my wall majority.,16,hughes-and-sons,2023,USD,1894332,737358,1156974,94716,1062258,6052,1056206,18943,37886,1018320,307671,1288094,811477,476617,,1894332,763.19,381.6,0.0323,1466,107.63,1000.0,307.67,0.6108
5932,Figueroa-Ford,False,ZA,Lake Cynthia,AgriTech,2023,https://figueroa-ford.com,Public certainly item scientist public people need drug style.,19,figueroa-ford,2023,USD,224764,86776,137988,64371,73617,47428,26189,2247,4495,21694,8623,299537,90776,208761,,224764,20.0,74.22,0.0752,86,215.4,14378.1,0.6,0.6139
5933,Navarro Howell and Martinez,False,DE,Housemouth,AgriTech,2008,https://navarrohowellandmartinez.com,If investment hard daughter learn civil five spring enough.,21,navarro-howell-and-martinez,2023,EUR,278280,143211,135069,140244,-5175,6100,-11275,2782,5565,-16840,35030,301459,79658,221801,,278280,20.0,16.04,0.0623,246,93.93,1000.0,35.03,0.4854
5934,Flowers LLC,False,BR,New Nicholas,AgriTech,2014,https://flowersllc.com,Total money important six member offer accept baby.,17,flowers-llc,2023,USD,39981,19615,20366,2066,18300,0,18300,399,799,17501,5297,107887,89406,18481,,39981,20.0,83.25,0.1074,166,20.0,5761.32,0.92,0.5094
5935,Miller-Stafford,False,DE,Kimberlychester,Cybersecurity,2022,https://miller-stafford.com,Least west myself why reflect fast high might protect time.,23,miller-stafford,2023,EUR,1092401,382523,709878,745510,-35632,35113,-70745,10924,21848,-92593,69415,651960,290549,361411,,1092401,20.0,104.73,0.0818,4551,20.0,62112.2,1.12,0.6498
5936,Monroe Mitchell and Chandler,False,AU,Lake Patrickfort,SaaS,2009,https://monroemitchellandchandler.com,Food air decade should with until partner morning.,23,monroe-mitchell-and-chandler,2023,USD,1029481,420599,608882,296095,312787,0,312787,10294,20589,292198,57934,673455,317508,355947,85790.08,1029481,10.0,52.41,0.0769,1492,57.47,31826.23,1.82,0.5914
5937,Palmer Montgomery and Gray,False,KE,Williamsonfort,Energy,2023,https://palmermontgomeryandgray.com,Section human wonder morning property world should.,22,palmer-montgomery-and-gray,2023,USD,2993804,661530,2332274,975554,1356720,5599,1351121,29938,59876,1291245,108744,1665618,643298,1022320,,2993804,81.91,278.46,0.0013,1477,168.87,89421.43,1.22,0.779
5938,Willis Group,False,AU,East James,EdTech,2009,https://willisgroup.com,Candidate which between product throughout training drop.,22,willis-group,2023,USD,344281,172744,171537,17214,154323,12403,141920,3442,6885,135035,90268,383914,74117,309797,28690.08,344281,320.37,1878.79,0.0757,507,56.52,6863.93,13.15,0.4982
5939,Stephenson-Hill,False,IN,Josephport,E-commerce,2010,https://stephenson-hill.com,Such though serious suddenly.,19,stephenson-hill,2023,USD,185582,57760,127822,123565,4257,0,4257,1855,3711,546,10228,269453,22209,247244,,185582,213.19,762.04,0.001,365,42.27,1000.0,10.23,0.6888
5940,Martinez Thompson and Willis,False,KE,Calhounmouth,E-commerce,2022,https://martinezthompsonandwillis.com,Since good better deep course goal analysis old skin true.,21,martinez-thompson-and-willis,2023,USD,629394,240411,388983,437893,-48910,21122,-70032,6293,12587,-82619,13599,415163,194115,221048,,629394,728.36,1566.46,0.0221,1317,39.81,18709.6,0.73,0.618
5941,Lewis LLC,False,EG,Mcmillanstad,AI/ML,2013,https://lewisllc.com,Listen over low raise responsibility hit collection story sister.,25,lewis-llc,2023,USD,1287152,394957,892195,827415,64780,49618,15162,12871,25743,-10581,209450,902373,285326,617047,,1287152,20.0,17.9,0.0196,5363,20.0,112961.26,1.85,0.6932
5942,Rodriguez-Barton,False,CA,West Jessica,Marketplaces,2019,https://rodriguez-barton.com,Account soon important along stop.,21,rodriguez-barton,2023,USD,317612,120398,197214,318904,-121690,4184,-125874,3176,6352,-132226,1612,333271,84753,248518,,317612,20.0,18.84,0.0556,1323,20.0,17626.92,0.09,0.6209
5943,Hunt Inc,False,ZA,South Richard,AI/ML,2012,https://huntinc.com,Along history international according college always.,14,hunt-inc,2023,USD,1046377,204853,841524,570681,270843,36978,233865,10463,20927,212938,68736,709797,397652,312145,,1046377,20.0,10.0,0.0843,412,211.22,42318.63,1.62,0.8042
5944,Haynes LLC,False,CA,Danielhaven,Cybersecurity,2019,https://haynesllc.com,Yard sell early land determine arm bad all anything discuss.,18,haynes-llc,2023,USD,568147,141391,426756,418079,8677,0,8677,5681,11362,-2685,40168,442305,62155,380150,,568147,20.0,46.86,0.0607,466,101.42,1000.0,40.17,0.7511
5945,Mcneil Cook and Wells,False,TN,Williamsville,HealthTech,2020,https://mcneilcookandwells.com,Stuff foreign good often trial develop.,29,mcneil-cook-and-wells,2023,USD,524756,114368,410388,186733,223655,0,223655,5247,10495,213160,179847,505579,164734,340845,43729.67,524756,195.57,885.45,0.0026,828,52.76,18272.75,9.84,0.7821
5946,Anderson Brewer and Fisher,False,CA,Bradside,Mobility,2019,https://andersonbrewerandfisher.com,Building play rest apply personal.,15,anderson-brewer-and-fisher,2023,USD,1605303,547031,1058272,621757,436515,30625,405890,16053,32106,373784,113900,987356,149997,837359,,1605303,1610.17,805.08,0.0906,939,142.43,26727.98,4.26,0.6592
5947,Butler-Leblanc,False,AU,Carolton,AgriTech,2012,https://butler-leblanc.com,For southern sign ever budget piece government.,27,butler-leblanc,2023,USD,432290,139326,292964,149075,143889,6677,137212,4322,8645,128567,37021,344962,199915,145047,,432290,736.24,2770.68,0.0745,121,297.4,1000.0,37.02,0.6777
5948,Smith LLC,False,BR,Jenniferville,Mobility,2021,https://smithllc.com,Meet sea finally sport form whom right return.,15,smith-llc,2023,USD,474063,181198,292865,373821,-80956,0,-80956,4740,9481,-90437,11141,249295,34283,215012,,474063,20.0,51.51,0.0136,126,311.78,13875.82,0.8,0.6178
5949,Harvey-Hoover,False,CA,Josephbury,Energy,2010,https://harvey-hoover.com,Change mention wear back rise.,16,harvey-hoover,2023,USD,2172231,974804,1197427,338379,859048,6050,852998,21722,43444,809554,96949,1218062,316164,901898,,2172231,1714.08,1392.34,0.0992,1230,147.08,19791.89,4.9,0.5512
5950,Cook-Kim,False,KE,Calebtown,AgriTech,2012,https://cook-kim.com,Energy environmental cup fine policy leg use sense.,15,cook-kim,2023,USD,339545,132587,206958,161388,45570,213,45357,3395,6790,38567,15150,248709,124609,124100,,339545,1194.27,2072.94,0.11,362,78.16,13119.53,1.15,0.6095
5951,Beasley LLC,False,CA,Carlosburgh,E-commerce,2022,https://beasleyllc.com,Exist into watch little suffer.,21,beasley-llc,2023,USD,253076,89185,163891,52255,111636,0,111636,2530,5061,106575,1732,132193,67939,64254,,253076,20.0,48.05,0.001,1054,20.0,1000.0,1.73,0.6476
5952,Koch Ltd,False,EG,Jamesbury,AI/ML,2013,https://kochltd.com,Table stop kid natural term kind term able fear heart enough.,29,koch-ltd,2023,USD,538535,81946,456589,291136,165453,0,165453,5385,10770,154683,31211,487543,158882,328661,,538535,1966.28,6283.36,0.0817,2243,20.0,34565.12,0.9,0.8478
5953,Pearson-Lewis,False,US,Port Vincent,E-commerce,2024,https://pearson-lewis.com,Look call interview two manager see no road us.,21,pearson-lewis,2023,USD,628609,223577,405032,90117,314915,2004,312911,6286,12572,300339,188988,563841,280252,283589,,628609,335.62,1114.66,0.0578,164,318.99,1000.0,188.99,0.6443
5954,Harris Alvarez and Phillips,False,BR,Crystalfort,HealthTech,2018,https://harrisalvarezandphillips.com,Skill gun woman system choose.,19,harris-alvarez-and-phillips,2023,USD,991827,228629,763198,703429,59769,10533,49236,9918,19836,29400,7938,643552,423068,220484,82652.25,991827,666.55,3997.6,0.0328,16530,5.0,26974.84,0.29,0.7695
5955,Lee Rodriguez and Meyer,False,NG,Ianton,Marketplaces,2013,https://leerodriguezandmeyer.com,National prevent during expect accept dark.,12,lee-rodriguez-and-meyer,2023,USD,1766289,733901,1032388,1228633,-196245,22053,-218298,17662,35325,-253623,51349,1100225,642216,458009,,1766289,20.0,23.38,0.0704,704,208.88,98557.26,0.52,0.5845
5956,Webb LLC,False,AU,Moorestad,IoT,2012,https://webbllc.com,Campaign structure family our certain learn.,18,webb-llc,2023,USD,198321,43503,154818,47319,107499,7913,99586,1983,3966,95620,11922,172808,46837,125971,,198321,791.02,1364.13,0.0468,826,20.0,1000.0,11.92,0.7806
5957,Rivera Hernandez and Barker,False,AU,South Erica,EdTech,2020,https://riverahernandezandbarker.com,Machine order success method black.,21,rivera-hernandez-and-barker,2023,USD,228352,87879,140473,155860,-15387,7633,-23020,2283,4567,-27587,14734,225255,24606,200649,19029.33,228352,282.62,327.06,0.001,344,55.26,19478.27,0.76,0.6152
5958,Robinson Miranda and Kim,False,FR,Lake Maryport,Energy,2011,https://robinsonmirandaandkim.com,Set interview cultural account.,22,robinson-miranda-and-kim,2023,EUR,1069653,382217,687436,484424,203012,0,203012,10696,21393,181619,9708,652398,289663,362735,,1069653,420.37,937.75,0.0291,4456,20.0,47452.5,0.2,0.6427
5959,Ruiz Inc,False,NG,Lauramouth,AI/ML,2009,https://ruizinc.com,Recently everybody no ground great yourself plan miss.,31,ruiz-inc,2023,USD,1645476,82273,1563203,1410187,153016,0,153016,16454,32909,120107,117194,965725,511851,453874,,1645476,1878.72,3904.25,0.0048,1884,72.75,124188.72,0.94,0.95
5960,Mcbride Ltd,False,NG,North Christina,Fintech,2008,https://mcbrideltd.com,Mention I guy control behavior drop whose.,20,mcbride-ltd,2023,USD,2407084,373128,2033956,120354,1913602,0,1913602,24070,48141,1865461,41585,1247500,517793,729707,,2407084,20.0,37.18,0.0612,10029,20.0,17258.6,2.41,0.845
5961,Le Thompson and Hunter,False,IN,Andrewside,AI/ML,2013,https://lethompsonandhunter.com,Piece across exactly especially threat never president black.,16,le-thompson-and-hunter,2023,USD,153366,30788,122578,125577,-2999,20166,-23165,1533,3067,-26232,37670,189258,39237,150021,,153366,1287.53,6908.11,0.1686,81,156.53,1000.0,37.67,0.7993
5962,Sullivan and Sons,False,ZA,New Brian,EdTech,2018,https://sullivanandsons.com,Find she bit only movie.,16,sullivan-and-sons,2023,USD,700811,140045,560766,159560,401206,39823,361383,7008,14016,347367,28827,441615,123351,318264,58400.92,700811,155.18,828.89,0.0067,1325,44.07,3989.07,7.23,0.8002
5963,Robinson Wheeler and Neal,False,EG,South Jamesville,Fintech,2018,https://robinsonwheelerandneal.com,Happy receive hot whatever those amount.,19,robinson-wheeler-and-neal,2023,USD,970175,288687,681488,48508,632980,15501,617479,9701,19403,598076,20108,693077,34653,658424,,970175,20.0,36.69,0.0933,315,255.97,25621.1,0.78,0.7024
5964,Rodriguez Inc,False,ZA,West Barbara,E-commerce,2020,https://rodriguezinc.com,Star nothing support prepare reach black many sure price fly.,17,rodriguez-inc,2023,USD,3172991,1171394,2001597,1125549,876048,7325,868723,31729,63459,805264,815995,2420797,121039,2299758,,3172991,1652.06,3158.86,0.001,3566,74.14,105732.44,7.72,0.6308
5965,Gonzalez and Sons,False,NG,Christopherstad,Marketplaces,2020,https://gonzalezandsons.com,Least yard ground quality special spend.,20,gonzalez-and-sons,2023,USD,279654,114165,165489,210892,-45403,17163,-62566,2796,5593,-68159,23016,193270,46059,147211,,279654,855.57,1977.14,0.0228,1165,20.0,22858.48,1.01,0.5918
5966,Wright-Moore,False,DE,Frankview,IoT,2019,https://wright-moore.com,Ground food home feel often organization watch performance probably.,13,wright-moore,2023,EUR,739730,364917,374813,320352,54461,0,54461,7397,14794,39667,84038,571173,209806,361367,,739730,20.0,73.0,0.0612,3082,20.0,49415.94,1.7,0.5067
5967,Mccall Murphy and Stone,False,ZA,New David,Energy,2011,https://mccallmurphyandstone.com,Class interview environmental myself campaign.,15,mccall-murphy-and-stone,2023,USD,2390124,1119014,1271110,980897,290213,0,290213,23901,47802,242411,41812,1325481,747619,577862,,2390124,20.0,58.01,0.001,3343,59.58,65852.41,0.63,0.5318
5968,Colon-Perez,False,DE,Russoberg,Marketplaces,2022,https://colon-perez.com,Near reveal might military ready.,14,colon-perez,2023,EUR,670316,223894,446422,69760,376662,0,376662,6703,13406,363256,54784,438703,248008,190695,,670316,614.01,3178.74,0.001,831,67.18,32451.41,1.69,0.666
5969,Miller-Smith,False,GB,Jacksonburgh,Cybersecurity,2014,https://miller-smith.com,Son strong participant outside actually seat throw person.,30,miller-smith,2023,USD,833362,342232,491130,221307,269823,0,269823,8333,16667,253156,9812,495539,81965,413574,,833362,1110.27,1235.5,0.0839,240,288.51,14754.98,0.66,0.5893
5970,Taylor-Snow,False,ZA,Matthewberg,SaaS,2024,https://taylor-snow.com,Large front open who never break really coach true memory.,19,taylor-snow,2023,USD,561868,155722,406146,302465,103681,30017,73664,5618,11237,62427,12736,410776,117878,292898,46822.33,561868,10.0,38.72,0.055,9364,5.0,9799.75,1.3,0.7228
5971,Parks Patton and Wilson,False,AU,Crystalborough,Fintech,2023,https://parkspattonandwilson.com,West explain it pretty give project mission less despite window.,19,parks-patton-and-wilson,2023,USD,559857,100291,459566,265588,193978,0,193978,5598,11197,182781,13225,404736,145270,259466,,559857,299.05,535.7,0.001,709,65.76,10563.06,1.25,0.8209
5972,Roth Snyder and Jordan,False,GB,North Sabrinaborough,Fintech,2017,https://rothsnyderandjordan.com,Rest history these study score.,20,roth-snyder-and-jordan,2023,USD,800336,220260,580076,702752,-122676,0,-122676,8003,16006,-138682,29720,534691,74137,460554,,800336,20.0,28.94,0.1024,332,200.38,61455.0,0.48,0.7248
5973,Steele Brady and Diaz,False,DE,West Jasminehaven,Energy,2017,https://steelebradyanddiaz.com,Arm throw worry land class model experience writer activity.,14,steele-brady-and-diaz,2023,EUR,597719,195202,402517,124062,278455,0,278455,5977,11954,266501,17324,384228,118739,265489,,597719,269.99,462.28,0.0913,247,201.55,2640.36,6.56,0.6734
5974,Mcdonald-Padilla,False,DE,Michellestad,AI/ML,2011,https://mcdonald-padilla.com,Almost international usually clearly around respond truth.,23,mcdonald-padilla,2023,EUR,1295976,295823,1000153,726743,273410,19319,254091,12959,25919,228172,71979,832005,358707,473298,,1295976,449.35,1112.61,0.0446,5399,20.0,51413.63,1.4,0.7717
5975,Ramos Hernandez and Ryan,False,DE,Juliemouth,SaaS,2008,https://ramoshernandezandryan.com,Person policy suddenly participant go stage door address public especially.,18,ramos-hernandez-and-ryan,2023,EUR,651460,251412,400048,447085,-47037,0,-47037,6514,13029,-60066,19033,540085,439488,100597,54288.33,651460,271.02,1338.95,0.001,957,56.7,45599.96,0.42,0.6141
5976,Johnson-Mack,False,US,East Kelly,AgriTech,2011,https://johnson-mack.com,System use ago yeah reduce.,25,johnson-mack,2023,USD,472233,156065,316168,202211,113957,11599,102358,4722,9444,92914,20805,288280,85794,202486,,472233,20.0,109.75,0.1647,356,110.25,41825.13,0.5,0.6695
5977,Spencer Ltd,False,DE,Dawnburgh,HealthTech,2010,https://spencerltd.com,Western TV finally military money service view.,15,spencer-ltd,2023,EUR,4502543,911921,3590622,2316926,1273696,22470,1251226,45025,90050,1161176,691411,2943515,1767290,1176225,375211.92,4502543,10.0,63.91,0.0242,20458,18.34,220033.95,3.14,0.7975
5978,Wolf-Young,False,FR,Cynthiaton,AgriTech,2022,https://wolf-young.com,Particularly the make respond resource share future value kid including.,27,wolf-young,2023,EUR,330795,108487,222308,129217,93091,9845,83246,3307,6615,76631,57499,349676,311131,38545,,330795,118.9,59.45,0.1611,71,384.54,16289.48,3.53,0.672
5979,Miller Inc,False,FR,New Josephborough,Energy,2019,https://millerinc.com,That us apply be she phone easy million good eight after.,17,miller-inc,2023,EUR,1476388,736322,740066,737550,2516,14329,-11813,14763,29527,-41340,54142,846945,363500,483445,,1476388,993.23,496.62,0.0152,1103,111.51,4982.06,10.87,0.5013
5980,Duarte LLC,False,BR,North Alexander,Energy,2008,https://duartellc.com,Success play poor always positive environment wonder officer.,13,duarte-llc,2023,USD,2814752,1342225,1472527,1463895,8632,0,8632,28147,56295,-47663,383760,1879915,1081613,798302,,2814752,288.42,1087.02,0.067,6609,35.49,114832.83,3.34,0.5231
5981,Swanson LLC,False,ZA,Aaronmouth,IoT,2017,https://swansonllc.com,Fall party after way event particularly realize finish sure.,22,swanson-llc,2023,USD,1723314,693778,1029536,86165,943371,17523,925848,17233,34466,891382,171612,1064783,205060,859723,,1723314,932.89,466.44,0.0234,7180,20.0,50545.95,3.4,0.5974
5982,Brown Hartman and Fitzgerald,False,CA,East Markville,Energy,2019,https://brownhartmanandfitzgerald.com,That increase production according night rest.,17,brown-hartman-and-fitzgerald,2023,USD,1778349,108824,1669525,1272958,396567,0,396567,17783,35566,361001,93055,1084132,703354,380778,,1778349,580.65,3206.74,0.055,1052,140.8,95945.11,0.97,0.9388
5983,Sandoval Griffin and Morris,False,DE,Zunigaton,AgriTech,2021,https://sandovalgriffinandmorris.com,Quite interesting every air last might finish chance.,19,sandoval-griffin-and-morris,2023,EUR,1251334,335928,915406,543421,371985,3054,368931,12513,25026,343905,41379,745391,194279,551112,,1251334,20.0,31.94,0.0935,1100,94.79,23221.22,1.78,0.7315
5984,Gonzales Wall and Roy,False,KE,Port Mckenzie,IoT,2023,https://gonzaleswallandroy.com,Fast audience leader tax four story fact nice then open.,23,gonzales-wall-and-roy,2023,USD,459844,256172,203672,203242,430,16904,-16474,4598,9196,-25670,28087,369279,93376,275903,,459844,360.16,541.27,0.0692,1916,20.0,1000.0,28.09,0.4429
5985,Barnes Inc,False,BR,Allenview,IoT,2009,https://barnesinc.com,Factor control available own eye better them ability number.,23,barnes-inc,2023,USD,580191,262249,317942,253367,64575,0,64575,5801,11603,52972,1912,413539,191208,222331,,580191,1029.05,1201.23,0.001,2417,20.0,45132.98,0.04,0.548
5986,Meza Group,False,BR,Lake Julieberg,Mobility,2009,https://mezagroup.com,Share popular describe parent hair.,23,meza-group,2023,USD,2140034,603796,1536238,1327928,208310,0,208310,21400,42800,165510,38773,1228017,451675,776342,,2140034,1289.75,5090.33,0.0656,1415,125.98,93164.3,0.42,0.7179
5987,Church Powell and Dunn,False,EG,Port Andrew,E-commerce,2019,https://churchpowellanddunn.com,Vote community ok budget summer pass particular send city trip.,20,church-powell-and-dunn,2023,USD,800959,322148,478811,206685,272126,18590,253536,8009,16019,237517,204838,766252,180134,586118,,800959,424.65,2120.99,0.0583,636,104.84,30924.11,6.62,0.5978
5988,Hoover Group,False,US,South Melissa,AgriTech,2023,https://hoovergroup.com,Debate avoid describe somebody wind six traditional soldier arrive appear.,23,hoover-group,2023,USD,448447,172395,276052,305127,-29075,21041,-50116,4484,8968,-59084,7269,340683,103882,236801,,448447,1321.91,6570.55,0.0536,118,316.33,56995.28,0.13,0.6156
5989,Anderson LLC,False,AU,South Jeffreyview,Energy,2011,https://andersonllc.com,Decision well consumer book hear must this over.,23,anderson-llc,2023,USD,8443310,2638133,5805177,4925344,879833,0,879833,84433,168866,710967,2971188,7262770,2103688,5159082,,8443310,1054.45,7306.66,0.001,35180,20.0,406933.6,7.3,0.6875
5990,Jones PLC,False,TN,North Bradley,Cybersecurity,2019,https://jonesplc.com,Approach rate chance laugh dark eight attorney.,13,jones-plc,2023,USD,288583,116919,171664,232229,-60565,22289,-82854,2885,5771,-88625,43259,299048,66064,232984,,288583,387.66,1821.53,0.001,146,164.71,25893.4,1.67,0.5949
5991,Hill Mack and Erickson,False,BR,New Jane,Mobility,2008,https://hillmackanderickson.com,To those grow event science along several single weight.,24,hill-mack-and-erickson,2023,USD,356826,151846,204980,108642,96338,0,96338,3568,7136,89202,41728,284776,54315,230461,,356826,631.73,315.86,0.0822,217,136.85,42713.0,0.98,0.5745
5992,Caldwell-Flores,False,TN,Bassview,SaaS,2023,https://caldwell-flores.com,Century experience half little serious deal speech economic.,21,caldwell-flores,2023,USD,2143505,677072,1466433,870454,595979,1699,594280,21435,42870,551410,65294,1232695,707217,525478,178625.42,2143505,10.0,47.59,0.0167,2851,62.65,47140.43,1.39,0.6841
5993,Rodriguez-Garcia,False,AU,Hernandezside,Fintech,2023,https://rodriguez-garcia.com,Fear Mrs he week sense detail assume federal should your.,17,rodriguez-garcia,2023,USD,8694756,2629313,6065443,4408912,1656531,0,1656531,86947,173895,1482636,372160,4878125,2251316,2626809,,8694756,20.0,113.72,0.059,2886,251.04,348109.46,1.07,0.6976
5994,Fox Inc,False,IN,Port Richard,AI/ML,2010,https://foxinc.com,Voice discover center successful year order during.,12,fox-inc,2023,USD,3199098,1062921,2136177,2452890,-316713,16114,-332827,31990,63981,-396808,394740,2132654,720770,1411884,,3199098,204.48,102.24,0.001,1829,145.71,182793.72,2.16,0.6677
5995,Smith Inc,False,FR,Austinfurt,EdTech,2011,https://smithinc.com,Knowledge support safe require along scene second.,22,smith-inc,2023,EUR,262074,173532,88542,13103,75439,0,75439,2620,5241,70198,15739,316653,15832,300821,21839.5,262074,10.0,23.81,0.0171,2975,7.34,1000.0,15.74,0.3379
5996,Garcia Best and Wells,False,EG,Chadland,Energy,2018,https://garciabestandwells.com,Among level result through yes response my you far.,25,garcia-best-and-wells,2023,USD,3176183,780854,2395329,1941871,453458,30802,422656,31761,63523,359133,50449,1760907,849860,911047,,3176183,20.0,100.74,0.1127,13234,20.0,194691.25,0.26,0.7542
5997,Kim-Oliver,False,DE,New Marissamouth,IoT,2023,https://kim-oliver.com,Million generation policy ever every behavior light seven artist involve.,21,kim-oliver,2023,EUR,388245,70255,317990,163459,154531,0,154531,3882,7764,146767,16013,359218,120281,238937,,388245,980.84,6952.82,0.0892,429,75.4,1255.32,12.76,0.819
5998,Greene PLC,False,US,North Michael,E-commerce,2017,https://greeneplc.com,Choice ask morning art one weight.,20,greene-plc,2023,USD,3787238,1849503,1937735,3170305,-1232570,13053,-1245623,37872,75744,-1321367,171869,2169425,1052479,1116946,,3787238,20.0,115.08,0.0704,3007,104.94,273243.38,0.63,0.5116
5999,Floyd-Robles,False,NG,Stewartberg,Cybersecurity,2022,https://floyd-robles.com,Plan more car government customer degree fill.,21,floyd-robles,2023,USD,1645640,820393,825247,496698,328549,0,328549,16456,32912,295637,413668,1331577,721288,610289,,1645640,1394.66,5013.64,0.001,1351,101.5,47997.48,8.62,0.5015
6000,Golden-Anderson,False,DE,New Nathan,IoT,2021,https://golden-anderson.com,Trial add hard experience up successful happen family per relate.,20,golden-anderson,2023,EUR,161619,80096,81523,65087,16436,0,16436,1616,3232,13204,17553,246563,72766,173797,,161619,23.36,176.27,0.001,74,180.16,8787.71,2.0,0.5044
6001,Montoya-Jones,False,FR,Traceytown,SaaS,2012,https://montoya-jones.com,Clear after deal office commercial.,20,montoya-jones,2023,EUR,3415414,1427525,1987889,170770,1817119,17872,1799247,34154,68308,1730939,81614,1873460,333172,1540288,284617.83,3415414,655.99,2486.68,0.0139,2834,100.41,1000.0,81.61,0.582
6002,Jenkins and Sons,False,KE,Troyville,Marketplaces,2008,https://jenkinsandsons.com,Significant sport economy model public question evening partner.,22,jenkins-and-sons,2023,USD,408625,133371,275254,49052,226202,15932,210270,4086,8172,202098,28050,262418,127312,135106,,408625,20.0,51.15,0.0508,346,98.32,31485.24,0.89,0.6736
6003,Lewis Barnes and Lewis,False,NG,South Elizabethland,Mobility,2010,https://lewisbarnesandlewis.com,Little action fight audience believe animal per far tonight maybe.,14,lewis-barnes-and-lewis,2023,USD,2141593,423184,1718409,2265518,-547109,28132,-575241,21415,42831,-618072,102298,1327342,633662,693680,,2141593,783.69,2876.21,0.1098,8923,20.0,185484.07,0.55,0.8024
6004,Smith Rivera and Kennedy,False,NG,Williamchester,HealthTech,2022,https://smithriveraandkennedy.com,Such painting marriage hospital Mr she appear.,24,smith-rivera-and-kennedy,2023,USD,452327,173942,278385,344702,-66317,20143,-86460,4523,9046,-95506,12777,330852,193523,137329,37693.92,452327,282.13,938.45,0.001,945,39.87,1000.0,12.78,0.6155
6005,Holland Inc,False,IN,Baldwinborough,Cybersecurity,2020,https://hollandinc.com,Product but human democratic benefit out detail.,17,holland-inc,2023,USD,1629540,622852,1006688,166600,840088,5188,834900,16295,32590,802310,47197,1024126,307355,716771,,1629540,414.28,1864.77,0.0952,908,149.5,1000.0,47.2,0.6178
6006,Lee-Jones,False,AU,Joseside,AI/ML,2009,https://lee-jones.com,Page me dark my majority practice money cut teach environmental.,16,lee-jones,2023,USD,437184,243378,193806,21859,171947,0,171947,4371,8743,163204,7594,316880,146265,170615,,437184,153.82,585.03,0.0816,1049,34.73,9361.49,0.81,0.4433
6007,Jimenez Ltd,False,IN,Christineville,IoT,2011,https://jimenezltd.com,Factor seven sit tax policy particular type leg agency.,20,jimenez-ltd,2023,USD,738020,228660,509360,347936,161424,0,161424,7380,14760,146664,10239,571806,166926,404880,,738020,643.26,321.63,0.001,314,195.62,24495.91,0.42,0.6902
6008,Lyons-Torres,False,ZA,Port Brianview,AI/ML,2023,https://lyons-torres.com,Bad economic anyone player letter three coach how body hold.,18,lyons-torres,2023,USD,531524,239690,291834,232533,59301,29325,29976,5315,10630,19346,27269,414616,249012,165604,,531524,25.24,43.79,0.2277,114,386.17,20522.72,1.33,0.5491
6009,Jones Group,False,GB,Watersland,Mobility,2017,https://jonesgroup.com,Left young soon glass politics whom high skin.,27,jones-group,2023,USD,388981,99354,289627,110165,179462,18272,161190,3889,7779,153411,15358,369252,105337,263915,,388981,20.0,25.54,0.1169,126,256.15,7142.34,2.15,0.7446
6010,Burton Inc,False,GB,Owenport,SaaS,2017,https://burtoninc.com,Those not table involve positive final down pretty.,21,burton-inc,2023,USD,1333667,378936,954731,984234,-29503,0,-29503,13336,26673,-56176,11492,859318,615110,244208,111138.92,1333667,35.7,130.18,0.0782,5217,21.3,76934.16,0.15,0.7159
6011,Miller PLC,False,KE,South Ashley,E-commerce,2021,https://millerplc.com,Size clear heavy suddenly material.,22,miller-plc,2023,USD,869559,394976,474583,120956,353627,0,353627,8695,17391,336236,17320,482311,284932,197379,,869559,267.66,133.83,0.0455,3035,23.87,10849.79,1.6,0.5458
6012,Beard-Allison,False,FR,South Rayshire,Marketplaces,2012,https://beard-allison.com,Even dream piece exist article.,15,beard-allison,2023,EUR,258405,41620,216785,212005,4780,0,4780,2584,5168,-388,14481,230308,13787,216521,,258405,1014.77,507.38,0.035,143,150.22,1000.0,14.48,0.8389
6013,Daniel-Bentley,False,FR,Cantufort,EdTech,2023,https://daniel-bentley.com,Position wife think firm history imagine so accept sell.,15,daniel-bentley,2023,EUR,1770592,167478,1603114,681697,921417,15814,905603,17705,35411,870192,522371,1466143,309913,1156230,147549.33,1770592,550.32,2023.61,0.0322,3051,48.35,45486.89,11.48,0.9054
6014,Thompson Ltd,False,EG,North Douglasborough,EdTech,2008,https://thompsonltd.com,Whom news base already partner.,22,thompson-ltd,2023,USD,593989,221622,372367,338146,34221,9649,24572,5939,11879,12693,103638,521886,150643,371243,49499.08,593989,424.58,1503.19,0.0244,385,128.42,1000.0,103.64,0.6269
6015,Chandler LLC,False,TN,East Larry,Cybersecurity,2013,https://chandlerllc.com,Fund thank partner expert activity no poor contain.,21,chandler-llc,2023,USD,1072761,187518,885243,374478,510765,4310,506455,10727,21455,485000,38103,591391,237731,353660,,1072761,20.0,86.89,0.001,4469,20.0,38002.58,1.0,0.8252
6016,Reyes PLC,False,AU,Ronaldshire,Energy,2009,https://reyesplc.com,As remember ten site seven mention whether he environmental.,20,reyes-plc,2023,USD,1036955,129135,907820,453422,454398,4357,450041,10369,20739,429302,43421,754788,139076,615712,,1036955,706.61,3271.09,0.0594,1030,83.83,60865.31,0.71,0.8755
6017,Stanton Rogers and Holmes,False,IN,West Karen,HealthTech,2015,https://stantonrogersandholmes.com,Three single various television while.,24,stanton-rogers-and-holmes,2023,USD,7952927,2852819,5100108,4325003,775105,0,775105,79529,159058,616047,335029,4367016,1684793,2682223,662743.92,7952927,19.33,40.17,0.0442,132548,5.0,351768.33,0.95,0.6413
6018,Bowen Marshall and Williams,False,CA,East Meredith,Marketplaces,2023,https://bowenmarshallandwilliams.com,Guy much old land view middle.,10,bowen-marshall-and-williams,2023,USD,724733,41661,683072,295933,387139,776,386363,7247,14494,371869,72014,615960,128874,487086,,724733,1235.5,2688.3,0.056,581,103.91,4190.5,17.19,0.9425
6019,Gordon Hernandez and Jenkins,False,DE,Port Elizabeth,Cybersecurity,2022,https://gordonhernandezandjenkins.com,Few much help oil statement me plan guy decide.,17,gordon-hernandez-and-jenkins,2023,EUR,5443854,2466473,2977381,2336413,640968,0,640968,54438,108877,532091,259133,3131057,156552,2974505,,5443854,372.22,1560.03,0.048,22682,20.0,185830.34,1.39,0.5469
6020,Gordon PLC,False,AU,New John,Cybersecurity,2011,https://gordonplc.com,Tree figure a recently us.,19,gordon-plc,2023,USD,1043810,258497,785313,665430,119883,0,119883,10438,20876,99007,70819,755819,313330,442489,,1043810,1155.87,6613.38,0.0844,4349,20.0,27728.91,2.55,0.7524
6021,Wells and Sons,False,FR,Murraymouth,HealthTech,2012,https://wellsandsons.com,Home drug more since two.,21,wells-and-sons,2023,EUR,370005,224736,145269,204388,-59119,23631,-82750,3700,7400,-90150,47711,394188,146792,247396,30833.75,370005,27.14,131.41,0.0076,596,51.73,23311.57,2.05,0.3926
6022,Carlson-Williams,False,GB,New Alexandria,Cybersecurity,2008,https://carlson-williams.com,Manage course direction war.,20,carlson-williams,2023,USD,9018672,4955170,4063502,3094487,969015,0,969015,90186,180373,788642,1587054,6143670,1538298,4605372,,9018672,20.0,57.27,0.054,37577,20.0,235266.7,6.75,0.4506
6023,Williams Williams and Vasquez,False,EG,Joannaland,Mobility,2019,https://williamswilliamsandvasquez.com,Weight child imagine clear person seven create system property.,26,williams-williams-and-vasquez,2023,USD,1747829,263054,1484775,149157,1335618,21838,1313780,17478,34956,1278824,32379,1066238,481849,584389,,1747829,20.0,77.13,0.001,7282,20.0,1000.0,32.38,0.8495
6024,Flores-West,False,AU,Rachaelstad,Cybersecurity,2021,https://flores-west.com,Claim present law environmental development social consider employee doctor design.,12,flores-west,2023,USD,2796612,1191830,1604782,943804,660978,16432,644546,27966,55932,588614,95986,1688138,328957,1359181,,2796612,1374.8,5795.45,0.1191,3766,61.88,112392.27,0.85,0.5738
6025,Clark-Walker,False,US,Cristianview,Cybersecurity,2024,https://clark-walker.com,Understand line to read wrong pattern value during.,24,clark-walker,2023,USD,1699846,655794,1044052,1343713,-299661,26611,-326272,16998,33996,-360268,248954,1186851,528185,658666,,1699846,940.54,2633.59,0.0041,2954,47.95,146379.75,1.7,0.6142
6026,Boyd Diaz and Lewis,False,ZA,Longhaven,E-commerce,2011,https://boyddiazandlewis.com,Particular east sea ability hope.,21,boyd-diaz-and-lewis,2023,USD,2668506,828843,1839663,1477912,361751,15963,345788,26685,53370,292418,307139,1755426,657249,1098177,,2668506,20.0,34.58,0.131,1044,212.91,148504.55,2.07,0.6894
6027,Preston-White,False,TN,South Georgechester,Mobility,2009,https://preston-white.com,Various land movement decision leader nice account tough meeting investment.,24,preston-white,2023,USD,2395289,1126123,1269166,1125079,144087,1655,142432,23952,47905,94527,120085,1454472,148473,1305999,,2395289,20.0,28.9,0.001,1590,125.48,69053.79,1.74,0.5299
6028,Edwards Group,False,IN,South Destiny,Energy,2021,https://edwardsgroup.com,State tonight mean radio safe house bag old.,26,edwards-group,2023,USD,481715,255439,226276,223126,3150,26227,-23077,4817,9634,-32711,11011,300113,63389,236724,,481715,985.45,6328.37,0.0256,263,152.2,15893.77,0.69,0.4697
6029,Turner-Andrews,False,FR,West Christopherchester,Fintech,2010,https://turner-andrews.com,Indicate possible much two treatment keep miss such.,14,turner-andrews,2023,EUR,457108,194353,262755,325140,-62385,2078,-64463,4571,9142,-73605,37538,289681,81504,208177,,457108,703.15,2352.07,0.0159,136,278.05,26002.56,1.44,0.5748
6030,Taylor Hughes and Kelly,False,IN,East Madison,Marketplaces,2019,https://taylorhughesandkelly.com,Partner perhaps early three scene condition.,16,taylor-hughes-and-kelly,2023,USD,4115634,1386384,2729250,3445267,-716017,0,-716017,41156,82312,-798329,122652,2203497,1176496,1027001,,4115634,20.0,85.02,0.001,2655,129.16,302195.34,0.41,0.6631
6031,Hopkins LLC,False,EG,South Kristinastad,Energy,2024,https://hopkinsllc.com,Stage upon space attack every fund.,16,hopkins-llc,2023,USD,11536718,4584539,6952179,3516053,3436126,0,3436126,115367,230734,3205392,3236434,9127085,2627106,6499979,,11536718,20.0,11.3,0.0799,18718,51.36,293144.33,11.04,0.6026
6032,Carter-Howell,False,DE,South Lorihaven,HealthTech,2011,https://carter-howell.com,Step story upon especially thought reduce budget.,18,carter-howell,2023,EUR,520766,182073,338693,344929,-6236,0,-6236,5207,10415,-16651,12406,317463,172778,144685,43397.17,520766,10.0,10.11,0.0312,1782,24.35,11465.37,1.08,0.6504
6033,Rivera Inc,False,US,West Charles,HealthTech,2010,https://riverainc.com,Involve good those sort store seem big.,14,rivera-inc,2023,USD,450219,209650,240569,201484,39085,0,39085,4502,9004,30081,13919,291205,118063,173142,37518.25,450219,91.78,232.87,0.091,7503,5.0,39717.12,0.35,0.5343
6034,Johnson Oconnell and Hill,False,KE,North Matthew,HealthTech,2014,https://johnsonoconnellandhill.com,Defense window power or include experience administration ever.,21,johnson-oconnell-and-hill,2023,USD,1050350,352260,698090,171323,526767,33914,492853,10503,21007,471846,128438,763268,115076,648192,87529.17,1050350,10.0,58.36,0.001,1179,74.22,20204.78,6.36,0.6646
6035,Turner Group,False,EG,Lisabury,Marketplaces,2019,https://turnergroup.com,Form ask political especially into indeed year thought ago must.,31,turner-group,2023,USD,1320230,379433,940797,612178,328619,16650,311969,13202,26404,285565,22129,748872,182584,566288,,1320230,1081.36,4388.45,0.001,5500,20.0,58224.11,0.38,0.7126
6036,Lopez Group,False,NG,Jamestown,AgriTech,2023,https://lopezgroup.com,Return child station only number guy you attention land.,12,lopez-group,2023,USD,159505,64860,94645,97706,-3061,0,-3061,1595,3190,-6251,5545,245138,47955,197183,,159505,443.39,637.05,0.0988,664,20.0,1000.0,5.54,0.5934
6037,Hendricks and Sons,False,FR,West Angelashire,Marketplaces,2013,https://hendricksandsons.com,Picture half teach notice media wide country nothing candidate.,13,hendricks-and-sons,2023,EUR,507723,187144,320579,388491,-67912,0,-67912,5077,10154,-78066,30518,399448,189090,210358,,507723,1378.44,4688.6,0.0373,211,200.21,33442.73,0.91,0.6314
6038,Payne Owens and Cruz,False,KE,New Joanmouth,Energy,2011,https://payneowensandcruz.com,Own themselves camera west mother point create card.,17,payne-owens-and-cruz,2023,USD,1460941,268182,1192759,826216,366543,4393,362150,14609,29218,332932,58127,972975,302615,670360,,1460941,779.72,5334.57,0.036,1128,107.91,28186.38,2.06,0.8164
6039,Hayes Ochoa and Castillo,False,NG,Patrickchester,SaaS,2015,https://hayesochoaandcastillo.com,Describe big piece myself environmental letter suddenly something pass.,11,hayes-ochoa-and-castillo,2023,USD,6505648,2804043,3701605,1334805,2366800,0,2366800,65056,130112,2236688,124716,3557764,1322408,2235356,542137.33,6505648,461.44,2966.92,0.0494,3944,137.43,132596.7,0.94,0.569
6040,Moyer-Flores,False,DE,South Raymondstad,HealthTech,2017,https://moyer-flores.com,Hear time agent since forget yet.,10,moyer-flores,2023,EUR,4579471,1351818,3227653,2905302,322351,0,322351,45794,91589,230762,29901,2404996,1132510,1272486,381622.58,4579471,398.36,3241.76,0.001,8086,47.19,253220.07,0.12,0.7048
6041,Campos PLC,False,GB,Johnsonfort,Cybersecurity,2020,https://camposplc.com,Even onto indicate beat specific happen theory most play opportunity.,23,campos-plc,2023,USD,2065604,334100,1731504,638054,1093450,52981,1040469,20656,41312,999157,25084,1187112,103748,1083364,,2065604,20.0,35.47,0.0584,8606,20.0,66792.35,0.38,0.8383
6042,Webb Smith and Brewer,False,US,North Carol,E-commerce,2009,https://webbsmithandbrewer.com,Around western expect air high factor identify enjoy short option.,23,webb-smith-and-brewer,2023,USD,410104,194965,215139,283459,-68320,8150,-76470,4101,8202,-84672,4787,224749,61928,162821,,410104,20.0,41.86,0.1286,99,344.15,1446.97,3.31,0.5246
6043,Rodriguez Reed and Frazier,False,NG,Coreymouth,SaaS,2011,https://rodriguezreedandfrazier.com,Especially experience center party sound they adult truth time.,19,rodriguez-reed-and-frazier,2023,USD,2096813,965257,1131556,326701,804855,5306,799549,20968,41936,757613,26492,1258195,179566,1078629,174734.42,2096813,100.61,100.61,0.001,10327,16.92,60908.45,0.43,0.5397
6044,Chung Jackson and Torres,False,NG,Leeland,Marketplaces,2016,https://chungjacksonandtorres.com,Simply time big newspaper inside PM believe key.,32,chung-jackson-and-torres,2023,USD,1597600,645634,951966,874695,77271,33335,43936,15976,31952,11984,110042,1054865,52743,1002122,,1597600,20.0,90.32,0.0044,1530,86.99,96793.55,1.14,0.5959
6045,King PLC,False,KE,Julietown,AI/ML,2008,https://kingplc.com,At young economic song miss guess her involve tell.,19,king-plc,2023,USD,603858,363794,240064,336269,-96205,0,-96205,6038,12077,-108282,40214,392797,96097,296700,,603858,1425.98,6700.9,0.0669,287,175.17,11971.93,3.36,0.3976
6046,Allison-Hill,False,IN,Port Kimberly,HealthTech,2018,https://allison-hill.com,Member perform design discussion among research space experience sea attack.,28,allison-hill,2023,USD,843089,298536,544553,277326,267227,19067,248160,8430,16861,231299,33099,542310,196328,345982,70257.42,843089,10.0,64.76,0.0234,14051,5.0,1000.0,33.1,0.6459
6047,Boyd Salazar and Flores,False,DE,Port Maryborough,Mobility,2014,https://boydsalazarandflores.com,Question staff hot detail order outside agree money return pretty.,14,boyd-salazar-and-flores,2023,EUR,543470,292955,250515,519469,-268954,0,-268954,5434,10869,-279823,10349,297036,14851,282185,,543470,20.0,62.17,0.041,993,45.58,44782.46,0.23,0.461
6048,Johnson Berry and Acevedo,False,DE,East Francisco,Marketplaces,2023,https://johnsonberryandacevedo.com,Cultural condition threat set weight yourself single seven.,17,johnson-berry-and-acevedo,2023,EUR,6301190,1563055,4738135,4278955,459180,4991,454189,63011,126023,328166,356184,3507433,720412,2787021,,6301190,20.0,48.27,0.0325,2115,248.2,353288.69,1.01,0.7519
6049,Coleman-Schmidt,False,EG,Huffmanville,Mobility,2014,https://coleman-schmidt.com,Office time new talk argue for check.,20,coleman-schmidt,2023,USD,4009353,1383730,2625623,2958736,-333113,0,-333113,40093,80187,-413300,22175,2077722,1185463,892259,,4009353,1043.72,5630.26,0.0314,3440,97.12,240657.05,0.09,0.6549
6050,Wilson and Sons,False,FR,South James,HealthTech,2020,https://wilsonandsons.com,Fall beautiful capital middle level if throughout small.,18,wilson-and-sons,2023,EUR,600790,185868,414922,574447,-159525,5381,-164906,6007,12015,-176921,20712,411879,359756,52123,50065.83,600790,40.46,127.98,0.0142,401,124.66,36680.5,0.56,0.6906
6051,Powers LLC,False,NG,Jenniferberg,Marketplaces,2010,https://powersllc.com,Whole month far bring though.,23,powers-llc,2023,USD,2374070,967824,1406246,575171,831075,5851,825224,23740,47481,777743,1139063,2352225,916438,1435787,,2374070,1133.31,1024.36,0.112,9891,20.0,45928.54,24.8,0.5923
6052,Phillips-Williams,False,GB,Ginaton,Marketplaces,2012,https://phillips-williams.com,Write from walk maybe address catch tell each year by law.,24,phillips-williams,2023,USD,3677221,1046442,2630779,327422,2303357,6995,2296362,36772,73544,2222818,857221,2852566,783535,2069031,,3677221,910.01,5908.25,0.001,4165,73.56,18021.91,47.57,0.7154
6053,Griffin and Sons,False,NG,New Mariaberg,HealthTech,2010,https://griffinandsons.com,Green enter view political everyone education.,15,griffin-and-sons,2023,USD,1269915,546042,723873,554335,169538,19278,150260,12699,25398,124862,988758,1642331,773344,868987,105826.25,1269915,130.3,599.29,0.0191,2417,43.77,69226.49,14.28,0.57
6054,Jordan Ltd,False,EG,Maryfurt,AI/ML,2010,https://jordanltd.com,American draw agent age in wide positive who west seven.,19,jordan-ltd,2023,USD,416361,160739,255622,20818,234804,0,234804,4163,8327,226477,57630,291355,24336,267019,,416361,557.17,3539.7,0.001,134,257.89,34059.8,1.69,0.6139
6055,Williams-Shaw,False,KE,Port Jimmyville,HealthTech,2015,https://williams-shaw.com,Firm actually owner management least moment factor.,13,williams-shaw,2023,USD,2184140,341178,1842962,281404,1561558,17185,1544373,21841,43682,1500691,10658,1261633,518192,743441,182011.67,2184140,482.95,1779.74,0.0136,2094,86.9,1000.0,10.66,0.8438
6056,Holt Phillips and Carter,False,BR,North Davidview,Energy,2019,https://holtphillipsandcarter.com,Should economic suddenly than president official talk wear among indeed.,20,holt-phillips-and-carter,2023,USD,1022991,467890,555101,51149,503952,265,503687,10229,20459,483228,161127,723428,85611,637817,,1022991,20.0,34.3,0.0369,4262,20.0,1000.0,161.13,0.5426
6057,Johnston-Morris,False,DE,Christineton,AgriTech,2021,https://johnston-morris.com,Practice than age drug.,27,johnston-morris,2023,EUR,727962,279159,448803,402897,45906,0,45906,7279,14559,31347,106587,566506,253637,312869,,727962,1198.56,599.28,0.0597,493,122.85,20187.01,5.28,0.6165
6058,Mcclure LLC,False,US,West Allison,Energy,2009,https://mcclurellc.com,Old radio produce assume figure old.,23,mcclure-llc,2023,USD,780152,392174,387978,352389,35589,0,35589,7801,15603,19986,134913,584696,221116,363580,,780152,20.0,113.5,0.1015,358,181.34,14356.67,9.4,0.4973
6059,Perez Matthews and Austin,False,CA,South Dannyton,Energy,2008,https://perezmatthewsandaustin.com,Over concern role also quickly difference.,17,perez-matthews-and-austin,2023,USD,1848914,292081,1556833,473751,1083082,0,1083082,18489,36978,1046104,534242,1599743,778547,821196,,1848914,1320.66,6600.18,0.007,3181,48.43,45060.19,11.86,0.842
6060,Kirk Group,False,DE,New Dannyshire,Marketplaces,2019,https://kirkgroup.com,Table memory country major sport.,19,kirk-group,2023,EUR,1943161,527774,1415387,758516,656871,11160,645711,19431,38863,606848,174851,1252656,62632,1190024,,1943161,532.9,1727.32,0.001,1369,118.28,70885.96,2.47,0.7284
6061,Mathis-Coleman,False,TN,Jonesport,Mobility,2015,https://mathis-coleman.com,Sometimes fund front near bag second include appear my those.,22,mathis-coleman,2023,USD,4305579,1535625,2769954,1217241,1552713,0,1552713,43055,86111,1466602,300100,2605526,970053,1635473,,4305579,20.0,61.61,0.059,17939,20.0,99525.51,3.02,0.6433
6062,Gonzalez Group,False,ZA,Jaredstad,HealthTech,2023,https://gonzalezgroup.com,Her charge quickly without hold seem society ground despite music.,26,gonzalez-group,2023,USD,1641075,638082,1002993,279854,723139,8234,714905,16410,32821,682084,75865,935115,741740,193375,136756.25,1641075,423.81,701.84,0.0131,2985,45.81,10666.79,7.11,0.6112
6063,Jimenez-Anderson,False,KE,Thomaston,AI/ML,2021,https://jimenez-anderson.com,Language course leader stand son sometimes nice health.,27,jimenez-anderson,2023,USD,149711,64961,84750,86872,-2122,24611,-26733,1497,2994,-29727,7575,239293,101161,138132,,149711,1196.52,5332.66,0.0709,70,176.09,1000.0,7.58,0.5661
6064,Taylor Farmer and Mathews,False,BR,North Davidview,Marketplaces,2013,https://taylorfarmerandmathews.com,Assume away campaign fund nice effort program to.,16,taylor-farmer-and-mathews,2023,USD,2323904,328486,1995418,882209,1113209,25772,1087437,23239,46478,1040959,41859,1209089,626361,582728,,2323904,20.0,98.74,0.0306,2513,77.05,64774.9,0.65,0.8586
6065,Ward Wilson and Smith,False,DE,Brandifort,IoT,2024,https://wardwilsonandsmith.com,Red long else society value gun.,20,ward-wilson-and-smith,2023,EUR,550417,226933,323484,253271,70213,23219,46994,5504,11008,35986,36087,448533,235039,213494,,550417,1644.35,3769.74,0.0079,2293,20.0,1000.0,36.09,0.5877
6066,Bowers-Carrillo,False,IN,Cummingsburgh,Mobility,2010,https://bowers-carrillo.com,Hold degree carry government team.,20,bowers-carrillo,2023,USD,804657,398547,406110,548632,-142522,14636,-157158,8046,16093,-173251,445735,1015959,540839,475120,,804657,1096.31,548.16,0.0221,3352,20.0,20627.97,21.61,0.5047
6067,Juarez LLC,False,TN,Jonathanborough,IoT,2008,https://juarezllc.com,Apply knowledge example Congress family forward support and film late.,19,juarez-llc,2023,USD,342725,70937,271788,206288,65500,12707,52793,3427,6854,45939,50759,356609,170788,185821,,342725,27.07,70.99,0.1281,1428,20.0,7583.97,6.69,0.793
6068,Nicholson-Fletcher,False,TN,Santiagochester,Fintech,2010,https://nicholson-fletcher.com,Final better stock recently machine purpose upon.,19,nicholson-fletcher,2023,USD,2424926,1059946,1364980,1562346,-197366,35999,-233365,24249,48498,-281863,225750,1536559,590773,945786,,2424926,319.21,646.73,0.057,10103,20.0,157732.57,1.43,0.5629
6069,Nguyen Thomas and Donaldson,False,ZA,Holderstad,HealthTech,2009,https://nguyenthomasanddonaldson.com,Some worry like behavior owner face.,12,nguyen-thomas-and-donaldson,2023,USD,3225654,1159288,2066366,1422313,644053,8482,635571,32256,64513,571058,222128,1846658,1466017,380641,268804.5,3225654,193.3,813.28,0.001,5716,47.02,129601.89,1.71,0.6406
6070,Martin-Schultz,False,CA,Andrewschester,AgriTech,2020,https://martin-schultz.com,Former military himself big today morning fine.,20,martin-schultz,2023,USD,1178587,255251,923336,184736,738600,23353,715247,11785,23571,691676,430312,1065353,223580,841773,,1178587,1668.35,3604.03,0.001,894,109.78,37680.19,11.42,0.7834
6071,Mckinney and Sons,False,IN,Lake Deanshire,Mobility,2018,https://mckinneyandsons.com,Doctor daughter seek result local.,17,mckinney-and-sons,2023,USD,2530449,1177047,1353402,126522,1226880,7276,1219604,25304,50608,1168996,175401,1496588,632639,863949,,2530449,1736.29,7468.84,0.001,3323,63.44,1000.0,175.4,0.5348
6072,Bean LLC,False,IN,Salasstad,AI/ML,2018,https://beanllc.com,Task marriage hand center end.,18,bean-llc,2023,USD,631988,394665,237323,124411,112912,0,112912,6319,12639,100273,78782,424717,171163,253554,,631988,20.0,69.66,0.0147,2633,20.0,43707.74,1.8,0.3755
6073,Gay-Guerra,False,IN,North Robertochester,Mobility,2024,https://gay-guerra.com,Hospital investment just how truth light show.,15,gay-guerra,2023,USD,1771712,468115,1303597,723989,579608,7166,572442,17717,35434,537008,628850,1679344,632007,1047337,,1771712,20.0,64.93,0.001,7382,20.0,71848.19,8.75,0.7358
6074,Hamilton PLC,False,EG,Dennisberg,Energy,2012,https://hamiltonplc.com,School son practice general Mrs hard.,16,hamilton-plc,2023,USD,1091147,302746,788401,1052799,-264398,0,-264398,10911,21822,-286220,224663,909732,469841,439891,,1091147,961.62,4540.11,0.0056,344,263.58,81558.11,2.75,0.7225
6075,Garrett PLC,False,EG,Davidport,E-commerce,2010,https://garrettplc.com,Thought offer possible lose either boy article impact vote wait.,27,garrett-plc,2023,USD,1114525,201888,912637,321990,590647,17942,572705,11145,22290,550415,14450,653770,423854,229916,,1114525,1636.41,2719.91,0.0093,686,135.2,40132.86,0.36,0.8189
6076,Steele Inc,False,ZA,East Markland,Mobility,2018,https://steeleinc.com,Out school possible question education tough own.,24,steele-inc,2023,USD,128804,50533,78271,64472,13799,0,13799,1288,2576,11223,2793,123876,34664,89212,,128804,948.47,2897.66,0.0254,119,89.92,1000.0,2.79,0.6077
6077,Cantu Inc,False,NG,Port Denisemouth,AI/ML,2010,https://cantuinc.com,Size large special decade develop Democrat response behind loss.,23,cantu-inc,2023,USD,245229,101750,143479,25224,118255,23951,94304,2452,4904,89400,17710,141607,80173,61434,,245229,335.47,2152.84,0.1168,95,213.18,1000.0,17.71,0.5851
6078,Thomas Group,False,IN,New Jennifer,Marketplaces,2016,https://thomasgroup.com,Four go list choice reach senior near.,20,thomas-group,2023,USD,1578319,700330,877989,761619,116370,6923,109447,15783,31566,77881,277046,1172492,201649,970843,,1578319,1125.78,2194.32,0.0208,536,245.24,49698.8,5.57,0.5563
6079,Brown-Valdez,False,IN,Kathleenburgh,AgriTech,2024,https://brown-valdez.com,Measure outside boy also hundred baby front.,21,brown-valdez,2023,USD,314582,109997,204585,256261,-51676,24,-51700,3145,6291,-57991,5644,336554,198719,137835,,314582,20.0,66.94,0.0349,263,99.58,35405.74,0.16,0.6503
6080,Black Manning and Villa,False,DE,South Jessica,E-commerce,2018,https://blackmanningandvilla.com,Team would western change court team help tough wonder.,16,black-manning-and-villa,2023,EUR,221034,88301,132733,55494,77239,0,77239,2210,4420,72819,2597,253672,72030,181642,,221034,1034.59,2145.94,0.0725,920,20.0,10762.8,0.24,0.6005
6081,Gross Inc,False,DE,South Dawn,IoT,2014,https://grossinc.com,Behind able machine method military seem several.,18,gross-inc,2023,EUR,938023,371467,566556,670795,-104239,0,-104239,9380,18760,-122999,117991,668012,472594,195418,,938023,498.65,712.61,0.1695,3908,20.0,42960.84,2.75,0.604
6082,James-Meza,False,CA,West Danielland,AgriTech,2014,https://james-meza.com,Born husband tough ability sign.,23,james-meza,2023,USD,171074,54148,116926,111794,5132,28095,-22963,1710,3421,-26384,14381,252749,116181,136568,,171074,20.0,44.01,0.0484,207,68.75,1000.0,14.38,0.6835
6083,Thompson PLC,False,CA,Josephstad,AI/ML,2021,https://thompsonplc.com,Evening each family interesting by.,26,thompson-plc,2023,USD,1091526,540230,551296,404843,146453,0,146453,10915,21830,124623,76991,632369,72169,560200,,1091526,20.0,58.18,0.0523,4548,20.0,49442.87,1.56,0.5051
6084,Snyder-Ball,False,IN,Micheleshire,AgriTech,2021,https://snyder-ball.com,Meet eight on seat onto.,23,snyder-ball,2023,USD,124718,58545,66173,87250,-21077,0,-21077,1247,2494,-23571,3790,239855,17024,222831,,124718,20.0,10.0,0.0216,53,195.35,1000.0,3.79,0.5306
6085,Phillips and Sons,False,BR,South Phillipfurt,Marketplaces,2014,https://phillipsandsons.com,Everybody since character various information.,23,phillips-and-sons,2023,USD,888724,329736,558988,472663,86325,459,85866,8887,17774,68092,43215,526241,190802,335439,,888724,65.83,364.44,0.0425,273,270.57,17680.0,2.44,0.629
6086,Mccarty Taylor and Velez,False,AU,Port Frank,IoT,2012,https://mccartytaylorandvelez.com,Activity good society article work side energy security.,16,mccarty-taylor-and-velez,2023,USD,990249,580058,410191,549418,-139227,0,-139227,9902,19804,-159031,36652,614483,252828,361655,,990249,511.0,936.93,0.1091,1904,43.32,66871.46,0.55,0.4142
6087,Rasmussen Hurst and Bauer,False,AU,Jerryside,Cybersecurity,2017,https://rasmussenhurstandbauer.com,Finally adult moment soon instead bring movement hold really song water.,13,rasmussen-hurst-and-bauer,2023,USD,384791,82935,301856,349732,-47876,0,-47876,3847,7695,-55571,51143,266693,54717,211976,,384791,20.0,80.16,0.1364,626,51.21,28872.36,1.77,0.7845
6088,Alvarado-Hamilton,False,DE,West Ethan,Marketplaces,2019,https://alvarado-hamilton.com,Mission lot between clear positive you project.,23,alvarado-hamilton,2023,EUR,260169,92239,167930,194152,-26222,56309,-82531,2601,5203,-87734,40400,323639,153446,170193,,260169,20.0,53.94,0.1047,679,31.91,5897.08,6.85,0.6455
6089,Wilson Inc,False,ZA,Lake Danielle,AI/ML,2018,https://wilsoninc.com,Knowledge magazine resource sort others tough he quite.,16,wilson-inc,2023,USD,1421166,447729,973437,282286,691151,0,691151,14211,28423,662728,138736,936161,354616,581545,,1421166,1152.96,6161.24,0.1082,591,200.17,20899.33,6.64,0.685
6090,Rivas PLC,False,DE,East Thomas,Mobility,2024,https://rivasplc.com,Under investment section stuff position.,14,rivas-plc,2023,EUR,612038,279960,332078,226944,105134,27795,77339,6120,12240,65099,9092,399222,225832,173390,,612038,271.66,214.22,0.0665,222,229.64,58159.18,0.16,0.5426
6091,Walker Inc,False,GB,Kristinfort,Fintech,2017,https://walkerinc.com,Shoulder alone option challenge themselves watch.,28,walker-inc,2023,USD,1191267,493806,697461,554544,142917,6360,136557,11912,23825,112732,287397,887847,352143,535704,,1191267,1883.58,10340.84,0.0876,710,139.82,35078.05,8.19,0.5855
6092,Sandoval Group,False,BR,Rogersland,EdTech,2014,https://sandovalgroup.com,Month store save education determine half.,22,sandoval-group,2023,USD,150832,56118,94714,90024,4690,38975,-34285,1508,3016,-37301,4600,224209,70978,153231,12569.33,150832,330.05,1265.04,0.0492,317,39.62,1000.0,4.6,0.6279
6093,Thomas Sullivan and Scott,False,KE,Jessicamouth,Marketplaces,2018,https://thomassullivanandscott.com,Point purpose cost away.,19,thomas-sullivan-and-scott,2023,USD,235405,101786,133619,117477,16142,7432,8710,2354,4708,4002,15396,291983,31643,260340,,235405,20.0,32.75,0.1094,182,107.58,1000.0,15.4,0.5676
6094,Jimenez Swanson and Johnson,False,GB,Reginastad,Marketplaces,2023,https://jimenezswansonandjohnson.com,Source many until mention herself exist.,26,jimenez-swanson-and-johnson,2023,USD,70764,22884,47880,46637,1243,49141,-47898,707,1415,-49313,23723,62041,35238,26803,,70764,20.0,29.24,0.0498,15,392.53,51291.98,0.46,0.6766
6095,Salinas Peters and Jacobs,False,CA,Fuentesside,EdTech,2020,https://salinaspetersandjacobs.com,Account item director admit lose.,17,salinas-peters-and-jacobs,2023,USD,323853,99552,224301,167413,56888,9584,47304,3238,6477,40827,20486,209712,82219,127493,26987.75,323853,244.22,944.91,0.0713,534,50.51,22099.64,0.93,0.6926
6096,Hanna Davis and Farrell,False,EG,Norrisbury,Cybersecurity,2016,https://hannadavisandfarrell.com,Table direction claim true blue myself your impact.,23,hanna-davis-and-farrell,2023,USD,792886,301414,491472,520192,-28720,5151,-33871,7928,15857,-49728,46883,594086,29704,564382,,792886,20.0,24.92,0.0881,934,70.74,40587.56,1.16,0.6199
6097,Zavala-Williamson,False,KE,Elizabethbury,Mobility,2018,https://zavala-williamson.com,Bad enough factor direction rise effect.,22,zavala-williamson,2023,USD,1490620,720234,770386,717663,52723,0,52723,14906,29812,22911,375456,1157786,752245,405541,,1490620,556.11,1905.58,0.0702,1168,106.35,52132.91,7.2,0.5168
6098,Wilson-Carr,False,GB,Zacharyfort,AgriTech,2010,https://wilson-carr.com,Program southern real pretty moment loss how again land.,21,wilson-carr,2023,USD,1779426,668019,1111407,153311,958096,20145,937951,17794,35588,902363,154979,1112053,329249,782804,,1779426,74.5,282.93,0.0527,1933,76.68,1000.0,154.98,0.6246
6099,Bishop PLC,False,IN,West Joseph,Fintech,2020,https://bishopplc.com,Laugh interesting camera decision less this.,31,bishop-plc,2023,USD,1156890,633542,523348,621236,-97888,5470,-103358,11568,23137,-126495,143625,800717,643212,157505,,1156890,762.44,4388.55,0.001,4820,20.0,56512.31,2.54,0.4524
6100,Johnson-Griffin,False,NG,Port Shelby,Energy,2008,https://johnson-griffin.com,Protect perform system involve oil.,14,johnson-griffin,2023,USD,2933137,1363514,1569623,146656,1422967,0,1422967,29331,58662,1364305,191745,1757840,87892,1669948,,2933137,1926.98,963.49,0.0478,12076,20.24,26036.63,7.36,0.5351
6101,Coleman and Sons,False,FR,East Danielshire,EdTech,2016,https://colemanandsons.com,Forget letter black wall could green.,26,coleman-and-sons,2023,EUR,922810,246150,676660,574095,102565,0,102565,9228,18456,84109,62949,612299,129926,482373,76900.83,922810,236.99,603.85,0.0046,1271,60.47,9968.75,6.31,0.7333
6102,Wilson-Smith,False,EG,Anthonytown,Mobility,2016,https://wilson-smith.com,Forward shake step data member husband eye.,17,wilson-smith,2023,USD,329447,116433,213014,236765,-23751,4878,-28629,3294,6588,-35217,3558,261729,84559,177170,,329447,977.78,4258.82,0.0888,1372,20.0,24114.37,0.15,0.6466
6103,Smith Inc,False,NG,East Diana,IoT,2021,https://smithinc.com,Senior certain true plant project action fire his cold five.,22,smith-inc,2023,USD,953357,335938,617419,739274,-121855,26575,-148430,9533,19067,-167497,35195,528642,96816,431826,,953357,1457.01,4262.33,0.0609,3972,20.0,98294.11,0.36,0.6476
6104,Jones Chavez and Kane,False,DE,Garciaberg,AgriTech,2009,https://joneschavezandkane.com,Coach since population company big just during.,13,jones-chavez-and-kane,2023,EUR,218692,121824,96868,73278,23590,0,23590,2186,4373,19217,10712,224188,11209,212979,,218692,485.08,612.06,0.001,83,218.76,1000.0,10.71,0.4429
6105,Williams-Lee,False,TN,Jonathanburgh,Marketplaces,2023,https://williams-lee.com,Pass admit follow factor simple attack claim.,19,williams-lee,2023,USD,145803,58545,87258,88991,-1733,0,-1733,1458,2916,-4649,1836,179281,99123,80158,,145803,74.74,274.33,0.0822,607,20.0,20195.8,0.09,0.5985
6106,Davis-Allen,False,KE,Larsonbury,Fintech,2023,https://davis-allen.com,Recent room front word page call person rest receive water.,16,davis-allen,2023,USD,1808512,374427,1434085,1270382,163703,7760,155943,18085,36170,119773,269103,1327169,708922,618247,,1808512,366.04,1512.78,0.0989,7535,20.0,98836.05,2.72,0.793
6107,Deleon LLC,False,TN,Cainbury,Energy,2018,https://deleonllc.com,Throughout course occur cultural her century ability five.,22,deleon-llc,2023,USD,3741498,1354913,2386585,582965,1803620,34631,1768989,37414,74829,1694160,461736,2495312,792165,1703147,,3741498,451.54,1963.6,0.0125,3915,79.62,25250.65,18.29,0.6379
6108,Sullivan-Thomas,False,FR,West Crystalbury,HealthTech,2013,https://sullivan-thomas.com,Relationship vote deal thank church physical interest recently whether young.,15,sullivan-thomas,2023,EUR,506197,236200,269997,25309,244688,38553,206135,5061,10123,196012,89372,376956,276327,100629,42183.08,506197,538.8,2798.99,0.0176,417,101.06,19475.94,4.59,0.5334
6109,Brown LLC,False,FR,Kirkside,E-commerce,2009,https://brownllc.com,Into ever develop employee shake cell idea.,24,brown-llc,2023,EUR,1702429,703292,999137,627526,371611,0,371611,17024,34048,337563,398804,1446088,417697,1028391,,1702429,20.0,84.88,0.1097,934,151.81,76186.39,5.23,0.5869
6110,Robinson PLC,False,US,Mcleanville,Fintech,2016,https://robinsonplc.com,School pass at student way hour goal outside worry central.,26,robinson-plc,2023,USD,1217584,70301,1147283,1033939,113344,29559,83785,12175,24351,59434,45997,812326,512544,299782,,1217584,459.58,1522.88,0.001,1363,74.44,77567.07,0.59,0.9423
6111,Gonzales-Ramirez,False,FR,North Danielle,AI/ML,2016,https://gonzales-ramirez.com,Source allow point experience per best example.,30,gonzales-ramirez,2023,EUR,214790,82162,132628,54561,78067,15856,62211,2147,4295,57916,59742,291612,165903,125709,,214790,645.39,1702.68,0.1038,83,215.38,23683.15,2.52,0.6175
6112,Thornton Hernandez and Baker,False,GB,Garcialand,Fintech,2021,https://thorntonhernandezandbaker.com,Before whole five approach threat significant smile role increase community.,16,thornton-hernandez-and-baker,2023,USD,1937887,921391,1016496,1071088,-54592,27520,-82112,19378,38757,-120869,21135,1099826,507628,592198,,1937887,234.68,231.82,0.0054,840,192.09,79277.11,0.27,0.5245
6113,Dickerson-Crane,False,DE,Leeburgh,SaaS,2009,https://dickerson-crane.com,Quality responsibility its design.,19,dickerson-crane,2023,EUR,1359729,680512,679217,1278338,-599121,20131,-619252,13597,27194,-646446,57333,825430,45772,779658,113310.75,1359729,10.0,88.88,0.0309,22662,5.0,129024.97,0.44,0.4995
6114,Salas-Johnson,False,US,West Ariana,Fintech,2018,https://salas-johnson.com,Movie box bring during task interesting.,20,salas-johnson,2023,USD,1423264,536353,886911,951639,-64728,35657,-100385,14232,28465,-128850,11244,850157,42507,807650,,1423264,178.15,118.64,0.0351,486,243.6,48086.79,0.23,0.6232
6115,Clayton Ltd,False,KE,Patriciafurt,Cybersecurity,2016,https://claytonltd.com,Know great score how create woman authority.,17,clayton-ltd,2023,USD,1079700,403204,676496,446810,229686,7363,222323,10797,21594,200729,93315,662789,548454,114335,,1079700,1443.05,3132.12,0.1164,1626,55.31,21363.88,4.37,0.6266
6116,Castillo Group,False,IN,Shawnport,Energy,2015,https://castillogroup.com,Pick investment son quality employee.,18,castillo-group,2023,USD,3664442,281429,3383013,2464779,918234,5134,913100,36644,73288,839812,380154,2331233,1568488,762745,,3664442,584.15,3421.94,0.0502,10921,27.96,194999.24,1.95,0.9232
6117,Davis-Dennis,False,DE,Stephanieview,EdTech,2016,https://davis-dennis.com,Shoulder allow anything beyond wear attention eye strategy according.,27,davis-dennis,2023,EUR,264245,95126,169119,247770,-78651,2405,-81056,2642,5284,-86340,5471,203383,60086,143297,22020.42,264245,195.66,1295.95,0.0133,482,45.65,26741.76,0.2,0.64
6118,Sampson Inc,False,NG,Freemanburgh,E-commerce,2015,https://sampsoninc.com,Sometimes before it national party question book exist.,15,sampson-inc,2023,USD,631784,161832,469952,104869,365083,45359,319724,6317,12635,307089,31979,375430,192678,182752,,631784,308.24,1075.16,0.0695,278,189.26,1000.0,31.98,0.7438
6119,Sullivan-Moran,False,GB,Perezside,SaaS,2018,https://sullivan-moran.com,Director national until pretty test range author type fast four.,12,sullivan-moran,2023,USD,5270835,1723546,3547289,2206184,1341105,0,1341105,52708,105416,1235689,178227,2980969,149048,2831921,439236.25,5270835,413.6,852.84,0.0026,17326,25.35,224383.62,0.79,0.673
6120,Villegas Becker and Smith,False,AU,West Kristy,EdTech,2013,https://villegasbeckerandsmith.com,Environmental both simply north evening building staff safe vote health.,13,villegas-becker-and-smith,2023,USD,694182,270202,423980,169266,254714,27047,227667,6941,13883,213784,52763,449193,59740,389453,57848.5,694182,10.0,52.51,0.0375,11569,5.0,17182.98,3.07,0.6108
6121,Raymond Collins and Jackson,False,AU,New Andrew,Energy,2014,https://raymondcollinsandjackson.com,Year continue with citizen foot subject site three.,23,raymond-collins-and-jackson,2023,USD,864134,337777,526357,608030,-81673,317,-81990,8641,17282,-99272,5596,566798,249661,317137,,864134,20.0,82.93,0.0011,414,173.62,53132.12,0.11,0.6091
6122,Liu and Sons,False,NG,Lake Tiffany,IoT,2008,https://liuandsons.com,Practice debate laugh low everyone.,19,liu-and-sons,2023,USD,297130,123337,173793,185856,-12063,0,-12063,2971,5942,-18005,3213,256058,116903,139155,,297130,58.15,161.84,0.0451,146,168.48,1000.0,3.21,0.5849
6123,Tapia Group,False,GB,Dillonfort,Fintech,2016,https://tapiagroup.com,Term which television pattern new.,20,tapia-group,2023,USD,564403,98473,465930,39633,426297,18900,407397,5644,11288,396109,40233,510415,193761,316654,,564403,20.0,16.89,0.0363,238,196.91,23545.08,1.71,0.8255
6124,Diaz-Clayton,False,AU,North Mark,Mobility,2011,https://diaz-clayton.com,Should month range whether prove successful fine class live.,18,diaz-clayton,2023,USD,610049,214608,395441,341131,54310,40252,14058,6100,12200,1858,29764,451332,178635,272697,,610049,160.42,190.46,0.001,204,248.42,31121.46,0.96,0.6482
6125,Smith PLC,False,FR,South Patriciatown,EdTech,2021,https://smithplc.com,Week point southern concern model ground foot concern language.,14,smith-plc,2023,EUR,1531166,597468,933698,842610,91088,0,91088,15311,30623,60465,68188,1029470,376007,653463,127597.17,1531166,10.0,62.45,0.0056,1575,80.99,27948.47,2.44,0.6098
6126,Wade-Suarez,False,DE,Stricklandshire,EdTech,2022,https://wade-suarez.com,Speak I along page response population not manager case near.,25,wade-suarez,2023,EUR,529123,119519,409604,192392,217212,0,217212,5291,10582,206630,59074,495573,184384,311189,44093.58,529123,10.0,52.5,0.0537,1754,25.13,1000.0,59.07,0.7741
6127,Pope-Bruce,False,KE,Gonzalezside,HealthTech,2013,https://pope-bruce.com,Reflect paper certain arrive news western hold stage.,19,pope-bruce,2023,USD,154146,23387,130759,96999,33760,0,33760,1541,3082,30678,42894,175406,81513,93893,12845.5,154146,743.77,2371.27,0.0426,220,58.35,1000.0,42.89,0.8483
6128,Gardner-Wilson,False,DE,Port Carla,AgriTech,2011,https://gardner-wilson.com,Institution wall win respond pattern happy.,17,gardner-wilson,2023,EUR,952667,336523,616144,781595,-165451,35570,-201021,9526,19053,-220074,8737,625956,140396,485560,,952667,283.06,1650.44,0.001,388,204.32,57090.29,0.15,0.6468
6129,Reed-Garcia,False,US,Riveramouth,EdTech,2017,https://reed-garcia.com,Baby position born level character several break red enter form.,16,reed-garcia,2023,USD,314429,110119,204310,228585,-24275,0,-24275,3144,6288,-30563,44256,226260,27465,198795,26202.42,314429,637.71,2340.07,0.001,5240,5.0,1000.0,44.26,0.6498
6130,Torres-Stone,False,TN,South Bradley,IoT,2020,https://torres-stone.com,Travel usually while wind ok prevent argue store woman.,19,torres-stone,2023,USD,368065,160759,207306,197800,9506,3836,5670,3680,7361,-1691,2555,210921,88788,122133,,368065,1649.93,1203.23,0.0507,83,369.07,1000.0,2.56,0.5632
6131,Pierce-Williams,False,EG,Port Michael,EdTech,2015,https://pierce-williams.com,These expect assume black us theory production.,13,pierce-williams,2023,USD,869196,150930,718266,661414,56852,0,56852,8691,17383,39469,12414,576098,28804,547294,72433.0,869196,404.18,1774.11,0.0637,2329,31.09,44040.77,0.28,0.8264
6132,Frazier-Williams,False,FR,Singhport,Fintech,2021,https://frazier-williams.com,Small series approach respond individual.,26,frazier-williams,2023,EUR,622919,216948,405971,425712,-19741,4786,-24527,6229,12458,-36985,38952,435518,21775,413743,,622919,1533.93,6666.18,0.0339,232,222.97,23961.6,1.63,0.6517
6133,Anderson-Davis,False,ZA,Ballardberg,Mobility,2022,https://anderson-davis.com,Relationship move daughter forward level shoulder structure term create.,23,anderson-davis,2023,USD,2027848,602539,1425309,1489112,-63803,24440,-88243,20278,40556,-128799,242117,1314644,110954,1203690,,2027848,128.47,925.26,0.0505,5732,29.48,124589.71,1.94,0.7029
6134,Cooper-Jones,False,GB,Smithfort,Cybersecurity,2020,https://cooper-jones.com,Statement federal worker dinner push truth hear page free scene.,10,cooper-jones,2023,USD,3671970,2162892,1509078,841909,667169,0,667169,36719,73439,593730,104224,2049020,686979,1362041,,3671970,20.0,94.41,0.0161,926,330.45,75466.27,1.38,0.411
6135,Mayer Ltd,False,KE,New Emilyhaven,Energy,2008,https://mayerltd.com,Enjoy cause southern cell only.,21,mayer-ltd,2023,USD,2251727,1090570,1161157,1822728,-661571,17424,-678995,22517,45034,-724029,78987,1327257,273688,1053569,,2251727,20.0,32.13,0.0385,1612,116.34,173886.52,0.45,0.5157
6136,Castro-Fitzgerald,False,NG,Vanessamouth,AgriTech,2014,https://castro-fitzgerald.com,Heavy contain pattern indicate campaign include for.,16,castro-fitzgerald,2023,USD,381645,34554,347091,214659,132432,805,131627,3816,7632,123995,23002,375096,48893,326203,,381645,1231.77,615.88,0.0819,212,149.83,41190.86,0.56,0.9095
6137,Brown-Brady,False,BR,South Donald,Mobility,2021,https://brown-brady.com,Arm activity nearly entire likely another.,20,brown-brady,2023,USD,433642,70214,363428,271494,91934,0,91934,4336,8672,83262,11681,246716,52044,194672,,433642,20.0,66.14,0.0283,266,135.44,1000.0,11.68,0.8381
6138,Davis LLC,False,AU,New Christopher,AI/ML,2018,https://davisllc.com,Style total almost nature identify.,31,davis-llc,2023,USD,496505,122012,374493,180861,193632,15340,178292,4965,9930,168362,12166,412951,100014,312937,,496505,538.38,2476.62,0.087,2068,20.0,33649.86,0.36,0.7543
6139,Long-Jones,False,CA,Mccanntown,SaaS,2023,https://long-jones.com,They bank civil deep there each lawyer.,30,long-jones,2023,USD,791834,246141,545693,163537,382156,18863,363293,7918,15836,347457,6565,459815,40720,419095,65986.17,791834,10.0,56.67,0.0429,1194,55.26,42507.04,0.15,0.6892
6140,Vega Mitchell and Guerrero,False,NG,New Stephaniebury,IoT,2020,https://vegamitchellandguerrero.com,Art they blood these market personal adult own artist.,18,vega-mitchell-and-guerrero,2023,USD,267120,135461,131659,364855,-233196,0,-233196,2671,5342,-238538,75071,228522,55237,173285,,267120,1271.64,5070.59,0.0239,865,25.71,66877.04,1.12,0.4929
6141,Mcclain and Sons,False,EG,Amandabury,IoT,2014,https://mcclainandsons.com,Final race mouth yourself traditional.,26,mcclain-and-sons,2023,USD,5464067,2457774,3006293,3894998,-888705,962,-889667,54640,109281,-998948,303394,3036092,836038,2200054,,5464067,20.0,101.48,0.001,1940,234.71,321080.82,0.94,0.5502
6142,Hester Knox and Adams,False,CA,North Natashaside,HealthTech,2010,https://hesterknoxandadams.com,Probably partner voice meeting.,31,hester-knox-and-adams,2023,USD,1352277,698153,654124,416778,237346,0,237346,13522,27045,210301,21733,702459,547874,154585,112689.75,1352277,10.0,31.95,0.0073,3103,36.31,31443.44,0.69,0.4837
6143,Short Walsh and Bell,False,KE,Jeffreyview,Cybersecurity,2020,https://shortwalshandbell.com,Notice give low than author Democrat join believe behind.,22,short-walsh-and-bell,2023,USD,1293081,358484,934597,443531,491066,0,491066,12930,25861,465205,162530,818198,462390,355808,,1293081,202.05,1103.39,0.0598,5387,20.0,39510.75,4.11,0.7228
6144,Davis Group,False,GB,Lake Melissaburgh,Energy,2014,https://davisgroup.com,Leave third realize soldier police various feeling.,19,davis-group,2023,USD,157974,70372,87602,185307,-97705,14034,-111739,1579,3159,-114898,2541,139348,11983,127365,,157974,541.36,955.46,0.0566,190,69.15,50299.44,0.05,0.5545
6145,Carson PLC,False,DE,Allisonland,E-commerce,2019,https://carsonplc.com,Family mean use system fire certainly system quality about energy.,15,carson-plc,2023,EUR,2094331,421624,1672707,949205,723502,0,723502,20943,41886,681616,20043,1127613,362459,765154,,2094331,82.9,183.41,0.0885,1190,146.61,83300.64,0.24,0.7987
6146,Bishop Kim and Robinson,False,TN,Lake Robert,AgriTech,2015,https://bishopkimandrobinson.com,Interesting herself space right indeed kitchen always wait woman life.,19,bishop-kim-and-robinson,2023,USD,313210,129970,183240,206039,-22799,2052,-24851,3132,6264,-31115,12048,304958,48427,256531,,313210,717.36,2006.62,0.0224,1305,20.0,17298.46,0.7,0.585
6147,Newton-Jones,False,ZA,North Shannonburgh,AgriTech,2015,https://newton-jones.com,So degree blood Republican save long accept.,16,newton-jones,2023,USD,809229,233347,575882,286417,289465,10910,278555,8092,16184,262371,45613,515354,154288,361066,,809229,1017.22,2799.26,0.067,3371,20.0,21286.84,2.14,0.7116
6148,Young Group,False,TN,Cookchester,IoT,2023,https://younggroup.com,Most issue person floor type risk husband receive.,20,young-group,2023,USD,229975,36949,193026,98197,94829,0,94829,2299,4599,90230,9776,144206,73914,70292,,229975,898.62,2380.37,0.143,958,20.0,1000.0,9.78,0.8393
6149,Buckley Ltd,False,US,Jacobburgh,Marketplaces,2015,https://buckleyltd.com,Often interest special seem standard.,21,buckley-ltd,2023,USD,1186837,209558,977279,515101,462178,1406,460772,11868,23736,437036,139150,881207,246451,634756,,1186837,536.42,637.2,0.001,279,353.83,47534.89,2.93,0.8234
6150,Mcdonald PLC,False,BR,South Joshuamouth,Cybersecurity,2010,https://mcdonaldplc.com,Always choice however wait happen.,9,mcdonald-plc,2023,USD,1136648,613800,522848,486972,35876,2975,32901,11366,22732,10169,119093,705581,494786,210795,,1136648,692.59,1725.46,0.0427,3251,29.13,27951.0,4.26,0.46
6151,James Hunter and Johnson,False,EG,North Whitneyshire,Cybersecurity,2008,https://jameshunterandjohnson.com,Lay fish social scientist we kitchen lot.,25,james-hunter-and-johnson,2023,USD,746240,297466,448774,224605,224169,0,224169,7462,14924,209245,31924,512840,375813,137027,,746240,20.0,17.86,0.056,526,118.01,5886.95,5.42,0.6014
6152,Wilson-Jackson,False,TN,Jeffreyport,IoT,2019,https://wilson-jackson.com,This shoulder all discussion.,25,wilson-jackson,2023,USD,753116,365637,387479,294401,93078,0,93078,7531,15062,78016,103401,655717,244623,411094,,753116,687.21,3061.1,0.0661,277,226.15,18370.17,5.63,0.5145
6153,Serrano-Patterson,False,CA,South Anthony,Energy,2008,https://serrano-patterson.com,Know doctor home everybody participant.,19,serrano-patterson,2023,USD,1887831,611566,1276265,696911,579354,0,579354,18878,37756,541598,125867,1124796,508581,616215,,1887831,302.5,1431.84,0.0267,1738,90.51,64850.9,1.94,0.676
6154,Thompson Coleman and Patrick,False,EG,Barberside,Energy,2022,https://thompsoncolemanandpatrick.com,Ball father attention very section garden own reduce.,21,thompson-coleman-and-patrick,2023,USD,2279046,871306,1407740,625725,782015,8867,773148,22790,45580,727568,136503,1282804,570013,712791,,2279046,234.53,228.63,0.0895,685,277.06,35467.61,3.85,0.6177
6155,Lopez Yates and Jones,False,TN,Port Daniel,Fintech,2021,https://lopezyatesandjones.com,Southern system him court best no line.,14,lopez-yates-and-jones,2023,USD,925837,322695,603142,348102,255040,9667,245373,9258,18516,226857,63751,675094,167327,507767,,925837,184.99,758.65,0.1064,542,142.22,20837.03,3.06,0.6515
6156,Sanchez Inc,False,IN,Debrahaven,E-commerce,2015,https://sanchezinc.com,Against issue quickly poor every guess message fine decade.,29,sanchez-inc,2023,USD,1930071,436730,1493341,2052215,-558874,0,-558874,19300,38601,-597475,337998,1399059,118588,1280471,,1930071,20.0,73.99,0.0669,656,244.91,146125.56,2.31,0.7737
6157,Waller Inc,False,IN,Lake Lisa,E-commerce,2016,https://wallerinc.com,Standard painting else safe indicate idea everybody figure exist.,21,waller-inc,2023,USD,359688,142964,216724,189208,27516,9880,17636,3596,7193,10443,129717,455559,179969,275590,,359688,481.67,594.09,0.001,239,125.07,52971.1,2.45,0.6025
6158,Daniels Group,False,EG,Kerriborough,HealthTech,2013,https://danielsgroup.com,Who walk book picture language.,25,daniels-group,2023,USD,513062,78773,434289,264883,169406,19772,149634,5130,10261,139373,24148,416305,20815,395490,42755.17,513062,10.0,34.84,0.0236,1384,30.89,45518.99,0.53,0.8465
6159,Walters-Blake,False,DE,Hillshire,IoT,2024,https://walters-blake.com,Scientist least traditional without its hot return least.,13,walters-blake,2023,EUR,423444,220978,202466,75199,127267,47752,79515,4234,8468,71047,32238,437341,39707,397634,,423444,372.92,506.07,0.0645,159,221.52,1000.0,32.24,0.4781
6160,Nelson Inc,False,KE,Port Sean,AI/ML,2014,https://nelsoninc.com,Politics side effort young professional hold better.,21,nelson-inc,2023,USD,1085464,322240,763224,379997,383227,14019,369208,10854,21709,347499,34888,719436,451122,268314,,1085464,44.13,77.63,0.0349,579,156.0,61526.76,0.57,0.7031
6161,Jackson-Norton,False,US,West Elizabethstad,Energy,2019,https://jackson-norton.com,Say truth bank person political economy alone.,15,jackson-norton,2023,USD,1010830,367956,642874,361428,281446,0,281446,10108,20216,261230,79751,634811,52592,582219,,1010830,1728.21,7937.56,0.0165,468,179.89,22974.37,3.47,0.636
6162,Davis and Sons,False,US,East Bethshire,EdTech,2010,https://davisandsons.com,Group final modern yourself someone compare live wear.,27,davis-and-sons,2023,USD,143925,17646,126279,7196,119083,29162,89921,1439,2878,87043,12908,180116,42893,137223,11993.75,143925,10.0,32.3,0.0823,343,34.89,5651.22,2.28,0.8774
6163,Perez Wade and Liu,False,ZA,West Bradley,HealthTech,2010,https://perezwadeandliu.com,Close authority education plant pretty interesting art scene somebody.,24,perez-wade-and-liu,2023,USD,84871,29606,55265,30637,24628,0,24628,848,1697,22931,2375,80861,25929,54932,7072.58,84871,10.0,16.25,0.0029,88,79.72,2228.51,1.07,0.6512
6164,Collins Group,False,KE,North Jennifer,Cybersecurity,2009,https://collinsgroup.com,His dark view push these herself need tell benefit summer education.,23,collins-group,2023,USD,1023949,156715,867234,577243,289991,13343,276648,10239,20478,256170,59917,645490,159672,485818,,1023949,1220.72,3391.38,0.001,4266,20.0,49645.37,1.21,0.847
6165,Graham Mack and Soto,False,IN,Lake Kimberlyshire,Fintech,2024,https://grahammackandsoto.com,Hope Mr pull ahead at tree cut course simple add.,17,graham-mack-and-soto,2023,USD,840472,197256,643216,180236,462980,8916,454064,8404,16809,437255,117736,601676,30083,571593,,840472,1226.46,4479.0,0.1516,530,132.12,31252.17,3.77,0.7653
6166,Castillo-Chung,False,IN,Lake Anitaland,Mobility,2012,https://castillo-chung.com,Speech decision third would TV vote prove fill age war.,23,castillo-chung,2023,USD,224441,69831,154610,182562,-27952,0,-27952,2244,4488,-32440,2528,234921,134950,99971,,224441,789.03,3829.97,0.0328,72,259.73,1000.0,2.53,0.6889
6167,Jackson-Cunningham,False,IN,Brittanyville,HealthTech,2021,https://jackson-cunningham.com,Major day type what give family last over watch officer.,18,jackson-cunningham,2023,USD,1243895,701408,542487,860329,-317842,0,-317842,12438,24877,-342719,223281,870505,342416,528089,103657.92,1243895,10.0,19.22,0.0315,1987,52.15,95202.89,2.35,0.4361
6168,Rogers Group,False,IN,North Barbara,HealthTech,2015,https://rogersgroup.com,Any game side old image production environment set draw offer.,18,rogers-group,2023,USD,3475408,1087364,2388044,1357271,1030773,24911,1005862,34754,69508,936354,617873,2512851,1024350,1488501,289617.33,3475408,10.0,41.98,0.0736,1891,153.08,77089.84,8.01,0.6871
6169,Anderson Molina and Green,False,TN,Port Tina,AgriTech,2013,https://andersonmolinaandgreen.com,Lose those individual attorney recently budget feel claim why sometimes.,20,anderson-molina-and-green,2023,USD,137906,24865,113041,65735,47306,7828,39478,1379,2758,36720,6298,242662,169757,72905,,137906,20.0,10.0,0.1046,272,42.13,1000.0,6.3,0.8197
6170,Jimenez Todd and Lopez,False,NG,South Elizabethburgh,Fintech,2015,https://jimeneztoddandlopez.com,Lose identify into dream town break short agreement.,23,jimenez-todd-and-lopez,2023,USD,1266143,480901,785242,504960,280282,10579,269703,12661,25322,244381,64531,830972,277336,553636,,1266143,704.01,1500.4,0.1276,5275,20.0,48682.61,1.33,0.6202
6171,Wright Joseph and Brown,False,FR,Osbornhaven,IoT,2009,https://wrightjosephandbrown.com,Recent material page customer long represent Republican ball.,23,wright-joseph-and-brown,2023,EUR,209451,74176,135275,59954,75321,17471,57850,2094,4189,53661,8347,192498,30753,161745,,209451,1126.61,3321.26,0.0843,81,214.06,5575.87,1.5,0.6459
6172,Garcia Alexander and Skinner,False,KE,West Morgan,Marketplaces,2013,https://garciaalexanderandskinner.com,Beyond force voice everything human successful pattern interview even government.,21,garcia-alexander-and-skinner,2023,USD,1820404,722675,1097729,1000824,96905,0,96905,18204,36408,60497,311058,1331211,692898,638313,,1820404,20.0,85.4,0.0765,7585,20.0,77766.39,4.0,0.603
6173,Bailey Ltd,False,IN,South Christopherville,AI/ML,2023,https://baileyltd.com,Responsibility significant key available sea form travel.,17,bailey-ltd,2023,USD,3489846,901995,2587851,2810327,-222476,23190,-245666,34898,69796,-315462,38584,1793838,155873,1637965,,3489846,20.0,10.0,0.0044,14541,20.0,226967.52,0.17,0.7415
6174,James-Wright,False,TN,Lake Melissaborough,HealthTech,2015,https://james-wright.com,Understand soon study talk vote sort challenge level international.,14,james-wright,2023,USD,509707,202233,307474,312219,-4745,13706,-18451,5097,10194,-28645,2673,297890,110263,187627,42475.58,509707,171.47,874.4,0.001,1690,25.13,28269.72,0.09,0.6032
6175,Ball PLC,False,US,Johnmouth,EdTech,2010,https://ballplc.com,Rise final believe event couple institution effect.,21,ball-plc,2023,USD,400020,225288,174732,204111,-29379,23747,-53126,4000,8000,-61126,16397,321992,84421,237571,33335.0,400020,396.08,1419.84,0.0608,944,35.29,32787.74,0.5,0.4368
6176,Cross-Jordan,False,FR,East Joshuachester,Fintech,2016,https://cross-jordan.com,Information sell everything great call none away media.,21,cross-jordan,2023,EUR,2144375,374777,1769598,107218,1662380,45663,1616717,21443,42887,1573830,113424,1197500,147995,1049505,,2144375,1894.33,8895.33,0.0954,712,250.83,1000.0,113.42,0.8252
6177,Wright PLC,False,AU,Scottberg,HealthTech,2011,https://wrightplc.com,Spring close role modern respond local believe.,25,wright-plc,2023,USD,1753297,455927,1297370,360262,937108,0,937108,17532,35065,902043,172386,1119562,234805,884757,146108.08,1753297,625.92,4672.97,0.0132,2261,64.6,9658.15,17.85,0.74
6178,Lambert Powell and Davis,False,AU,New Bryan,Mobility,2019,https://lambertpowellanddavis.com,Avoid mention choice true strategy change director apply.,31,lambert-powell-and-davis,2023,USD,242994,83053,159941,43698,116243,41878,74365,2429,4859,69506,1512,296383,101901,194482,,242994,470.25,235.12,0.051,435,46.54,1000.0,1.51,0.6582
6179,Wilson Obrien and Mcdonald,False,ZA,East Joseph,HealthTech,2012,https://wilsonobrienandmcdonald.com,Program yeah what rate participant fly tend else control treat.,19,wilson-obrien-and-mcdonald,2023,USD,1631773,458855,1172918,1263029,-90111,33428,-123539,16317,32635,-156174,37326,967197,275930,691267,135981.08,1631773,375.12,1398.95,0.0066,4412,30.82,106140.64,0.35,0.7188
6180,Larson Howard and Bentley,False,NG,Jacksonfurt,HealthTech,2015,https://larsonhowardandbentley.com,Major military standard again.,23,larson-howard-and-bentley,2023,USD,1611084,570036,1041048,878853,162195,27095,135100,16110,32221,102879,42544,910318,191859,718459,134257.0,1611084,10.0,46.69,0.0124,1500,89.5,48128.34,0.88,0.6462
6181,Shaffer Hodge and Taylor,False,AU,Calvinborough,SaaS,2018,https://shafferhodgeandtaylor.com,Wonder particularly none respond significant less.,23,shaffer-hodge-and-taylor,2023,USD,2590802,718251,1872551,1050041,822510,0,822510,25908,51816,770694,371446,1821964,1005273,816691,215900.17,2590802,432.58,1909.97,0.0116,1778,121.38,76287.29,4.87,0.7228
6182,Alexander Ltd,False,GB,New Amy,AgriTech,2024,https://alexanderltd.com,West two couple space sort dream where next paper professional.,11,alexander-ltd,2023,USD,304042,152321,151721,83854,67867,26703,41164,3040,6080,35084,7087,206942,10347,196595,,304042,20.0,131.42,0.0637,154,164.18,1000.0,7.09,0.499
6183,Navarro Group,False,US,Rayborough,AI/ML,2024,https://navarrogroup.com,Ground anyone executive nice century baby long.,29,navarro-group,2023,USD,1419701,422264,997437,368438,628999,0,628999,14197,28394,600605,127864,903008,86473,816535,,1419701,20.0,24.92,0.001,5915,20.0,49682.28,2.57,0.7026
6184,Rogers-Nichols,False,US,Mullinsport,Energy,2012,https://rogers-nichols.com,Near kid let record response sea early alone.,20,rogers-nichols,2023,USD,851342,295700,555642,292334,263308,0,263308,8513,17026,246282,12338,495147,123734,371413,,851342,20.0,93.13,0.001,560,126.61,27398.0,0.45,0.6527
6185,Thomas Barker and Morse,False,GB,Williamsport,SaaS,2023,https://thomasbarkerandmorse.com,Some decade charge deep sense on expect be production.,20,thomas-barker-and-morse,2023,USD,681461,239005,442456,508124,-65668,329,-65997,6814,13629,-79626,8168,418003,87364,330639,56788.42,681461,242.0,242.0,0.0362,451,125.65,60229.2,0.14,0.6493
6186,Rogers Allen and Rowland,False,GB,North Brandonshire,HealthTech,2015,https://rogersallenandrowland.com,Rather research president second else number work production who lawyer.,13,rogers-allen-and-rowland,2023,USD,998273,300843,697430,430447,266983,30836,236147,9982,19965,216182,80252,698845,210180,488665,83189.42,998273,292.2,1339.05,0.0267,8179,10.17,12896.19,6.22,0.6986
6187,Harrison Ltd,False,KE,Bradyview,E-commerce,2016,https://harrisonltd.com,Event kitchen reach always see there.,30,harrison-ltd,2023,USD,715234,308151,407083,112252,294831,32648,262183,7152,14304,247879,8870,492594,222588,270006,,715234,557.84,1762.23,0.0288,529,112.55,2736.21,3.24,0.5692
6188,Williams Oneill and Jenkins,False,EG,Ashleyport,EdTech,2022,https://williamsoneillandjenkins.com,Reveal radio still mention bar society.,18,williams-oneill-and-jenkins,2023,USD,86359,16437,69922,47148,22774,33284,-10510,863,1727,-12237,6154,145090,26299,118791,7196.58,86359,593.7,1267.16,0.0694,126,56.83,1000.0,6.15,0.8097
6189,Bailey Group,False,GB,North Alexandra,Cybersecurity,2011,https://baileygroup.com,That bit thus music important it hear hot provide.,19,bailey-group,2023,USD,331104,72735,258369,353748,-95379,0,-95379,3311,6622,-102001,19686,282569,116842,165727,,331104,477.85,858.06,0.0478,175,157.34,6802.69,2.89,0.7803
6190,Payne Barber and Jones,False,ZA,North Samanthashire,EdTech,2013,https://paynebarberandjones.com,Mind military white claim career professor practice team.,23,payne-barber-and-jones,2023,USD,267599,117476,150123,116931,33192,5317,27875,2675,5351,22524,16733,154579,101814,52765,22299.92,267599,245.18,1039.78,0.0624,223,99.87,40240.91,0.42,0.561
6191,Singh Kirk and Francis,False,BR,North Brian,IoT,2009,https://singhkirkandfrancis.com,Long grow week low because.,22,singh-kirk-and-francis,2023,USD,1220494,460443,760051,214926,545125,26422,518703,12204,24409,494294,37199,703551,282818,420733,,1220494,844.49,5040.23,0.0483,359,282.95,17146.03,2.17,0.6227
6192,Jackson-Kennedy,False,FR,Lake Johnburgh,Energy,2012,https://jackson-kennedy.com,Thought ever develop spring can spring myself wear.,21,jackson-kennedy,2023,EUR,132744,49509,83235,6637,76598,7640,68958,1327,2654,66304,27331,157686,86584,71102,,132744,20.0,37.59,0.0207,70,156.86,1000.0,27.33,0.627
6193,Kelly-Scott,False,US,Port Patrick,AgriTech,2022,https://kelly-scott.com,Magazine leader language adult care turn.,18,kelly-scott,2023,USD,151236,56222,95014,7561,87453,5077,82376,1512,3024,79352,5775,101150,47912,53238,,151236,1594.51,5027.51,0.0794,64,196.34,1000.0,5.78,0.6282
6194,Allen Group,False,NG,Benjaminmouth,Mobility,2020,https://allengroup.com,Generation baby detail officer report politics send finish.,12,allen-group,2023,USD,203063,81869,121194,92209,28985,20632,8353,2030,4061,4292,4940,181044,101923,79121,,203063,537.11,3194.1,0.0032,846,20.0,1000.0,4.94,0.5968
6195,Chambers Ltd,False,NG,Millerside,AI/ML,2020,https://chambersltd.com,Treatment lead organization employee respond describe value whom at argue.,22,chambers-ltd,2023,USD,901979,170524,731455,759543,-28088,13465,-41553,9019,18039,-59592,93247,621860,210847,411013,,901979,63.96,146.4,0.0353,1265,59.39,77660.05,1.2,0.8109
6196,Washington Allen and Roth,False,NG,Lake Hannahshire,Mobility,2024,https://washingtonallenandroth.com,Glass whole indeed moment compare standard lose environment general.,23,washington-allen-and-roth,2023,USD,639561,328290,311271,163183,148088,0,148088,6395,12791,135297,110891,578747,220362,358385,,639561,1278.59,6084.59,0.043,519,102.59,16299.33,6.8,0.4867
6197,Lawrence-Castro,False,CA,Wigginsborough,IoT,2020,https://lawrence-castro.com,Military success free leg Republican someone capital.,18,lawrence-castro,2023,USD,419088,96254,322834,72744,250090,21455,228635,4190,8381,220254,6798,294563,99710,194853,,419088,1782.84,891.42,0.0655,1158,30.15,9157.99,0.74,0.7703
6198,Villanueva and Sons,False,AU,Port Adrianabury,AgriTech,2024,https://villanuevaandsons.com,Throughout network already wait magazine method choose affect election trade.,22,villanueva-and-sons,2023,USD,421781,245552,176229,130321,45908,0,45908,4217,8435,37473,5431,404467,171171,233296,,421781,20.0,73.02,0.001,1757,20.0,33707.33,0.16,0.4178
6199,Lang and Sons,False,TN,North Derek,HealthTech,2024,https://langandsons.com,Think arm they action no worry leave remain customer.,19,lang-and-sons,2023,USD,236888,63774,173114,54503,118611,27505,91106,2368,4737,86369,196564,322830,33840,288990,19740.67,236888,10.0,58.42,0.0342,3948,5.0,6629.97,29.65,0.7308
6200,Collins-Chen,False,EG,Lake Stevenfort,HealthTech,2009,https://collins-chen.com,Set war difficult face country foot.,25,collins-chen,2023,USD,2458239,762181,1696058,1891038,-194980,12357,-207337,24582,49164,-256501,122635,1363456,142770,1220686,204853.25,2458239,802.2,2087.36,0.0245,1544,132.6,193496.98,0.63,0.6899
6201,Stewart Group,False,DE,Jasminehaven,Fintech,2019,https://stewartgroup.com,Myself off girl floor they sense.,24,stewart-group,2023,EUR,8603584,3236840,5366744,4803853,562891,31284,531607,86035,172071,359536,346646,4726057,3112626,1613431,,8603584,2144.76,11458.25,0.0286,10480,68.41,382199.31,0.91,0.6238
6202,Ortiz-Tucker,False,IN,Roberttown,Fintech,2021,https://ortiz-tucker.com,According why these decision early finally show analysis.,20,ortiz-tucker,2023,USD,1622109,665872,956237,1126935,-170698,10329,-181027,16221,32442,-213469,253829,1122306,56115,1066191,,1622109,68.57,218.67,0.001,472,285.99,108766.35,2.33,0.5895
6203,Mccoy Group,False,TN,New Devon,Energy,2017,https://mccoygroup.com,Ever story recognize area west director east country product term.,11,mccoy-group,2023,USD,1305556,640734,664822,133439,531383,33597,497786,13055,26111,471675,11733,858448,343851,514597,,1305556,970.26,5222.33,0.0148,817,133.15,70220.97,0.17,0.5092
6204,Jackson-Rubio,False,CA,Georgehaven,SaaS,2018,https://jackson-rubio.com,Beautiful phone these investment huge former military education.,22,jackson-rubio,2023,USD,524029,77050,446979,209756,237223,11839,225384,5240,10480,214904,28426,407547,193744,213803,43669.08,524029,10.0,18.67,0.0218,8733,5.0,26313.25,1.08,0.853
6205,Holt Gardner and Price,False,EG,Lorichester,EdTech,2008,https://holtgardnerandprice.com,Help road ground eight late part full.,13,holt-gardner-and-price,2023,USD,574293,329195,245098,525717,-280619,15765,-296384,5742,11485,-307869,56186,490915,49456,441459,47857.75,574293,405.25,2178.61,0.001,4035,11.86,37881.06,1.48,0.4268
6206,Williams-May,False,DE,Edwardfort,Energy,2012,https://williams-may.com,Be glass early say wife plan identify effect.,18,williams-may,2023,EUR,624223,132268,491955,137064,354891,9566,345325,6242,12484,332841,39519,359324,104887,254437,,624223,1756.27,7779.42,0.078,1683,30.89,1000.0,39.52,0.7881
6207,Norris-Huang,False,EG,New Erinmouth,IoT,2012,https://norris-huang.com,Catch worry talk report candidate hotel throughout up ability.,20,norris-huang,2023,USD,929246,401787,527459,418488,108971,0,108971,9292,18584,90387,60848,588230,353969,234261,,929246,321.93,2183.38,0.1111,3871,20.0,40962.92,1.49,0.5676
6208,Smith-Lane,False,BR,Lake Karenfort,AgriTech,2020,https://smith-lane.com,Plant impact personal federal natural different cause same quickly.,15,smith-lane,2023,USD,73109,19723,53386,23596,29790,16786,13004,731,1462,11542,29788,146990,58099,88891,,73109,46.25,106.38,0.0332,35,169.95,17278.63,1.72,0.7302
6209,Allen Kim and Tucker,False,DE,South Clayton,HealthTech,2008,https://allenkimandtucker.com,Bar meet check that above seat able good spring page.,18,allen-kim-and-tucker,2023,EUR,1493660,363953,1129707,1026406,103301,8661,94640,14936,29873,64767,38756,984889,118848,866041,124471.67,1493660,43.74,240.79,0.0598,6013,20.7,72445.62,0.53,0.7563
6210,Kirk Thompson and Harris,False,DE,North Kelseyborough,Mobility,2016,https://kirkthompsonandharris.com,Myself commercial happy forward carry upon popular.,19,kirk-thompson-and-harris,2023,EUR,7387569,2912736,4474833,5581056,-1106223,0,-1106223,73875,147751,-1253974,891584,4779751,1132721,3647030,,7387569,93.6,450.02,0.0351,2096,293.71,489677.94,1.82,0.6057
6211,Spencer-Pruitt,False,EG,Williamland,Energy,2022,https://spencer-pruitt.com,Traditional local find responsibility doctor live part crime step sit.,29,spencer-pruitt,2023,USD,629441,298446,330995,31472,299523,15875,283648,6294,12588,271060,10454,330016,162784,167232,,629441,371.63,185.82,0.001,857,61.16,1000.0,10.45,0.5259
6212,Marsh-Jackson,False,ZA,Morsefurt,Mobility,2019,https://marsh-jackson.com,Ahead less character dream month daughter old little.,19,marsh-jackson,2023,USD,724728,245169,479559,297614,181945,800,181145,7247,14494,166651,26538,499512,370148,129364,,724728,459.55,1831.27,0.0418,3019,20.0,38701.38,0.69,0.6617
6213,Mathews-Juarez,False,DE,East Cliffordside,Mobility,2012,https://mathews-juarez.com,Dinner go network trouble truth share teacher.,19,mathews-juarez,2023,EUR,323284,137860,185424,107930,77494,18520,58974,3232,6465,52509,19630,379626,118724,260902,,323284,1716.63,6565.62,0.001,108,247.73,1000.0,19.63,0.5736
6214,Tapia Grant and Miller,False,TN,Michaelfort,SaaS,2015,https://tapiagrantandmiller.com,Itself eight newspaper Republican become draw few continue.,21,tapia-grant-and-miller,2023,USD,410931,51267,359664,46230,313434,0,313434,4109,8218,305216,53451,414286,240514,173772,34244.25,410931,161.67,263.53,0.0404,6848,5.0,37391.37,1.43,0.8752
6215,Porter Garcia and Humphrey,False,GB,West Jenniferburgh,Marketplaces,2011,https://portergarciaandhumphrey.com,Happen benefit one stage later important free research chair.,19,porter-garcia-and-humphrey,2023,USD,2020699,336718,1683981,1228657,455324,15369,439955,20206,40413,399542,48990,1093143,203037,890106,,2020699,604.36,3181.26,0.1181,1095,153.68,127886.76,0.38,0.8334
6216,Bennett-Weeks,False,IN,West Christina,E-commerce,2009,https://bennett-weeks.com,Doctor meet follow enough agree side north.,25,bennett-weeks,2023,USD,778125,103221,674904,143994,530910,0,530910,7781,15562,515348,72678,551221,205705,345516,,778125,20.0,36.36,0.0154,3242,20.0,1000.0,72.68,0.8673
6217,Bates Beasley and Burnett,False,CA,Gordonhaven,Mobility,2020,https://batesbeasleyandburnett.com,Modern crime continue field produce skill.,20,bates-beasley-and-burnett,2023,USD,555568,270685,284883,27778,257105,16592,240513,5555,11111,229402,23148,376901,108848,268053,,555568,20.0,58.04,0.001,2314,20.0,2203.91,10.5,0.5128
6218,Miller Ltd,False,BR,Lake Robert,Energy,2010,https://millerltd.com,Time describe star whole media law major role star dark.,15,miller-ltd,2023,USD,1330329,422676,907653,357343,550310,1619,548691,13303,26606,522085,56525,767778,105507,662271,,1330329,800.58,2885.27,0.0228,450,245.91,34195.33,1.65,0.6823
6219,Stewart Inc,False,KE,West Tara,AgriTech,2019,https://stewartinc.com,Easy various record third agree start wait.,19,stewart-inc,2023,USD,526633,141671,384962,209356,175606,12170,163436,5266,10532,152904,12409,457024,103319,353705,,526633,178.95,404.46,0.0782,129,339.93,42551.34,0.29,0.731
6220,Russo Group,False,NG,Perezview,AI/ML,2023,https://russogroup.com,Leg bit me measure though.,28,russo-group,2023,USD,1188269,541229,647040,631905,15135,23757,-8622,11882,23765,-32387,50299,701941,337238,364703,,1188269,785.4,1730.42,0.001,262,376.66,11376.05,4.42,0.5445
6221,Powell-Garcia,False,US,South Thomas,Mobility,2010,https://powell-garcia.com,Public drug something appear fall order hold side.,16,powell-garcia,2023,USD,236477,149499,86978,103495,-16517,8517,-25034,2364,4729,-29763,6084,243128,108254,134874,,236477,549.82,971.28,0.0914,251,78.3,1000.0,6.08,0.3678
6222,Mercer Ltd,False,CA,Graytown,E-commerce,2014,https://mercerltd.com,Light enjoy answer movement factor respond show add people.,17,mercer-ltd,2023,USD,1301140,296191,1004949,808288,196661,39039,157622,13011,26022,131600,3235,802650,40132,762518,,1301140,20.0,42.09,0.0779,372,291.16,54846.29,0.06,0.7724
6223,Logan LLC,False,IN,Nicholasland,AI/ML,2013,https://loganllc.com,Late continue perform its budget college bill party.,16,logan-llc,2023,USD,2456560,627725,1828835,850006,978829,3594,975235,24565,49131,926104,20352,1420495,527193,893302,,2456560,20.0,65.33,0.107,1287,158.99,68827.76,0.3,0.7445
6224,Lewis and Sons,False,US,Robinsontown,Fintech,2012,https://lewisandsons.com,Support some would meeting any.,20,lewis-and-sons,2023,USD,1948400,258900,1689500,830115,859385,0,859385,19484,38968,820417,355734,1341080,706374,634706,,1948400,114.95,228.47,0.0301,1483,109.43,47639.86,7.47,0.8671
6225,Russell Morrison and Burgess,False,ZA,Reidburgh,Cybersecurity,2016,https://russellmorrisonandburgess.com,Chance bring bit clearly husband kind health develop must line.,28,russell-morrison-and-burgess,2023,USD,2215111,822838,1392273,2870638,-1478365,11474,-1489839,22151,44302,-1534141,19558,1177865,509880,667985,,2215111,1275.04,1369.56,0.0398,2971,62.12,222401.94,0.09,0.6285
6226,Newton LLC,False,US,Carlsonhaven,SaaS,2024,https://newtonllc.com,Public yourself door there huge remain there situation travel.,27,newton-llc,2023,USD,935942,218350,717592,605736,111856,8255,103601,9359,18718,84883,15017,547401,81175,466226,77995.17,935942,462.98,1151.52,0.0452,1520,51.29,90311.58,0.17,0.7667
6227,Davis Rowe and Peterson,False,DE,North Wendy,Marketplaces,2024,https://davisroweandpeterson.com,Their not finish official natural open never.,19,davis-rowe-and-peterson,2023,EUR,820601,265618,554983,123683,431300,6383,424917,8206,16412,408505,21109,556026,256963,299063,,820601,357.99,1315.53,0.0774,659,103.62,1000.0,21.11,0.6763
6228,Johnson Sanchez and Haley,False,CA,Joanneview,SaaS,2022,https://johnsonsanchezandhaley.com,Risk military street past worry situation brother southern same.,17,johnson-sanchez-and-haley,2023,USD,185564,72124,113440,117522,-4082,27510,-31592,1855,3711,-35303,8779,289081,115859,173222,15463.67,185564,10.0,51.58,0.1214,263,58.74,1000.0,8.78,0.6113
6229,Reed Wilson and Washington,False,TN,Port Wendyside,E-commerce,2022,https://reedwilsonandwashington.com,Skill operation score some act.,15,reed-wilson-and-washington,2023,USD,358671,88912,269759,17933,251826,0,251826,3586,7173,244653,21744,206718,98645,108073,,358671,20.0,99.59,0.1476,1494,20.0,1000.0,21.74,0.7521
6230,Williams Fox and Liu,False,CA,Port Sarahview,IoT,2018,https://williamsfoxandliu.com,Learn western carry environmental type.,20,williams-fox-and-liu,2023,USD,283972,123032,160940,95178,65762,866,64896,2839,5679,59217,31362,240734,75456,165278,,283972,1737.0,8363.66,0.0846,341,69.33,11981.26,2.62,0.5667
6231,Jones Inc,False,IN,North Nicolefort,E-commerce,2009,https://jonesinc.com,They traditional rate yet majority.,13,jones-inc,2023,USD,1970912,600925,1369987,255790,1114197,2057,1112140,19709,39418,1072722,99870,1119201,692989,426212,,1970912,1211.87,1381.29,0.0796,2640,62.2,39599.23,2.52,0.6951
6232,Castillo-Colon,False,AU,Garciaton,AI/ML,2011,https://castillo-colon.com,Popular author moment each scene reduce compare agreement civil half.,19,castillo-colon,2023,USD,763847,372249,391598,38192,353406,0,353406,7638,15276,338130,32348,414713,109023,305690,,763847,850.41,3204.72,0.001,549,115.93,1000.0,32.35,0.5127
6233,Campbell-Daniels,False,EG,East Trevorburgh,Mobility,2021,https://campbell-daniels.com,Remain join east strong raise artist should eat south.,20,campbell-daniels,2023,USD,468749,165674,303075,128369,174706,0,174706,4687,9374,165332,20758,408396,20419,387977,,468749,1134.08,4497.68,0.001,485,80.48,1000.0,20.76,0.6466
6234,Garcia-Vazquez,False,AU,North Ryan,AI/ML,2009,https://garcia-vazquez.com,She speech dinner either dinner exist house product miss experience.,29,garcia-vazquez,2023,USD,342848,43605,299243,98491,200752,34666,166086,3428,6856,159230,26744,338173,200841,137332,,342848,20.0,59.1,0.1181,813,35.12,24286.15,1.1,0.8728
6235,Rodriguez-Martin,False,BR,South Gabriellaberg,AI/ML,2024,https://rodriguez-martin.com,Provide land war forget whose appear establish probably man training.,17,rodriguez-martin,2023,USD,1121321,688592,432729,350214,82515,0,82515,11213,22426,60089,25430,599504,374462,225042,,1121321,20.0,50.9,0.001,744,125.44,14130.68,1.8,0.3859
6236,Wright Jackson and Hanna,False,FR,New Madisonside,HealthTech,2020,https://wrightjacksonandhanna.com,Bit plan up everyone including food thousand.,13,wright-jackson-and-hanna,2023,EUR,671969,267549,404420,313210,91210,0,91210,6719,13439,77771,80082,430620,70238,360382,55997.42,671969,880.48,4530.36,0.0452,750,74.63,7802.01,10.26,0.6018
6237,Snyder-Harris,False,CA,Valdezchester,Marketplaces,2022,https://snyder-harris.com,Sport couple night chair attack ball describe.,8,snyder-harris,2023,USD,1434398,720199,714199,564059,150140,0,150140,14343,28687,121453,53039,836868,173985,662883,,1434398,303.63,151.82,0.0769,780,153.08,47306.84,1.12,0.4979
6238,English LLC,False,ZA,Lake Julie,Cybersecurity,2016,https://englishllc.com,Forget consumer TV school audience.,23,english-llc,2023,USD,999745,405975,593770,441542,152228,28541,123687,9997,19994,103693,49047,583266,195154,388112,,999745,69.19,231.53,0.1481,4165,20.0,39094.39,1.25,0.5939
6239,Perez LLC,False,GB,New Felicia,HealthTech,2014,https://perezllc.com,Close effort long possible increase standard whether actually somebody front.,18,perez-llc,2023,USD,3939928,2165542,1774386,427736,1346650,41322,1305328,39399,78798,1226530,484752,2555302,127765,2427537,328327.33,3939928,438.5,766.21,0.0383,3531,92.96,19776.07,24.51,0.4504
6240,Walsh-Lopez,False,FR,Matthewfort,IoT,2020,https://walsh-lopez.com,Physical enough pick world population realize north benefit know.,17,walsh-lopez,2023,EUR,1165329,188268,977061,386281,590780,0,590780,11653,23306,567474,19281,797819,39890,757929,,1165329,443.95,1436.22,0.1721,1324,73.32,1000.0,19.28,0.8384
6241,Franklin-Miller,False,IN,North Julian,Energy,2015,https://franklin-miller.com,Fill family can enjoy defense push paper theory.,31,franklin-miller,2023,USD,1521262,552204,969058,768789,200269,13251,187018,15212,30425,156593,98183,943253,166791,776462,,1521262,20.0,73.2,0.0697,548,231.24,63698.52,1.54,0.637
6242,Fry-Mendez,False,US,West Jennifer,SaaS,2017,https://fry-mendez.com,Other someone reach fire able throw serve.,15,fry-mendez,2023,USD,4858282,2179969,2678313,1038627,1639686,0,1639686,48582,97165,1542521,1055993,3644687,1090043,2554644,404856.83,4858282,10.0,69.07,0.0156,6442,62.84,84504.52,12.5,0.5513
6243,Banks Perry and Rodriguez,False,US,East Joshuabury,HealthTech,2014,https://banksperryandrodriguez.com,Behavior check power involve live chair fund interview task tell.,25,banks-perry-and-rodriguez,2023,USD,1226587,639979,586608,267379,319229,0,319229,12265,24531,294698,37492,655097,355561,299536,102215.58,1226587,415.48,2919.49,0.0016,20443,5.0,13172.55,2.85,0.4782
6244,Johnson Vance and Fernandez,False,TN,Lake Richardshire,IoT,2014,https://johnsonvanceandfernandez.com,Claim green leg early attack board late senior shoulder.,21,johnson-vance-and-fernandez,2023,USD,516476,224006,292470,413079,-120609,0,-120609,5164,10329,-130938,48084,343723,118412,225311,,516476,20.0,92.74,0.001,2151,20.0,56301.59,0.85,0.5663
6245,Hernandez-Mccarty,False,TN,West Bryce,HealthTech,2021,https://hernandez-mccarty.com,Side organization inside leave way.,26,hernandez-mccarty,2023,USD,875596,248267,627329,713780,-86451,5143,-91594,8755,17511,-109105,13607,547288,82298,464990,72966.33,875596,478.21,875.83,0.0303,1786,40.85,101708.06,0.13,0.7165
6246,Hebert-Clark,False,NG,Johnview,IoT,2016,https://hebert-clark.com,Other water pull resource administration try artist method up.,28,hebert-clark,2023,USD,327838,200684,127154,274720,-147566,2192,-149758,3278,6556,-156314,24277,249535,92060,157475,,327838,20.0,35.96,0.0551,236,115.3,35509.81,0.68,0.3879
6247,Boyd-Miller,False,DE,Elliston,SaaS,2010,https://boyd-miller.com,Low court partner reveal decade court son day break explain.,21,boyd-miller,2023,EUR,3699741,1917127,1782614,366735,1415879,19846,1396033,36997,73994,1322039,46202,2022905,1014262,1008643,308311.75,3699741,10.0,48.96,0.0155,3218,95.79,33032.52,1.4,0.4818
6248,Rojas Ltd,False,GB,Kristyport,SaaS,2016,https://rojasltd.com,Realize contain action read during might between.,26,rojas-ltd,2023,USD,1011728,352547,659181,878764,-219583,8841,-228424,10117,20234,-248658,17731,606796,130259,476537,84310.67,1011728,375.71,2248.77,0.0251,833,101.11,77196.14,0.23,0.6515
6249,Potter Benjamin and Reyes,False,ZA,South Kelsey,Mobility,2010,https://potterbenjaminandreyes.com,Impact program power under role attack reveal instead maybe war.,22,potter-benjamin-and-reyes,2023,USD,1891781,507581,1384200,1256988,127212,0,127212,18917,37835,89377,761702,1725114,671029,1054085,,1891781,670.23,1720.52,0.0436,690,228.32,106700.57,7.14,0.7317
6250,Hoffman and Sons,False,DE,Lake Janetview,Mobility,2013,https://hoffmanandsons.com,Soon else morning week organization music.,14,hoffman-and-sons,2023,EUR,1419237,573671,845566,610771,234795,1268,233527,14192,28384,205143,26590,748648,258675,489973,,1419237,1482.42,3617.79,0.001,602,196.29,50091.57,0.53,0.5958
6251,Manning-Hansen,False,BR,Lake Kevin,Mobility,2011,https://manning-hansen.com,College indicate same responsibility fall buy wife.,19,manning-hansen,2023,USD,553669,81486,472183,91095,381088,15419,365669,5536,11073,354596,13978,345306,179315,165991,,553669,342.09,2584.88,0.0302,2306,20.0,1000.0,13.98,0.8528
6252,Morales-Woods,False,FR,North Angelaburgh,Marketplaces,2022,https://morales-woods.com,Stage dog investment anyone a then generation economy yard his.,16,morales-woods,2023,EUR,216884,100631,116253,155417,-39164,0,-39164,2168,4337,-43501,11220,222571,65459,157112,,216884,2301.22,12015.03,0.0323,74,243.27,11001.27,1.02,0.536
6253,Meyers LLC,False,AU,West Robin,E-commerce,2019,https://meyersllc.com,Away officer sea herself two real value politics trade.,20,meyers-llc,2023,USD,886024,248218,637806,151064,486742,5681,481061,8860,17720,463341,24576,485233,75597,409636,,886024,20.0,24.13,0.001,301,244.79,1593.7,15.42,0.7199
6254,Peterson Group,False,EG,Kelleyborough,AgriTech,2018,https://petersongroup.com,Hit appear important buy season him fish deal court treat decision.,20,peterson-group,2023,USD,460506,185185,275321,118662,156659,17633,139026,4605,9210,129816,8814,429040,158022,271018,,460506,23.49,114.07,0.001,725,52.88,1000.0,8.81,0.5979
6255,White-Lawson,False,BR,North Tammyview,Marketplaces,2018,https://white-lawson.com,Information hundred past effort firm soldier throw me myself.,15,white-lawson,2023,USD,1030321,246058,784263,336090,448173,21547,426626,10303,20606,406020,112788,649940,205536,444404,,1030321,20.0,99.18,0.1598,495,173.36,73186.35,1.54,0.7612
6256,Pittman-Shaffer,False,NG,Lake Ashleyshire,HealthTech,2024,https://pittman-shaffer.com,For democratic detail country break friend plan turn be Congress remain.,13,pittman-shaffer,2023,USD,266099,92744,173355,274210,-100855,0,-100855,2660,5321,-106176,3799,273302,120677,152625,22174.92,266099,204.96,353.07,0.0599,328,67.47,44580.55,0.09,0.6515
6257,Rosales-Garcia,False,BR,Crawfordfort,AgriTech,2015,https://rosales-garcia.com,Involve job rich send matter simple clear throw style.,34,rosales-garcia,2023,USD,144646,49348,95298,130261,-34963,18858,-53821,1446,2892,-56713,10642,212206,40509,171697,,144646,1171.78,1324.89,0.0714,271,44.45,11241.61,0.95,0.6588
6258,Smith Inc,False,DE,Hensleyville,SaaS,2021,https://smithinc.com,Common simple money daughter dream very know off beat environmental.,16,smith-inc,2023,EUR,1539563,659565,879998,167063,712935,0,712935,15395,30791,682144,5360,960933,48046,912887,128296.92,1539563,10.0,44.03,0.0404,1422,90.22,30546.06,0.18,0.5716
6259,Lamb Burke and Turner,False,EG,Stephaniechester,AgriTech,2018,https://lambburkeandturner.com,Where summer happen arm value those charge reason.,18,lamb-burke-and-turner,2023,USD,407651,189453,218198,252456,-34258,0,-34258,4076,8153,-42411,35066,291413,82518,208895,,407651,370.89,837.4,0.0235,481,70.55,1000.0,35.07,0.5353
6260,Oneal-Barrett,False,NG,West Paulahaven,AgriTech,2023,https://oneal-barrett.com,Either head bill machine.,26,oneal-barrett,2023,USD,318791,100479,218312,262208,-43896,0,-43896,3187,6375,-50271,176713,479130,230786,248344,,318791,20.0,10.0,0.001,302,87.89,44191.08,4.0,0.6848
6261,Mitchell LLC,False,ZA,Lake Kelliestad,Energy,2009,https://mitchellllc.com,Red guess try positive far local staff common.,22,mitchell-llc,2023,USD,733024,189517,543507,104116,439391,896,438495,7330,14660,423835,27845,571355,229315,342040,,733024,226.75,771.04,0.001,388,157.39,7504.1,3.71,0.7415
6262,Thomas-Meyer,False,KE,Lake Christine,AgriTech,2016,https://thomas-meyer.com,Less discover step our support.,16,thomas-meyer,2023,USD,1189720,237084,952636,1088044,-135408,31905,-167313,11897,23794,-191107,44516,657581,174575,483006,,1189720,1548.09,2690.23,0.1413,865,114.54,60924.3,0.73,0.8007
6263,Burke-Singh,False,FR,Johnfurt,HealthTech,2015,https://burke-singh.com,Sit throw ready price somebody one letter fly figure even.,14,burke-singh,2023,EUR,1095668,681385,414283,411362,2921,11259,-8338,10956,21913,-30251,78896,747002,252833,494169,91305.67,1095668,91.1,409.91,0.001,1547,58.99,54859.89,1.44,0.3781
6264,Forbes-Stevens,False,AU,Daymouth,EdTech,2015,https://forbes-stevens.com,Program contain religious culture worker.,23,forbes-stevens,2023,USD,91810,57065,34745,29188,5557,35679,-30122,918,1836,-31958,36445,172909,54995,117914,7650.83,91810,253.46,920.38,0.034,114,66.95,1000.0,36.44,0.3784
6265,Yang Pratt and Patterson,False,EG,Benderberg,HealthTech,2011,https://yangprattandpatterson.com,Because piece for hundred society story magazine role collection.,22,yang-pratt-and-patterson,2023,USD,181767,75834,105933,75935,29998,9899,20099,1817,3635,16464,6861,278059,196608,81451,15147.25,181767,468.28,468.28,0.027,1941,7.8,38321.19,0.18,0.5828
6266,Walker-Cook,False,ZA,Harmonbury,AI/ML,2024,https://walker-cook.com,Quality thing little painting short account.,18,walker-cook,2023,USD,824517,253733,570784,518012,52772,0,52772,8245,16490,36282,19045,446810,147549,299261,,824517,1827.37,6795.91,0.001,3435,20.0,88856.31,0.21,0.6923
6267,Wagner-Lambert,False,CA,Thomasburgh,Energy,2020,https://wagner-lambert.com,Rich cold against actually more.,15,wagner-lambert,2023,USD,2953487,960514,1992973,1723010,269963,45967,223996,29534,59069,164927,1273061,2884207,1089812,1794395,,2953487,258.58,129.29,0.001,1532,160.57,166792.91,7.63,0.6748
6268,Moore PLC,False,TN,Annton,IoT,2018,https://mooreplc.com,Sense forget provide door receive hand traditional month.,18,moore-plc,2023,USD,710098,218935,491163,256069,235094,0,235094,7100,14201,220893,25117,532357,325527,206830,,710098,717.74,358.87,0.027,819,72.21,8921.74,2.82,0.6917
6269,Warner-Williams,False,IN,Lake Jordan,Fintech,2015,https://warner-williams.com,It firm catch despite fall about agency wide man art.,14,warner-williams,2023,USD,2427941,862485,1565456,1152388,413068,4582,408486,24279,48558,359928,553718,1960210,98010,1862200,,2427941,20.0,10.0,0.0149,2373,85.26,98001.39,5.65,0.6448
6270,Morse George and Davis,False,GB,Riveramouth,IoT,2023,https://morsegeorgeanddavis.com,President realize sense stand address major significant it.,19,morse-george-and-davis,2023,USD,2722806,1170540,1552266,136140,1416126,2919,1413207,27228,54456,1358751,102157,1464209,918028,546181,,2722806,533.87,3621.7,0.0366,1144,198.18,42024.34,2.43,0.5701
6271,Williams Howard and Graham,False,BR,New Mason,Fintech,2018,https://williamshowardandgraham.com,Hotel have appear customer event yourself.,20,williams-howard-and-graham,2023,USD,343679,168729,174950,233302,-58352,7565,-65917,3436,6873,-72790,52648,356164,45092,311072,,343679,1106.34,553.17,0.1343,242,118.06,38951.53,1.35,0.5091
6272,Bailey-Ruiz,False,US,Pricebury,Energy,2020,https://bailey-ruiz.com,Different task prepare blood.,15,bailey-ruiz,2023,USD,1880421,672053,1208368,172806,1035562,34968,1000594,18804,37608,962986,219902,1251259,241231,1010028,,1880421,20.0,64.42,0.0914,786,199.23,23017.96,9.55,0.6426
6273,Cruz-Vasquez,False,TN,Port Amandaview,HealthTech,2021,https://cruz-vasquez.com,Sister entire Mrs culture himself woman.,15,cruz-vasquez,2023,USD,150138,29650,120488,63448,57040,36838,20202,1501,3002,17200,1916,201316,19091,182225,12511.5,150138,580.83,2474.29,0.0775,495,25.25,12876.03,0.15,0.8025
6274,Rubio PLC,False,EG,Lake Matthewstad,SaaS,2018,https://rubioplc.com,Professional might church room receive continue especially.,22,rubio-plc,2023,USD,1540895,711077,829818,760514,69304,27000,42304,15408,30817,11487,116208,939724,427967,511757,128407.92,1540895,217.47,852.05,0.0148,3303,38.87,60754.15,1.91,0.5385
6275,Johnson Smith and Cline,False,CA,Lake Geneton,Fintech,2017,https://johnsonsmithandcline.com,Four until Congress police picture star.,21,johnson-smith-and-cline,2023,USD,7655944,2132198,5523746,3489186,2034560,0,2034560,76559,153118,1881442,235841,4146000,1650919,2495081,,7655944,1353.68,4906.54,0.0813,2732,233.48,319604.45,0.74,0.7215
6276,Howard Cohen and Weber,False,DE,Port Victoriaborough,Mobility,2023,https://howardcohenandweber.com,Hope fear democratic speech way either.,23,howard-cohen-and-weber,2023,EUR,1778946,707185,1071761,313869,757892,59575,698317,17789,35578,662739,321170,1386622,779608,607014,,1778946,736.03,2932.44,0.1458,787,188.27,48793.45,6.58,0.6025
6277,Weber Group,False,TN,Allisonchester,IoT,2014,https://webergroup.com,Reduce deep voice company process possible health commercial outside step own.,16,weber-group,2023,USD,1436924,516658,920266,732829,187437,1004,186433,14369,28738,157695,48006,952679,445132,507547,,1436924,20.0,54.23,0.032,761,157.21,43591.67,1.1,0.6404
6278,Reyes and Sons,False,TN,Kevintown,Energy,2015,https://reyesandsons.com,Picture area sea yet rate.,21,reyes-and-sons,2023,USD,1310690,393580,917110,359028,558082,0,558082,13106,26213,531869,99636,811982,432500,379482,,1310690,1014.23,5185.06,0.1855,380,287.42,1000.0,99.64,0.6997
6279,Shaw Burns and Mitchell,False,IN,Rochamouth,EdTech,2013,https://shawburnsandmitchell.com,Take will small lay assume agree gas white lay design.,17,shaw-burns-and-mitchell,2023,USD,584638,166493,418145,304023,114122,18044,96078,5846,11692,84386,49064,378224,18911,359313,48719.83,584638,307.73,1910.75,0.0507,789,61.71,13227.13,3.71,0.7152
6280,Cannon Turner and Aguirre,False,CA,Rebeccamouth,HealthTech,2018,https://cannonturnerandaguirre.com,Worker require generation safe bag which.,18,cannon-turner-and-aguirre,2023,USD,299054,64873,234181,273214,-39033,52618,-91651,2990,5981,-97632,6141,330038,151595,178443,24921.17,299054,357.99,1243.09,0.0193,777,32.04,8036.47,0.76,0.7831
6281,King LLC,False,KE,Griffinburgh,Energy,2010,https://kingllc.com,My religious democratic station treatment state weight spend.,22,king-llc,2023,USD,378448,61690,316758,154409,162349,5075,157274,3784,7568,149706,6625,335447,234900,100547,,378448,405.82,1450.08,0.0486,115,271.89,16705.05,0.4,0.837
6282,Graham Group,False,FR,Stephaniehaven,Fintech,2010,https://grahamgroup.com,See plan dog price summer both.,17,graham-group,2023,EUR,1069735,531435,538300,416958,121342,21667,99675,10697,21394,78281,64204,738663,386142,352521,,1069735,293.24,350.23,0.0273,337,264.14,11151.37,5.76,0.5032
6283,Mitchell-Travis,False,AU,East Angela,Cybersecurity,2008,https://mitchell-travis.com,Fund own might argue country daughter role several.,20,mitchell-travis,2023,USD,173578,65964,107614,8678,98936,5189,93747,1735,3471,90276,12417,242486,31911,210575,,173578,20.0,99.53,0.0979,138,104.76,1000.0,12.42,0.62
6284,Wong-Sheppard,False,GB,East Gerald,AI/ML,2021,https://wong-sheppard.com,Half people so possible even article story item box factor.,21,wong-sheppard,2023,USD,2073583,1211548,862035,811117,50918,18856,32062,20735,41471,-9409,134802,1201542,102511,1099031,,2073583,468.58,234.29,0.0372,1210,142.78,84706.44,1.59,0.4157
6285,Shaffer PLC,False,EG,Hunterfurt,Fintech,2012,https://shafferplc.com,Just range information me rest man mean how.,20,shaffer-plc,2023,USD,798266,305178,493088,540065,-46977,18979,-65956,7982,15965,-81921,105471,581970,341133,240837,,798266,20.0,35.64,0.001,898,74.04,23662.12,4.46,0.6177
6286,Stephens and Sons,False,US,New Ryanbury,SaaS,2023,https://stephensandsons.com,Parent business son southern pick deep time just lose activity position.,23,stephens-and-sons,2023,USD,1509511,675612,833899,614694,219205,17302,201903,15095,30190,171713,172116,1060523,53026,1007497,125792.58,1509511,99.06,386.94,0.035,7171,17.54,26932.05,6.39,0.5524
6287,Johnson-Cox,False,GB,Williamsmouth,SaaS,2012,https://johnson-cox.com,Lay week future bag project.,23,johnson-cox,2023,USD,592568,95640,496928,440657,56271,3970,52301,5925,11851,40450,16629,339351,219352,119999,49380.67,592568,19.76,119.41,0.043,1617,30.53,2345.77,7.09,0.8386
6288,Jones-Dunlap,False,IN,South Dana,E-commerce,2019,https://jones-dunlap.com,Often nice meet future detail opportunity before customer sometimes.,17,jones-dunlap,2023,USD,1350209,267302,1082907,671810,411097,12616,398481,13502,27004,371477,159915,947744,203198,744546,,1350209,780.14,1494.55,0.0396,490,229.58,86992.39,1.84,0.802
6289,Frank Group,False,BR,Port William,IoT,2010,https://frankgroup.com,Law individual reflect technology room sometimes professor off.,15,frank-group,2023,USD,214636,70275,144361,156947,-12586,0,-12586,2146,4292,-16878,3592,164152,57746,106406,,214636,587.11,1128.88,0.001,107,166.03,46314.64,0.08,0.6726
6290,Henry Dean and Lee,False,US,West Danielland,HealthTech,2017,https://henrydeanandlee.com,Far site page ready anything management exist what each tend.,24,henry-dean-and-lee,2023,USD,361316,148905,212411,375596,-163185,17282,-180467,3613,7226,-187693,41297,275402,214211,61191,30109.67,361316,622.28,4116.04,0.0327,362,83.0,1000.0,41.3,0.5879
6291,Haas Ltd,False,CA,East Joshua,Fintech,2009,https://haasltd.com,Under floor describe almost stage.,11,haas-ltd,2023,USD,4196744,1818815,2377929,2254916,123013,0,123013,41967,83934,39079,82137,2313763,115688,2198075,,4196744,800.29,2513.69,0.0973,1832,190.89,208860.96,0.39,0.5666
6292,Moody Ltd,False,KE,East Robert,Fintech,2009,https://moodyltd.com,Significant moment billion item front risk over continue interview.,31,moody-ltd,2023,USD,929753,287379,642374,645683,-3309,25444,-28753,9297,18595,-47348,37128,647507,84025,563482,,929753,1727.02,3617.66,0.1015,1214,63.8,67641.72,0.55,0.6909
6293,King Inc,False,KE,Hernandezview,SaaS,2014,https://kinginc.com,Behind year stock item western.,24,king-inc,2023,USD,797737,372148,425589,444947,-19358,24706,-44064,7977,15954,-60018,33715,547734,53177,494557,66478.08,797737,10.0,39.37,0.0982,1484,44.78,35628.23,0.95,0.5335
6294,Davis-Young,False,AU,West Jamesberg,HealthTech,2020,https://davis-young.com,Audience watch situation push wait day mind old argue.,15,davis-young,2023,USD,200374,87648,112726,208447,-95721,30509,-126230,2003,4007,-130237,30441,305177,60608,244569,16697.83,200374,296.4,2202.03,0.0052,338,49.34,1000.0,30.44,0.5626
6295,Mejia-Carney,False,EG,Ashleyfurt,Fintech,2016,https://mejia-carney.com,Hope nothing the account next three until kitchen these truth.,21,mejia-carney,2023,USD,2428495,725224,1703271,1092567,610704,0,610704,24284,48569,562135,94078,1395963,583062,812901,,2428495,1141.6,4603.9,0.1083,7058,28.67,91315.24,1.03,0.7014
6296,Long-Miller,False,KE,Rodgersview,AgriTech,2024,https://long-miller.com,Research reality partner radio set.,28,long-miller,2023,USD,162349,84329,78020,74939,3081,0,3081,1623,3246,-165,51243,265879,197563,68316,,162349,20.0,38.07,0.0417,676,20.0,1000.0,51.24,0.4806
6297,Sweeney LLC,False,FR,New Anthony,IoT,2017,https://sweeneyllc.com,Great person ten court teacher to.,25,sweeney-llc,2023,EUR,883865,171679,712186,210726,501460,0,501460,8838,17677,483783,484093,1105672,440744,664928,,883865,520.83,1252.18,0.0372,3682,20.0,1000.0,484.09,0.8058
6298,Curry-Johnson,False,GB,Williamsville,Fintech,2022,https://curry-johnson.com,Speak citizen various hear policy system staff instead smile bad threat.,24,curry-johnson,2023,USD,1935749,1225813,709936,822985,-113049,10376,-123425,19357,38714,-162139,89685,1107070,528746,578324,,1935749,1864.47,4680.3,0.001,1640,98.36,48561.14,1.85,0.3668
6299,Quinn Group,False,KE,Benjaminborough,AgriTech,2013,https://quinngroup.com,Question moment skill according society coach voice floor bring call.,23,quinn-group,2023,USD,201737,37327,164410,111895,52515,0,52515,2017,4034,48481,12120,158619,50896,107723,,201737,411.53,1077.89,0.001,61,272.72,1000.0,12.12,0.815
6300,Brandt Group,False,BR,South Valerie,Cybersecurity,2024,https://brandtgroup.com,Deal forward fact issue economy condition young.,23,brandt-group,2023,USD,3615449,1522130,2093319,1629945,463374,0,463374,36154,72308,391066,81296,1895448,751534,1143914,,3615449,451.51,400.63,0.029,1599,188.39,125348.86,0.65,0.579
6301,Benjamin-Thomas,False,FR,Michaelbury,Mobility,2015,https://benjamin-thomas.com,Risk note during school sing exactly food.,24,benjamin-thomas,2023,EUR,2879419,212038,2667381,143970,2523411,61646,2461765,28794,57588,2404177,113982,1606347,441395,1164952,,2879419,1575.05,5342.61,0.0972,978,245.19,2679.41,42.54,0.9264
6302,Gordon-Cowan,False,ZA,Port Michellemouth,AgriTech,2009,https://gordon-cowan.com,Need item agreement despite mother special.,22,gordon-cowan,2023,USD,112882,16428,96454,69595,26859,0,26859,1128,2257,24602,1692,121581,22078,99503,,112882,944.16,472.08,0.078,21,434.41,43463.07,0.04,0.8545
6303,Holland Inc,False,TN,Lake Lauraland,E-commerce,2013,https://hollandinc.com,Serve have receive result.,22,holland-inc,2023,USD,575472,160657,414815,253095,161720,20215,141505,5754,11509,129996,10766,480388,260797,219591,,575472,1227.12,3176.52,0.0882,380,125.87,1000.0,10.77,0.7208
6304,Chung Brandt and Miller,False,ZA,Leslieport,Mobility,2022,https://chungbrandtandmiller.com,Behavior hand region case chair.,14,chung-brandt-and-miller,2023,USD,2034888,884082,1150806,869874,280932,0,280932,20348,40697,240235,77143,1117836,182933,934903,,2034888,927.45,2594.18,0.1321,1641,103.33,83851.24,0.92,0.5655
6305,Howard Mann and Anthony,False,CA,New Angela,AI/ML,2017,https://howardmannandanthony.com,Win religious bring short happy.,17,howard-mann-and-anthony,2023,USD,548364,223176,325188,193056,132132,8993,123139,5483,10967,112172,126793,545324,240553,304771,,548364,20.0,34.12,0.0899,171,267.02,26245.28,4.83,0.593
6306,Cooper and Sons,False,IN,Sarahfurt,Marketplaces,2020,https://cooperandsons.com,Future politics back seem drug indicate.,18,cooper-and-sons,2023,USD,1859936,886623,973313,1279571,-306258,0,-306258,18599,37198,-343456,717635,1698091,150036,1548055,,1859936,587.18,2941.39,0.0531,1224,126.57,117066.01,6.13,0.5233
6307,Ortiz-Miller,False,TN,North Christinamouth,EdTech,2017,https://ortiz-miller.com,Every hard some page to certainly.,14,ortiz-miller,2023,USD,268859,128559,140300,194839,-54539,0,-54539,2688,5377,-59916,2803,277519,62116,215403,22404.92,268859,322.43,522.14,0.0079,513,43.63,1000.0,2.8,0.5218
6308,Charles and Sons,False,BR,Port Markfurt,E-commerce,2014,https://charlesandsons.com,Blood everyone end agreement food job.,21,charles-and-sons,2023,USD,88951,22464,66487,45332,21155,0,21155,889,1779,19376,16502,131611,58329,73282,,88951,1984.62,4485.72,0.1073,35,207.43,8730.94,1.89,0.7475
6309,Kerr-Washington,False,DE,Nguyenchester,Mobility,2012,https://kerr-washington.com,Herself bring company class worker certainly.,23,kerr-washington,2023,EUR,1654457,364712,1289745,1376915,-87170,3511,-90681,16544,33089,-123770,71218,975803,48790,927013,,1654457,747.78,3691.97,0.1055,6893,20.0,128192.84,0.56,0.7796
6310,Smith PLC,False,ZA,Sullivanmouth,HealthTech,2009,https://smithplc.com,Rule from million spend bag mouth bit court.,24,smith-plc,2023,USD,1092373,512678,579695,412928,166767,0,166767,10923,21847,144920,20092,635017,333303,301714,91031.08,1092373,192.52,192.52,0.0228,1049,86.73,9261.14,2.17,0.5307
6311,Guzman Nicholson and Lewis,False,FR,Danielleland,SaaS,2011,https://guzmannicholsonandlewis.com,Nation it partner plant level.,30,guzman-nicholson-and-lewis,2023,EUR,900052,284635,615417,402569,212848,0,212848,9000,18001,194847,175216,793760,414432,379328,75004.33,900052,281.0,1679.67,0.0113,1812,41.38,54545.28,3.21,0.6838
6312,Weeks-Tran,False,GB,South Carolynfurt,Fintech,2022,https://weeks-tran.com,Wrong Republican difficult cut rock speech him with.,31,weeks-tran,2023,USD,1439993,776488,663505,769743,-106238,0,-106238,14399,28799,-135037,146871,1065558,374940,690618,,1439993,815.71,1177.87,0.0405,1815,66.1,53759.69,2.73,0.4608
6313,Miller LLC,False,GB,South Josephberg,HealthTech,2010,https://millerllc.com,Process voice hear light activity.,17,miller-llc,2023,USD,909586,336345,573241,521364,51877,0,51877,9095,18191,33686,151700,802848,447564,355284,75798.83,909586,10.0,31.27,0.0818,8167,9.28,86518.41,1.75,0.6302
6314,Hale and Sons,False,IN,East Haleyton,E-commerce,2018,https://haleandsons.com,Level beautiful worker upon blood think particular customer.,19,hale-and-sons,2023,USD,824357,424231,400126,452970,-52844,17990,-70834,8243,16487,-87321,13298,477286,302965,174321,,824357,270.7,1093.32,0.126,435,157.76,43098.71,0.31,0.4854
6315,Richardson and Sons,False,KE,New Ryan,EdTech,2023,https://richardsonandsons.com,Office late eye national recognize media.,21,richardson-and-sons,2023,USD,358333,159764,198569,207798,-9229,11,-9240,3583,7166,-16406,40535,272016,101583,170433,29861.08,358333,71.85,85.35,0.0314,451,66.07,3910.14,10.37,0.5541
6316,Gonzalez-Anderson,False,TN,Lewisview,Energy,2011,https://gonzalez-anderson.com,To finish economic son tree.,23,gonzalez-anderson,2023,USD,1169782,302015,867767,560183,307584,0,307584,11697,23395,284189,164896,922587,225436,697151,,1169782,20.0,45.29,0.1082,894,109.01,9550.46,17.27,0.7418
6317,Schroeder and Sons,False,BR,Morganberg,Marketplaces,2017,https://schroederandsons.com,Yeah forward strategy walk store customer space argue include.,24,schroeder-and-sons,2023,USD,1562960,563013,999947,996451,3496,0,3496,15629,31259,-27763,162859,1070004,637892,432112,,1562960,20.0,114.66,0.0254,6512,20.0,100535.08,1.62,0.6398
6318,Stephens Jones and Burns,False,ZA,North Lindsay,EdTech,2023,https://stephensjonesandburns.com,Action result term tend community.,26,stephens-jones-and-burns,2023,USD,359471,64469,295002,122212,172790,9426,163364,3594,7189,156175,16858,210082,134779,75303,29955.92,359471,10.0,42.12,0.0412,332,90.11,19463.45,0.87,0.8207
6319,Miller Inc,False,BR,Port Jacobmouth,SaaS,2019,https://millerinc.com,Listen white sort somebody our head red.,18,miller-inc,2023,USD,773556,405769,367787,121670,246117,7033,239084,7735,15471,223613,8967,497979,176121,321858,64463.0,773556,10.0,28.47,0.0632,12892,5.0,1000.0,8.97,0.4754
6320,Michael-Pena,False,GB,Tracyland,Energy,2014,https://michael-pena.com,Recently south something century affect blood consider.,19,michael-pena,2023,USD,508887,179953,328934,292821,36113,1056,35057,5088,10177,24880,24320,366382,129187,237195,,508887,1761.56,7854.65,0.1251,251,168.67,64096.56,0.38,0.6464
6321,Hill Group,False,CA,Port Richardville,Fintech,2009,https://hillgroup.com,See whose network boy cut however avoid watch.,17,hill-group,2023,USD,1015499,491208,524291,888254,-363963,28764,-392727,10154,20309,-413036,49465,674734,324274,350460,,1015499,841.21,420.6,0.0386,890,95.01,81292.56,0.61,0.5163
6322,Romero Wells and Jefferson,False,US,Lake Bruceberg,AgriTech,2020,https://romerowellsandjefferson.com,Computer American interview up better cell street quickly.,23,romero-wells-and-jefferson,2023,USD,177496,45080,132416,115444,16972,0,16972,1774,3549,13423,10847,103654,5182,98472,,177496,20.0,10.0,0.0175,739,20.0,1000.0,10.85,0.746
6323,Davis Dennis and Wright,False,GB,Nelsonport,Mobility,2022,https://davisdennisandwright.com,Sea memory difficult customer recent site close walk.,19,davis-dennis-and-wright,2023,USD,874223,380925,493298,819973,-326675,3438,-330113,8742,17484,-347597,609175,1116370,218421,897949,,874223,20.0,47.35,0.1472,660,110.31,43113.23,14.13,0.5643
6324,Hall Inc,False,BR,Griffinborough,Energy,2018,https://hallinc.com,Table defense material letter son father character war government.,22,hall-inc,2023,USD,1719076,685380,1033696,666840,366856,11052,355804,17190,34381,321423,63037,948908,854017,94891,,1719076,871.91,3268.93,0.0547,1428,100.26,33089.83,1.91,0.6013
6325,Holland-Benson,False,EG,North Eric,HealthTech,2018,https://holland-benson.com,Minute deep serve others effort under.,20,holland-benson,2023,USD,197048,72788,124260,103839,20421,28206,-7785,1970,3940,-11725,2597,120533,39390,81143,16420.67,197048,619.72,1073.32,0.0074,2319,7.08,22002.62,0.12,0.6306
6326,Barrett Inc,False,ZA,West Brandonbury,Cybersecurity,2021,https://barrettinc.com,Many or born develop put language black agreement.,24,barrett-inc,2023,USD,1058854,319631,739223,52942,686281,19333,666948,10588,21177,645771,28240,724658,574294,150364,,1058854,307.7,650.58,0.0738,4411,20.0,3587.69,7.87,0.6981
6327,Lopez Davis and Nolan,False,BR,Paulatown,E-commerce,2013,https://lopezdavisandnolan.com,Concern make they whole weight modern last race.,14,lopez-davis-and-nolan,2023,USD,377404,152118,225286,234196,-8910,6650,-15560,3774,7548,-23108,12234,283499,202425,81074,,377404,20.0,10.0,0.0441,140,223.28,6792.54,1.8,0.5969
6328,Miller-Harris,False,US,South Wandastad,HealthTech,2016,https://miller-harris.com,Guess say shake those sport state kitchen fight some.,20,miller-harris,2023,USD,1024966,267318,757648,526308,231340,0,231340,10249,20499,210841,85047,647268,310116,337152,85413.83,1024966,637.72,2384.05,0.0312,1568,54.45,5221.41,16.29,0.7392
6329,Martinez Welch and Bennett,False,TN,Lake Samuelfort,Fintech,2023,https://martinezwelchandbennett.com,Section great important open into lay.,20,martinez-welch-and-bennett,2023,USD,3344077,1286707,2057370,1391886,665484,11159,654325,33440,66881,587444,203877,2012348,970904,1041444,,3344077,1248.78,4670.83,0.0914,2535,109.92,132728.71,1.54,0.6152
6330,Nelson-Weber,False,CA,North Kelly,HealthTech,2009,https://nelson-weber.com,Science experience young language action line a partner program.,20,nelson-weber,2023,USD,4565673,1893616,2672057,3380202,-708145,10658,-718803,45656,91313,-810116,119599,2558659,558622,2000037,380472.75,4565673,745.44,4242.64,0.0847,31758,11.98,291527.01,0.41,0.5852
6331,Reyes Brock and Solomon,False,GB,North Thomasview,EdTech,2024,https://reyesbrockandsolomon.com,Party along staff herself improve American fish.,19,reyes-brock-and-solomon,2023,USD,472767,127872,344895,229167,115728,0,115728,4727,9455,106273,53478,365947,135073,230874,39397.25,472767,843.85,6701.94,0.0107,788,49.99,15299.49,3.5,0.7295
6332,Wilson Yates and Johnson,False,KE,Lake Janetland,Mobility,2016,https://wilsonyatesandjohnson.com,Season vote watch much power although.,20,wilson-yates-and-johnson,2023,USD,2885922,1006602,1879320,1258122,621198,3851,617347,28859,57718,559629,115551,1620844,81042,1539802,,2885922,357.53,1469.4,0.0608,1410,170.56,109288.08,1.06,0.6512
6333,Acosta-Cisneros,False,DE,East Sandraside,Cybersecurity,2013,https://acosta-cisneros.com,Speech identify why approach despite measure policy.,21,acosta-cisneros,2023,EUR,1765804,243355,1522449,128976,1393473,13666,1379807,17658,35316,1344491,49809,1070341,604409,465932,,1765804,675.46,337.73,0.001,905,162.5,26422.47,1.89,0.8622
6334,Brown LLC,False,TN,East Sherryfurt,SaaS,2008,https://brownllc.com,Moment resource site character government body chair daughter.,16,brown-llc,2023,USD,1391779,349957,1041822,961433,80389,2557,77832,13917,27835,49997,37579,863034,157389,705645,115981.58,1391779,207.98,1290.4,0.001,7072,16.4,94059.89,0.4,0.7486
6335,Webb Ltd,False,BR,East Andrew,E-commerce,2018,https://webbltd.com,Shake finally himself reach thought.,20,webb-ltd,2023,USD,49368,14554,34814,18506,16308,0,16308,493,987,15321,2468,213792,60749,153043,,49368,367.39,1482.84,0.1117,143,28.71,11760.27,0.21,0.7052
6336,Montgomery and Sons,False,AU,Port Charlesstad,IoT,2019,https://montgomeryandsons.com,Offer little wonder until recent whom candidate material.,13,montgomery-and-sons,2023,USD,117318,67025,50293,58646,-8353,7414,-15767,1173,2346,-18113,27940,248880,41447,207433,,117318,1551.69,7455.32,0.0513,50,193.55,1000.0,27.94,0.4287
6337,Anderson Bird and Fuentes,False,CA,Michaelfurt,SaaS,2011,https://andersonbirdandfuentes.com,Same respond that along try business process miss blue.,29,anderson-bird-and-fuentes,2023,USD,920592,468937,451655,369002,82653,0,82653,9205,18411,64242,123522,779521,407961,371560,76716.0,920592,10.0,33.74,0.0727,827,92.67,25458.17,4.85,0.4906
6338,Bennett Mclaughlin and Allen,False,EG,Jonesfurt,AI/ML,2014,https://bennettmclaughlinandallen.com,Behavior crime laugh offer still sit increase some street though woman.,19,bennett-mclaughlin-and-allen,2023,USD,524146,247282,276864,312766,-35902,12221,-48123,5241,10482,-58605,113413,395512,103439,292073,,524146,603.37,2628.27,0.0715,193,225.82,49263.66,2.3,0.5282
6339,Mejia Gillespie and Mendoza,False,DE,Petersburgh,HealthTech,2018,https://mejiagillespieandmendoza.com,Goal option tax long perform crime bank magazine.,15,mejia-gillespie-and-mendoza,2023,EUR,388716,48573,340143,189248,150895,0,150895,3887,7774,143121,16690,367458,18372,349086,32393.0,388716,91.86,235.86,0.0025,5794,5.59,3101.2,5.38,0.875
6340,May and Sons,False,BR,West Andrew,Marketplaces,2024,https://mayandsons.com,Process head history important most might.,16,may-and-sons,2023,USD,3026434,552440,2473994,1582142,891852,27772,864080,30264,60528,803552,1453074,3130916,481126,2649790,,3026434,1364.61,3742.58,0.022,3073,82.06,134126.07,10.83,0.8175
6341,Lynch-Bryant,False,IN,North Alexis,AI/ML,2020,https://lynch-bryant.com,Lay listen skin community politics finally each five thus wrong.,19,lynch-bryant,2023,USD,1359287,416590,942697,679993,262704,17773,244931,13592,27185,217746,268560,1112593,377093,735500,,1359287,20.0,100.59,0.0136,869,130.26,76461.88,3.51,0.6935
6342,Smith Shaw and Scott,False,NG,Andersonshire,IoT,2014,https://smithshawandscott.com,And from others sense hope discussion necessary.,18,smith-shaw-and-scott,2023,USD,474539,23726,450813,258716,192097,0,192097,4745,9490,182607,2479,385018,145979,239039,,474539,340.6,1814.1,0.0184,1977,20.0,15437.28,0.16,0.95
6343,Clark Ltd,False,TN,Martinport,Cybersecurity,2009,https://clarkltd.com,Evidence by lawyer simply color develop type staff.,19,clark-ltd,2023,USD,139002,22672,116330,130361,-14031,0,-14031,1390,2780,-16811,31037,175467,45500,129967,,139002,626.33,1475.93,0.0385,367,31.53,18698.83,1.66,0.8369
6344,Kline LLC,False,EG,North Danielleland,Cybersecurity,2017,https://klinellc.com,Same election more white country soldier.,20,kline-llc,2023,USD,3436824,1243519,2193305,1856139,337166,28565,308601,34368,68736,239865,1099714,2936334,731791,2204543,,3436824,871.88,4788.24,0.03,5741,49.88,119376.97,9.21,0.6382
6345,Lawson-Gonzalez,False,NG,Brandonstad,Mobility,2009,https://lawson-gonzalez.com,Keep degree plan accept information piece.,27,lawson-gonzalez,2023,USD,535715,122416,413299,26785,386514,20743,365771,5357,10714,355057,11238,460098,186082,274016,,535715,20.0,105.69,0.001,252,176.86,34682.25,0.32,0.7715
6346,Jones James and Taylor,False,IN,New Amber,E-commerce,2008,https://jonesjamesandtaylor.com,Ever truth control name change ability painting establish because.,18,jones-james-and-taylor,2023,USD,315350,176101,139249,304034,-164785,0,-164785,3153,6307,-171092,4141,236899,176698,60201,,315350,20.0,10.0,0.109,128,204.21,1000.0,4.14,0.4416
6347,Salas-Gutierrez,False,TN,New Barbara,IoT,2010,https://salas-gutierrez.com,Begin nature amount well all while table best outside major.,15,salas-gutierrez,2023,USD,108335,43884,64451,113224,-48773,0,-48773,1083,2166,-50939,3690,68696,34691,34005,,108335,1948.4,974.2,0.0173,31,284.41,61509.92,0.06,0.5949
6348,Mcdonald-Phillips,False,EG,Port Michaelborough,Energy,2022,https://mcdonald-phillips.com,Onto seat side bring lead.,23,mcdonald-phillips,2023,USD,183687,103702,79985,160718,-80733,12159,-92892,1836,3673,-96565,9025,159247,62446,96801,,183687,983.4,2209.52,0.0782,56,271.26,26047.31,0.35,0.4354
6349,Nichols Group,False,KE,East Melinda,IoT,2015,https://nicholsgroup.com,Forward father system in media less here finish window real.,24,nichols-group,2023,USD,485356,186878,298478,340869,-42391,25519,-67910,4853,9707,-77617,10173,280291,35688,244603,,485356,20.0,26.01,0.001,190,211.86,28383.74,0.36,0.615
6350,Knapp-Ramirez,False,CA,Smithview,IoT,2015,https://knapp-ramirez.com,Fear manager appear image exactly explain any.,27,knapp-ramirez,2023,USD,635251,336409,298842,233471,65371,42888,22483,6352,12705,9778,24170,519399,223140,296259,,635251,284.8,1155.42,0.001,748,70.75,1000.0,24.17,0.4704
6351,Martinez-Martin,False,EG,Karenberg,AgriTech,2017,https://martinez-martin.com,Challenge though down music range item.,25,martinez-martin,2023,USD,451209,137826,313383,197859,115524,0,115524,4512,9024,106500,30869,380745,71185,309560,,451209,2081.05,10578.1,0.015,1880,20.0,50483.46,0.61,0.6945
6352,Becker Ltd,False,BR,Derrickland,SaaS,2015,https://beckerltd.com,Film herself believe catch official vote career score provide threat.,16,becker-ltd,2023,USD,288760,87401,201359,55776,145583,16486,129097,2887,5775,123322,69262,408286,45496,362790,24063.33,288760,218.12,762.97,0.06,524,45.92,1000.0,69.26,0.6973
6353,Sloan Doyle and Figueroa,False,BR,Duffystad,IoT,2016,https://sloandoyleandfigueroa.com,Fast close surface hotel history sure design.,15,sloan-doyle-and-figueroa,2023,USD,5193652,1409151,3784501,259682,3524819,337,3524482,51936,103873,3420609,325749,2938657,1547388,1391269,,5193652,337.31,918.21,0.0489,5968,72.51,23132.63,14.08,0.7287
6354,Chavez-Fuentes,False,TN,Anthonyborough,AgriTech,2008,https://chavez-fuentes.com,Themselves seven experience attention our realize else difference law.,17,chavez-fuentes,2023,USD,200272,49568,150704,141109,9595,2090,7505,2002,4005,3500,11161,266346,77430,188916,,200272,1003.38,1011.29,0.0107,834,20.0,17809.28,0.63,0.7525
6355,Palmer Inc,False,NG,Johnsonmouth,EdTech,2009,https://palmerinc.com,Memory government process bring short lawyer.,14,palmer-inc,2023,USD,281992,138917,143075,91712,51363,5539,45824,2819,5639,40185,47545,340919,103136,237783,23499.33,281992,10.0,13.37,0.001,4699,5.0,9255.88,5.14,0.5074
6356,Greene-Bates,False,DE,Andreaville,Mobility,2015,https://greene-bates.com,Yes owner street oil table avoid.,22,greene-bates,2023,EUR,501588,142669,358919,205645,153274,0,153274,5015,10031,143243,33466,360786,150463,210323,,501588,777.93,2949.42,0.0261,226,184.66,9549.31,3.5,0.7156
6357,Simon PLC,False,TN,Williamsview,SaaS,2021,https://simonplc.com,Tree get western difference month apply option audience attack once receive.,16,simon-plc,2023,USD,432055,128431,303624,212929,90695,28761,61934,4320,8641,53293,8426,297252,38591,258661,36004.58,432055,319.68,1581.82,0.001,303,118.77,3891.81,2.17,0.7027
6358,Archer-Newman,False,US,East Jessica,Fintech,2016,https://archer-newman.com,Role wind like energy whom.,19,archer-newman,2023,USD,1277879,574739,703140,469887,233253,0,233253,12778,25557,207696,292453,964881,372294,592587,,1277879,510.96,1452.75,0.001,5324,20.0,32558.51,8.98,0.5502
6359,Lee and Sons,False,NG,Chadhaven,AI/ML,2021,https://leeandsons.com,Yard scientist guy popular use skin.,30,lee-and-sons,2023,USD,281221,97490,183731,176606,7125,1215,5910,2812,5624,286,45923,351914,157540,194374,,281221,1138.35,569.17,0.0412,1171,20.0,6369.55,7.21,0.6533
6360,Ross Norris and Johnson,False,US,East Veronica,AI/ML,2017,https://rossnorrisandjohnson.com,Poor dream reality change poor across few.,20,ross-norris-and-johnson,2023,USD,773754,94024,679730,235838,443892,0,443892,7737,15475,428417,173977,630451,191616,438835,,773754,587.21,1820.27,0.0967,3223,20.0,1000.0,173.98,0.8785
6361,Jackson-West,False,AU,Lake Christina,IoT,2009,https://jackson-west.com,Couple go white summer care draw building.,14,jackson-west,2023,USD,2214032,657230,1556802,543978,1012824,0,1012824,22140,44280,968544,194997,1491121,729583,761538,,2214032,472.03,452.26,0.0784,2007,91.89,50800.06,3.84,0.7032
6362,Bowman Miller and Higgins,False,EG,Lake Timothymouth,IoT,2014,https://bowmanmillerandhiggins.com,Anything new hotel hear mind way audience manage deal wish.,13,bowman-miller-and-higgins,2023,USD,497988,208274,289714,225151,64563,0,64563,4979,9959,54604,24073,347158,151951,195207,,497988,1112.58,3035.27,0.0203,556,74.55,17631.47,1.37,0.5818
6363,Lucas-Cook,False,NG,New Laura,Marketplaces,2017,https://lucas-cook.com,Bring five first force leave position quickly why until.,20,lucas-cook,2023,USD,1082029,546949,535080,713640,-178560,8747,-187307,10820,21640,-208947,55455,607811,177378,430433,,1082029,20.0,67.55,0.0301,4508,20.0,48522.23,1.14,0.4945
6364,Hernandez-Johnson,False,AU,Middletonville,Fintech,2015,https://hernandez-johnson.com,Throw fall science enjoy write clearly side model enough role.,22,hernandez-johnson,2023,USD,1715691,983963,731728,1067996,-336268,0,-336268,17156,34313,-370581,46872,1062939,112941,949998,,1715691,684.84,627.03,0.06,7148,20.0,75112.61,0.62,0.4265
6365,Decker Fernandez and Mitchell,False,TN,Lake Shelbyport,AI/ML,2018,https://deckerfernandezandmitchell.com,Maintain new eye approach yourself soldier professor.,19,decker-fernandez-and-mitchell,2023,USD,3918379,1180373,2738006,1539284,1198722,0,1198722,39183,78367,1120355,110798,2091891,157107,1934784,,3918379,20.0,31.25,0.0464,2964,110.16,124314.92,0.89,0.6988
6366,Neal-Marshall,False,GB,West James,AI/ML,2014,https://neal-marshall.com,Condition final edge character quite treat.,27,neal-marshall,2023,USD,1503271,500696,1002575,373271,629304,0,629304,15032,30065,599239,202168,1119246,281665,837581,,1503271,20.0,21.21,0.0209,6263,20.0,3865.96,52.29,0.6669
6367,Harrison Pham and Stevens,False,US,Walshville,Marketplaces,2021,https://harrisonphamandstevens.com,Next if area effort score team.,14,harrison-pham-and-stevens,2023,USD,259218,74524,184694,169333,15361,18524,-3163,2592,5184,-8347,16533,147885,83750,64135,,259218,1107.18,3346.2,0.0349,217,99.26,51174.53,0.32,0.7125
6368,Wood and Sons,False,FR,Sarahfurt,E-commerce,2015,https://woodandsons.com,Listen back hotel surface imagine ability whatever many change.,11,wood-and-sons,2023,EUR,633315,226330,406985,205378,201607,0,201607,6333,12666,188941,95561,437921,109431,328490,,633315,20.0,97.75,0.1313,2638,20.0,33370.63,2.86,0.6426
6369,Coleman Ltd,False,EG,Jessicaview,SaaS,2011,https://colemanltd.com,At save occur attack these item.,17,coleman-ltd,2023,USD,1418559,321131,1097428,554360,543068,6569,536499,14185,28371,508128,54743,882006,558962,323044,118213.25,1418559,10.0,49.44,0.001,23642,5.0,36720.37,1.49,0.7736
6370,Ponce Inc,False,GB,Brianside,Cybersecurity,2016,https://ponceinc.com,Side throughout court question quickly history.,21,ponce-inc,2023,USD,3431463,1766242,1665221,554408,1110813,12656,1098157,34314,68629,1029528,106364,2017065,857222,1159843,,3431463,1439.61,4952.15,0.0726,958,298.27,16626.62,6.4,0.4853
6371,Myers Inc,False,GB,Heatherside,Marketplaces,2017,https://myersinc.com,Suddenly current word them themselves debate pick night group.,21,myers-inc,2023,USD,687776,204406,483370,433452,49918,0,49918,6877,13755,36163,11720,361576,56554,305022,,687776,20.0,40.9,0.0789,230,249.1,31754.47,0.37,0.7028
6372,Crawford-Carroll,False,BR,West David,AgriTech,2021,https://crawford-carroll.com,Act market up which catch both receive.,20,crawford-carroll,2023,USD,451302,100581,350721,245696,105025,4655,100370,4513,9026,91344,9568,324472,36277,288195,,451302,20.0,92.28,0.001,597,62.99,1682.81,5.69,0.7771
6373,Greer Ltd,False,GB,Lindahaven,Energy,2014,https://greerltd.com,Wrong wide agree education center team thus affect enter stage.,16,greer-ltd,2023,USD,6764795,3248123,3516672,3872616,-355944,0,-355944,67647,135295,-491239,317345,3887098,2588352,1298746,,6764795,20.0,83.25,0.128,9145,61.64,329276.74,0.96,0.5198
6374,Holmes-Sharp,False,ZA,North Lisahaven,HealthTech,2019,https://holmes-sharp.com,Weight step for look someone cultural even practice he may.,18,holmes-sharp,2023,USD,979218,375766,603452,271996,331456,28712,302744,9792,19584,283160,40974,672995,422763,250232,81601.5,979218,10.0,31.6,0.0367,1019,80.06,12169.38,3.37,0.6163
6375,Williams-Graves,False,FR,Port Jacquelinemouth,AgriTech,2017,https://williams-graves.com,Far result interview do necessary form.,22,williams-graves,2023,EUR,115266,44453,70813,52500,18313,0,18313,1152,2305,16008,12371,223054,11152,211902,,115266,2043.22,7475.99,0.0034,25,376.98,1000.0,12.37,0.6143
6376,Smith LLC,False,NG,New Matthew,Cybersecurity,2010,https://smithllc.com,Church practice civil small full itself could.,23,smith-llc,2023,USD,325175,143794,181381,192421,-11040,20555,-31595,3251,6503,-38098,5357,184513,76495,108018,,325175,20.0,55.45,0.077,113,239.2,26647.23,0.2,0.5578
6377,James-Pham,False,FR,Adamville,HealthTech,2011,https://james-pham.com,May message begin dream business quickly.,17,james-pham,2023,EUR,164100,38779,125321,188198,-62877,0,-62877,1641,3282,-66159,8457,193040,56214,136826,13675.0,164100,43.26,215.69,0.0263,166,81.93,9153.5,0.92,0.7637
6378,Howard-Heath,False,US,South Stevenfort,EdTech,2010,https://howard-heath.com,Citizen cut offer how firm tend.,11,howard-heath,2023,USD,528477,230991,297486,354404,-56918,0,-56918,5284,10569,-67487,38921,303834,153092,150742,44039.75,528477,10.0,55.13,0.0073,1619,27.2,33982.99,1.15,0.5629
6379,Moore Walker and Smith,False,AU,East Sandramouth,AgriTech,2013,https://moorewalkerandsmith.com,By detail little admit key.,23,moore-walker-and-smith,2023,USD,191636,85166,106470,30455,76015,8152,67863,1916,3832,64031,6883,266204,101132,165072,,191636,1641.98,5550.67,0.001,202,78.88,1000.0,6.88,0.5556
6380,Johnson Inc,False,FR,East Joshua,Mobility,2018,https://johnsoninc.com,There left remain benefit hour rise.,22,johnson-inc,2023,EUR,195318,68846,126472,41243,85229,23615,61614,1953,3906,57708,2381,199530,84789,114741,,195318,746.63,3986.2,0.0726,272,59.7,39824.72,0.06,0.6475
6381,Macias Inc,False,FR,New Christopherview,AI/ML,2022,https://maciasinc.com,Since push night soon finally save while within case.,18,macias-inc,2023,EUR,1248635,473365,775270,441351,333919,17254,316665,12486,24972,291693,76885,705858,413086,292772,,1248635,739.05,1358.06,0.0565,1693,61.45,50332.47,1.53,0.6209
6382,Hunter-Moore,False,NG,Lake Helenborough,Fintech,2023,https://hunter-moore.com,Candidate election too more skin.,24,hunter-moore,2023,USD,905711,91206,814505,643136,171369,9711,161658,9057,18114,143544,34568,638760,341031,297729,,905711,867.25,3720.29,0.0949,546,138.11,53250.74,0.65,0.8993
6383,Griffin PLC,False,BR,North Justin,IoT,2016,https://griffinplc.com,Let economy so support paper or.,26,griffin-plc,2023,USD,841768,281481,560287,444054,116233,0,116233,8417,16835,99398,83745,520140,194297,325843,,841768,1606.92,7045.5,0.0736,510,137.3,21656.06,3.87,0.6656
6384,Webb PLC,False,AU,Evansbury,Fintech,2019,https://webbplc.com,Get relationship prepare involve sell option car scientist.,25,webb-plc,2023,USD,869694,388579,481115,318317,162798,0,162798,8696,17393,145405,56048,641997,112777,529220,,869694,1170.68,2901.04,0.061,615,117.84,14149.12,3.96,0.5532
6385,Sims-Henry,False,AU,East Alan,Fintech,2019,https://sims-henry.com,Skin collection agency but everything.,19,sims-henry,2023,USD,741935,289970,451965,504569,-52604,0,-52604,7419,14838,-67442,58638,456935,114387,342548,,741935,20.0,10.0,0.0949,246,250.55,50846.81,1.15,0.6092
6386,Lambert Lyons and Stone,False,GB,South Pamela,Energy,2014,https://lambertlyonsandstone.com,No kitchen ahead camera set number move include forget building.,19,lambert-lyons-and-stone,2023,USD,658846,200961,457885,275137,182748,45321,137427,6588,13176,124251,25868,467321,291695,175626,,658846,398.99,597.02,0.013,2745,20.0,2862.1,9.04,0.695
6387,Gamble-Boyd,False,NG,West Lisaville,AgriTech,2008,https://gamble-boyd.com,A source theory answer despite bag wall project time simply.,19,gamble-boyd,2023,USD,206015,100508,105507,147907,-42400,3715,-46115,2060,4120,-50235,6054,247609,47321,200288,,206015,60.44,62.33,0.1276,858,20.0,1000.0,6.05,0.5121
6388,Ferrell and Sons,False,KE,Jacksonshire,Fintech,2010,https://ferrellandsons.com,Feel civil show modern thousand collection expert consider director.,21,ferrell-and-sons,2023,USD,2211347,573438,1637909,668173,969736,33164,936572,22113,44226,892346,244479,1367763,73000,1294763,,2211347,325.55,1425.14,0.0705,2799,65.82,47405.84,5.16,0.7407
6389,Benson Inc,False,GB,Sloanton,HealthTech,2018,https://bensoninc.com,Remain history sell care big.,20,benson-inc,2023,USD,712041,179131,532910,697404,-164494,8458,-172952,7120,14240,-187192,18587,485465,115548,369917,59336.75,712041,10.0,39.15,0.0618,1927,30.79,66697.6,0.28,0.7484
6390,Adams and Sons,False,GB,Kingbury,AI/ML,2014,https://adamsandsons.com,Rest challenge series cultural only this low adult international.,18,adams-and-sons,2023,USD,1266206,399756,866450,543779,322671,18061,304610,12662,25324,279286,64614,865551,110586,754965,,1266206,2066.0,12321.59,0.001,5275,20.0,58437.28,1.11,0.6843
6391,Hill Hampton and Olson,False,EG,West Derek,Marketplaces,2019,https://hillhamptonandolson.com,Number traditional rock church performance listen song check key.,20,hill-hampton-and-olson,2023,USD,148327,34968,113359,72864,40495,14665,25830,1483,2966,22864,4640,201930,115916,86014,,148327,641.76,504.09,0.0447,618,20.0,1000.0,4.64,0.7643
6392,Mcgrath-Romero,False,US,Martinezbury,E-commerce,2020,https://mcgrath-romero.com,Front push cup leg light cut miss far.,30,mcgrath-romero,2023,USD,1506194,516561,989633,546129,443504,11914,431590,15061,30123,401467,24673,948773,770498,178275,,1506194,1657.58,7681.48,0.0805,1060,118.31,57722.36,0.43,0.657
6393,Adams LLC,False,AU,Baxterchester,Energy,2011,https://adamsllc.com,Notice fine player while hope wrong one town.,15,adams-llc,2023,USD,1370651,452958,917693,68532,849161,4686,844475,13706,27413,817062,121301,887952,79475,808477,,1370651,208.77,1043.31,0.1318,573,199.14,5602.37,21.65,0.6695
6394,Stephens Ltd,False,AU,Traceyfurt,AI/ML,2020,https://stephensltd.com,Real religious trade listen free.,22,stephens-ltd,2023,USD,586103,219798,366305,62065,304240,5296,298944,5861,11722,287222,11103,334432,58214,276218,,586103,20.0,87.09,0.094,195,249.87,26579.23,0.42,0.625
6395,Brown Hawkins and Moore,False,DE,Maldonadofort,HealthTech,2014,https://brownhawkinsandmoore.com,Become difference information specific difference.,12,brown-hawkins-and-moore,2023,EUR,685721,204536,481185,341738,139447,36354,103093,6857,13714,89379,26392,502139,93518,408621,57143.42,685721,396.16,3395.99,0.0275,11428,5.0,23997.75,1.1,0.7017
6396,Dougherty Ltd,False,KE,Kellyburgh,Marketplaces,2023,https://doughertyltd.com,Young parent military newspaper left fire.,20,dougherty-ltd,2023,USD,706249,304406,401843,360902,40941,14560,26381,7062,14124,12257,28360,559355,226848,332507,,706249,521.83,1156.35,0.0596,2942,20.0,1017.34,27.88,0.569
6397,Franco-Parsons,False,AU,Williamfort,IoT,2010,https://franco-parsons.com,Service source whatever never call.,17,franco-parsons,2023,USD,765889,259845,506044,38294,467750,4731,463019,7658,15317,447702,76991,599818,156684,443134,,765889,20.0,10.0,0.0071,575,110.83,7857.06,9.8,0.6607
6398,Perez LLC,False,ZA,South Ryanville,EdTech,2023,https://perezllc.com,Enough never experience cover have throw stuff anything within test.,19,perez-llc,2023,USD,454394,212352,242042,323605,-81563,29301,-110864,4543,9087,-119951,6438,326876,134687,192189,37866.17,454394,10.0,36.97,0.001,408,92.7,35178.52,0.18,0.5327
6399,Stewart-Norris,False,NG,Jasonfort,Mobility,2020,https://stewart-norris.com,Those traditional performance professor right than everything.,20,stewart-norris,2023,USD,1967822,413715,1554107,1357035,197072,0,197072,19678,39356,157716,107876,1235623,397401,838222,,1967822,46.89,41.39,0.001,4619,35.5,146333.46,0.74,0.7898
6400,Cox-Walker,False,CA,Douglasfort,Marketplaces,2019,https://cox-walker.com,Bill drive able artist health draw laugh wind small.,21,cox-walker,2023,USD,404217,222039,182178,94751,87427,0,87427,4042,8084,79343,2746,402355,288511,113844,,404217,660.35,5210.28,0.0253,521,64.54,27677.56,0.1,0.4507
6401,Nichols and Sons,False,DE,West Ashley,SaaS,2009,https://nicholsandsons.com,Much field some fish view wear understand sign natural.,25,nichols-and-sons,2023,EUR,1779419,1178454,600965,109275,491690,0,491690,17794,35588,456102,31855,1013051,326155,686896,148284.92,1779419,327.87,410.69,0.1007,1756,84.41,1000.0,31.86,0.3377
6402,Brewer-Clarke,False,EG,Port Joshuaton,EdTech,2008,https://brewer-clarke.com,Always hundred staff we wrong condition evidence end.,25,brewer-clarke,2023,USD,426453,113123,313330,263388,49942,0,49942,4264,8529,41413,111916,424701,100785,323916,35537.75,426453,249.17,1292.57,0.0549,7107,5.0,28264.51,3.96,0.7347
6403,Perez Lynch and Lee,False,KE,North Mark,E-commerce,2008,https://perezlynchandlee.com,Appear visit nation safe station situation media reality officer soldier.,14,perez-lynch-and-lee,2023,USD,770805,286384,484421,184642,299779,18535,281244,7708,15416,265828,3665,521251,128915,392336,,770805,1097.16,2110.5,0.141,491,130.74,15807.14,0.23,0.6285
6404,Scott Pruitt and Bolton,False,BR,Troyview,E-commerce,2018,https://scottpruittandbolton.com,Performance say not middle inside term choose food test.,23,scott-pruitt-and-bolton,2023,USD,612896,180092,432804,393219,39585,0,39585,6128,12257,27328,49031,385937,100841,285096,,612896,153.58,253.82,0.0159,512,99.74,7175.32,6.83,0.7062
6405,Jones LLC,False,TN,New Darylmouth,Cybersecurity,2008,https://jonesllc.com,Establish company alone door too.,24,jones-llc,2023,USD,2453773,945516,1508257,953528,554729,2869,551860,24537,49075,502785,502637,1852756,965161,887595,,2453773,20.0,116.64,0.0608,1200,170.26,61747.56,8.14,0.6147
6406,Lawrence LLC,False,CA,West James,Mobility,2010,https://lawrencellc.com,Cell perform majority food job run time pretty.,18,lawrence-llc,2023,USD,453987,173606,280381,22699,257682,0,257682,4539,9079,248603,5676,258550,129558,128992,,453987,427.62,1711.66,0.001,189,200.1,1000.0,5.68,0.6176
6407,Robinson Humphrey and Fletcher,False,GB,Michealshire,Fintech,2024,https://robinsonhumphreyandfletcher.com,Either body soon name growth.,20,robinson-humphrey-and-fletcher,2023,USD,1038639,304926,733713,375485,358228,2849,355379,10386,20772,334607,20385,548833,234399,314434,,1038639,102.48,327.2,0.0173,1049,82.45,51570.24,0.4,0.7064
6408,Lucero Ross and Gonzalez,False,NG,East Christinefort,Fintech,2012,https://lucerorossandgonzalez.com,Film eight system bit where environment there author pretty.,33,lucero-ross-and-gonzalez,2023,USD,4776319,2252603,2523716,1113171,1410545,4524,1406021,47763,95526,1310495,273015,2663122,1099353,1563769,,4776319,369.61,493.78,0.096,19901,20.0,84219.34,3.24,0.5284
6409,Reilly LLC,False,EG,Genefort,Mobility,2018,https://reillyllc.com,Glass place word page address different.,21,reilly-llc,2023,USD,374551,101122,273429,231466,41963,6114,35849,3745,7491,28358,14154,395996,142984,253012,,374551,309.66,1421.22,0.0183,146,213.12,29530.32,0.48,0.73
6410,Page-Perez,False,FR,Willisfurt,IoT,2009,https://page-perez.com,General experience hair above ahead language state.,17,page-perez,2023,EUR,672840,370876,301964,214008,87956,17604,70352,6728,13456,56896,38633,439141,21957,417184,,672840,364.72,2015.02,0.063,255,219.76,37255.36,1.04,0.4488
6411,Sawyer-Hess,False,AU,North Adam,Marketplaces,2018,https://sawyer-hess.com,Officer run yet third sing fire part.,23,sawyer-hess,2023,USD,1665562,1073226,592336,529882,62454,7310,55144,16655,33311,21833,40352,947784,286434,661350,,1665562,562.87,681.31,0.001,862,160.93,61510.37,0.66,0.3556
6412,Powell LLC,False,DE,New Cynthiaville,AgriTech,2021,https://powellllc.com,Within much stage choice.,24,powell-llc,2023,EUR,192242,119031,73211,82451,-9240,5876,-15116,1922,3844,-18960,7971,299288,41524,257764,,192242,20.0,50.37,0.1033,123,129.8,1000.0,7.97,0.3808
6413,Contreras Inc,False,IN,Hayleyview,SaaS,2011,https://contrerasinc.com,Guess nature many moment sit poor rule kid matter.,24,contreras-inc,2023,USD,299009,134774,164235,194512,-30277,1727,-32004,2990,5980,-37984,51184,284397,191034,93363,24917.42,299009,240.72,1087.93,0.0794,265,93.97,46355.17,1.1,0.5493
6414,Cunningham Ltd,False,US,New Andrea,AgriTech,2012,https://cunninghamltd.com,Couple learn write their person owner city of near.,21,cunningham-ltd,2023,USD,102624,35674,66950,71641,-4691,0,-4691,1026,2052,-6743,19039,122415,32034,90381,,102624,20.0,59.68,0.1412,427,20.0,1000.0,19.04,0.6524
6415,Hicks Ltd,False,ZA,Danielborough,AgriTech,2020,https://hicksltd.com,Wear see kind measure discussion office hotel many new.,26,hicks-ltd,2023,USD,1081765,509644,572121,370770,201351,0,201351,10817,21635,179716,160259,755163,446570,308593,,1081765,20.0,27.2,0.0913,1701,52.99,8536.64,18.77,0.5289
6416,Robinson Bryan and Vasquez,False,GB,Johnberg,AgriTech,2018,https://robinsonbryanandvasquez.com,Someone woman better either wish building task make chair.,15,robinson-bryan-and-vasquez,2023,USD,332512,84967,247545,230362,17183,33424,-16241,3325,6650,-22891,2609,315544,143476,172068,,332512,2141.75,8762.75,0.0348,154,179.5,39150.4,0.07,0.7445
6417,Fritz and Sons,False,TN,West Williechester,Fintech,2024,https://fritzandsons.com,Sign certain model friend machine never easy plant blood.,23,fritz-and-sons,2023,USD,2239332,1397088,842244,452379,389865,0,389865,22393,44786,345079,161284,1369988,830886,539102,,2239332,440.49,320.04,0.001,9330,20.0,1000.0,161.28,0.3761
6418,Perkins-Benson,False,CA,East Connie,Fintech,2023,https://perkins-benson.com,Pressure senior away either.,17,perkins-benson,2023,USD,2641423,1279201,1362222,2577159,-1214937,868,-1215805,26414,52828,-1268633,53516,1452200,456882,995318,,2641423,319.08,487.85,0.0678,11005,20.0,199506.62,0.27,0.5157
6419,Bowers-Brandt,False,IN,Garciabury,Cybersecurity,2017,https://bowers-brandt.com,Teach traditional change war indicate few you.,22,bowers-brandt,2023,USD,1344773,569546,775227,614916,160311,0,160311,13447,26895,133416,280062,1116862,248721,868141,,1344773,862.77,4814.0,0.054,2292,48.88,40755.98,6.87,0.5765
6420,Chambers White and Whitaker,False,TN,Jeremyburgh,SaaS,2008,https://chamberswhiteandwhitaker.com,Seven tough back together debate risk risk million expect.,20,chambers-white-and-whitaker,2023,USD,5469268,1203550,4265718,2719730,1545988,23283,1522705,54692,109385,1413320,333126,3114846,1964546,1150300,455772.33,5469268,299.74,2321.52,0.0235,91154,5.0,238706.46,1.4,0.7799
6421,Wilson Kelley and White,False,IN,West Heatherport,E-commerce,2013,https://wilsonkelleyandwhite.com,Friend candidate purpose past.,17,wilson-kelley-and-white,2023,USD,1148195,238971,909224,277626,631598,0,631598,11481,22963,608635,20733,754301,169204,585097,,1148195,287.63,1088.52,0.0674,807,118.44,24503.06,0.85,0.7919
6422,Smith-Gould,False,ZA,Bensonton,Fintech,2012,https://smith-gould.com,Identify draw administration all figure half store truth.,22,smith-gould,2023,USD,359958,129849,230109,208663,21446,17022,4424,3599,7199,-2775,9022,317023,35744,281279,,359958,20.0,55.78,0.037,177,169.24,8876.39,1.02,0.6393
6423,Edwards-Myers,False,NG,South Tracyburgh,IoT,2011,https://edwards-myers.com,Me meet discuss fast hear under of responsibility.,19,edwards-myers,2023,USD,1441218,506273,934945,973817,-38872,0,-38872,14412,28824,-67696,24179,932444,290191,642253,,1441218,372.79,186.4,0.1197,6005,20.0,81996.26,0.29,0.6487
6424,Allen-Andrews,False,CA,Anthonystad,Fintech,2011,https://allen-andrews.com,Appear cut window somebody process toward field which.,16,allen-andrews,2023,USD,1903471,368768,1534703,1151762,382941,12289,370652,19034,38069,332583,139584,1102359,603641,498718,,1903471,1227.8,5003.0,0.0151,1029,154.06,131897.87,1.06,0.8063
6425,Carpenter Wilson and Bright,False,IN,North Timothychester,E-commerce,2018,https://carpenterwilsonandbright.com,Worker I black area former above.,22,carpenter-wilson-and-bright,2023,USD,168500,107304,61196,112202,-51006,14409,-65415,1685,3370,-68785,3977,171438,85422,86016,,168500,1475.43,4776.25,0.1229,70,199.03,1000.0,3.98,0.3632
6426,Quinn Lewis and Diaz,False,FR,Simpsonfurt,HealthTech,2014,https://quinnlewisanddiaz.com,Thousand though available participant reach thought.,22,quinn-lewis-and-diaz,2023,EUR,369382,133116,236266,151653,84613,5820,78793,3693,7387,71406,29081,262109,83166,178943,30781.83,369382,217.94,1658.07,0.0019,2541,12.11,1000.0,29.08,0.6396
6427,Williams Christian and Wright,False,KE,Ramoston,Fintech,2015,https://williamschristianandwright.com,Bar boy human tough television stage rather.,13,williams-christian-and-wright,2023,USD,225307,11265,214042,174715,39327,24514,14813,2253,4506,10307,73110,385575,141043,244532,,225307,215.17,816.08,0.1073,938,20.0,1000.0,73.11,0.95
6428,Barajas Group,False,US,West Shanebury,AgriTech,2017,https://barajasgroup.com,Stage buy really computer record which me.,24,barajas-group,2023,USD,377710,176144,201566,233036,-31470,0,-31470,3777,7554,-39024,6268,264948,70064,194884,,377710,1664.04,10916.09,0.035,616,51.08,4586.36,1.37,0.5337
6429,Weaver Miller and Morgan,False,AU,Halemouth,AI/ML,2010,https://weavermillerandmorgan.com,Animal inside allow drop keep well base build.,9,weaver-miller-and-morgan,2023,USD,2213911,492084,1721827,907316,814511,17536,796975,22139,44278,752697,349316,1521219,336579,1184640,,2213911,536.63,1406.75,0.1093,1236,149.22,55815.79,6.26,0.7777
6430,Leach Lucas and Rich,False,AU,Port Lucasville,Cybersecurity,2017,https://leachlucasandrich.com,Hear dog case husband both officer.,23,leach-lucas-and-rich,2023,USD,402292,206221,196071,31794,164277,18233,146044,4022,8045,137999,32186,269520,71944,197576,,402292,20.0,124.73,0.1022,183,183.11,18169.99,1.77,0.4874
6431,Rojas Griffin and Booth,False,NG,Mullinsville,Marketplaces,2017,https://rojasgriffinandbooth.com,Prepare read then eye against among college.,26,rojas-griffin-and-booth,2023,USD,688436,195006,493430,410476,82954,0,82954,6884,13768,69186,83554,582620,83888,498732,,688436,475.07,836.63,0.0084,389,147.47,48022.45,1.74,0.7167
6432,Brown Anderson and Mcneil,False,FR,Lake Jordan,Energy,2009,https://brownandersonandmcneil.com,Inside reach range head throw still world us manage fire.,17,brown-anderson-and-mcneil,2023,EUR,3258203,1285423,1972780,3224427,-1251647,0,-1251647,32582,65164,-1316811,147149,1877234,137121,1740113,,3258203,273.54,291.93,0.1183,4268,63.61,199757.85,0.74,0.6055
6433,Shea Group,False,IN,New Jeanne,Energy,2010,https://sheagroup.com,Ask produce walk so rest best ball.,16,shea-group,2023,USD,805741,266710,539031,123095,415936,3554,412382,8057,16114,396268,8891,505417,157162,348255,,805741,20.0,34.95,0.116,233,287.17,33314.23,0.27,0.669
6434,Wilson Yang and Mays,False,BR,Aguilarmouth,E-commerce,2016,https://wilsonyangandmays.com,Team how have about section politics.,10,wilson-yang-and-mays,2023,USD,1670609,793383,877226,463582,413644,24157,389487,16706,33412,356075,48152,1016881,340350,676531,,1670609,484.77,1068.47,0.0979,614,226.73,17354.57,2.77,0.5251
6435,Johnson Spence and Ramirez,False,ZA,Cannonburgh,SaaS,2012,https://johnsonspenceandramirez.com,Table experience nearly say whole your first pay.,27,johnson-spence-and-ramirez,2023,USD,582553,105321,477232,247448,229784,14829,214955,5825,11651,203304,20694,440757,96678,344079,48546.08,582553,83.99,540.66,0.0455,9709,5.0,30838.35,0.67,0.8192
6436,Dean LLC,False,FR,Sarahland,Fintech,2008,https://deanllc.com,Include send or generation shoulder top gas.,19,dean-llc,2023,EUR,5151230,1507863,3643367,2877659,765708,8785,756923,51512,103024,653899,449005,3094790,1106943,1987847,,5151230,902.18,3528.68,0.0118,21463,20.0,198639.03,2.26,0.7073
6437,Foster-Allen,False,FR,Lake Susantown,Mobility,2009,https://foster-allen.com,Us effort life big hot information.,21,foster-allen,2023,EUR,1472166,604891,867275,73608,793667,0,793667,14721,29443,764224,643247,1449257,494834,954423,,1472166,346.72,2781.17,0.0577,1278,95.92,1352.32,475.66,0.5891
6438,Murray Holder and Stevenson,False,EG,Jessicaview,E-commerce,2020,https://murrayholderandstevenson.com,Age surface continue firm public author environmental view.,17,murray-holder-and-stevenson,2023,USD,640757,106667,534090,32037,502053,0,502053,6407,12815,489238,182216,613611,366040,247571,,640757,20.0,89.39,0.0613,313,170.08,9059.59,20.11,0.8335
6439,Malone Inc,False,NG,Lake Stephenport,Fintech,2016,https://maloneinc.com,Fight own idea interesting traditional number wish current.,16,malone-inc,2023,USD,816980,447787,369193,90448,278745,21095,257650,8169,16339,241311,82100,595830,398428,197402,,816980,1024.84,1770.03,0.001,599,113.56,1000.0,82.1,0.4519
6440,Smith Lopez and Wolf,False,GB,Conniefurt,IoT,2015,https://smithlopezandwolf.com,Claim occur organization suffer deal hope after exactly.,25,smith-lopez-and-wolf,2023,USD,2483003,1080469,1402534,1536608,-134074,32454,-166528,24830,49660,-216188,206081,1497487,74874,1422613,,2483003,770.87,1273.8,0.0201,927,223.05,82103.59,2.51,0.5649
6441,Wong-Merritt,False,FR,Jordanhaven,E-commerce,2013,https://wong-merritt.com,Human ago nature return strategy goal building religious upon direction.,20,wong-merritt,2023,EUR,2691431,917025,1774406,2056809,-282403,0,-282403,26914,53828,-336231,233890,1681001,456213,1224788,,2691431,571.39,2915.34,0.0409,930,241.12,140371.09,1.67,0.6593
6442,Willis Alvarez and Molina,False,GB,New Nicoleview,Marketplaces,2011,https://willisalvarezandmolina.com,Here window never artist huge.,16,willis-alvarez-and-molina,2023,USD,1296886,606580,690306,1013205,-322899,0,-322899,12968,25937,-348836,30100,736950,83286,653664,,1296886,680.49,2025.0,0.1026,1196,90.35,87701.21,0.34,0.5323
6443,Vincent Group,False,BR,Port Roger,SaaS,2023,https://vincentgroup.com,Include spend owner quite issue woman must since.,13,vincent-group,2023,USD,4165979,2611138,1554841,1736397,-181556,0,-181556,41659,83319,-264875,66377,2180974,741904,1439070,347164.92,4165979,724.03,4518.64,0.015,4692,73.99,123615.25,0.54,0.3732
6444,Johnson LLC,False,DE,North Ronnietown,Cybersecurity,2012,https://johnsonllc.com,Behind way woman top door than happy.,26,johnson-llc,2023,EUR,189769,74751,115018,66900,48118,20794,27324,1897,3795,23529,64726,289503,148655,140848,,189769,20.0,27.1,0.0589,673,23.49,52879.38,1.22,0.6061
6445,Willis Patterson and Huerta,False,GB,South Jose,Cybersecurity,2024,https://willispattersonandhuerta.com,Enough keep natural price usually.,28,willis-patterson-and-huerta,2023,USD,4887366,2294808,2592558,3185450,-592892,15835,-608727,48873,97747,-706474,100968,2603347,1363833,1239514,,4887366,20.0,59.36,0.001,10098,40.33,291399.27,0.35,0.5305
6446,Coleman Horne and Davis,False,DE,South Danafort,Energy,2008,https://colemanhorneanddavis.com,Color even college race bank avoid yard whom personal military those.,8,coleman-horne-and-davis,2023,EUR,1154756,573047,581709,1000539,-418830,16771,-435601,11547,23095,-458696,111328,884844,326885,557959,,1154756,1470.87,6032.71,0.025,308,312.4,75967.42,1.47,0.5038
6447,Poole Group,False,BR,New Jesusmouth,AI/ML,2016,https://poolegroup.com,Responsibility forward cultural say take.,21,poole-group,2023,USD,275926,85540,190386,221507,-31121,27046,-58167,2759,5518,-63685,20737,275554,171610,103944,,275926,462.97,1137.53,0.0552,304,75.4,18722.43,1.11,0.69
6448,Holder Hayes and Bender,False,KE,Sharonton,Cybersecurity,2014,https://holderhayesandbender.com,Simply nothing travel pretty place decision explain sense get check.,21,holder-hayes-and-bender,2023,USD,333307,111085,222222,109986,112236,0,112236,3333,6666,105570,3919,354000,183201,170799,,333307,975.44,2326.07,0.1897,153,180.88,42627.59,0.09,0.6667
6449,Mcbride-Hamilton,False,EG,Adamton,AI/ML,2015,https://mcbride-hamilton.com,Everyone participant experience their dinner evidence vote theory old.,27,mcbride-hamilton,2023,USD,1169439,447047,722392,789062,-66670,4463,-71133,11694,23388,-94521,33333,659264,273171,386093,,1169439,1352.54,5942.46,0.001,548,177.57,76991.51,0.43,0.6177
6450,Roy Peterson and Bryan,False,US,Port Seanborough,Energy,2014,https://roypetersonandbryan.com,Tv possible expert feeling option long.,18,roy-peterson-and-bryan,2023,USD,23434536,8220989,15213547,12500394,2713153,0,2713153,234345,468690,2244463,3866412,15593103,4401397,11191706,,23434536,265.89,915.21,0.0686,10321,189.21,1019912.94,3.79,0.6492
6451,Robertson Group,False,KE,New Chelseatown,Marketplaces,2020,https://robertsongroup.com,Certain imagine style no believe nature leave woman.,27,robertson-group,2023,USD,21979913,3042963,18936950,6418557,12518393,0,12518393,219799,439598,12078795,318129,11451839,8504352,2947487,,21979913,731.04,4146.68,0.0537,8973,204.12,537494.54,0.59,0.8616
6452,Matthews-Mckinney,False,DE,Lopezland,AI/ML,2017,https://matthews-mckinney.com,House shake on continue hour sort society.,15,matthews-mckinney,2023,EUR,916166,324819,591347,97616,493731,2849,490882,9161,18323,472559,33375,576337,51045,525292,,916166,92.87,579.56,0.0948,3817,20.0,1000.0,33.38,0.6455
6453,Jones Group,False,CA,Hortonhaven,HealthTech,2020,https://jonesgroup.com,Discussion seat but bed improve.,19,jones-group,2023,USD,655989,175288,480701,380647,100054,25026,75028,6559,13119,61909,29916,397081,51963,345118,54665.75,655989,42.41,42.41,0.0564,725,75.4,11694.47,2.56,0.7328
6454,Ibarra and Sons,False,KE,Lake Tina,Energy,2017,https://ibarraandsons.com,Threat several international quickly animal.,26,ibarra-and-sons,2023,USD,874503,297901,576602,284204,292398,34736,257662,8745,17490,240172,32263,605745,186719,419026,,874503,20.0,65.19,0.007,3643,20.0,61291.03,0.53,0.6593
6455,Hicks Mullins and Turner,False,IN,Michellebury,EdTech,2011,https://hicksmullinsandturner.com,Blood what weight smile accept.,20,hicks-mullins-and-turner,2023,USD,477840,141856,335984,190831,145153,40248,104905,4778,9556,95349,15732,336616,170418,166198,39820.0,477840,10.0,42.7,0.0313,424,93.91,34177.77,0.46,0.7031
6456,Long-Villanueva,False,ZA,Port Mariaport,Energy,2016,https://long-villanueva.com,Pay science scientist dream travel key.,13,long-villanueva,2023,USD,3942951,1127183,2815768,1485112,1330656,9313,1321343,39429,78859,1242484,254672,2347259,994330,1352929,,3942951,2280.23,9446.27,0.0441,16428,20.0,125420.67,2.03,0.7141
6457,Osborn-Sanchez,False,BR,Hartmouth,IoT,2023,https://osborn-sanchez.com,Student away story continue just need town good necessary control.,15,osborn-sanchez,2023,USD,5551870,1378012,4173858,1580600,2593258,0,2593258,55518,111037,2482221,136316,2917060,1027823,1889237,,5551870,1569.19,3491.84,0.001,10472,44.18,109614.92,1.24,0.7518
6458,House and Sons,False,US,Millerberg,Fintech,2020,https://houseandsons.com,Challenge after provide study race yard ahead stay.,12,house-and-sons,2023,USD,4378511,1949146,2429365,2448511,-19146,15618,-34764,43785,87570,-122334,447744,2736600,1022922,1713678,,4378511,20.0,10.0,0.111,4373,83.42,218773.42,2.05,0.5548
6459,Morales Adkins and Phillips,False,KE,Wilkinsberg,EdTech,2016,https://moralesadkinsandphillips.com,Operation statement area part guess action answer.,24,morales-adkins-and-phillips,2023,USD,57049,20773,36276,25465,10811,27426,-16615,570,1140,-17755,18060,93564,10133,83431,4754.08,57049,578.22,946.14,0.1008,48,97.04,1000.0,18.06,0.6359
6460,Clark Ltd,False,ZA,Kevinbury,HealthTech,2013,https://clarkltd.com,Southern mention all degree nothing series course few once blood.,15,clark-ltd,2023,USD,237158,63506,173652,54008,119644,0,119644,2371,4743,114901,20780,198317,114816,83501,19763.17,237158,166.51,968.68,0.0773,328,60.16,16923.65,1.23,0.7322
6461,Beard-Crawford,False,BR,West Jennifertown,IoT,2011,https://beard-crawford.com,Effect sign PM man art production window.,19,beard-crawford,2023,USD,1503632,440629,1063003,709684,353319,0,353319,15036,30072,323247,179390,945911,431346,514565,,1503632,1286.56,709.0,0.0887,556,225.25,88796.8,2.02,0.707
6462,Wells-Melendez,False,BR,East Adam,EdTech,2012,https://wells-melendez.com,Half general true consider cell benefit letter house.,16,wells-melendez,2023,USD,269304,94218,175086,114288,60798,5509,55289,2693,5386,49903,31238,221466,40514,180952,22442.0,269304,10.0,26.24,0.0042,373,60.14,30904.78,1.01,0.6501
6463,Wright LLC,False,ZA,Garrettborough,SaaS,2015,https://wrightllc.com,Left American sure skill attorney then involve official.,24,wright-llc,2023,USD,1482159,606760,875399,492788,382611,7496,375115,14821,29643,345472,190390,967131,490247,476884,123513.25,1482159,10.0,44.35,0.0382,2256,54.73,38983.36,4.88,0.5906
6464,Hayes LLC,False,DE,New Scotthaven,Cybersecurity,2009,https://hayesllc.com,Simply before politics skin necessary room behavior probably stay.,23,hayes-llc,2023,EUR,211940,21259,190681,92870,97811,38843,58968,2119,4238,54730,4392,256156,143350,112806,,211940,537.69,1534.23,0.0354,316,55.72,1000.0,4.39,0.8997
6465,Burnett-Wilson,False,ZA,Seanfort,Fintech,2020,https://burnett-wilson.com,Create sometimes politics wife produce bad strategy service.,20,burnett-wilson,2023,USD,2642194,942113,1700081,884160,815921,6176,809745,26421,52843,756902,202920,1649250,826724,822526,,2642194,1315.62,6498.07,0.0984,991,222.11,102861.48,1.97,0.6434
6466,Williams LLC,False,GB,New Michael,EdTech,2016,https://williamsllc.com,Large leader central contain middle major.,23,williams-llc,2023,USD,292479,121062,171417,163539,7878,5581,2297,2924,5849,-3552,8400,278043,166687,111356,24373.25,292479,295.64,913.0,0.0577,236,103.22,1000.0,8.4,0.5861
6467,Mason-Mercado,False,FR,Codyberg,IoT,2008,https://mason-mercado.com,Rest executive everything mission media around.,16,mason-mercado,2023,EUR,1472906,226303,1246603,813161,433442,51517,381925,14729,29458,352467,110031,1006619,157231,849388,,1472906,366.99,749.09,0.0868,921,133.23,74692.5,1.47,0.8464
6468,Garza Campbell and Jarvis,False,BR,Danielleview,EdTech,2011,https://garzacampbellandjarvis.com,Executive responsibility organization other prepare her during under common.,13,garza-campbell-and-jarvis,2023,USD,109739,40724,69015,48944,20071,8782,11289,1097,2194,9095,17443,73970,41719,32251,9144.92,109739,10.0,29.46,0.032,170,53.51,1000.0,17.44,0.6289
6469,Cole-Holt,False,ZA,Garrettside,SaaS,2021,https://cole-holt.com,Today seven right cost left member herself cup bill.,16,cole-holt,2023,USD,862817,220027,642790,122281,520509,0,520509,8628,17256,503253,55874,507139,56575,450564,71901.42,862817,580.83,2044.47,0.001,910,78.96,1000.0,55.87,0.745
6470,Medina Grant and Hoover,False,FR,New Natalie,E-commerce,2014,https://medinagrantandhoover.com,Son rate memory foot himself.,16,medina-grant-and-hoover,2023,EUR,217717,59795,157922,208169,-50247,21859,-72106,2177,4354,-76460,20186,168917,97445,71472,,217717,20.0,10.32,0.0592,65,275.15,38159.59,0.53,0.7254
6471,Moore-Smith,False,EG,Lake Mariaburgh,HealthTech,2012,https://moore-smith.com,Me audience east company box.,15,moore-smith,2023,USD,1119913,396791,723122,345003,378119,0,378119,11199,22398,355721,1108705,1793047,400620,1392427,93326.08,1119913,10.0,34.85,0.0728,18665,5.0,41059.24,27.0,0.6457
6472,Flores PLC,False,ZA,Smithville,Marketplaces,2011,https://floresplc.com,Drive final sense sign couple modern.,25,flores-plc,2023,USD,269573,89411,180162,193917,-13755,11746,-25501,2695,5391,-30892,25558,218126,21010,197116,,269573,339.54,855.62,0.0476,197,113.64,9747.97,2.62,0.6683
6473,Hines Brown and Herrera,False,CA,Shortfort,E-commerce,2021,https://hinesbrownandherrera.com,Note later term response employee type street.,18,hines-brown-and-herrera,2023,USD,91218,13965,77253,4560,72693,763,71930,912,1824,70106,4420,84263,43520,40743,,91218,20.0,36.55,0.001,371,20.44,24504.73,0.18,0.8469
6474,Diaz Inc,False,TN,South Brian,Marketplaces,2024,https://diazinc.com,Page bank imagine firm some.,21,diaz-inc,2023,USD,633922,193681,440241,230993,209248,0,209248,6339,12678,196570,27327,441829,260075,181754,,633922,20.0,84.27,0.0502,2641,20.0,9925.53,2.75,0.6945
6475,Mendoza-Murphy,False,BR,Mcclureside,AgriTech,2022,https://mendoza-murphy.com,Your house history day contain six me.,22,mendoza-murphy,2023,USD,1437285,785799,651486,937095,-285609,5247,-290856,14372,28745,-319601,73759,863547,500712,362835,,1437285,1078.61,1631.28,0.001,5988,20.0,52489.32,1.41,0.4533
6476,Andrews Group,False,BR,Wallacestad,EdTech,2012,https://andrewsgroup.com,Control part training those administration produce fear region same.,17,andrews-group,2023,USD,176997,57467,119530,52432,67098,0,67098,1769,3539,63559,41124,275289,27217,248072,14749.75,176997,10.0,42.28,0.0855,2949,5.0,1000.0,41.12,0.6753
6477,Obrien Garcia and Moore,False,DE,Rachaelbury,Energy,2019,https://obriengarciaandmoore.com,Purpose different somebody support type find ask year explain home.,22,obrien-garcia-and-moore,2023,EUR,579562,102760,476802,207391,269411,37948,231463,5795,11591,219872,16531,407855,20392,387463,,579562,137.56,305.49,0.1128,254,189.46,20918.1,0.79,0.8227
6478,Rodriguez-Bell,False,DE,Davisburgh,Marketplaces,2015,https://rodriguez-bell.com,Than interesting response large.,25,rodriguez-bell,2023,EUR,2987559,925668,2061891,832635,1229256,13753,1215503,29875,59751,1155752,168125,1761883,675576,1086307,,2987559,1380.9,2268.39,0.008,1011,246.18,49234.15,3.41,0.6902
6479,Richardson-Watson,False,EG,Alexisfurt,Mobility,2016,https://richardson-watson.com,Himself standard already successful appear reduce card help exist.,14,richardson-watson,2023,USD,2170849,387270,1783579,1103308,680271,5228,675043,21708,43416,631627,94787,1287541,597812,689729,,2170849,20.0,53.7,0.001,9045,20.0,74954.68,1.26,0.8216
6480,Torres-Allen,False,TN,New Alex,SaaS,2016,https://torres-allen.com,Loss record recent Republican citizen food boy trade religious.,16,torres-allen,2023,USD,2495131,1028513,1466618,784888,681730,5240,676490,24951,49902,626588,184695,1612190,80609,1531581,207927.58,2495131,362.41,1817.97,0.0293,12209,17.03,71297.94,2.59,0.5878
6481,Moore Terry and Jackson,False,US,Kristyside,Energy,2022,https://mooreterryandjackson.com,Organization west purpose throw theory least.,32,moore-terry-and-jackson,2023,USD,2235118,774352,1460766,910464,550302,18002,532300,22351,44702,487598,350376,1480666,587589,893077,,2235118,800.11,2192.23,0.0583,1639,113.58,54675.51,6.41,0.6536
6482,Roy Inc,False,GB,Davidmouth,SaaS,2009,https://royinc.com,Lot we chance simple growth detail cup learn opportunity.,21,roy-inc,2023,USD,7092072,1912159,5179913,1542903,3637010,15963,3621047,70920,141841,3479206,116431,3774298,1539036,2235262,591006.0,7092072,638.92,2460.9,0.009,6242,94.68,130953.75,0.89,0.7304
6483,Bell Ltd,False,ZA,Bradleyhaven,Mobility,2024,https://bellltd.com,Particular respond listen newspaper thing.,17,bell-ltd,2023,USD,777481,230935,546546,486248,60298,8509,51789,7774,15549,36240,41153,545957,382132,163825,,777481,20.0,107.17,0.0954,381,170.03,1000.0,41.15,0.703
6484,Edwards Barrett and Stanley,False,IN,Lake Walter,EdTech,2021,https://edwardsbarrettandstanley.com,Fine method more sort economy left point meet including instead.,23,edwards-barrett-and-stanley,2023,USD,448179,106434,341745,190724,151021,0,151021,4481,8963,142058,28399,285421,37775,247646,37348.25,448179,584.71,4911.43,0.0142,7469,5.0,1000.0,28.4,0.7625
6485,Johnston-Robinson,False,FR,Desireemouth,AgriTech,2012,https://johnston-robinson.com,Every cell avoid factor the mouth assume condition.,23,johnston-robinson,2023,EUR,780273,347806,432467,511978,-79511,22370,-101881,7802,15605,-117486,23375,539181,26959,512222,,780273,20.0,33.87,0.052,261,248.43,29905.13,0.78,0.5543
6486,Black-Nash,False,IN,Andersonhaven,AgriTech,2013,https://black-nash.com,Particular through consider radio stage.,23,black-nash,2023,USD,1068742,417553,651189,1258657,-607468,14878,-622346,10687,21374,-643720,51350,663319,471726,191593,,1068742,999.45,499.72,0.1046,4453,20.0,73921.61,0.69,0.6093
6487,Rogers Greene and Swanson,False,TN,Stewarthaven,SaaS,2023,https://rogersgreeneandswanson.com,Recognize bar run water card argue international.,19,rogers-greene-and-swanson,2023,USD,2311879,548641,1763238,734424,1028814,0,1028814,23118,46237,982577,134005,1344031,718185,625846,192656.58,2311879,249.52,1153.25,0.0529,2199,87.61,50891.58,2.63,0.7627
6488,Griffith Gonzalez and Yates,False,AU,Winterston,AI/ML,2010,https://griffithgonzalezandyates.com,Tree future various treat road until.,22,griffith-gonzalez-and-yates,2023,USD,1191518,319845,871673,652333,219340,0,219340,11915,23830,195510,174441,884458,217726,666732,,1191518,608.82,1492.54,0.0727,1138,87.25,50634.96,3.45,0.7316
6489,Drake-Bell,False,KE,Lake Veronica,Mobility,2019,https://drake-bell.com,Oil night senior social east under staff natural whether.,23,drake-bell,2023,USD,1316929,381003,935926,846156,89770,12382,77388,13169,26338,51050,12243,736915,302971,433944,,1316929,871.24,1413.14,0.0254,463,236.71,39031.9,0.31,0.7107
6490,Graham LLC,False,IN,Rangelside,Marketplaces,2015,https://grahamllc.com,Change age town find prevent parent customer reach where.,16,graham-llc,2023,USD,127403,25702,101701,93767,7934,0,7934,1274,2548,5386,4825,95905,21373,74532,,127403,1459.59,9251.3,0.0711,75,141.0,1552.01,3.11,0.7983
6491,Hutchinson Ltd,False,EG,East Anthony,EdTech,2016,https://hutchinsonltd.com,Truth just laugh Mr get outside.,12,hutchinson-ltd,2023,USD,517087,159558,357529,289400,68129,0,68129,5170,10341,57788,21316,294989,165842,129147,43090.58,517087,10.0,19.8,0.001,457,94.23,35623.82,0.6,0.6914
6492,Fox Group,False,EG,Marshmouth,Energy,2016,https://foxgroup.com,Then pressure wide hear knowledge huge.,17,fox-group,2023,USD,20253498,5619200,14634298,1012674,13621624,30410,13591214,202534,405069,13186145,585940,10906385,3808015,7098370,,20253498,541.99,2645.61,0.0654,12232,137.98,99144.24,5.91,0.7226
6493,Miller-Howard,False,GB,Kingside,Mobility,2015,https://miller-howard.com,May him bar response.,14,miller-howard,2023,USD,1977362,950616,1026746,98868,927878,0,927878,19773,39547,888331,194499,1352395,1004466,347929,,1977362,959.77,2237.6,0.1574,1132,145.46,41494.66,4.69,0.5193
6494,Stein Garrett and Guzman,False,EG,Cherylbury,HealthTech,2008,https://steingarrettandguzman.com,Discuss business source star east kind nearly between.,24,stein-garrett-and-guzman,2023,USD,3431428,692731,2738697,171571,2567126,0,2567126,34314,68628,2498498,290216,2103480,552940,1550540,285952.33,3431428,10.0,57.01,0.0711,13526,21.14,48062.59,6.04,0.7981
6495,Evans-Sanford,False,AU,Port Donaldton,EdTech,2023,https://evans-sanford.com,Society debate bring instead action.,19,evans-sanford,2023,USD,166930,73803,93127,8346,84781,39057,45724,1669,3338,42386,2386,188720,100985,87735,13910.83,166930,291.51,949.7,0.0486,2782,5.0,1000.0,2.39,0.5579
6496,Colon Group,False,TN,Woodshire,EdTech,2024,https://colongroup.com,Fact language hot rather nor.,10,colon-group,2023,USD,972423,206543,765880,580436,185444,0,185444,9724,19448,165996,66131,641484,192283,449201,81035.25,972423,261.8,1042.11,0.0292,16207,5.0,54563.9,1.21,0.7876
6497,Garcia Hill and Harper,False,BR,Port Zachary,HealthTech,2011,https://garciahillandharper.com,Old me list agree stop else area join knowledge.,16,garcia-hill-and-harper,2023,USD,458021,113658,344363,282337,62026,6162,55864,4580,9160,46704,34403,335760,160220,175540,38168.42,458021,299.32,771.16,0.041,549,69.47,47389.72,0.73,0.7518
6498,Kirk Johnson and Hancock,False,IN,Emilymouth,Cybersecurity,2019,https://kirkjohnsonandhancock.com,Peace old treat follow safe fact region area.,17,kirk-johnson-and-hancock,2023,USD,260035,83232,176803,134432,42371,24613,17758,2600,5200,12558,19540,312735,128167,184568,,260035,527.05,3578.88,0.071,395,54.74,40648.77,0.48,0.6799
6499,Torres-Brown,False,NG,North Andrea,AgriTech,2011,https://torres-brown.com,All to middle body new religious few.,19,torres-brown,2023,USD,589945,345608,244337,285832,-41495,0,-41495,5899,11798,-53293,32240,398018,232158,165860,,589945,470.0,1132.5,0.001,2254,21.81,11256.12,2.86,0.4142
6500,Gonzalez LLC,False,IN,Johnsonborough,Marketplaces,2024,https://gonzalezllc.com,Information ready suffer civil space perhaps yet expert middle wife.,26,gonzalez-llc,2023,USD,391439,118896,272543,274837,-2294,0,-2294,3914,7828,-10122,21637,401241,20062,381179,,391439,296.41,1079.13,0.0538,1630,20.0,41668.6,0.52,0.6963
6501,Roberts Carey and Wilson,False,AU,Parsonsport,AgriTech,2020,https://robertscareyandwilson.com,Share until challenge degree begin fact.,13,roberts-carey-and-wilson,2023,USD,162315,66577,95738,27853,67885,0,67885,1623,3246,64639,17204,263504,42985,220519,,162315,20.0,54.22,0.1164,86,155.74,25380.18,0.68,0.5898
6502,Lopez Peters and Russell,False,US,Sanchezland,Fintech,2011,https://lopezpetersandrussell.com,Sure use on black since fast sometimes attorney federal bill.,29,lopez-peters-and-russell,2023,USD,157958,53984,103974,33126,70848,42534,28314,1579,3159,25155,6975,284043,108292,175751,,157958,837.59,3477.31,0.0135,219,60.05,16491.3,0.42,0.6582
6503,Norris LLC,False,DE,East Bradton,AgriTech,2016,https://norrisllc.com,Picture enter home edge between support soldier public.,17,norris-llc,2023,EUR,1087367,350922,736445,434294,302151,38339,263812,10873,21747,242065,64791,694484,207121,487363,,1087367,1467.3,2810.06,0.0588,322,280.93,33532.75,1.93,0.6773
6504,Fernandez-George,False,AU,Sydneymouth,EdTech,2024,https://fernandez-george.com,Line clearly various herself bar real total face.,28,fernandez-george,2023,USD,400700,105807,294893,256889,38004,0,38004,4007,8014,29990,184253,386672,241166,145506,33391.67,400700,243.28,1590.39,0.0914,6678,5.0,1000.0,184.25,0.7359
6505,Peterson-Jones,False,GB,Brendachester,Marketplaces,2023,https://peterson-jones.com,Sister itself good same write be experience.,17,peterson-jones,2023,USD,708870,258294,450576,396787,53789,50169,3620,7088,14177,-10557,118553,616413,32729,583684,,708870,1127.1,563.55,0.0133,2953,20.0,27522.17,4.31,0.6356
6506,Smith Greene and Meyer,False,NG,Nancystad,SaaS,2012,https://smithgreeneandmeyer.com,Perform during describe nice firm unit.,31,smith-greene-and-meyer,2023,USD,1660109,625702,1034407,991785,42622,59671,-17049,16601,33202,-50251,79669,1005325,50266,955059,138342.42,1660109,94.85,420.8,0.0326,1864,74.19,65141.81,1.22,0.6231
6507,Frazier Ltd,False,US,Joelmouth,E-commerce,2021,https://frazierltd.com,Determine each kitchen director leader building action consider.,15,frazier-ltd,2023,USD,722513,301138,421375,194507,226868,28427,198441,7225,14450,183991,48536,597626,446172,151454,,722513,20.0,24.04,0.0523,470,127.94,36545.82,1.33,0.5832
6508,Soto and Sons,False,KE,South Randall,E-commerce,2008,https://sotoandsons.com,Music suddenly color I tell bill.,17,soto-and-sons,2023,USD,283435,130754,152681,25036,127645,22226,105419,2834,5668,99751,7824,311088,175285,135803,,283435,20.0,59.11,0.001,1180,20.0,1000.0,7.82,0.5387
6509,Wilson Flowers and Scott,False,EG,Port Suzanneview,EdTech,2013,https://wilsonflowersandscott.com,Red high fine voice father example report relationship capital community.,14,wilson-flowers-and-scott,2023,USD,825259,275188,550071,482404,67667,13275,54392,8252,16505,37887,93359,647874,314310,333564,68771.58,825259,10.0,33.53,0.028,2503,27.47,53937.05,1.73,0.6665
6510,Mercado Group,False,FR,North Amberview,Cybersecurity,2017,https://mercadogroup.com,Good group on choice myself sing.,25,mercado-group,2023,EUR,1069255,364929,704326,295411,408915,11814,397101,10692,21385,375716,104282,813470,170165,643305,,1069255,904.38,3582.84,0.001,358,248.74,51002.31,2.04,0.6587
6511,Bush Richard and Gomez,False,ZA,Port Ryanland,Energy,2016,https://bushrichardandgomez.com,Candidate reveal senior available else however million reality reach industry.,17,bush-richard-and-gomez,2023,USD,609910,133403,476507,427086,49421,23899,25522,6099,12198,13324,143848,508752,190264,318488,,609910,367.37,183.68,0.0872,2080,24.43,60388.05,2.38,0.7813
6512,Owens and Sons,False,ZA,West Connorton,AgriTech,2014,https://owensandsons.com,Person white machine development fill traditional network financial consumer.,13,owens-and-sons,2023,USD,617411,230676,386735,444850,-58115,0,-58115,6174,12348,-70463,13101,435593,113480,322113,,617411,941.22,4876.37,0.1276,470,109.4,19612.73,0.67,0.6264
6513,Roberts Ltd,False,BR,Lauraport,Energy,2019,https://robertsltd.com,Write husband above major wish necessary music.,27,roberts-ltd,2023,USD,6037424,2230237,3807187,2970823,836364,0,836364,60374,120748,715616,411091,3581719,2359423,1222296,,6037424,1573.65,14251.71,0.0046,25155,20.0,248140.14,1.66,0.6306
6514,Harrison Smith and Salinas,False,FR,New Theresaborough,Energy,2023,https://harrisonsmithandsalinas.com,Boy live leg attorney start rate.,23,harrison-smith-and-salinas,2023,EUR,2835062,680800,2154262,1111185,1043077,17987,1025090,28350,56701,968389,270631,1736081,185750,1550331,,2835062,20.0,103.74,0.001,600,393.68,83871.87,3.23,0.7599
6515,Wood James and Crawford,False,KE,East Daniel,EdTech,2015,https://woodjamesandcrawford.com,Similar knowledge brother both charge would great.,13,wood-james-and-crawford,2023,USD,386101,179169,206932,335427,-128495,10224,-138719,3861,7722,-146441,15859,306956,45018,261938,32175.08,386101,499.66,2555.05,0.0598,342,93.88,23930.44,0.66,0.536
6516,Phillips-Ramirez,False,CA,Micheleland,SaaS,2018,https://phillips-ramirez.com,Suffer year international laugh artist store property.,16,phillips-ramirez,2023,USD,1329959,394100,935859,66497,869362,33183,836179,13299,26599,809580,79497,938322,290970,647352,110829.92,1329959,10.0,52.18,0.0563,1208,91.72,10075.04,7.89,0.7037
6517,Thompson PLC,False,CA,Williamview,Mobility,2015,https://thompsonplc.com,Maintain attack foreign summer suddenly book.,23,thompson-plc,2023,USD,1188654,520574,668080,890303,-222223,0,-222223,11886,23773,-245996,92346,854845,403613,451232,,1188654,549.47,2084.64,0.0822,1247,79.39,48490.84,1.9,0.562
6518,Allen Blackwell and Robinson,False,NG,Sullivanmouth,E-commerce,2023,https://allenblackwellandrobinson.com,Bag camera by figure day.,17,allen-blackwell-and-robinson,2023,USD,115007,42834,72173,77527,-5354,25774,-31128,1150,2300,-33428,3731,123398,61201,62197,,115007,20.0,35.75,0.1061,108,88.58,1000.0,3.73,0.6276
6519,Rose Roberts and Ross,False,DE,West Deanfort,Energy,2008,https://roserobertsandross.com,Seek though beat tax from nor service.,29,rose-roberts-and-ross,2023,EUR,2646061,1021579,1624482,513709,1110773,27340,1083433,26460,52921,1030512,875368,2287400,193201,2094199,,2646061,321.85,160.93,0.001,1297,169.99,18845.02,46.45,0.6139
6520,Cole-Garcia,False,ZA,Wardfurt,Fintech,2011,https://cole-garcia.com,Talk ten why American out.,17,cole-garcia,2023,USD,438082,154857,283225,41326,241899,4938,236961,4380,8761,228200,11386,234570,145684,88886,,438082,1511.24,755.62,0.001,1825,20.0,1000.0,11.39,0.6465
6521,Rich Group,False,KE,North Steven,HealthTech,2015,https://richgroup.com,Chair also affect customer soldier accept.,16,rich-group,2023,USD,450394,134752,315642,286713,28929,30562,-1633,4503,9007,-10640,55504,466873,29806,437067,37532.83,450394,191.89,846.09,0.0391,402,93.24,1000.0,55.5,0.7008
6522,Moore Patterson and Perez,False,TN,Montoyafort,SaaS,2014,https://moorepattersonandperez.com,Story million position between.,20,moore-patterson-and-perez,2023,USD,2136664,753570,1383094,873779,509315,0,509315,21366,42733,466582,40717,1184328,343938,840390,178055.33,2136664,10.0,48.99,0.0245,2910,61.17,37844.6,1.08,0.6473
6523,Fowler-Jackson,False,EG,Port Marybury,Energy,2010,https://fowler-jackson.com,Fire decade couple help government should.,26,fowler-jackson,2023,USD,610514,315626,294888,117592,177296,14709,162587,6105,12210,150377,168533,500567,371948,128619,,610514,20.0,33.9,0.0617,363,139.96,13255.79,12.71,0.483
6524,Guerra Stone and Williams,False,FR,Port Eugene,Marketplaces,2022,https://guerrastoneandwilliams.com,Wife reach page figure skin dark quite social company.,15,guerra-stone-and-williams,2023,EUR,588971,256514,332457,277692,54765,5868,48897,5889,11779,37118,26437,478241,97594,380647,,588971,32.34,88.17,0.0572,2454,20.0,25999.25,1.02,0.5645
6525,Willis Brewer and Christian,False,ZA,Lake Shannon,HealthTech,2015,https://willisbrewerandchristian.com,Magazine another hair method lot.,29,willis-brewer-and-christian,2023,USD,729476,256613,472863,172043,300820,8820,292000,7294,14589,277411,7618,524056,77408,446648,60789.67,729476,230.55,304.59,0.001,1230,49.42,3615.14,2.11,0.6482
6526,Weber Young and Oliver,False,ZA,Brianfurt,EdTech,2014,https://weberyoungandoliver.com,Avoid question age fill rock.,26,weber-young-and-oliver,2023,USD,238263,43449,194814,136650,58164,41991,16173,2382,4765,11408,25524,290991,142945,148046,19855.25,238263,10.0,32.83,0.0452,3971,5.0,54284.32,0.47,0.8176
6527,Warren Ltd,False,CA,New Robert,Fintech,2009,https://warrenltd.com,Enter yet total read ten.,25,warren-ltd,2023,USD,376308,55723,320585,367028,-46443,0,-46443,3763,7526,-53969,14861,292196,14609,277587,,376308,355.83,1101.89,0.0096,308,101.81,36424.76,0.41,0.8519
6528,Torres PLC,False,IN,South Breannaborough,SaaS,2021,https://torresplc.com,Thus can sense billion answer.,19,torres-plc,2023,USD,813034,295470,517564,409815,107749,0,107749,8130,16260,91489,88742,550623,230531,320092,67752.83,813034,510.08,1863.34,0.0356,1940,34.91,37189.71,2.39,0.6366
6529,Hicks Group,False,FR,Port Henryshire,AgriTech,2022,https://hicksgroup.com,Hope fire hospital half maintain oil range step.,17,hicks-group,2023,EUR,324847,132401,192446,127519,64927,0,64927,3248,6496,58431,24255,314103,193421,120682,,324847,795.03,4653.18,0.0334,240,112.66,8458.44,2.87,0.5924
6530,Lee Henderson and Hunter,False,DE,New Timothy,Fintech,2018,https://leehendersonandhunter.com,Work once seek national expect see PM position.,18,lee-henderson-and-hunter,2023,EUR,1227882,526110,701772,1030913,-329141,0,-329141,12278,24557,-353698,134032,754546,286281,468265,,1227882,1909.26,7824.32,0.0708,832,122.95,75144.37,1.78,0.5715
6531,Jacobs-Ramirez,False,DE,Hutchinsonburgh,IoT,2011,https://jacobs-ramirez.com,Stay significant however side whom before pass.,21,jacobs-ramirez,2023,EUR,862771,279169,583602,326973,256629,0,256629,8627,17255,239374,26639,646527,340745,305782,,862771,20.0,16.49,0.001,3594,20.0,15430.92,1.73,0.6764
6532,Sanchez-Cisneros,False,FR,Port Jason,AgriTech,2015,https://sanchez-cisneros.com,Throughout address movement ability rather century should reveal blue chair.,19,sanchez-cisneros,2023,EUR,324374,129135,195239,284631,-89392,0,-89392,3243,6487,-95879,13964,371604,261699,109905,,324374,422.46,1604.17,0.012,136,198.25,33475.35,0.42,0.6019
6533,Mason Group,False,US,West Christopher,Mobility,2016,https://masongroup.com,Sport population them wide question hard.,13,mason-group,2023,USD,372983,107642,265341,117258,148083,0,148083,3729,7459,140624,25972,275153,208936,66217,,372983,1368.45,6537.5,0.0167,1554,20.0,17495.13,1.48,0.7114
6534,Turner and Sons,False,NG,East Davidchester,HealthTech,2008,https://turnerandsons.com,Ago art once ok social wonder will theory ahead house.,19,turner-and-sons,2023,USD,1424804,647947,776857,71240,705617,0,705617,14248,28496,677121,74752,925158,70273,854885,118733.67,1424804,10.0,44.66,0.0493,3792,31.31,1000.0,74.75,0.5452
6535,Stephens Michael and Kelley,False,EG,North Monicafort,EdTech,2021,https://stephensmichaelandkelley.com,Community officer TV imagine top evidence Congress type.,18,stephens-michael-and-kelley,2023,USD,2125846,921529,1204317,830150,374167,0,374167,21258,42516,331651,96453,1244267,62213,1182054,177153.83,2125846,189.96,678.59,0.0253,1729,102.45,39871.87,2.42,0.5665
6536,Campbell Kelly and Morrison,False,CA,Barkermouth,Fintech,2010,https://campbellkellyandmorrison.com,You question degree day though economic be recognize.,18,campbell-kelly-and-morrison,2023,USD,6972069,830678,6141391,4055916,2085475,19965,2065510,69720,139441,1926069,372154,4043646,1697673,2345973,,6972069,221.87,760.91,0.1957,3637,159.74,309968.68,1.2,0.8809
6537,Harris PLC,False,NG,Port Sabrina,IoT,2015,https://harrisplc.com,Herself agreement part return main during white.,24,harris-plc,2023,USD,1233683,384647,849036,792118,56918,31545,25373,12336,24673,700,74971,865793,685581,180212,,1233683,1302.99,848.71,0.0436,809,126.96,60551.63,1.24,0.6882
6538,Estes Bonilla and Brown,False,KE,West Tiffanyton,AgriTech,2008,https://estesbonillaandbrown.com,Material practice cold such responsibility money although pretty box.,21,estes-bonilla-and-brown,2023,USD,331698,76960,254738,62917,191821,29141,162680,3316,6633,156047,36696,246466,54375,192091,,331698,981.14,1604.79,0.0187,172,159.89,1000.0,36.7,0.768
6539,Woodward-Morales,False,TN,Justinhaven,Cybersecurity,2019,https://woodward-morales.com,Order ready game cold claim field wonder professor.,19,woodward-morales,2023,USD,901512,262957,638555,858348,-219793,22319,-242112,9015,18030,-260142,59102,592222,195465,396757,,901512,1572.18,6501.38,0.0737,3756,20.0,81938.87,0.72,0.7083
6540,Rosario Inc,False,CA,North Joshua,Mobility,2013,https://rosarioinc.com,Free indicate everybody right little learn any never.,12,rosario-inc,2023,USD,4425846,1787310,2638536,2095234,543302,23696,519606,44258,88516,431090,237114,2617578,1641726,975852,,4425846,20.0,95.05,0.1255,12900,28.59,145447.48,1.63,0.5962
6541,Pittman Inc,False,US,West Michaelstad,Cybersecurity,2011,https://pittmaninc.com,Check friend degree foot opportunity minute pull.,25,pittman-inc,2023,USD,1145034,419909,725125,534753,190372,0,190372,11450,22900,167472,4419,705242,243191,462051,,1145034,291.7,1324.67,0.0248,403,236.68,52903.03,0.08,0.6333
6542,Evans and Sons,False,BR,Brittneyborough,IoT,2008,https://evansandsons.com,Hope however increase air tax life financial rise whatever past.,16,evans-and-sons,2023,USD,269514,138769,130745,173562,-42817,21465,-64282,2695,5390,-69672,8302,338866,101822,237044,,269514,268.72,1005.98,0.0739,238,94.09,43124.62,0.19,0.4851
6543,Houston Green and Hanson,False,BR,West Rebeccastad,AgriTech,2014,https://houstongreenandhanson.com,Something ask notice team thousand like blue receive.,20,houston-green-and-hanson,2023,USD,625357,241305,384052,349584,34468,0,34468,6253,12507,21961,24745,355549,117861,237688,,625357,447.94,1224.73,0.0316,177,292.82,79804.24,0.31,0.6141
6544,Mathis-Hays,False,GB,Taratown,HealthTech,2015,https://mathis-hays.com,Relationship realize production theory range fine.,17,mathis-hays,2023,USD,1862544,556493,1306051,642476,663575,10106,653469,18625,37250,616219,97366,1029321,648287,381034,155212.0,1862544,434.78,2468.08,0.0516,31042,5.0,81050.5,1.2,0.7012
6545,Warren LLC,False,ZA,Port William,SaaS,2013,https://warrenllc.com,Cut dark degree heavy positive measure cost impact.,18,warren-llc,2023,USD,2506991,688107,1818884,1019719,799165,967,798198,25069,50139,748059,346163,1612840,802232,810608,208915.92,2506991,77.14,252.39,0.0564,6031,34.64,60950.4,5.68,0.7255
6546,Martinez Carney and Bell,False,DE,Brentton,EdTech,2014,https://martinezcarneyandbell.com,Specific per peace three land government.,16,martinez-carney-and-bell,2023,EUR,371053,89611,281442,302898,-21456,0,-21456,3710,7421,-28877,20526,335062,169079,165983,30921.08,371053,10.0,31.15,0.001,1693,18.26,24326.34,0.84,0.7585
6547,Taylor Ferguson and Davidson,False,GB,South John,AgriTech,2022,https://taylorfergusonanddavidson.com,It fear might along training style money note forward suddenly.,16,taylor-ferguson-and-davidson,2023,USD,1068227,480167,588060,247020,341040,0,341040,10682,21364,319676,90943,784769,225945,558824,,1068227,20.0,100.05,0.0223,1255,70.89,46802.97,1.94,0.5505
6548,Smith Inc,False,US,South Christopher,Marketplaces,2022,https://smithinc.com,Move manage although after majority country.,17,smith-inc,2023,USD,1278182,413531,864651,341149,523502,0,523502,12781,25563,497939,148007,909963,627357,282606,,1278182,20.0,18.02,0.0168,1517,70.19,39834.49,3.72,0.6765
6549,Gallegos-Glover,False,DE,West Grace,IoT,2012,https://gallegos-glover.com,Expect economic before drive child others edge everyone reason weight.,19,gallegos-glover,2023,EUR,833888,281595,552293,436773,115520,0,115520,8338,16677,98843,84389,632405,336566,295839,,833888,20.0,123.05,0.0271,733,94.76,45282.98,1.86,0.6623
6550,Anderson PLC,False,US,Port Amy,Fintech,2014,https://andersonplc.com,Scene all trade week type rule other energy.,28,anderson-plc,2023,USD,355270,114552,240718,186813,53905,113,53792,3552,7105,46687,10106,366552,170720,195832,,355270,858.63,5692.16,0.0338,657,45.06,27267.53,0.37,0.6776
6551,Padilla-Johnson,False,CA,Skinnerhaven,Marketplaces,2017,https://padilla-johnson.com,Leg tend dinner cup part resource manage.,20,padilla-johnson,2023,USD,2062823,466154,1596669,911488,685181,0,685181,20628,41256,643925,101618,1285877,767704,518173,,2062823,98.45,102.44,0.0731,8595,20.0,86568.35,1.17,0.774
6552,Pineda-Schmitt,False,BR,Mataburgh,Energy,2012,https://pineda-schmitt.com,Create difficult catch citizen decide area.,17,pineda-schmitt,2023,USD,2485483,650729,1834754,2223574,-388820,935,-389755,24854,49709,-439464,84557,1332631,662203,670428,,2485483,20.0,93.57,0.0159,1372,150.87,212614.25,0.4,0.7382
6553,Johnson-May,False,ZA,Brownchester,Fintech,2013,https://johnson-may.com,American this north weight past American never beat where.,19,johnson-may,2023,USD,2015930,696227,1319703,932941,386762,0,386762,20159,40318,346444,28191,1105858,354475,751383,,2015930,36.49,212.37,0.001,680,246.85,88527.11,0.32,0.6546
6554,Miller Johnson and Hodge,False,EG,North Laurashire,Energy,2008,https://millerjohnsonandhodge.com,Week industry from already whose none.,22,miller-johnson-and-hodge,2023,USD,1557526,405190,1152336,790974,361362,0,361362,15575,31150,330212,46756,865127,346336,518791,,1557526,70.17,229.72,0.1019,1042,124.45,47602.73,0.98,0.7399
6555,Cox PLC,False,GB,Port Kyle,E-commerce,2009,https://coxplc.com,Us beyond professional debate president create good.,16,cox-plc,2023,USD,549713,172688,377025,542529,-165504,0,-165504,5497,10994,-176498,10477,468343,94308,374035,,549713,938.65,3512.13,0.0364,1382,33.13,62557.85,0.17,0.6859
6556,Forbes Lawson and Poole,False,NG,Patrickville,HealthTech,2021,https://forbeslawsonandpoole.com,Charge choice million thing two relationship know behavior loss.,15,forbes-lawson-and-poole,2023,USD,260350,61579,198771,130406,68365,0,68365,2603,5207,63158,5146,332305,168864,163441,21695.83,260350,10.0,65.1,0.0246,454,47.72,20469.1,0.25,0.7635
6557,Cervantes LLC,False,FR,South Cassieport,Fintech,2013,https://cervantesllc.com,Build century full less full forget son financial who.,15,cervantes-llc,2023,EUR,396484,92766,303718,159080,144638,13751,130887,3964,7929,122958,127780,414135,219306,194829,,396484,20.0,42.37,0.0452,218,151.2,28619.75,4.46,0.766
6558,Todd-Crane,False,DE,Priceborough,Fintech,2012,https://todd-crane.com,Return back my point issue.,27,todd-crane,2023,EUR,260093,109729,150364,140493,9871,0,9871,2600,5201,4670,4283,197670,19101,178569,,260093,38.43,151.8,0.0738,272,79.49,17703.06,0.24,0.5781
6559,Cherry-Richards,False,TN,Fosterport,Fintech,2021,https://cherry-richards.com,Few last keep Mrs discuss interview way wall especially use stand.,20,cherry-richards,2023,USD,6353726,2617506,3736220,2753592,982628,17362,965266,63537,127074,838192,133784,3480256,1508701,1971555,,6353726,20.0,69.28,0.0419,26473,20.0,213062.05,0.63,0.588
6560,Johnson-Norman,False,DE,West Thomasview,Cybersecurity,2013,https://johnson-norman.com,In politics explain reason voice art.,31,johnson-norman,2023,EUR,1604127,420941,1183186,1142786,40400,29170,11230,16041,32082,-20852,207068,1098650,339078,759572,,1604127,1115.06,5987.42,0.001,6683,20.0,89094.97,2.32,0.7376
6561,Walton-Nunez,False,IN,West Janice,Cybersecurity,2024,https://walton-nunez.com,Situation for animal course month drug lose.,17,walton-nunez,2023,USD,1257280,511704,745576,644154,101422,0,101422,12572,25145,76277,112474,810835,337487,473348,,1257280,858.07,2425.26,0.0885,5238,20.0,44730.76,2.51,0.593
6562,Brooks Ltd,False,ZA,Lake Lori,AI/ML,2024,https://brooksltd.com,Assume fight surface international girl cell I magazine open room.,21,brooks-ltd,2023,USD,2133049,674417,1458632,1264046,194586,0,194586,21330,42660,151926,20435,1256439,308360,948079,,2133049,1407.81,4470.02,0.074,695,255.76,108702.47,0.19,0.6838
6563,Jordan Bradford and Winters,False,KE,Elizabethhaven,IoT,2018,https://jordanbradfordandwinters.com,Maintain among church read common set.,20,jordan-bradford-and-winters,2023,USD,266117,80973,185144,104815,80329,38015,42314,2661,5322,36992,15580,155172,41668,113504,,266117,135.32,113.55,0.0377,113,196.21,16225.2,0.96,0.6957
6564,Bradford Bush and Alvarado,False,EG,Port Tammiebury,HealthTech,2014,https://bradfordbushandalvarado.com,Growth war entire expect just may unit stay easy fly hospital.,24,bradford-bush-and-alvarado,2023,USD,471651,204864,266787,57485,209302,0,209302,4716,9433,199869,20688,281937,56556,225381,39304.25,471651,10.0,55.81,0.0372,565,69.56,8032.39,2.58,0.5656
6565,Porter and Sons,False,EG,Longmouth,Energy,2013,https://porterandsons.com,Somebody mention trouble improve relate relate.,18,porter-and-sons,2023,USD,5144859,1702779,3442080,847267,2594813,2077,2592736,51448,102897,2489839,75756,2726176,1599368,1126808,,5144859,74.49,236.98,0.1042,2590,165.53,70804.13,1.07,0.669
6566,Hayes-Morrison,False,KE,Lynnborough,Mobility,2016,https://hayes-morrison.com,Activity present discussion significant control year.,18,hayes-morrison,2023,USD,2175601,987119,1188482,1884877,-696395,15533,-711928,21756,43512,-755440,86360,1346900,762492,584408,,2175601,432.27,1452.92,0.001,1976,91.73,178030.28,0.49,0.5463
6567,Freeman-Wells,False,CA,East Timothy,AgriTech,2014,https://freeman-wells.com,Test chance civil support summer support those leave.,15,freeman-wells,2023,USD,407559,209087,198472,205111,-6639,714,-7353,4075,8151,-15504,3597,235563,22612,212951,,407559,20.0,27.37,0.0221,157,215.09,40654.98,0.09,0.487
6568,Quinn Rice and Peters,False,ZA,New Michaelfort,SaaS,2014,https://quinnriceandpeters.com,Example enter his page beyond perhaps billion part ten.,15,quinn-rice-and-peters,2023,USD,1867825,752921,1114904,1494366,-379462,0,-379462,18678,37356,-416818,66810,1063915,53195,1010720,155652.08,1867825,10.0,40.98,0.001,3629,42.88,164470.98,0.41,0.5969
6569,Carr PLC,False,TN,Lake Shelby,AgriTech,2020,https://carrplc.com,Others century teach ground two.,34,carr-plc,2023,USD,152803,76450,76353,72763,3590,5903,-2313,1528,3056,-5369,7598,132654,71587,61067,,152803,2399.04,3396.64,0.1091,93,136.44,4133.07,1.84,0.4997
6570,Dean-Patel,False,AU,New Audreychester,AI/ML,2022,https://dean-patel.com,Hour throughout by clearly thank.,23,dean-patel,2023,USD,306994,91167,215827,109324,106503,0,106503,3069,6139,100364,39404,300930,64686,236244,,306994,20.0,95.71,0.001,108,235.4,48427.3,0.81,0.703
6571,Williams and Sons,False,FR,Davischester,IoT,2011,https://williamsandsons.com,Go several determine performance article hope else agency speech the.,17,williams-and-sons,2023,EUR,107884,32615,75269,60306,14963,0,14963,1078,2157,12806,4111,219747,13223,206524,,107884,566.78,283.39,0.1086,54,166.13,17080.37,0.24,0.6977
6572,Wilson-Graham,False,AU,Whiteshire,Cybersecurity,2012,https://wilson-graham.com,Themselves hold message direction work method difference job pressure third.,19,wilson-graham,2023,USD,692559,170716,521843,454069,67774,0,67774,6925,13851,53923,54294,449605,137033,312572,,692559,364.83,291.62,0.001,2885,20.0,43769.11,1.24,0.7535
6573,Davis Perry and Smith,False,US,Higginsfurt,EdTech,2011,https://davisperryandsmith.com,Hot the Mr simply leader assume land whose.,21,davis-perry-and-smith,2023,USD,1097208,547261,549947,619059,-69112,0,-69112,10972,21944,-91056,39401,763977,191091,572886,91434.0,1097208,417.23,417.23,0.0487,18286,5.0,60967.04,0.65,0.5012
6574,Jackson-Collins,False,NG,Julieshire,Mobility,2020,https://jackson-collins.com,Population argue number again food.,25,jackson-collins,2023,USD,448102,169309,278793,304017,-25224,19639,-44863,4481,8962,-53825,63072,341708,17085,324623,,448102,20.0,84.09,0.0743,286,130.22,32723.3,1.93,0.6222
6575,Berry Inc,False,BR,Bobbyview,IoT,2012,https://berryinc.com,Employee that box up institution north gas.,18,berry-inc,2023,USD,450230,220388,229842,216144,13698,10701,2997,4502,9004,-6007,209866,435466,76099,359367,,450230,20.0,110.9,0.0667,684,54.83,4471.96,46.93,0.5105
6576,Hammond Bush and Hebert,False,US,North Kristenmouth,AI/ML,2013,https://hammondbushandhebert.com,Interest meet popular only decision safe system skill wonder surface.,24,hammond-bush-and-hebert,2023,USD,4400014,816979,3583035,3299693,283342,24330,259012,44000,88000,171012,203133,2426971,562754,1864217,,4400014,90.77,424.79,0.0299,2839,129.11,245287.89,0.83,0.8143
6577,Thomas Sullivan and Medina,False,NG,Patrickshire,EdTech,2012,https://thomassullivanandmedina.com,Person marriage our third heart dream police nice.,20,thomas-sullivan-and-medina,2023,USD,3833246,1462337,2370909,1853463,517446,48674,468772,38332,76664,392108,153190,2159605,701815,1457790,319437.17,3833246,459.27,2089.9,0.0582,13249,24.11,117691.24,1.3,0.6185
6578,Macdonald Collins and Stone,False,DE,New Laurie,SaaS,2024,https://macdonaldcollinsandstone.com,Only identify responsibility draw short young system.,18,macdonald-collins-and-stone,2023,EUR,1141758,523405,618353,565104,53249,500,52749,11417,22835,29914,162640,886019,530161,355858,95146.5,1141758,237.12,976.23,0.0337,1322,71.93,45754.63,3.55,0.5416
6579,Fowler Ramos and Flores,False,KE,Sandersborough,AI/ML,2010,https://fowlerramosandflores.com,Win early former step wide possible hope yeah number.,19,fowler-ramos-and-flores,2023,USD,1998164,958335,1039829,786009,253820,14750,239070,19981,39963,199107,150481,1237727,461685,776042,,1998164,1279.69,2550.98,0.1074,588,282.8,67963.4,2.21,0.5204
6580,Patton-Edwards,False,DE,Kylemouth,AI/ML,2010,https://patton-edwards.com,Generation out child real tough watch sort with.,18,patton-edwards,2023,EUR,418769,173919,244850,20938,223912,5909,218003,4187,8375,209628,39606,400453,157238,243215,,418769,1823.27,7544.07,0.032,1310,26.63,1000.0,39.61,0.5847
6581,Gonzalez Ltd,False,CA,Moralesfort,AI/ML,2010,https://gonzalezltd.com,New election network enough green realize none one.,28,gonzalez-ltd,2023,USD,3198440,1736521,1461919,2029900,-567981,0,-567981,31984,63968,-631949,654322,2400998,752630,1648368,,3198440,20.0,105.33,0.001,4205,63.38,148959.86,4.39,0.4571
6582,Morales-Rivera,False,IN,Elizabethborough,AgriTech,2018,https://morales-rivera.com,Risk civil special off top now admit let beyond.,28,morales-rivera,2023,USD,221754,81941,139813,120906,18907,24212,-5305,2217,4435,-9740,843,245757,12287,233470,,221754,570.48,2628.73,0.0122,94,196.06,26477.96,0.03,0.6305
6583,Bryant LLC,False,NG,Tommyberg,HealthTech,2013,https://bryantllc.com,Amount live student yes ok power trouble whether stand child.,19,bryant-llc,2023,USD,1094458,269000,825458,375496,449962,0,449962,10944,21889,428073,230923,794310,203055,591255,91204.83,1094458,308.57,658.62,0.001,3640,25.05,16207.74,14.25,0.7542
6584,Charles Velez and Campbell,False,US,Stokesburgh,Energy,2023,https://charlesvelezandcampbell.com,One become piece stock create should add animal.,11,charles-velez-and-campbell,2023,USD,1407806,366666,1041140,70390,970750,0,970750,14078,28156,942594,73725,785196,341375,443821,,1407806,98.2,413.85,0.0685,710,165.23,5029.99,14.66,0.7395
6585,Knapp Bush and Walker,False,DE,West Gabrielhaven,HealthTech,2015,https://knappbushandwalker.com,Recently debate whether need how court fund attention.,21,knapp-bush-and-walker,2023,EUR,896292,372722,523570,344099,179471,22509,156962,8962,17925,139037,12517,528756,326096,202660,74691.0,896292,10.0,55.15,0.0581,2093,35.67,17816.64,0.7,0.5842
6586,Cross Ltd,False,ZA,Lindseyshire,Marketplaces,2010,https://crossltd.com,Land still wind husband message girl.,21,cross-ltd,2023,USD,383735,115198,268537,197691,70846,0,70846,3837,7674,63172,4510,242620,92877,149743,,383735,909.92,2695.76,0.0437,1598,20.0,10938.62,0.41,0.6998
6587,Fernandez-Bell,False,NG,Port Joycebury,HealthTech,2022,https://fernandez-bell.com,Turn prepare pretty school college care wife tree.,36,fernandez-bell,2023,USD,2604277,656140,1948137,2492575,-544438,36454,-580892,26042,52085,-632977,417522,1875433,568267,1307166,217023.08,2604277,22.99,180.79,0.0924,5566,38.99,221320.79,1.89,0.7481
6588,Ferguson-Gonzalez,False,FR,Spencerbury,Energy,2010,https://ferguson-gonzalez.com,Even find able color find.,14,ferguson-gonzalez,2023,EUR,309224,111562,197662,151924,45738,29175,16563,3092,6184,10379,6123,324738,63018,261720,,309224,20.0,50.07,0.001,82,313.59,1000.0,6.12,0.6392
6589,Zhang PLC,False,ZA,Villarrealchester,E-commerce,2022,https://zhangplc.com,Employee prove produce might particular amount which add pull among.,15,zhang-plc,2023,USD,648289,329382,318907,368806,-49899,12678,-62577,6482,12965,-75542,5881,500841,274026,226815,,648289,2536.01,9023.81,0.001,2701,20.0,20137.93,0.29,0.4919
6590,Hernandez and Sons,False,GB,Carpenterborough,Marketplaces,2016,https://hernandezandsons.com,Realize well sure yeah food.,30,hernandez-and-sons,2023,USD,90133,42132,48001,35185,12816,11151,1665,901,1802,-137,21111,103000,5150,97850,,90133,20.0,52.32,0.0107,65,115.47,1000.0,21.11,0.5326
6591,Patterson Morris and Wall,False,CA,Lake Olivia,SaaS,2009,https://pattersonmorrisandwall.com,Bill high second rise to spring stuff difference.,25,patterson-morris-and-wall,2023,USD,1359715,67985,1291730,570732,720998,13853,707145,13597,27194,679951,67871,920927,396368,524559,113309.58,1359715,10.0,20.22,0.0429,22661,5.0,43237.69,1.57,0.95
6592,Miller and Sons,False,AU,Emilytown,SaaS,2008,https://millerandsons.com,Knowledge wish later world green growth research.,21,miller-and-sons,2023,USD,565313,62756,502557,130959,371598,0,371598,5653,11306,360292,17525,434425,118037,316388,47109.42,565313,10.0,73.07,0.0538,5641,8.35,18936.58,0.93,0.889
6593,Reyes-Kelley,False,AU,Monicastad,Marketplaces,2008,https://reyes-kelley.com,Shoulder concern bed loss yard tend fight.,23,reyes-kelley,2023,USD,947104,361177,585927,677519,-91592,0,-91592,9471,18942,-110534,32338,631976,385025,246951,,947104,20.0,111.81,0.0497,361,218.6,71814.54,0.45,0.6187
6594,Ortiz-Randall,False,AU,Yatesbury,Cybersecurity,2008,https://ortiz-randall.com,Area me red month season arm ready perhaps benefit current.,25,ortiz-randall,2023,USD,1581740,783997,797743,1363156,-565413,10549,-575962,15817,31634,-607596,34191,978961,194798,784163,,1581740,589.9,1544.52,0.001,480,274.24,130651.31,0.26,0.5043
6595,Mendez-Lopez,False,FR,Matthewton,E-commerce,2013,https://mendez-lopez.com,Attack moment region white task call police green.,19,mendez-lopez,2023,EUR,4481868,1538025,2943843,2462267,481576,12747,468829,44818,89637,379192,276517,2697495,1056121,1641374,,4481868,20.0,62.91,0.0673,1459,255.82,238312.52,1.16,0.6568
6596,Figueroa and Sons,False,AU,South Timothy,Cybersecurity,2010,https://figueroaandsons.com,Each meeting nothing between individual bank his possible special body.,23,figueroa-and-sons,2023,USD,745507,306518,438989,256704,182285,26111,156174,7455,14910,141264,5707,528214,142713,385501,,745507,833.05,2891.01,0.029,3106,20.0,10602.51,0.54,0.5888
6597,Patel Valdez and Andrews,False,FR,Lake Edwin,Cybersecurity,2014,https://patelvaldezandandrews.com,Civil focus lay travel family friend.,21,patel-valdez-and-andrews,2023,EUR,6257456,1575960,4681496,3588701,1092795,18012,1074783,62574,125149,949634,664978,3975755,3060384,915371,,6257456,881.52,2870.04,0.0098,7165,72.77,255423.74,2.6,0.7481
6598,Carpenter-Watson,False,EG,West John,Fintech,2022,https://carpenter-watson.com,Report close job network subject.,19,carpenter-watson,2023,USD,4270753,1431131,2839622,213537,2626085,0,2626085,42707,85415,2540670,21504,2236614,704707,1531907,,4270753,20.0,10.0,0.062,3624,98.19,11633.31,1.85,0.6649
6599,Henderson Benton and Fisher,False,AU,East Aaronview,AI/ML,2019,https://hendersonbentonandfisher.com,Federal boy answer various these indicate people.,20,henderson-benton-and-fisher,2023,USD,1090580,462858,627722,602404,25318,12184,13134,10905,21811,-8677,45756,645524,343528,301996,,1090580,442.17,2050.13,0.0588,1262,71.97,70581.46,0.65,0.5756
6600,Simmons Group,False,US,Fosterview,Marketplaces,2008,https://simmonsgroup.com,Wall recognize most approach firm director trip.,24,simmons-group,2023,USD,4071625,1068354,3003271,2384735,618536,2537,615999,40716,81432,534567,451148,2611514,130575,2480939,,4071625,552.56,3218.37,0.001,16965,20.0,205908.99,2.19,0.7376
6601,Copeland Inc,False,ZA,Port Gabriella,HealthTech,2019,https://copelandinc.com,Art response least issue while.,19,copeland-inc,2023,USD,1257399,286632,970767,1051055,-80288,20096,-100384,12573,25147,-125531,103201,868776,207116,661660,104783.25,1257399,10.0,17.66,0.0627,20956,5.0,59068.68,1.75,0.772
6602,Obrien Perez and Tanner,False,CA,Oliviafurt,Energy,2011,https://obrienperezandtanner.com,Itself line prepare pressure large win write mind room strategy.,21,obrien-perez-and-tanner,2023,USD,3258777,1304510,1954267,528015,1426252,0,1426252,32587,65175,1361077,219965,1927644,245366,1682278,,3258777,775.4,1916.53,0.0114,1680,161.62,39368.26,5.59,0.5997
6603,Warren LLC,False,AU,Ginatown,AI/ML,2017,https://warrenllc.com,Send magazine report suggest family new child many but.,22,warren-llc,2023,USD,548357,213571,334786,126024,208762,0,208762,5483,10967,197795,7599,417762,171631,246131,,548357,103.79,559.96,0.001,309,147.42,1000.0,7.6,0.6105
6604,Smith LLC,False,AU,Simmonsside,AgriTech,2016,https://smithllc.com,Boy professional buy decide fall.,28,smith-llc,2023,USD,350193,98449,251744,143730,108014,0,108014,3501,7003,101011,6863,303154,169953,133201,,350193,858.36,429.18,0.001,235,124.07,38671.5,0.18,0.7189
6605,Jackson Ltd,False,GB,West Brentborough,Fintech,2012,https://jacksonltd.com,Listen political low range somebody threat soldier.,19,jackson-ltd,2023,USD,1276522,602732,673790,326508,347282,31318,315964,12765,25530,290434,23733,839583,286658,552925,,1276522,714.92,3241.92,0.0291,854,124.45,23267.94,1.02,0.5278
6606,Blanchard-Brock,False,KE,Burchhaven,Marketplaces,2023,https://blanchard-brock.com,Increase again answer sing all how discover speak pick southern.,22,blanchard-brock,2023,USD,1454327,560253,894074,747760,146314,22627,123687,14543,29086,94601,573918,1448005,461289,986716,,1454327,1712.06,5990.08,0.001,1954,62.02,37453.56,15.32,0.6148
6607,Pham-Owens,False,IN,Lake Davidberg,Mobility,2024,https://pham-owens.com,Anyone report call successful brother instead television use seem south.,23,pham-owens,2023,USD,304089,146061,158028,174642,-16614,6869,-23483,3040,6081,-29564,47799,268692,104873,163819,,304089,1177.41,4395.78,0.0715,377,67.15,40843.49,1.17,0.5197
6608,Carlson Ltd,False,AU,Matthewport,Fintech,2012,https://carlsonltd.com,Major however stay difficult station conference central local.,19,carlson-ltd,2023,USD,9749634,1698125,8051509,6976244,1075265,0,1075265,97496,194992,880273,220984,5291513,1335994,3955519,,9749634,1191.69,11897.04,0.0282,10119,80.29,571774.56,0.39,0.8258
6609,Key Gonzalez and Hobbs,False,GB,Danielleborough,AgriTech,2024,https://keygonzalezandhobbs.com,Create certainly environment side will word.,17,key-gonzalez-and-hobbs,2023,USD,60188,20073,40115,18934,21181,27342,-6161,601,1203,-7364,6888,150968,13395,137573,,60188,20.0,22.16,0.001,77,64.59,2614.32,2.63,0.6665
6610,Smith Inc,False,KE,New Savannahside,SaaS,2018,https://smithinc.com,Speak imagine process base product finally course decade yet.,17,smith-inc,2023,USD,1514911,408626,1106285,482489,623796,0,623796,15149,30298,593498,50784,818869,184296,634573,126242.58,1514911,190.2,877.51,0.1017,1566,80.61,39269.5,1.29,0.7303
6611,Martinez Caldwell and Newton,False,TN,Lake Jeffrey,Mobility,2009,https://martinezcaldwellandnewton.com,Particular process exactly according society single second rest green glass.,22,martinez-caldwell-and-newton,2023,USD,589778,143696,446082,242633,203449,0,203449,5897,11795,191654,18710,406443,106419,300024,,589778,271.75,1082.97,0.0641,2457,20.0,37923.1,0.49,0.7564
6612,Griffith Reed and Rodriguez,False,NG,Jamesfort,Energy,2022,https://griffithreedandrodriguez.com,Despite send ahead care source about public kid look process its.,21,griffith-reed-and-rodriguez,2023,USD,967720,402324,565396,579267,-13871,15785,-29656,9677,19354,-49010,62616,646213,456850,189363,,967720,20.0,89.84,0.0318,556,144.86,45984.98,1.36,0.5843
6613,Wood-Malone,False,US,Jessicafurt,SaaS,2009,https://wood-malone.com,Common start set cover own wait.,24,wood-malone,2023,USD,3100975,968348,2132627,596887,1535740,8542,1527198,31009,62019,1465179,127463,1840661,92033,1748628,258414.58,3100975,10.0,65.09,0.0572,4832,53.47,5704.68,22.34,0.6877
6614,Wells-Reed,False,US,Lake Haroldshire,Marketplaces,2016,https://wells-reed.com,Bit small remain plant candidate teach claim director range ever.,30,wells-reed,2023,USD,546911,248865,298046,314309,-16263,3680,-19943,5469,10938,-30881,7603,298069,171045,127024,,546911,20.0,88.91,0.0906,161,282.6,1000.0,7.6,0.545
6615,Miller Inc,False,DE,Randolphberg,Energy,2019,https://millerinc.com,Peace character occur rate report whether much someone question wait.,11,miller-inc,2023,EUR,2381252,610569,1770683,1375623,395060,21178,373882,23812,47625,326257,119438,1353543,748819,604724,,2381252,1665.45,1176.26,0.001,9921,20.0,130443.43,0.92,0.7436
6616,Johnson-Peters,False,BR,Davisbury,E-commerce,2010,https://johnson-peters.com,Morning message see guess public.,30,johnson-peters,2023,USD,1122778,380595,742183,375962,366221,8337,357884,11227,22455,335429,19429,739292,336963,402329,,1122778,206.79,344.04,0.036,1981,47.21,31801.43,0.61,0.661
6617,Parks Group,False,CA,Frederickshire,Cybersecurity,2024,https://parksgroup.com,Upon reason on specific and citizen.,19,parks-group,2023,USD,794987,172599,622388,323814,298574,21145,277429,7949,15899,261530,82688,537656,166950,370706,,794987,20.0,39.95,0.001,351,188.33,1000.0,82.69,0.7829
6618,Lozano-Gardner,False,IN,New Jessicahaven,AI/ML,2012,https://lozano-gardner.com,Themselves game similar eye culture room threat year.,25,lozano-gardner,2023,USD,2131541,519936,1611605,1550724,60881,5488,55393,21315,42630,12763,102215,1260946,500213,760733,,2131541,1414.44,707.22,0.0412,8881,20.0,129494.38,0.79,0.7561
6619,Graham-Bennett,False,TN,Melanieview,Energy,2011,https://graham-bennett.com,Draw perform none security we.,23,graham-bennett,2023,USD,385517,167200,218317,160835,57482,14433,43049,3855,7710,35339,61481,439769,183019,256750,,385517,853.31,1858.64,0.0167,196,163.21,12758.73,4.82,0.5663
6620,Carter-Kelly,False,DE,Michelleside,Energy,2012,https://carter-kelly.com,Someone before right care they sea fight concern space learn probably.,26,carter-kelly,2023,EUR,694109,177782,516327,489990,26337,39873,-13536,6941,13882,-27418,35168,467298,176911,290387,,694109,514.49,3806.53,0.0116,167,345.48,54639.76,0.64,0.7439
6621,Ellis-Coleman,False,AU,Port Danielle,AgriTech,2024,https://ellis-coleman.com,Fine now detail establish scientist his operation I herself.,19,ellis-coleman,2023,USD,158173,45395,112778,86049,26729,7026,19703,1581,3163,16540,26889,194067,41552,152515,,158173,1341.2,4453.28,0.0665,659,20.0,38521.19,0.7,0.713
6622,Oneill Group,False,DE,South Jeremyshire,E-commerce,2019,https://oneillgroup.com,Front area we focus several task learn federal.,19,oneill-group,2023,EUR,730010,199962,530048,215631,314417,42011,272406,7300,14600,257806,33182,518103,151849,366254,,730010,456.42,254.12,0.0212,1401,43.41,46594.75,0.71,0.7261
6623,Jensen Inc,False,BR,New Jennifer,SaaS,2019,https://jenseninc.com,Admit cup ball real allow woman.,16,jensen-inc,2023,USD,753052,252932,500120,327244,172876,35714,137162,7530,15061,122101,412948,804638,318683,485955,62754.33,753052,328.95,1291.68,0.027,686,91.44,41365.96,9.98,0.6641
6624,Ingram LLC,False,IN,Sandraton,HealthTech,2020,https://ingramllc.com,List sister ten catch step.,15,ingram-llc,2023,USD,1311626,883643,427983,598385,-170402,36007,-206409,13116,26232,-232641,30619,809506,286714,522792,109302.17,1311626,10.0,44.67,0.065,1959,55.77,72967.58,0.42,0.3263
6625,Jordan Pearson and Nelson,False,ZA,Spenceview,SaaS,2009,https://jordanpearsonandnelson.com,Owner Republican society wear small nature.,27,jordan-pearson-and-nelson,2023,USD,864127,412902,451225,535402,-84177,0,-84177,8641,17282,-101459,37074,560433,122535,437898,72010.58,864127,10.0,63.55,0.0396,3564,20.2,21483.39,1.73,0.5222
6626,Gray Ltd,False,BR,South Aprilmouth,Mobility,2009,https://grayltd.com,Act production yourself standard other no when door feel onto.,24,gray-ltd,2023,USD,1655677,345484,1310193,529709,780484,43147,737337,16556,33113,704224,296022,1239331,555644,683687,,1655677,813.71,3080.13,0.0052,6898,20.0,54356.92,5.45,0.7913
6627,Morrison-Webb,False,TN,Zacharyburgh,EdTech,2015,https://morrison-webb.com,Change fear wrong begin evening call station.,18,morrison-webb,2023,USD,832603,399038,433565,461046,-27481,5257,-32738,8326,16652,-49390,84263,693862,197691,496171,69383.58,832603,240.6,1177.75,0.0274,1607,43.15,59177.37,1.42,0.5207
6628,Wells-Rivas,False,TN,New Emilymouth,IoT,2022,https://wells-rivas.com,Speak national culture within cover national address issue how concern.,20,wells-rivas,2023,USD,320049,165116,154933,299240,-144307,0,-144307,3200,6400,-150707,14857,343848,17192,326656,,320049,20.0,13.48,0.0048,137,194.14,46060.08,0.32,0.4841
6629,Boyer LLC,False,KE,East Ivantown,E-commerce,2008,https://boyerllc.com,Recent specific daughter time sing myself stage several who offer.,21,boyer-llc,2023,USD,1201010,347734,853276,722618,130658,0,130658,12010,24020,106638,24964,634735,136338,498397,,1201010,239.85,594.58,0.1209,917,109.07,52492.18,0.48,0.7105
6630,Thomas LLC,False,AU,South Alexisbury,IoT,2024,https://thomasllc.com,Other nature organization myself system guy close full card rich.,17,thomas-llc,2023,USD,1209292,759938,449354,916741,-467387,50280,-517667,12092,24185,-541852,146304,898030,98473,799557,,1209292,168.31,462.99,0.0492,851,118.33,69447.3,2.11,0.3716
6631,Rich-Phillips,False,GB,East Olivia,HealthTech,2010,https://rich-phillips.com,Bank cultural environment its pass order Mr last lead top.,22,rich-phillips,2023,USD,1384458,69222,1315236,69222,1246014,4378,1241636,13844,27689,1213947,52949,889985,428399,461586,115371.5,1384458,208.96,529.06,0.0424,1892,60.96,22471.24,2.36,0.95
6632,Anderson Lang and Lee,False,US,Whiteburgh,AgriTech,2009,https://andersonlangandlee.com,Born act light allow building though senior see.,26,anderson-lang-and-lee,2023,USD,894199,126096,768103,729093,39010,5952,33058,8941,17883,15175,35712,639181,177853,461328,,894199,1306.69,3152.37,0.0654,1327,56.12,113177.83,0.32,0.859
6633,Hines-Rodriguez,False,FR,Lake Mikaylaton,Energy,2016,https://hines-rodriguez.com,Sense sign them deal tough any which security meeting high.,26,hines-rodriguez,2023,EUR,884700,404898,479802,106862,372940,0,372940,8847,17694,355246,52260,522587,117352,405235,,884700,20.0,174.89,0.001,346,212.47,17078.62,3.06,0.5423
6634,Wilson Mendoza and Robbins,False,NG,Port Amy,Fintech,2024,https://wilsonmendozaandrobbins.com,Case president work whatever economic major.,31,wilson-mendoza-and-robbins,2023,USD,944295,343844,600451,144344,456107,0,456107,9442,18885,437222,7499,657691,296855,360836,,944295,1095.82,8549.79,0.001,243,323.15,18024.86,0.42,0.6359
6635,Jones-Jackson,False,ZA,Brownborough,SaaS,2016,https://jones-jackson.com,Until major long relate however.,16,jones-jackson,2023,USD,3627108,1818152,1808956,2832495,-1023539,6908,-1030447,36271,72542,-1102989,76313,2082932,1049177,1033755,302259.0,3627108,747.17,4175.93,0.0083,6172,48.97,223036.76,0.34,0.4987
6636,Lewis Munoz and Gray,False,BR,Sandrafurt,Cybersecurity,2016,https://lewismunozandgray.com,Determine lawyer dog tax late sit their surface.,16,lewis-munoz-and-gray,2023,USD,3558092,1092680,2465412,1544346,921066,21406,899660,35580,71161,828499,142343,2100499,586636,1513863,,3558092,151.0,204.26,0.0031,2193,135.2,138342.95,1.03,0.6929
6637,Odonnell-Thomas,False,BR,Anthonyhaven,HealthTech,2023,https://odonnell-thomas.com,At perhaps peace across news front second training movement middle.,17,odonnell-thomas,2023,USD,614813,222648,392165,66882,325283,11002,314281,6148,12296,301985,25179,333038,63684,269354,51234.42,614813,75.08,235.49,0.048,906,56.51,1000.0,25.18,0.6379
6638,Rivera LLC,False,EG,Lauramouth,EdTech,2024,https://riverallc.com,Security down put number themselves.,17,rivera-llc,2023,USD,412184,144302,267882,231443,36439,0,36439,4121,8243,28196,14787,230075,73807,156268,34348.67,412184,621.36,1553.0,0.0103,1132,30.32,1082.48,13.66,0.6499
6639,Stevens Group,False,DE,Wheelerhaven,Energy,2014,https://stevensgroup.com,Three they meet card thing forget truth small push hold hotel.,21,stevens-group,2023,EUR,340513,59223,281290,163333,117957,8499,109458,3405,6810,102648,9606,200044,30510,169534,,340513,1240.2,5687.93,0.0528,1418,20.0,1000.0,9.61,0.8261
6640,Gonzalez LLC,False,NG,Brockburgh,Marketplaces,2010,https://gonzalezllc.com,Least likely teacher significant recognize according.,32,gonzalez-llc,2023,USD,317347,129715,187632,161197,26435,5610,20825,3173,6346,14479,12792,200573,110976,89597,,317347,293.82,577.77,0.0369,111,237.83,60571.84,0.21,0.5913
6641,Johnson-Barry,False,TN,New Charlesport,AgriTech,2015,https://johnson-barry.com,Space central industry finally behind bring.,21,johnson-barry,2023,USD,302205,119054,183151,283754,-100603,13154,-113757,3022,6044,-119801,86339,284448,161311,123137,,302205,20.0,10.0,0.001,1259,20.0,31407.82,2.75,0.606
6642,Stephens Rodriguez and Hernandez,False,GB,Bakerberg,Marketplaces,2010,https://stephensrodriguezandhernandez.com,Step anything west wife much.,14,stephens-rodriguez-and-hernandez,2023,USD,302148,79019,223129,150997,72132,14236,57896,3021,6042,51854,26609,262804,117976,144828,,302148,876.06,2461.95,0.0798,1258,20.0,1000.0,26.61,0.7385
6643,Nunez James and Greene,False,GB,New Lauren,Cybersecurity,2020,https://nunezjamesandgreene.com,Writer happy very range since song again them down hard throughout.,27,nunez-james-and-greene,2023,USD,3961702,1077028,2884674,2543859,340815,0,340815,39617,79234,261581,114806,2133388,1284051,849337,,3961702,1164.4,4943.92,0.0902,939,351.28,239409.37,0.48,0.7281
6644,Fox-Castillo,False,KE,Briggsborough,Marketplaces,2017,https://fox-castillo.com,Lot talk identify magazine soldier past performance expect reflect cell.,28,fox-castillo,2023,USD,1221042,534865,686177,208439,477738,53015,424723,12210,24420,400303,33055,763890,262326,501564,,1221042,475.47,2902.6,0.0682,617,164.65,36940.66,0.89,0.562
6645,Johnson-Carroll,False,ZA,Lake Claudia,HealthTech,2024,https://johnson-carroll.com,Cost significant official remember notice.,17,johnson-carroll,2023,USD,434148,196306,237842,270128,-32286,23942,-56228,4341,8682,-64910,47714,305830,109389,196441,36179.0,434148,353.58,2140.45,0.0806,554,65.29,45143.5,1.06,0.5478
6646,Bradley-Ford,False,KE,North Blake,Marketplaces,2017,https://bradley-ford.com,Actually old stage choose.,21,bradley-ford,2023,USD,943547,200614,742933,336360,406573,20004,386569,9435,18870,367699,31828,572843,209208,363635,,943547,20.0,10.0,0.0945,292,268.72,30483.7,1.04,0.7874
6647,Aguilar-Valdez,False,TN,Katherineton,AgriTech,2013,https://aguilar-valdez.com,Military society Republican town blood who focus drive.,15,aguilar-valdez,2023,USD,305458,72248,233210,179927,53283,0,53283,3054,6109,47174,16603,352382,162897,189485,,305458,807.07,1947.21,0.1271,190,133.76,26963.85,0.62,0.7635
6648,Burnett PLC,False,US,Petersonfurt,EdTech,2021,https://burnettplc.com,Either surface piece official box.,23,burnett-plc,2023,USD,1447891,414469,1033422,666049,367373,8917,358456,14478,28957,329499,60130,978967,607439,371528,120657.58,1447891,362.2,2184.84,0.031,24131,5.0,59741.84,1.01,0.7137
6649,Williams Rivera and Mcmillan,False,AU,New Henry,Cybersecurity,2012,https://williamsriveraandmcmillan.com,Various good perhaps picture black.,21,williams-rivera-and-mcmillan,2023,USD,4304455,1601347,2703108,2789208,-86100,4781,-90881,43044,86089,-176970,256928,2553377,314737,2238640,,4304455,343.49,335.99,0.001,3103,115.57,221792.59,1.16,0.628
6650,Greer-Reed,False,CA,West Kathrynport,Cybersecurity,2024,https://greer-reed.com,Color site coach model law create across impact only owner.,12,greer-reed,2023,USD,215289,80561,134728,66688,68040,0,68040,2152,4305,63735,4034,149193,7459,141734,,215289,813.61,1401.63,0.001,124,144.16,7778.88,0.52,0.6258
6651,Harris Ltd,False,TN,Garciashire,EdTech,2011,https://harrisltd.com,Weight least join institution population.,25,harris-ltd,2023,USD,136221,32479,103742,33180,70562,1121,69441,1362,2724,66717,2941,120066,8617,111449,11351.75,136221,10.0,59.53,0.0746,140,80.83,1000.0,2.94,0.7616
6652,Riggs Figueroa and Mendoza,False,IN,Taylormouth,AgriTech,2010,https://riggsfigueroaandmendoza.com,Check them section lose move bill hard six.,17,riggs-figueroa-and-mendoza,2023,USD,1090655,320820,769835,425402,344433,0,344433,10906,21813,322620,24050,766085,158419,607666,,1090655,348.61,481.68,0.022,4544,20.0,49163.85,0.49,0.7058
6653,Marsh-Hunt,False,EG,New Danielle,SaaS,2020,https://marsh-hunt.com,Animal structure case run allow travel show.,23,marsh-hunt,2023,USD,1358726,246100,1112626,88078,1024548,7536,1017012,13587,27174,989838,64739,942164,282634,659530,113227.17,1358726,611.06,3921.01,0.0174,1992,56.84,1000.0,64.74,0.8189
6654,Lee Group,False,IN,East Rachelfurt,Marketplaces,2020,https://leegroup.com,Purpose test write statement half college future war police small.,21,lee-group,2023,USD,1134528,308259,826269,431470,394799,0,394799,11345,22690,372109,81322,796958,265563,531395,,1134528,20.0,10.0,0.0437,4727,20.0,2855.75,28.48,0.7283
6655,Norris Group,False,GB,Feliciaburgh,E-commerce,2019,https://norrisgroup.com,Decade wrong fear yard TV into population.,15,norris-group,2023,USD,531210,108953,422257,236653,185604,30757,154847,5312,10624,144223,148822,601054,30052,571002,,531210,998.3,3524.34,0.0638,1653,26.78,1000.0,148.82,0.7949
6656,King Smith and Johnson,False,AU,Jasminfurt,AgriTech,2009,https://kingsmithandjohnson.com,From medical should game stand.,19,king-smith-and-johnson,2023,USD,816792,309101,507691,311318,196373,5627,190746,8167,16335,174411,104119,613870,233329,380541,,816792,1739.76,7637.67,0.0655,379,179.27,5569.19,18.7,0.6216
6657,Wilson Gillespie and Holder,False,GB,Lake Williamhaven,Energy,2015,https://wilsongillespieandholder.com,Family turn someone support themselves green.,21,wilson-gillespie-and-holder,2023,USD,3468156,1476205,1991951,433423,1558528,6700,1551828,34681,69363,1482465,160612,1934268,508337,1425931,,3468156,20.0,24.15,0.0544,14450,20.0,60483.65,2.66,0.5744
6658,Peters Williams and Price,False,ZA,East Tony,Marketplaces,2019,https://peterswilliamsandprice.com,Real blood close any major.,21,peters-williams-and-price,2023,USD,2261080,1291917,969163,910660,58503,16617,41886,22610,45221,-3335,90741,1410770,577531,833239,,2261080,969.01,3919.35,0.0319,9421,20.0,98706.29,0.92,0.4286
6659,Padilla Inc,False,CA,West Ryanton,AI/ML,2013,https://padillainc.com,Sing bit them have fact behind.,26,padilla-inc,2023,USD,420715,173607,247108,196768,50340,9742,40598,4207,8414,32184,41265,314589,198770,115819,,420715,992.35,6503.45,0.0401,137,255.48,18353.11,2.25,0.5874
6660,Cordova LLC,False,IN,South Jasonhaven,EdTech,2008,https://cordovallc.com,Be make ahead cost song lot name.,15,cordova-llc,2023,USD,229151,57805,171346,206045,-34699,6266,-40965,2291,4583,-45548,7087,134717,34623,100094,19095.92,229151,154.8,1052.4,0.0713,3819,5.0,21513.92,0.33,0.7477
6661,Garcia Price and Peterson,False,BR,West Jessica,Fintech,2023,https://garciapriceandpeterson.com,Run create color color oil writer class everybody scene laugh.,19,garcia-price-and-peterson,2023,USD,637902,120997,516905,168113,348792,16207,332585,6379,12758,319827,22869,454032,164455,289577,,637902,44.91,69.15,0.001,956,55.55,17714.74,1.29,0.8103
6662,Terrell Wade and Anderson,False,TN,Dunnmouth,AgriTech,2021,https://terrellwadeandanderson.com,Population long compare open want federal garden.,17,terrell-wade-and-anderson,2023,USD,171387,61170,110217,18562,91655,39599,52056,1713,3427,48629,16579,126763,48284,78479,,171387,20.0,112.26,0.001,90,158.13,31257.64,0.53,0.6431
6663,Terry-Gonzalez,False,AU,Port Susanbury,AgriTech,2017,https://terry-gonzalez.com,Both international certain lead mission clearly late.,22,terry-gonzalez,2023,USD,819855,145865,673990,186790,487200,17810,469390,8198,16397,452993,35715,480440,24022,456418,,819855,20.0,69.77,0.0508,656,104.01,26463.32,1.35,0.8221
6664,Anderson Inc,False,NG,Dayborough,IoT,2024,https://andersoninc.com,Style travel paper relate blue detail law.,20,anderson-inc,2023,USD,4495016,1484815,3010201,4031159,-1020958,20013,-1040971,44950,89900,-1130871,86783,2386101,1385677,1000424,,4495016,1490.67,5554.77,0.0527,18729,20.0,354621.33,0.24,0.6697
6665,Lamb-Johnson,False,NG,West Michaelville,SaaS,2015,https://lamb-johnson.com,Happy list party new itself.,25,lamb-johnson,2023,USD,1142540,499164,643376,509573,133803,22387,111416,11425,22850,88566,569144,1208779,84098,1124681,95211.67,1142540,107.7,431.71,0.0384,1891,50.33,38326.78,14.85,0.5631
6666,Little Blevins and Gonzalez,False,ZA,East Jacobfurt,Fintech,2019,https://littleblevinsandgonzalez.com,Explain front outside finish throughout.,30,little-blevins-and-gonzalez,2023,USD,437170,140181,296989,27106,269883,0,269883,4371,8743,261140,29253,393974,109525,284449,,437170,755.78,2300.51,0.077,1821,20.0,1000.0,29.25,0.6793
6667,Fox and Sons,False,DE,Paulaland,AI/ML,2024,https://foxandsons.com,None present worry support police another.,19,fox-and-sons,2023,EUR,1519390,621205,898185,915504,-17319,0,-17319,15193,30387,-47706,65928,967467,659142,308325,,1519390,619.19,1610.06,0.0303,6330,20.0,80796.92,0.82,0.5911
6668,Jackson-Clark,False,NG,South Joshua,HealthTech,2016,https://jackson-clark.com,Follow fire office drop game choose.,22,jackson-clark,2023,USD,990383,330476,659907,381467,278440,23121,255319,9903,19807,235512,61200,732765,166946,565819,82531.92,990383,564.36,1923.44,0.0345,16506,5.0,32517.44,1.88,0.6663
6669,Ray Buckley and Becker,False,CA,Marktown,Cybersecurity,2012,https://raybuckleyandbecker.com,Month prove treat enjoy include force catch human decide nation else.,23,ray-buckley-and-becker,2023,USD,281058,61882,219176,292970,-73794,1368,-75162,2810,5621,-80783,28354,348587,27596,320991,,281058,20.0,60.79,0.0848,135,173.24,17772.94,1.6,0.7798
6670,Cisneros Group,False,EG,Davisland,IoT,2009,https://cisnerosgroup.com,Difficult determine detail head imagine nothing push.,24,cisneros-group,2023,USD,675196,350733,324463,289955,34508,2663,31845,6751,13503,18342,12289,499033,289855,209178,,675196,695.61,2403.03,0.001,482,116.62,44836.67,0.27,0.4805
6671,Phillips-King,False,BR,Martinezview,Cybersecurity,2018,https://phillips-king.com,Account provide foot firm partner side according before total per.,24,phillips-king,2023,USD,557481,159245,398236,136144,262092,0,262092,5574,11149,250943,49656,395597,120088,275509,,557481,836.08,5744.42,0.0868,211,219.19,9627.64,5.16,0.7143
6672,Cox White and Gonzales,False,US,New Dannyfort,AgriTech,2009,https://coxwhiteandgonzales.com,Possible national section provide owner whatever responsibility financial here.,23,cox-white-and-gonzales,2023,USD,393188,43551,349637,239029,110608,19503,91105,3931,7863,83242,80956,345882,194570,151312,,393188,153.06,423.31,0.0714,162,201.82,36214.87,2.24,0.8892
6673,Boyd-Palmer,False,IN,Cassandraland,EdTech,2014,https://boyd-palmer.com,Manager much know west understand road agreement.,32,boyd-palmer,2023,USD,164197,75619,88578,8209,80369,0,80369,1641,3283,77086,1917,144151,65460,78691,13683.08,164197,502.26,2125.64,0.0808,1060,12.9,1000.0,1.92,0.5395
6674,Estrada Cuevas and Acosta,False,DE,Hillborough,EdTech,2019,https://estradacuevasandacosta.com,Pay already respond son might since theory Congress.,18,estrada-cuevas-and-acosta,2023,EUR,800631,497535,303096,163049,140047,21171,118876,8006,16012,102864,11500,517427,171145,346282,66719.25,800631,10.0,37.07,0.001,1283,52.0,21667.07,0.53,0.3786
6675,Ritter Inc,False,DE,Port Brandi,AI/ML,2016,https://ritterinc.com,Those agreement later region gun note stay science.,20,ritter-inc,2023,EUR,1087331,454150,633181,739288,-106107,0,-106107,10873,21746,-127853,42812,612350,347509,264841,,1087331,689.54,4011.17,0.001,530,170.69,84435.39,0.51,0.5823
6676,Allen Barajas and Castillo,False,KE,West Michelle,E-commerce,2011,https://allenbarajasandcastillo.com,Go media down party reveal.,20,allen-barajas-and-castillo,2023,USD,594399,190677,403722,116477,287245,0,287245,5943,11887,275358,5743,493477,162568,330909,,594399,20.0,60.43,0.1018,253,195.76,9062.02,0.63,0.6792
6677,Brown and Sons,False,TN,Valentineville,Cybersecurity,2015,https://brownandsons.com,Compare stand think baby surface loss nearly pay activity.,19,brown-and-sons,2023,USD,393615,193643,199972,151489,48483,11944,36539,3936,7872,28667,71969,431378,43476,387902,,393615,1094.22,609.72,0.001,200,163.92,34599.72,2.08,0.508
6678,Marks Williams and Kelly,False,AU,Port Jacobhaven,HealthTech,2011,https://markswilliamsandkelly.com,Appear land which relate course again administration capital exactly.,20,marks-williams-and-kelly,2023,USD,2837136,764896,2072240,580980,1491260,7357,1483903,28371,56742,1427161,70696,1580819,144889,1435930,236428.0,2837136,214.27,214.27,0.001,6594,35.85,51599.05,1.37,0.7304
6679,Reid-Ayala,False,FR,South John,Fintech,2022,https://reid-ayala.com,Huge trip middle least see year.,21,reid-ayala,2023,EUR,781173,184386,596787,427907,168880,7328,161552,7811,15623,145929,48965,471265,183868,287397,,781173,843.86,5438.56,0.0728,3254,20.0,4929.09,9.93,0.764
6680,Larson-Barrett,False,NG,Garciaburgh,Mobility,2011,https://larson-barrett.com,Natural summer skill show data.,18,larson-barrett,2023,USD,5101552,1852203,3249349,2431557,817792,0,817792,51015,102031,715761,35706,2623854,857585,1766269,,5101552,1525.95,762.98,0.0686,2236,190.08,203448.01,0.18,0.6369
6681,Wilson-Gonzales,False,NG,North Robertborough,SaaS,2014,https://wilson-gonzales.com,Woman behind form military according show everyone worker think standard.,17,wilson-gonzales,2023,USD,320371,254866,65505,238638,-173133,6371,-179504,3203,6407,-185911,6886,313338,144868,168470,26697.58,320371,582.17,2227.74,0.0028,472,56.56,37758.82,0.18,0.2045
6682,Kennedy Inc,False,DE,South Terri,IoT,2010,https://kennedyinc.com,Place brother start agree young.,18,kennedy-inc,2023,EUR,1554012,331615,1222397,953409,268988,26395,242593,15540,31080,211513,122763,914785,88155,826630,,1554012,761.48,2181.92,0.1201,1176,110.03,60557.62,2.03,0.7866
6683,Dunn-Silva,False,BR,South Julia,Marketplaces,2014,https://dunn-silva.com,Imagine finish successful along expect certain group cut my.,26,dunn-silva,2023,USD,3479857,1132573,2347284,3901471,-1554187,6845,-1561032,34798,69597,-1630629,949963,2742002,770783,1971219,,3479857,278.97,476.89,0.0528,829,349.57,334855.06,2.84,0.6745
6684,Shields-Walker,False,EG,Woodardland,EdTech,2012,https://shields-walker.com,Hope decision even direction during concern black such player.,19,shields-walker,2023,USD,627861,163868,463993,376598,87395,17323,70072,6278,12557,57515,96513,595365,129965,465400,52321.75,627861,10.0,42.93,0.0258,886,59.02,42789.98,2.26,0.739
6685,Davidson Leon and Mckenzie,False,TN,Rodriguezside,Marketplaces,2018,https://davidsonleonandmckenzie.com,Agency this remember billion black sit strategy.,16,davidson-leon-and-mckenzie,2023,USD,1034466,317490,716976,325833,391143,19387,371756,10344,20689,351067,43209,596083,200920,395163,,1034466,162.89,573.24,0.0402,4310,20.0,46370.64,0.93,0.6931
6686,Green-Johnson,False,DE,Keithhaven,SaaS,2021,https://green-johnson.com,Plan hour always save base effect hotel room.,25,green-johnson,2023,EUR,716792,35839,680953,94005,586948,9853,577095,7167,14335,562760,82854,633138,465416,167722,59732.67,716792,10.0,53.2,0.0916,1041,57.34,17461.68,4.74,0.95
6687,Hodge-Gould,False,US,Obrienmouth,Cybersecurity,2010,https://hodge-gould.com,Black first place drop throw important campaign anyone.,18,hodge-gould,2023,USD,2536469,1096287,1440182,2289493,-849311,0,-849311,25364,50729,-900040,311342,1700327,239235,1461092,,2536469,20.0,93.5,0.1331,2016,104.84,199838.09,1.56,0.5678
6688,Ramirez Morris and Payne,False,FR,New Matthewbury,IoT,2024,https://ramirezmorrisandpayne.com,Attack condition each reach customer star establish about over generation.,17,ramirez-morris-and-payne,2023,EUR,659547,118566,540981,428973,112008,26315,85693,6595,13190,72503,13784,368853,177697,191156,,659547,972.27,1723.86,0.0968,2748,20.0,53250.4,0.26,0.8202
6689,Moore Carpenter and Adams,False,EG,Lake Rosefort,E-commerce,2020,https://moorecarpenterandadams.com,Five dog apply yes model clearly really bed.,19,moore-carpenter-and-adams,2023,USD,3965653,1215149,2750504,1661582,1088922,0,1088922,39656,79313,1009609,104740,2119496,1024178,1095318,,3965653,886.29,2456.48,0.0041,5783,57.14,181451.1,0.58,0.6936
6690,Williams-Lee,False,FR,Milestown,Mobility,2024,https://williams-lee.com,Audience new away tree law already.,27,williams-lee,2023,EUR,4015759,1046516,2969243,2016738,952505,58107,894398,40157,80315,814083,693814,2757357,869943,1887414,,4015759,423.34,1170.36,0.1864,3436,97.39,155055.91,4.47,0.7394
6691,Doyle-Scott,False,TN,Lake Gary,AI/ML,2024,https://doyle-scott.com,Easy health place hotel camera capital prepare camera edge.,21,doyle-scott,2023,USD,1121309,386717,734592,200156,534436,4939,529497,11213,22426,507071,63927,664299,454053,210246,,1121309,2039.58,1153.22,0.0286,4019,23.25,11936.34,5.36,0.6551
6692,Huff-Burch,False,US,Lake Charles,SaaS,2013,https://huff-burch.com,View special ever point moment finally this loss physical question.,20,huff-burch,2023,USD,925269,341560,583709,188012,395697,5561,390136,9252,18505,371631,123622,643485,277208,366277,77105.75,925269,249.86,1808.11,0.001,1199,64.3,33069.33,3.74,0.6309
6693,Williams Ruiz and Thornton,False,DE,Port Andrew,SaaS,2008,https://williamsruizandthornton.com,Beat identify air bit sea opportunity.,19,williams-ruiz-and-thornton,2023,EUR,1136405,299445,836960,643752,193208,51306,141902,11364,22728,119174,105644,685954,210654,475300,94700.42,1136405,10.0,29.2,0.0161,18940,5.0,31732.37,3.33,0.7365
6694,Kennedy Morgan and Hicks,False,KE,Stevenburgh,Fintech,2018,https://kennedymorganandhicks.com,Reflect analysis fire yes item.,20,kennedy-morgan-and-hicks,2023,USD,997216,279413,717803,923126,-205323,0,-205323,9972,19944,-225267,79899,628164,68337,559827,,997216,1485.52,2242.65,0.0488,695,119.51,62710.57,1.27,0.7198
6695,Chase Ltd,False,AU,Lawrencechester,Energy,2011,https://chaseltd.com,Crime spring sign quality reveal.,19,chase-ltd,2023,USD,3649774,1328954,2320820,1751744,569076,0,569076,36497,72995,496081,79096,2020412,892961,1127451,,3649774,1009.84,6926.27,0.0601,2128,142.91,133980.59,0.59,0.6359
6696,Walker-Bowers,False,NG,Lake Christophertown,HealthTech,2024,https://walker-bowers.com,See direction just reach exactly return.,21,walker-bowers,2023,USD,593877,115053,478824,221541,257283,2674,254609,5938,11877,242732,36307,392576,82925,309651,49489.75,593877,10.0,12.79,0.0289,1218,40.62,31130.93,1.17,0.8063
6697,Armstrong Robles and Lee,False,US,Lake Jayborough,EdTech,2020,https://armstrongroblesandlee.com,Card you name newspaper hotel coach chance treat big.,22,armstrong-robles-and-lee,2023,USD,512792,234472,278320,25639,252681,9624,243057,5127,10255,232802,11737,464559,154433,310126,42732.67,512792,26.06,68.62,0.0571,1273,33.55,6505.29,1.8,0.5428
6698,Warren Ltd,False,CA,Port Maureenview,Mobility,2023,https://warrenltd.com,And organization degree against treatment whom we.,24,warren-ltd,2023,USD,931039,470045,460994,704905,-243911,0,-243911,9310,18620,-262531,144304,772437,312394,460043,,931039,2979.85,10576.9,0.0411,3879,20.0,45796.64,3.15,0.4951
6699,Gardner-Buchanan,False,IN,Lake Christopher,Cybersecurity,2017,https://gardner-buchanan.com,Expert drive huge later little effort wrong goal total.,19,gardner-buchanan,2023,USD,1648067,507950,1140117,726387,413730,4228,409502,16480,32961,376541,74541,915111,361959,553152,,1648067,20.0,59.28,0.015,564,243.13,49144.01,1.52,0.6918
6700,Maldonado-Boone,False,KE,East Brett,Fintech,2021,https://maldonado-boone.com,Likely defense at scientist garden notice.,18,maldonado-boone,2023,USD,2848943,936909,1912034,817950,1094084,18356,1075728,28489,56978,1018750,432934,1998485,1247467,751018,,2848943,1222.26,3034.12,0.001,11870,20.0,60921.61,7.11,0.6711
6701,Cruz-Dawson,False,US,Orozcostad,IoT,2014,https://cruz-dawson.com,Book whatever wonder hotel increase room poor top.,21,cruz-dawson,2023,USD,1471772,638593,833179,572372,260807,16690,244117,14717,29435,214682,15507,914419,552424,361995,,1471772,1553.92,2911.15,0.1182,1334,91.9,24411.53,0.64,0.5661
6702,Lopez PLC,False,TN,Lake Alan,E-commerce,2019,https://lopezplc.com,Result above out wind skill movie day.,14,lopez-plc,2023,USD,2469586,857567,1612019,790476,821543,0,821543,24695,49391,772152,905599,2212083,323248,1888835,,2469586,20.0,118.03,0.0458,916,224.66,54853.27,16.51,0.6527
6703,Flynn-Mcintyre,False,GB,Collinsbury,SaaS,2010,https://flynn-mcintyre.com,Camera month toward population simply member theory.,22,flynn-mcintyre,2023,USD,1400699,689002,711697,605110,106587,14722,91865,14006,28013,63852,175262,1043219,274316,768903,116724.92,1400699,10.0,10.0,0.0437,1460,79.9,57381.91,3.05,0.5081
6704,Vega Richards and Miles,False,IN,North Daniel,IoT,2010,https://vegarichardsandmiles.com,Call process let see bag including worry middle share.,14,vega-richards-and-miles,2023,USD,903948,251479,652469,513856,138613,7849,130764,9039,18078,112686,137749,634318,197565,436753,,903948,1721.62,11374.94,0.0414,304,247.47,33376.0,4.13,0.7218
6705,Shelton Schmidt and Hall,False,AU,Perezburgh,Fintech,2024,https://sheltonschmidtandhall.com,Space group world discuss want.,18,shelton-schmidt-and-hall,2023,USD,1392827,333474,1059353,634089,425264,0,425264,13928,27856,397408,598670,1486302,451747,1034555,,1392827,20.0,125.15,0.0693,4834,24.01,24054.21,24.89,0.7606
6706,Stewart-Beck,False,BR,Adammouth,IoT,2017,https://stewart-beck.com,In suddenly race she among everybody individual the be away.,22,stewart-beck,2023,USD,315462,109816,205646,270671,-65025,8081,-73106,3154,6309,-79415,7538,348057,171506,176551,,315462,20.0,10.0,0.0147,185,142.0,43824.92,0.17,0.6519
6707,Compton-Elliott,False,FR,Christopherside,AI/ML,2017,https://compton-elliott.com,Happy cultural occur speak wind source major vote.,12,compton-elliott,2023,EUR,177954,64692,113262,99171,14091,44735,-30644,1779,3559,-34203,4173,201726,49124,152602,,177954,107.61,304.69,0.0614,741,20.0,5583.78,0.75,0.6365
6708,Mccoy Inc,False,DE,Rickyland,EdTech,2020,https://mccoyinc.com,Next mouth within avoid deep event eye.,21,mccoy-inc,2023,EUR,1149638,497296,652342,544031,108311,7033,101278,11496,22992,78286,58469,686853,564171,122682,95803.17,1149638,237.56,237.56,0.0486,734,130.46,75718.9,0.77,0.5674
6709,Schmidt Ltd,False,NG,Mccallbury,Mobility,2018,https://schmidtltd.com,Federal north game since defense strong material.,20,schmidt-ltd,2023,USD,2422209,952260,1469949,1380158,89791,0,89791,24222,48444,41347,182265,1436380,498831,937549,,2422209,343.68,1776.59,0.001,2067,97.63,124784.06,1.46,0.6069
6710,Gomez LLC,False,US,Torresfort,IoT,2012,https://gomezllc.com,Consumer investment citizen son build sense place true.,17,gomez-llc,2023,USD,339799,139842,199957,106511,93446,0,93446,3397,6795,86651,24373,230545,80477,150068,,339799,20.0,93.8,0.0014,324,87.17,8137.73,3.0,0.5885
6711,Caldwell Olson and Weber,False,AU,Smithtown,Energy,2014,https://caldwellolsonandweber.com,Break from model serious born over benefit.,14,caldwell-olson-and-weber,2023,USD,1103350,199249,904101,657059,247042,32516,214526,11033,22067,192459,10246,685466,151025,534441,,1103350,20.0,64.13,0.0162,4597,20.0,45414.85,0.23,0.8194
6712,Phillips-Potter,False,GB,North Jack,Cybersecurity,2013,https://phillips-potter.com,Move pretty development risk ball ability.,29,phillips-potter,2023,USD,4213778,1345242,2868536,2469969,398567,9125,389442,42137,84275,305167,1119064,3355296,167764,3187532,,4213778,504.08,2167.23,0.0341,17557,20.0,153098.64,7.31,0.6808
6713,Duke Williams and Foster,False,DE,New Leon,IoT,2024,https://dukewilliamsandfoster.com,Cell point race particular or.,28,duke-williams-and-foster,2023,EUR,225536,71361,154175,60138,94037,0,94037,2255,4510,89527,3738,146040,56458,89582,,225536,880.75,440.38,0.0288,939,20.0,1000.0,3.74,0.6836
6714,Ponce Jones and Roach,False,GB,North Elizabethshire,Fintech,2015,https://poncejonesandroach.com,Each can wide available billion.,15,ponce-jones-and-roach,2023,USD,2467629,1233856,1233773,2162946,-929173,0,-929173,24676,49352,-978525,56970,1299280,628717,670563,,2467629,20.0,24.53,0.001,1181,174.0,189308.22,0.3,0.5
6715,Le Steele and Ford,False,EG,Port Steven,AgriTech,2018,https://lesteeleandford.com,Actually realize war billion.,21,le-steele-and-ford,2023,USD,1086878,415714,671164,474837,196327,13532,182795,10868,21737,161058,173996,817558,197865,619693,,1086878,498.31,249.16,0.1137,960,94.33,7988.86,21.78,0.6175
6716,Howard Lee and Jackson,False,CA,Port Michaeltown,Energy,2010,https://howardleeandjackson.com,Election from fly gun age study station.,25,howard-lee-and-jackson,2023,USD,4517441,1934937,2582504,3122295,-539791,0,-539791,45174,90348,-630139,177799,2622087,749990,1872097,,4517441,1999.57,3048.02,0.0913,2622,143.53,250176.97,0.71,0.5717
6717,Gross Inc,False,FR,Curtiston,AgriTech,2009,https://grossinc.com,Kind protect among into skin song technology.,19,gross-inc,2023,EUR,482037,85490,396547,355144,41403,26335,15068,4820,9640,5428,39327,322479,72766,249713,,482037,960.01,4045.65,0.0256,2008,20.0,33521.34,1.17,0.8226
6718,Fields-Nguyen,False,ZA,South Rebecca,Cybersecurity,2017,https://fields-nguyen.com,Environment worker wrong remain fight put develop rise suggest.,13,fields-nguyen,2023,USD,1168549,400033,768516,869654,-101138,8410,-109548,11685,23370,-132918,35167,666774,294021,372753,,1168549,672.78,2973.13,0.0219,1053,92.45,86735.88,0.41,0.6577
6719,Carpenter and Sons,False,GB,Kimberlyview,AI/ML,2021,https://carpenterandsons.com,Head mouth kitchen only police board mission.,19,carpenter-and-sons,2023,USD,1929765,416580,1513185,313780,1199405,0,1199405,19297,38595,1160810,93628,1091473,349994,741479,,1929765,157.69,687.07,0.0613,1684,95.45,3828.4,24.46,0.7841
6720,Stanley Ltd,False,ZA,West Kristen,SaaS,2019,https://stanleyltd.com,Health risk big the opportunity.,19,stanley-ltd,2023,USD,827262,256412,570850,41363,529487,7368,522119,8272,16545,505574,49837,504675,222892,281783,68938.5,827262,42.91,234.65,0.0539,1553,44.37,1000.0,49.84,0.69
6721,Henderson LLC,False,BR,Gravesfurt,SaaS,2018,https://hendersonllc.com,Man available American past green thus concern ten politics Mr environmental.,34,henderson-llc,2023,USD,911413,243136,668277,426161,242116,22314,219802,9114,18228,201574,19153,506450,294589,211861,75951.08,911413,659.94,2127.52,0.0672,1793,42.35,18693.2,1.02,0.7332
6722,Carpenter PLC,False,DE,Aguilarfort,Mobility,2020,https://carpenterplc.com,Knowledge official either both long central.,12,carpenter-plc,2023,EUR,1773626,323030,1450596,605753,844843,25758,819085,17736,35472,783613,54757,1041611,476587,565024,,1773626,20.0,88.94,0.0156,4714,31.35,51090.89,1.07,0.8179
6723,Harris LLC,False,TN,South Heather,Energy,2009,https://harrisllc.com,Training event issue high tree produce.,15,harris-llc,2023,USD,1177321,467407,709914,411484,298430,33665,264765,11773,23546,241219,22750,721592,449018,272574,,1177321,1326.59,2433.78,0.0579,335,292.31,1000.0,22.75,0.603
6724,Gonzalez-Collins,False,NG,Thomasburgh,Cybersecurity,2011,https://gonzalez-collins.com,How water college TV best.,24,gonzalez-collins,2023,USD,1383543,509770,873773,615625,258148,20224,237924,13835,27670,210254,97699,800510,197684,602826,,1383543,20.0,58.9,0.0627,402,286.57,99236.13,0.98,0.6315
6725,Murphy-Lewis,False,FR,New Kirsten,Cybersecurity,2012,https://murphy-lewis.com,Allow watch which risk century during star.,16,murphy-lewis,2023,EUR,2782653,288469,2494184,2888627,-394443,45548,-439991,27826,55653,-495644,69134,1496707,185073,1311634,,2782653,1753.69,12318.65,0.1048,8085,28.68,257214.22,0.27,0.8963
6726,Hall Group,False,TN,Pamelachester,SaaS,2009,https://hallgroup.com,Bed the buy whom debate under close.,10,hall-group,2023,USD,792319,308424,483895,219014,264881,0,264881,7923,15846,249035,23363,466724,23336,443388,66026.58,792319,123.06,436.06,0.001,772,85.5,1000.0,23.36,0.6107
6727,Jimenez Ltd,False,DE,Schmidtland,SaaS,2024,https://jimenezltd.com,Since action small civil service.,17,jimenez-ltd,2023,EUR,564337,142660,421677,28216,393461,5487,387974,5643,11286,376688,35889,451369,234695,216674,47028.08,564337,10.0,44.0,0.0578,9405,5.0,3284.49,10.93,0.7472
6728,Patton-Lane,False,DE,Port Lindaborough,E-commerce,2020,https://patton-lane.com,Stop majority difference technology skill development various work policy bring.,18,patton-lane,2023,EUR,110485,38646,71839,38934,32905,0,32905,1104,2209,30696,4677,207564,20258,187306,,110485,511.96,255.98,0.0304,89,102.47,25242.59,0.19,0.6502
6729,Perry PLC,False,TN,East Krista,IoT,2010,https://perryplc.com,Song example analysis maintain space statement other result stuff.,23,perry-plc,2023,USD,277849,126722,151127,128665,22462,0,22462,2778,5556,16906,22602,208494,79066,129428,,277849,1195.02,5349.83,0.0675,98,235.5,32091.39,0.7,0.5439
6730,Morris-Figueroa,False,AU,Blairport,SaaS,2020,https://morris-figueroa.com,Student network past part feel top threat exist.,22,morris-figueroa,2023,USD,1296470,404265,892205,1141033,-248828,13820,-262648,12964,25929,-288577,50618,856581,300099,556482,108039.17,1296470,34.87,93.71,0.0311,2861,37.75,59784.82,0.85,0.6882
6731,Thompson Perez and Peterson,False,GB,Breannaville,Marketplaces,2022,https://thompsonperezandpeterson.com,Expert call two argue chair need rise operation hair let method.,25,thompson-perez-and-peterson,2023,USD,924092,405540,518552,734517,-215965,17514,-233479,9240,18481,-251960,25865,570498,142962,427536,,924092,739.97,4403.18,0.0498,351,218.96,58315.54,0.44,0.5611
6732,Austin Smith and Vega,False,FR,Chaveztown,E-commerce,2014,https://austinsmithandvega.com,Daughter fund husband series difference success must single whom.,25,austin-smith-and-vega,2023,EUR,1465311,673064,792247,757731,34516,11866,22650,14653,29306,-6656,125722,915285,620257,295028,,1465311,457.64,325.46,0.0185,854,142.83,80244.19,1.57,0.5407
6733,Leon Daniels and Burch,False,FR,North Suzanneside,HealthTech,2014,https://leondanielsandburch.com,Receive summer today rather land Mrs herself determine his.,17,leon-daniels-and-burch,2023,EUR,2059797,622919,1436878,1514949,-78071,2047,-80118,20597,41195,-121313,117514,1156916,628092,528824,171649.75,2059797,10.0,47.19,0.0238,2669,64.31,111871.29,1.05,0.6976
6734,Thompson-Ramos,False,IN,Rebeccaside,E-commerce,2019,https://thompson-ramos.com,Hotel capital north where model significant bar where between.,23,thompson-ramos,2023,USD,613798,263711,350087,188880,161207,165,161042,6137,12275,148767,54395,392878,31982,360896,,613798,472.24,236.12,0.0117,713,71.7,6248.98,8.7,0.5704
6735,Crosby Lawrence and Smith,False,US,East Megantown,Energy,2024,https://crosbylawrenceandsmith.com,Five citizen especially need administration one.,25,crosby-lawrence-and-smith,2023,USD,1554129,690065,864064,1243276,-379212,0,-379212,15541,31082,-410294,27354,890681,361697,528984,,1554129,1232.17,5609.25,0.0292,2815,46.0,91553.75,0.3,0.556
6736,Garrison Scott and Beasley,False,NG,Lake Ray,HealthTech,2021,https://garrisonscottandbeasley.com,Area everybody must throw value purpose painting behind.,19,garrison-scott-and-beasley,2023,USD,912269,347443,564826,97808,467018,4449,462569,9122,18245,444324,9086,496902,189226,307676,76022.42,912269,370.1,370.1,0.0208,15204,5.0,35715.17,0.25,0.6191
6737,Walker Vasquez and White,False,KE,Lake Sharonside,Fintech,2023,https://walkervasquezandwhite.com,Claim experience avoid research southern in.,19,walker-vasquez-and-white,2023,USD,913482,332064,581418,513439,67979,0,67979,9134,18269,49710,13097,477784,135338,342446,,913482,20.0,114.47,0.0849,3806,20.0,57698.05,0.23,0.6365
6738,Reyes-Bowman,False,BR,New Kylestad,Mobility,2021,https://reyes-bowman.com,It rule staff federal general.,17,reyes-bowman,2023,USD,3234640,1932942,1301698,1410697,-108999,20333,-129332,32346,64692,-194024,63360,1874968,531987,1342981,,3234640,578.09,2726.62,0.0156,2845,94.73,79333.29,0.8,0.4024
6739,Austin Erickson and Galloway,False,AU,Jacksonfurt,AI/ML,2012,https://austinericksonandgalloway.com,Economic this experience throughout discover all start manage detail.,25,austin-erickson-and-galloway,2023,USD,874885,207504,667381,506872,160509,11262,149247,8748,17497,131750,37381,574862,517375,57487,,874885,521.37,2405.6,0.0987,1101,66.16,37528.54,1.0,0.7628
6740,Klein LLC,False,KE,South Kevinview,EdTech,2024,https://kleinllc.com,Wear dinner stock near significant control issue.,28,klein-llc,2023,USD,351063,171232,179831,34656,145175,12506,132669,3510,7021,125648,14373,220136,147713,72423,29255.25,351063,71.97,151.45,0.062,296,98.56,1000.0,14.37,0.5122
6741,Brown Logan and Winters,False,IN,Alexanderbury,AgriTech,2009,https://brownloganandwinters.com,Specific trip attorney call however week rich nation better.,22,brown-logan-and-winters,2023,USD,476447,125616,350831,228375,122456,18366,104090,4764,9528,94562,20654,275789,118572,157217,,476447,314.34,1963.65,0.0894,277,143.28,19971.69,1.03,0.7363
6742,King Bowman and Shepherd,False,FR,Michellebury,EdTech,2017,https://kingbowmanandshepherd.com,Member campaign receive soldier step.,19,king-bowman-and-shepherd,2023,EUR,453221,92139,361082,22661,338421,0,338421,4532,9064,329357,177992,500715,145306,355409,37768.42,453221,404.48,3222.24,0.0131,1570,24.05,1000.0,177.99,0.7967
6743,Garcia PLC,False,NG,East Rebeccastad,SaaS,2024,https://garciaplc.com,Enough carry move side state inside born amount lay foreign majority.,18,garcia-plc,2023,USD,494982,254588,240394,274928,-34534,0,-34534,4949,9899,-44433,46089,436638,21831,414807,41248.5,494982,562.13,2174.51,0.0266,535,77.0,3959.34,11.64,0.4857
6744,Walters-Ford,False,EG,Port Haleyton,EdTech,2018,https://walters-ford.com,Different forget democratic claim work.,18,walters-ford,2023,USD,337573,194192,143381,192323,-48942,0,-48942,3375,6751,-55693,186682,417897,202624,215273,28131.08,337573,10.0,16.21,0.0416,5626,5.0,27649.8,6.75,0.4247
6745,Romero Ellison and Casey,False,IN,Davismouth,EdTech,2023,https://romeroellisonandcasey.com,Color eight view key meet court campaign challenge way level color.,22,romero-ellison-and-casey,2023,USD,315518,110919,204599,189114,15485,0,15485,3155,6310,9175,29258,272813,206309,66504,26293.17,315518,63.73,191.61,0.0556,5258,5.0,24006.5,1.22,0.6485
6746,Andrews Choi and Morgan,False,BR,Charlesborough,AI/ML,2024,https://andrewschoiandmorgan.com,Break only executive investment drug more.,22,andrews-choi-and-morgan,2023,USD,2021588,151031,1870557,702893,1167664,0,1167664,20215,40431,1127233,575290,1778110,236703,1541407,,2021588,1217.83,1635.51,0.0333,8423,20.0,61203.83,9.4,0.9253
6747,Russell Harris and Lane,False,GB,West Aaronbury,Energy,2009,https://russellharrisandlane.com,Finally school center factor fear.,24,russell-harris-and-lane,2023,USD,5381469,2569507,2811962,3974673,-1162711,0,-1162711,53814,107629,-1270340,100907,2973695,1569231,1404464,,5381469,829.53,2360.74,0.0966,2414,185.76,306219.1,0.33,0.5225
6748,Larson and Sons,False,DE,Traceyfurt,EdTech,2019,https://larsonandsons.com,Power course century she hope decade maybe military a describe hour.,8,larson-and-sons,2023,EUR,127532,40309,87223,112580,-25357,38589,-63946,1275,2550,-66496,40886,257289,92554,164735,10627.67,127532,347.83,974.82,0.0526,2125,5.0,18288.01,2.24,0.6839
6749,Liu Garcia and Clements,False,KE,East Erik,Cybersecurity,2011,https://liugarciaandclements.com,Enter like he build figure model will.,21,liu-garcia-and-clements,2023,USD,582478,213110,369368,228387,140981,0,140981,5824,11649,129332,30281,456503,22825,433678,,582478,356.85,1355.73,0.0625,1656,29.31,35871.66,0.84,0.6341
6750,Adkins PLC,False,US,Lake Nicholeshire,Fintech,2019,https://adkinsplc.com,Partner worry attack suggest test manage whom side later.,25,adkins-plc,2023,USD,254622,107435,147187,134589,12598,27506,-14908,2546,5092,-20000,40833,177523,44401,133122,,254622,844.86,3568.36,0.1396,1060,20.0,1000.0,40.83,0.5781
6751,Smith Ltd,False,EG,East Ericbury,Cybersecurity,2008,https://smithltd.com,Soldier three ago baby similar right opportunity.,22,smith-ltd,2023,USD,345115,198221,146894,124443,22451,3411,19040,3451,6902,12138,19771,257125,82389,174736,,345115,20.0,42.57,0.0429,313,91.72,9905.63,2.0,0.4256
6752,Hansen Benjamin and Williams,False,KE,New William,SaaS,2024,https://hansenbenjaminandwilliams.com,Already walk foreign myself whole party.,18,hansen-benjamin-and-williams,2023,USD,524454,109304,415150,312313,102837,27920,74917,5244,10489,64428,7395,383284,116858,266426,43704.5,524454,515.77,2386.31,0.038,924,47.27,40928.22,0.18,0.7916
6753,Kim Park and Richardson,False,CA,Nicholaschester,IoT,2010,https://kimparkandrichardson.com,Democratic chance itself month most.,11,kim-park-and-richardson,2023,USD,610263,150761,459502,203233,256269,0,256269,6102,12205,244064,17032,334397,77058,257339,,610263,1381.93,8498.52,0.0639,440,115.51,5390.33,3.16,0.753
6754,Hart James and Davis,False,AU,Lake Andre,AgriTech,2017,https://hartjamesanddavis.com,Law staff expert sell trip campaign.,13,hart-james-and-davis,2023,USD,116088,24844,91244,33496,57748,0,57748,1160,2321,55427,7862,177396,95769,81627,,116088,20.0,62.69,0.1155,41,231.65,3894.3,2.02,0.786
6755,Sanchez-Hill,False,KE,South Ryan,HealthTech,2008,https://sanchez-hill.com,Security effect accept computer they adult.,19,sanchez-hill,2023,USD,2669046,946073,1722973,299645,1423328,11301,1412027,26690,53380,1358647,537030,1881581,372705,1508876,222420.5,2669046,10.0,38.22,0.0142,44484,5.0,29092.98,18.46,0.6455
6756,Serrano Ltd,False,ZA,Avilastad,Mobility,2016,https://serranoltd.com,Adult night commercial dream tree.,25,serrano-ltd,2023,USD,2822366,995545,1826821,1292385,534436,23890,510546,28223,56447,454099,336525,1802497,495401,1307096,,2822366,1412.35,4375.9,0.0742,1806,130.23,64125.13,5.25,0.6473
6757,Knight Watson and Alvarez,False,KE,Lake Calvinborough,HealthTech,2020,https://knightwatsonandalvarez.com,Yard smile character star movie.,29,knight-watson-and-alvarez,2023,USD,313281,97649,215632,172071,43561,0,43561,3132,6265,37296,10013,170945,24319,146626,26106.75,313281,10.0,65.96,0.0481,526,49.56,25984.62,0.39,0.6883
6758,Rodriguez Spencer and Strickland,False,AU,Jasminstad,IoT,2021,https://rodriguezspencerandstrickland.com,Chance change everybody sister hotel outside way remember just Republican.,24,rodriguez-spencer-and-strickland,2023,USD,541390,182349,359041,103380,255661,36033,219628,5413,10827,208801,320359,687143,283288,403855,,541390,253.23,1453.92,0.0732,380,118.43,23675.86,13.53,0.6632
6759,Bennett-Martinez,False,AU,North Alexandrabury,IoT,2020,https://bennett-martinez.com,Involve ready science beautiful contain age thus religious.,19,bennett-martinez,2023,USD,133825,30024,103801,6691,97110,0,97110,1338,2676,94434,63047,235985,124498,111487,,133825,20.0,123.27,0.001,59,187.25,14059.08,4.48,0.7756
6760,Abbott and Sons,False,AU,Vincentfurt,Marketplaces,2017,https://abbottandsons.com,Late probably of least yourself.,33,abbott-and-sons,2023,USD,498531,185118,313413,46325,267088,0,267088,4985,9970,257118,43971,484156,259180,224976,,498531,20.0,76.04,0.0327,219,189.68,1000.0,43.97,0.6287
6761,Mendez Bennett and Anderson,False,NG,Griffinview,Marketplaces,2022,https://mendezbennettandanderson.com,Today theory wide choice enough.,20,mendez-bennett-and-anderson,2023,USD,393641,156291,237350,113465,123885,52957,70928,3936,7872,63056,5154,360168,77127,283041,,393641,20.0,93.47,0.001,413,79.27,1000.0,5.15,0.603
6762,Saunders Bowers and Jones,False,FR,West Kimberly,AI/ML,2017,https://saundersbowersandjones.com,Sound include during space analysis character.,21,saunders-bowers-and-jones,2023,EUR,969097,224145,744952,139390,605562,0,605562,9690,19381,586181,11924,627659,254655,373004,,969097,485.21,2859.49,0.1153,525,153.68,15027.04,0.79,0.7687
6763,Herman and Sons,False,GB,Lake Yolandafurt,AI/ML,2019,https://hermanandsons.com,Soldier road president into single significant.,21,herman-and-sons,2023,USD,4574748,1896284,2678464,228737,2449727,21775,2427952,45747,91494,2336458,313611,2746433,1050981,1695452,,4574748,20.0,82.45,0.001,1399,272.35,11356.48,27.62,0.5855
6764,Meyer Hill and Murray,False,KE,East Diana,Energy,2015,https://meyerhillandmurray.com,Yard exist personal there side Mrs.,17,meyer-hill-and-murray,2023,USD,375091,128660,246431,274702,-28271,0,-28271,3750,7501,-35772,127275,446574,295564,151010,,375091,1060.46,2439.22,0.0551,233,134.05,23790.57,5.35,0.657
6765,Coleman-Smith,False,GB,Shannonmouth,E-commerce,2011,https://coleman-smith.com,Choose race study leave new explain.,20,coleman-smith,2023,USD,2110116,236535,1873581,271441,1602140,49903,1552237,21101,42202,1510035,154741,1278255,797078,481177,,2110116,567.15,460.26,0.1021,1072,163.98,1000.0,154.74,0.8879
6766,Lawrence-Terry,False,IN,Cookhaven,SaaS,2024,https://lawrence-terry.com,Throw measure my red win whose for theory shake class.,20,lawrence-terry,2023,USD,1494225,354817,1139408,395500,743908,11275,732633,14942,29884,702749,34974,949636,155711,793925,124518.75,1494225,618.85,3400.13,0.0226,1118,111.34,62084.58,0.56,0.7625
6767,Foster and Sons,False,IN,South Brian,IoT,2014,https://fosterandsons.com,Pay break every nice for fire main yes look.,23,foster-and-sons,2023,USD,548990,241365,307625,276433,31192,0,31192,5489,10979,20213,124608,450097,146380,303717,,548990,1310.42,2368.7,0.1005,2287,20.0,23238.84,5.36,0.5603
6768,Jacobson Tyler and Reeves,False,GB,Hernandezside,EdTech,2011,https://jacobsontylerandreeves.com,Defense site mouth almost remember discover.,17,jacobson-tyler-and-reeves,2023,USD,252118,99761,152357,37861,114496,0,114496,2521,5042,109454,2865,156992,28711,128281,21009.83,252118,10.0,79.04,0.0356,4201,5.0,47246.83,0.06,0.6043
6769,Jensen-Grant,False,GB,West Kimberlyburgh,EdTech,2017,https://jensen-grant.com,Pass discussion sort suggest space international.,22,jensen-grant,2023,USD,307844,137127,170717,167918,2799,27725,-24926,3078,6156,-31082,57121,340665,97683,242982,25653.67,307844,294.36,946.63,0.0213,472,54.26,16535.1,3.45,0.5546
6770,Sanders-Brown,False,AU,Angelaview,HealthTech,2021,https://sanders-brown.com,Easy charge environmental threat sometimes difficult land task.,26,sanders-brown,2023,USD,382944,125586,257358,61021,196337,17658,178679,3829,7658,171021,37301,278688,224664,54024,31912.0,382944,10.0,41.55,0.0199,865,36.87,34686.46,1.08,0.6721
6771,Rose Gibson and Mcgee,False,TN,Heatherview,IoT,2009,https://rosegibsonandmcgee.com,Growth many power ten eight.,18,rose-gibson-and-mcgee,2023,USD,430021,186292,243729,79742,163987,26455,137532,4300,8600,128932,13155,284544,14227,270317,,430021,576.69,556.31,0.0314,304,117.65,30863.24,0.43,0.5668
6772,Hensley LLC,False,TN,Jeremyport,IoT,2008,https://hensleyllc.com,Positive dream teach what fire top inside happy.,17,hensley-llc,2023,USD,1398264,694663,703601,455152,248449,33167,215282,13982,27965,187317,40919,785210,440607,344603,,1398264,20.0,51.05,0.052,5826,20.0,8363.11,4.89,0.5032
6773,Hampton-Thomas,False,NG,Port Melissa,Mobility,2012,https://hampton-thomas.com,Color size Mrs number home challenge speech hotel.,20,hampton-thomas,2023,USD,1564530,354548,1209982,174280,1035702,0,1035702,15645,31290,1004412,68971,1009121,250660,758461,,1564530,58.33,195.78,0.0536,6518,20.0,1000.0,68.97,0.7734
6774,Hicks Inc,False,TN,Scottside,Marketplaces,2011,https://hicksinc.com,Any figure travel maybe memory current bag out success.,19,hicks-inc,2023,USD,263557,99965,163592,128708,34884,101,34783,2635,5271,29512,6441,246157,29188,216969,,263557,732.4,734.87,0.0666,164,133.5,1000.0,6.44,0.6207
6775,Barnett-Roberts,False,EG,Joeltown,Energy,2008,https://barnett-roberts.com,Imagine night economic represent save or meeting top small.,15,barnett-roberts,2023,USD,2181147,970399,1210748,109057,1101691,0,1101691,21811,43622,1058069,531644,1744026,201543,1542483,,2181147,20.0,83.62,0.067,723,251.28,25337.44,20.98,0.5551
6776,Bradley-Hoffman,False,BR,Jonathanside,Mobility,2013,https://bradley-hoffman.com,Arm whose prove some election white student entire.,25,bradley-hoffman,2023,USD,667407,324092,343315,422178,-78863,4955,-83818,6674,13348,-97166,27946,548840,297482,251358,,667407,421.42,2723.68,0.0243,2780,20.0,43950.03,0.64,0.5144
6777,Silva Herman and Day,False,ZA,West Amy,EdTech,2017,https://silvahermanandday.com,Other west up store business amount bar gas.,25,silva-herman-and-day,2023,USD,1103944,530167,573777,746265,-172488,49471,-221959,11039,22078,-244037,77767,826046,418050,407996,91995.33,1103944,10.0,15.66,0.0248,14579,6.31,94135.77,0.83,0.5198
6778,Aguirre and Sons,False,NG,South Paul,Cybersecurity,2015,https://aguirreandsons.com,Provide necessary risk source bad.,17,aguirre-and-sons,2023,USD,371480,164251,207229,103663,103566,3213,100353,3714,7429,92924,37523,337868,69165,268703,,371480,375.04,667.79,0.118,328,94.3,3496.19,10.73,0.5578
6779,Jennings Group,False,NG,North Laurenhaven,IoT,2015,https://jenningsgroup.com,Start memory career blue not heart seek.,16,jennings-group,2023,USD,215103,86579,128524,127457,1067,0,1067,2151,4302,-3235,5127,199543,38242,161301,,215103,704.45,4430.25,0.0338,144,124.46,11893.04,0.43,0.5975
6780,Gallegos and Sons,False,CA,Patrickburgh,Marketplaces,2019,https://gallegosandsons.com,Half we debate about half detail according beat sort compare action.,17,gallegos-and-sons,2023,USD,1071747,415734,656013,503874,152139,41844,110295,10717,21434,88861,41889,735734,291864,443870,,1071747,20.0,107.66,0.0807,2326,38.39,28142.69,1.49,0.6121
6781,Carey-Nguyen,False,BR,Sharonfurt,EdTech,2024,https://carey-nguyen.com,Close American method six voice military.,15,carey-nguyen,2023,USD,1639283,992386,646897,1383070,-736173,0,-736173,16392,32785,-768958,25239,879937,443206,436731,136606.92,1639283,192.47,1296.0,0.001,27321,5.0,111284.76,0.23,0.3946
6782,Martin Williams and Davis,False,GB,East Brooke,Marketplaces,2008,https://martinwilliamsanddavis.com,Outside left campaign describe who serve often happen.,20,martin-williams-and-davis,2023,USD,1998029,782232,1215797,313870,901927,12285,889642,19980,39960,849682,72864,1167837,58391,1109446,,1998029,138.43,493.09,0.0369,8325,20.0,35488.19,2.05,0.6085
6783,Miller PLC,False,IN,Lake Theresaton,SaaS,2019,https://millerplc.com,Listen possible road also despite they report consider center.,19,miller-plc,2023,USD,339151,90995,248156,229896,18260,538,17722,3391,6783,10939,45813,338953,107295,231658,28262.58,339151,10.0,39.86,0.044,5652,5.0,16814.74,2.72,0.7317
6784,Miller Group,False,TN,East Luisfurt,Marketplaces,2011,https://millergroup.com,Design figure important state message war.,24,miller-group,2023,USD,1172732,452428,720304,58636,661668,12069,649599,11727,23454,626145,4533,656253,448107,208146,,1172732,20.0,45.22,0.0727,4886,20.0,6013.15,0.75,0.6142
6785,Smith-Watson,False,GB,Thomaston,Cybersecurity,2021,https://smith-watson.com,Including list easy always reflect budget base project majority.,19,smith-watson,2023,USD,854413,278527,575886,279574,296312,31713,264599,8544,17088,247511,32804,596142,381042,215100,,854413,1171.19,4272.81,0.0408,1363,52.21,22046.54,1.49,0.674
6786,Graham-Rodriguez,False,CA,Hamptonberg,SaaS,2012,https://graham-rodriguez.com,Within PM president wind technology quite project network involve guess.,17,graham-rodriguez,2023,USD,519395,152168,367227,119115,248112,6879,241233,5193,10387,230846,6212,451104,282260,168844,43282.92,519395,38.71,116.58,0.0296,8656,5.0,11883.71,0.52,0.707
6787,Jones Nicholson and English,False,TN,Amandamouth,IoT,2019,https://jonesnicholsonandenglish.com,Almost for eat talk relationship spend read kid.,19,jones-nicholson-and-english,2023,USD,871149,399104,472045,542816,-70771,0,-70771,8711,17422,-88193,51821,673972,248375,425597,,871149,240.41,611.24,0.1172,348,208.38,27688.74,1.87,0.5419
6788,Walker-Phillips,False,NG,North Nancymouth,Marketplaces,2012,https://walker-phillips.com,Product chair event whose short seem.,20,walker-phillips,2023,USD,1110539,624806,485733,157616,328117,0,328117,11105,22210,305907,227564,901902,81307,820595,,1110539,20.0,10.18,0.0544,632,146.25,19724.78,11.54,0.4374
6789,Davis Burns and Blackwell,False,TN,New James,Marketplaces,2016,https://davisburnsandblackwell.com,Democrat argue sign week guess carry something officer.,20,davis-burns-and-blackwell,2023,USD,503748,218820,284928,85659,199269,3274,195995,5037,10074,185921,63310,442953,129061,313892,,503748,326.1,671.08,0.1021,791,53.01,24147.09,2.62,0.5656
6790,Boyd Gibbs and Wilson,False,FR,New Caleb,AI/ML,2020,https://boydgibbsandwilson.com,Quality close production day close.,11,boyd-gibbs-and-wilson,2023,EUR,1287438,388237,899201,403243,495958,16293,479665,12874,25748,453917,66302,761701,368126,393575,,1287438,1033.22,3453.85,0.1049,5364,20.0,1000.0,66.3,0.6984
6791,Sandoval-Johnston,False,KE,Theresatown,Energy,2019,https://sandoval-johnston.com,Successful network former model.,20,sandoval-johnston,2023,USD,1999126,366714,1632412,547454,1084958,20616,1064342,19991,39982,1024360,67333,1215770,133147,1082623,,1999126,20.0,18.58,0.0472,969,171.78,11841.09,5.69,0.8166
6792,Murphy Group,False,TN,Wardview,Marketplaces,2010,https://murphygroup.com,Board add according minute bring.,21,murphy-group,2023,USD,423313,155466,267847,233309,34538,9157,25381,4233,8466,16915,8955,405915,120491,285424,,423313,1385.69,8391.0,0.0307,183,192.25,11706.32,0.76,0.6327
6793,Guzman-Taylor,False,DE,New Renee,SaaS,2023,https://guzman-taylor.com,Natural loss candidate decide easy buy there lose.,16,guzman-taylor,2023,EUR,514213,47626,466587,375605,90982,0,90982,5142,10284,80698,98196,527927,167501,360426,42851.08,514213,82.51,328.23,0.0576,691,61.98,36970.04,2.66,0.9074
6794,Hahn-Brown,False,AU,Lake Jason,Energy,2011,https://hahn-brown.com,Surface right try certainly dog occur too authority year civil head.,18,hahn-brown,2023,USD,5836814,1714680,4122134,3402269,719865,47191,672674,58368,116736,555938,695850,3635181,1780243,1854938,,5836814,20.0,68.36,0.0347,2283,212.97,277108.73,2.51,0.7062
6795,Lee-King,False,BR,Monroechester,Marketplaces,2012,https://lee-king.com,Attack feel and policy stop answer we rock protect.,19,lee-king,2023,USD,2552715,508030,2044685,403351,1641334,0,1641334,25527,51054,1590280,68418,1527578,282165,1245413,,2552715,85.07,271.18,0.001,591,359.39,27855.82,2.46,0.801
6796,Stevens Inc,False,AU,Jonesview,EdTech,2024,https://stevensinc.com,During reality choice accept adult month.,26,stevens-inc,2023,USD,391857,165779,226078,28973,197105,7750,189355,3918,7837,181518,29188,246947,12347,234600,32654.75,391857,530.2,3578.43,0.0142,535,61.02,9843.45,2.97,0.5769
6797,Romero-Gates,False,CA,East Justin,IoT,2018,https://romero-gates.com,Low someone industry morning ever whatever many find after sure.,16,romero-gates,2023,USD,733163,83032,650131,280702,369429,21237,348192,7331,14663,333529,109780,543857,175991,367866,,733163,20.0,13.75,0.0861,568,107.42,42052.41,2.61,0.8867
6798,Lynch LLC,False,AU,Onealburgh,Fintech,2016,https://lynchllc.com,Western much inside baby hope look card decade.,20,lynch-llc,2023,USD,943973,580011,363962,642682,-278720,0,-278720,9439,18879,-297599,59875,725181,361572,363609,,943973,1222.72,611.36,0.134,277,283.64,60071.43,1.0,0.3856
6799,Griffin Gardner and Flynn,False,DE,Douglaston,AgriTech,2020,https://griffingardnerandflynn.com,Throughout particular relationship spend see top simply people anything popular travel.,21,griffin-gardner-and-flynn,2023,EUR,101063,37392,63671,38096,25575,26178,-603,1010,2021,-2624,18675,144792,57253,87539,,101063,871.44,2998.08,0.0125,421,20.0,1000.0,18.68,0.63
6800,Sharp PLC,False,NG,Hamptonton,HealthTech,2015,https://sharpplc.com,Boy plan room keep authority yourself name new close reason.,20,sharp-plc,2023,USD,4928720,2241783,2686937,1740063,946874,5694,941180,49287,98574,842606,724445,3380070,1255030,2125040,410726.67,4928720,210.82,1389.1,0.001,5053,81.27,143714.42,5.04,0.5452
6801,Beck Inc,False,KE,North Ashley,AgriTech,2024,https://beckinc.com,School person available teacher which fly lot boy degree foreign.,24,beck-inc,2023,USD,241428,46613,194815,76073,118742,4339,114403,2414,4828,109575,89972,399234,202542,196692,,241428,20.0,73.19,0.001,1005,20.0,1000.0,89.97,0.8069
6802,Crawford Smith and Perez,False,IN,North Nicholeburgh,Marketplaces,2009,https://crawfordsmithandperez.com,Threat piece catch audience wish rock detail behavior create age.,27,crawford-smith-and-perez,2023,USD,562103,276066,286037,244342,41695,7450,34245,5621,11242,23003,176412,642044,311288,330756,,562103,20.0,89.5,0.083,2342,20.0,10182.61,17.32,0.5089
6803,Daniels Singh and Mason,False,US,North Jessica,HealthTech,2023,https://danielssinghandmason.com,Physical I example firm sound need into create end also.,23,daniels-singh-and-mason,2023,USD,145970,43367,102603,160075,-57472,3797,-61269,1459,2919,-64188,7263,139524,97719,41805,12164.17,145970,10.0,45.34,0.0744,192,63.35,28375.58,0.26,0.7029
6804,Medina Herrera and Barnett,False,AU,Port David,EdTech,2008,https://medinaherreraandbarnett.com,Choose cut oil reason car prepare American fund western to.,25,medina-herrera-and-barnett,2023,USD,132585,42665,89920,105716,-15796,8733,-24529,1325,2651,-27180,20019,174191,70734,103457,11048.75,132585,516.57,3297.71,0.0944,682,16.2,7793.87,2.57,0.6782
6805,Smith Marks and Rodriguez,False,US,South Connor,Marketplaces,2024,https://smithmarksandrodriguez.com,Hour daughter economic north purpose you add recognize fine.,21,smith-marks-and-rodriguez,2023,USD,1079079,321074,758005,266028,491977,0,491977,10790,21581,470396,101993,708879,152002,556877,,1079079,56.65,148.81,0.0755,537,167.37,14251.1,7.16,0.7025
6806,Mason Davis and Sellers,False,TN,Robertmouth,IoT,2020,https://masondavisandsellers.com,Practice case fast former local fund.,22,mason-davis-and-sellers,2023,USD,410625,69657,340968,156598,184370,0,184370,4106,8212,176158,11037,377197,177951,199246,,410625,2068.82,3681.85,0.063,217,157.01,1000.0,11.04,0.8304
6807,Parrish Wilkins and Scott,False,TN,Davidchester,Fintech,2009,https://parrishwilkinsandscott.com,Suddenly now although word top several recently clearly community cold.,26,parrish-wilkins-and-scott,2023,USD,2200332,480390,1719942,1304256,415686,0,415686,22003,44006,371680,73722,1242962,533607,709355,,2200332,115.69,57.84,0.0233,5296,34.62,130825.05,0.56,0.7817
6808,Mccoy-Johnson,False,FR,Port Joseph,Energy,2024,https://mccoy-johnson.com,Media political tend daughter young continue challenge.,17,mccoy-johnson,2023,EUR,592687,165871,426816,238470,188346,11248,177098,5926,11853,165245,19156,435669,114985,320684,,592687,1252.79,4172.86,0.116,2469,20.0,1000.0,19.16,0.7201
6809,Newman-May,False,DE,Michaelton,Fintech,2010,https://newman-may.com,Race current man possible direction.,27,newman-may,2023,EUR,5939134,2421647,3517487,650203,2867284,10787,2856497,59391,118782,2737715,1981818,4956831,247841,4708990,,5939134,747.87,4634.11,0.021,24746,20.0,73035.42,27.14,0.5923
6810,Hale Garcia and Graham,False,BR,Ortegaberg,EdTech,2018,https://halegarciaandgraham.com,Religious above hold officer reach.,15,hale-garcia-and-graham,2023,USD,1083630,418558,665072,184420,480652,0,480652,10836,21672,458980,113109,841744,324002,517742,90302.5,1083630,872.49,4408.49,0.0732,4165,21.68,14835.55,7.62,0.6137
6811,Valenzuela-James,False,US,Lake Catherine,SaaS,2010,https://valenzuela-james.com,Build set any fly decide decade page defense why line.,25,valenzuela-james,2023,USD,1003308,241689,761619,564060,197559,3677,193882,10033,20066,173816,78562,628437,158821,469616,83609.0,1003308,269.0,1673.45,0.0905,799,104.58,39812.59,1.97,0.7591
6812,Butler-Chavez,False,TN,North Peter,AI/ML,2009,https://butler-chavez.com,Police who Mrs TV total.,14,butler-chavez,2023,USD,843803,186270,657533,483023,174510,10258,164252,8438,16876,147376,311885,824298,307238,517060,,843803,20.0,10.0,0.082,3515,20.0,39845.34,7.83,0.7792
6813,Finley-Wilson,False,KE,East Joanna,Marketplaces,2016,https://finley-wilson.com,Site change our resource million safe.,23,finley-wilson,2023,USD,1546174,701168,845006,77308,767698,2608,765090,15461,30923,734167,27558,908532,314523,594009,,1546174,2125.86,3092.0,0.02,2512,51.29,6067.88,4.54,0.5465
6814,Luna Reeves and Lopez,False,FR,Christinastad,AgriTech,2010,https://lunareevesandlopez.com,Hard Congress green effect high hit stop.,17,luna-reeves-and-lopez,2023,EUR,1312068,359356,952712,1026030,-73318,12273,-85591,13120,26241,-111832,5679,833154,250028,583126,,1312068,1383.37,6635.92,0.0869,355,307.95,89464.28,0.06,0.7261
6815,Malone-Shaw,False,ZA,Port Jimmy,E-commerce,2009,https://malone-shaw.com,Smile low especially phone so entire themselves dog.,25,malone-shaw,2023,USD,422037,129459,292578,240250,52328,0,52328,4220,8440,43888,59833,398482,218245,180237,,422037,2151.5,8513.77,0.0445,169,207.45,6278.47,9.53,0.6933
6816,Nunez Reynolds and Lucas,False,EG,East John,Energy,2013,https://nunezreynoldsandlucas.com,Inside debate next take operation certainly.,19,nunez-reynolds-and-lucas,2023,USD,1800267,436573,1363694,1188483,175211,0,175211,18002,36005,139206,87193,1083563,583346,500217,,1800267,20.0,10.0,0.001,7501,20.0,95377.44,0.91,0.7575
6817,Mitchell-Guzman,False,BR,South Laura,AI/ML,2014,https://mitchell-guzman.com,Both point small community rather would difference do a.,19,mitchell-guzman,2023,USD,938882,413791,525091,284207,240884,3183,237701,9388,18777,218924,73140,715174,163914,551260,,938882,20.0,83.85,0.0133,3734,20.95,42512.95,1.72,0.5593
6818,Chavez Ltd,False,KE,Port Paul,Mobility,2021,https://chavezltd.com,Back describe finally discussion involve over while responsibility son couple.,21,chavez-ltd,2023,USD,310659,156537,154122,60370,93752,0,93752,3106,6213,87539,16343,232737,59318,173419,,310659,1618.26,6279.74,0.0626,92,279.93,1000.0,16.34,0.4961
6819,Patel Martin and Morris,False,BR,North Andreastad,HealthTech,2009,https://patelmartinandmorris.com,Nation song whom public may form.,20,patel-martin-and-morris,2023,USD,412515,143215,269300,99370,169930,12114,157816,4125,8250,149566,7679,263643,135220,128423,34376.25,412515,360.31,1419.81,0.0468,824,41.68,5402.37,1.42,0.6528
6820,Harrison Group,False,ZA,Smithbury,E-commerce,2015,https://harrisongroup.com,Threat right evening blood woman ever.,19,harrison-group,2023,USD,438915,180557,258358,22085,236273,0,236273,4389,8778,227495,32862,391911,19595,372316,,438915,338.6,212.04,0.0348,1828,20.0,1000.0,32.86,0.5886
6821,Lang Inc,False,BR,Nicholasbury,AgriTech,2016,https://langinc.com,Up crime line have easy indicate.,15,lang-inc,2023,USD,154561,53714,100847,30644,70203,13971,56232,1545,3091,53141,99110,237784,45515,192269,,154561,1617.14,1477.17,0.001,38,334.92,1000.0,99.11,0.6525
6822,Rodriguez Mccann and Smith,False,US,Lake Michellestad,Mobility,2022,https://rodriguezmccannandsmith.com,Road cup pattern artist learn.,23,rodriguez-mccann-and-smith,2023,USD,2158431,678665,1479766,856486,623280,19314,603966,21584,43168,560798,91537,1221807,551344,670463,,2158431,20.0,66.17,0.0112,768,234.09,85304.96,1.07,0.6856
6823,Moreno and Sons,False,EG,Marvinland,IoT,2017,https://morenoandsons.com,Hit notice and state behavior free show.,22,moreno-and-sons,2023,USD,639187,155834,483353,440108,43245,19408,23837,6391,12783,11054,22179,426555,143559,282996,,639187,994.02,7637.32,0.0981,1524,34.95,37801.08,0.59,0.7562
6824,Burch Ltd,False,TN,Nolanborough,HealthTech,2009,https://burchltd.com,Better water four data marriage boy type.,13,burch-ltd,2023,USD,622202,252608,369594,553616,-184022,11685,-195707,6222,12444,-208151,11038,329321,166173,163148,51850.17,622202,505.59,2724.58,0.0629,571,90.72,57736.74,0.19,0.594
6825,Hernandez Ltd,False,ZA,Port Denise,Mobility,2012,https://hernandezltd.com,Couple sometimes nation popular affect visit.,21,hernandez-ltd,2023,USD,743690,271483,472207,64308,407899,0,407899,7436,14873,393026,245463,710951,303628,407323,,743690,20.0,81.93,0.0555,1164,53.22,1000.0,245.46,0.635
6826,Farrell Inc,False,ZA,New Paulbury,Energy,2021,https://farrellinc.com,Individual onto whom official college pattern enough population radio recently.,20,farrell-inc,2023,USD,1024837,269521,755316,326165,429151,8496,420655,10248,20496,400159,316935,872561,316992,555569,,1024837,972.91,2107.97,0.0429,664,128.43,23022.51,13.77,0.737
6827,Garcia Watson and Cohen,False,BR,New Shirleyville,HealthTech,2012,https://garciawatsonandcohen.com,Theory environment conference how case rock himself campaign billion dark.,16,garcia-watson-and-cohen,2023,USD,2638235,1102613,1535622,2017083,-481461,27555,-509016,26382,52764,-561780,228695,1616477,1060967,555510,219852.92,2638235,10.0,67.03,0.001,2200,99.92,179643.63,1.27,0.5821
6828,Terry-Webb,False,CA,Danielmouth,SaaS,2010,https://terry-webb.com,Service rather national notice everyone collection.,23,terry-webb,2023,USD,1296948,408846,888102,1079389,-191287,8946,-200233,12969,25938,-226171,43449,781036,205235,575801,108079.0,1296948,513.89,3474.05,0.0318,1848,58.47,88047.94,0.49,0.6848
6829,Oliver Group,False,ZA,Williamville,Mobility,2023,https://olivergroup.com,Reduce against Democrat leg board might road course range security.,22,oliver-group,2023,USD,1238801,555051,683750,667300,16450,15270,1180,12388,24776,-23596,52528,709867,347372,362495,,1238801,1459.52,6481.94,0.0354,5161,20.0,27793.36,1.89,0.5519
6830,Kent LLC,False,TN,Jonathanmouth,SaaS,2013,https://kentllc.com,Different public pretty author however deep less.,16,kent-llc,2023,USD,2948908,1631525,1317383,2057415,-740032,4959,-744991,29489,58978,-803969,186008,1678078,412837,1265241,245742.33,2948908,309.65,309.65,0.001,4194,58.59,188649.62,0.99,0.4467
6831,Harris Barker and Smith,False,KE,Dianaland,Cybersecurity,2010,https://harrisbarkerandsmith.com,Sing throughout cultural manage local today ball finally particular.,15,harris-barker-and-smith,2023,USD,335431,101031,234400,16771,217629,34916,182713,3354,6708,176005,60809,359438,165092,194346,,335431,20.0,66.13,0.001,307,91.01,1681.22,36.17,0.6988
6832,Johnson PLC,False,AU,Luismouth,AgriTech,2008,https://johnsonplc.com,Good gun family night and provide man.,26,johnson-plc,2023,USD,305850,112720,193130,230034,-36904,19308,-56212,3058,6117,-62329,7654,263530,151686,111844,,305850,347.3,1264.31,0.0763,1274,20.0,11881.12,0.64,0.6315
6833,Hill-Wright,False,TN,Vaughnshire,AI/ML,2016,https://hill-wright.com,Prevent which nature choice office music affect paper kid.,25,hill-wright,2023,USD,400058,87285,312773,217947,94826,4824,90002,4000,8001,82001,14961,368130,67729,300401,,400058,779.93,3563.13,0.0617,273,121.84,8037.69,1.86,0.7818
6834,Wade Dillon and Flynn,False,FR,East Kayla,EdTech,2014,https://wadedillonandflynn.com,Little them consumer not under recent discussion.,29,wade-dillon-and-flynn,2023,EUR,1593479,828490,764989,810306,-45317,0,-45317,15934,31869,-77186,364079,1295030,371781,923249,132789.92,1593479,140.15,740.5,0.0726,1161,114.28,55873.61,6.52,0.4801
6835,Morgan and Sons,False,DE,West Catherineland,Mobility,2015,https://morganandsons.com,Against together state eye surface.,17,morgan-and-sons,2023,EUR,1795514,815168,980346,561244,419102,0,419102,17955,35910,383192,31188,957429,364862,592567,,1795514,20.0,10.0,0.1353,3863,38.73,51362.96,0.61,0.546
6836,Hicks-Watts,False,FR,North Emily,HealthTech,2018,https://hicks-watts.com,Hit travel whom after federal seat reason knowledge certain office.,19,hicks-watts,2023,EUR,862765,252958,609807,363412,246395,29179,217216,8627,17255,199961,47901,497943,241882,256061,71897.08,862765,196.58,722.62,0.0311,927,77.54,10825.51,4.42,0.7068
6837,White-Roberts,False,CA,East Karentown,Cybersecurity,2013,https://white-roberts.com,Specific personal not general produce less.,15,white-roberts,2023,USD,1047107,298470,748637,679298,69339,11996,57343,10471,20942,36401,42583,691953,325504,366449,,1047107,3355.63,8421.85,0.0944,427,204.15,74413.41,0.57,0.715
6838,Bass Leach and Bennett,False,DE,Cherylburgh,E-commerce,2020,https://bassleachandbennett.com,Relationship however laugh threat three score sit measure mind.,23,bass-leach-and-bennett,2023,EUR,739159,182748,556411,428631,127780,24390,103390,7391,14783,88607,18922,558294,286237,272057,,739159,20.0,68.12,0.0897,730,84.3,26620.0,0.71,0.7528
6839,Roberts Conley and Lamb,False,FR,South Sandrahaven,Mobility,2010,https://robertsconleyandlamb.com,Yourself within happy ball middle ask quality reality.,18,roberts-conley-and-lamb,2023,EUR,637563,252476,385087,332435,52652,0,52652,6375,12751,39901,4589,406470,220438,186032,,637563,788.36,2475.1,0.1642,2656,20.0,72232.1,0.06,0.604
6840,Allen PLC,False,EG,New Christopher,SaaS,2014,https://allenplc.com,Back light article cover series wonder process feeling structure blue plant.,16,allen-plc,2023,USD,1232472,552938,679534,499007,180527,25656,154871,12324,24649,130222,63424,747817,250539,497278,102706.0,1232472,198.78,422.3,0.001,4181,24.56,16171.73,3.92,0.5514
6841,Perkins Inc,False,GB,Garciachester,Marketplaces,2011,https://perkinsinc.com,Cold responsibility participant similar cause edge media.,25,perkins-inc,2023,USD,1459827,406572,1053255,818732,234523,5386,229137,14598,29196,199941,270889,1115080,385878,729202,,1459827,273.24,575.9,0.001,1245,97.65,107105.67,2.53,0.7215
6842,Gregory Thomas and Phelps,False,FR,Lake Elizabethbury,IoT,2013,https://gregorythomasandphelps.com,Cup standard compare question surface send candidate.,20,gregory-thomas-and-phelps,2023,EUR,179137,71458,107679,34722,72957,0,72957,1791,3582,69375,5368,107621,89009,18612,,179137,608.24,1242.15,0.001,746,20.0,1000.0,5.37,0.6011
6843,Velasquez PLC,False,US,Lake Alyssamouth,Energy,2011,https://velasquezplc.com,Prevent large young executive push final black key.,16,velasquez-plc,2023,USD,870022,308376,561646,231350,330296,19943,310353,8700,17400,292953,19601,614878,199832,415046,,870022,20.0,39.53,0.0495,424,170.98,21574.49,0.91,0.6456
6844,Martin Nichols and Lewis,False,DE,West Michaelside,Energy,2015,https://martinnicholsandlewis.com,By learn foot least ago store smile individual.,19,martin-nichols-and-lewis,2023,EUR,2241634,894844,1346790,112081,1234709,0,1234709,22416,44832,1189877,244802,1428323,292813,1135510,,2241634,20.0,102.72,0.1343,1575,118.58,1000.0,244.8,0.6008
6845,Lopez-Kim,False,NG,Watsonchester,Marketplaces,2018,https://lopez-kim.com,Training everything nice air security growth action.,17,lopez-kim,2023,USD,1775966,686025,1089941,782851,307090,26531,280559,17759,35519,245040,45303,942285,451961,490324,,1775966,823.1,1237.41,0.001,2472,59.85,30298.12,1.5,0.6137
6846,King Ltd,False,GB,Patelstad,Mobility,2023,https://kingltd.com,Someone service how soon project set care election.,23,king-ltd,2023,USD,460332,214397,245935,209813,36122,0,36122,4603,9206,26916,60939,351823,227102,124721,,460332,539.56,598.23,0.0125,359,106.84,30780.81,1.98,0.5343
6847,Hawkins Davis and Walsh,False,NG,Johnsonside,IoT,2019,https://hawkinsdavisandwalsh.com,End pick allow sister hair.,28,hawkins-davis-and-walsh,2023,USD,165038,83274,81764,94818,-13054,32669,-45723,1650,3300,-49023,9696,251713,130710,121003,,165038,924.23,2389.49,0.06,65,209.18,24392.03,0.4,0.4954
6848,Sullivan Group,False,TN,South James,Fintech,2014,https://sullivangroup.com,Republican whole contain decade his both mind.,15,sullivan-group,2023,USD,1183761,434499,749262,548906,200356,25242,175114,11837,23675,151439,18951,680379,368419,311960,,1183761,767.14,3066.24,0.0519,448,219.71,66480.31,0.29,0.633
6849,Jones Group,False,DE,Timothyburgh,Mobility,2010,https://jonesgroup.com,Record type majority many relate never report audience detail.,12,jones-group,2023,EUR,782364,296456,485908,519734,-33826,11576,-45402,7823,15647,-61049,11466,520838,270255,250583,,782364,910.32,1325.51,0.153,270,240.82,46332.81,0.25,0.6211
6850,Wilson-Mitchell,False,BR,Martinezstad,AI/ML,2017,https://wilson-mitchell.com,Still pass plan source property smile scientist simply fall.,15,wilson-mitchell,2023,USD,831565,265061,566504,133489,433015,0,433015,8315,16631,416384,15232,601926,311830,290096,,831565,564.67,2376.41,0.0582,2768,25.03,25069.72,0.61,0.6813
6851,Anderson Fernandez and Lambert,False,IN,Robertsonland,AgriTech,2009,https://andersonfernandezandlambert.com,Everybody civil help that should themselves arm far name.,28,anderson-fernandez-and-lambert,2023,USD,151935,38704,113231,69491,43740,0,43740,1519,3038,40702,44651,262449,103948,158501,,151935,1192.36,2933.9,0.0728,150,84.06,17807.54,2.51,0.7453
6852,English Inc,False,ZA,East Matthew,HealthTech,2018,https://englishinc.com,Kind ready really forget.,21,english-inc,2023,USD,502821,158608,344213,317503,26710,17126,9584,5028,10056,-472,24037,382102,20016,362086,41901.75,502821,13.06,105.19,0.0316,671,62.44,10898.84,2.21,0.6846
6853,Garcia-Hogan,False,US,Chrisfurt,HealthTech,2020,https://garcia-hogan.com,Situation product guess else old though.,22,garcia-hogan,2023,USD,4067776,974731,3093045,544117,2548928,0,2548928,40677,81355,2467573,409269,2506060,730953,1775107,338981.33,4067776,299.05,1333.5,0.0519,2393,141.62,51863.21,7.89,0.7604
6854,Freeman Inc,False,IN,Henryhaven,AI/ML,2009,https://freemaninc.com,Decade admit value establish himself class central point station.,25,freeman-inc,2023,USD,924961,282856,642105,62595,579510,16897,562613,9249,18499,544114,42855,653927,314756,339171,,924961,104.04,419.76,0.0194,214,359.21,1000.0,42.86,0.6942
6855,Garner Smith and Everett,False,FR,Lake Susanmouth,Energy,2016,https://garnersmithandeverett.com,Music nearly career campaign central market.,21,garner-smith-and-everett,2023,EUR,1860163,727281,1132882,1353359,-220477,6722,-227199,18601,37203,-264402,39281,1061082,392947,668135,,1860163,246.18,123.09,0.001,467,331.58,109064.37,0.36,0.609
6856,Cunningham-Hernandez,False,IN,East Elizabeth,SaaS,2015,https://cunningham-hernandez.com,Eat rate believe bank son.,33,cunningham-hernandez,2023,USD,2196062,765750,1430312,166182,1264130,6673,1257457,21960,43921,1213536,326886,1562414,1060793,501621,183005.17,2196062,430.1,1244.35,0.0113,4225,43.31,27324.94,11.96,0.6513
6857,Coleman Ltd,False,EG,Justinland,EdTech,2016,https://colemanltd.com,Herself store while into him prevent look.,26,coleman-ltd,2023,USD,662498,266073,396425,211252,185173,18487,166686,6624,13249,153437,33464,508000,132872,375128,55208.17,662498,100.97,117.58,0.0044,11041,5.0,8689.31,3.85,0.5984
6858,Morgan Wright and Young,False,FR,Glennport,Energy,2023,https://morganwrightandyoung.com,Although miss lose strategy bank.,18,morgan-wright-and-young,2023,EUR,4639166,1737717,2901449,2023113,878336,18189,860147,46391,92783,767364,401283,2728278,1150356,1577922,,4639166,648.02,3674.19,0.001,1841,209.98,139283.1,2.88,0.6254
6859,Lopez-Smith,False,NG,Harrymouth,Fintech,2012,https://lopez-smith.com,Rest eat house remain protect window cover attention.,16,lopez-smith,2023,USD,1713295,683672,1029623,1397464,-367841,17196,-385037,17132,34265,-419302,83282,1034848,533323,501525,,1713295,700.22,1656.05,0.0459,1197,119.21,115478.03,0.72,0.601
6860,Lopez-Davis,False,EG,New Cathychester,Cybersecurity,2023,https://lopez-davis.com,Clearly treatment above discussion feel lot accept professional.,22,lopez-davis,2023,USD,997566,243377,754189,293960,460229,0,460229,9975,19951,440278,28909,658412,162645,495767,,997566,20.0,10.0,0.0358,824,100.8,4584.98,6.31,0.756
6861,Morales LLC,False,BR,South Elizabeth,AI/ML,2013,https://moralesllc.com,Site everybody sometimes ever organization cup around kid us.,16,morales-llc,2023,USD,4239507,1966195,2273312,1343133,930179,5924,924255,42395,84790,839465,612937,2909861,1197531,1712330,,4239507,82.4,41.2,0.0866,1158,304.93,133855.15,4.58,0.5362
6862,Guzman Ltd,False,GB,Morganbury,Fintech,2008,https://guzmanltd.com,Fund decision herself budget hear thank able.,22,guzman-ltd,2023,USD,415987,90584,325403,102281,223122,112,223010,4159,8319,214691,8666,297781,142933,154848,,415987,551.34,3739.89,0.0483,122,283.03,1000.0,8.67,0.7822
6863,Chung-Green,False,GB,Meyerport,Marketplaces,2010,https://chung-green.com,Go also indicate never property whatever.,18,chung-green,2023,USD,591621,118880,472741,177324,295417,0,295417,5916,11832,283585,17174,505647,222615,283032,,591621,20.0,16.77,0.036,623,79.06,9052.3,1.9,0.7991
6864,Kramer Garcia and May,False,EG,South Michaelton,IoT,2013,https://kramergarciaandmay.com,Free PM four painting pick.,25,kramer-garcia-and-may,2023,USD,1313619,701754,611865,382955,228910,27046,201864,13136,26272,175592,157395,889673,138827,750846,,1313619,332.0,913.7,0.1002,647,169.06,12600.4,12.49,0.4658
6865,Hamilton Holt and Brown,False,FR,Sarahfurt,Marketplaces,2014,https://hamiltonholtandbrown.com,Goal usually degree eye number pay.,17,hamilton-holt-and-brown,2023,EUR,345300,170272,175028,48694,126334,0,126334,3453,6906,119428,15030,255054,55994,199060,,345300,20.0,55.27,0.1569,200,143.67,10158.84,1.48,0.5069
6866,Ross-Davies,False,IN,Lewisburgh,AI/ML,2021,https://ross-davies.com,Discuss must reveal price program alone town.,21,ross-davies,2023,USD,1080113,696263,383850,304340,79510,17301,62209,10801,21602,40607,102628,723187,36159,687028,,1080113,1446.94,7691.18,0.001,4500,20.0,10561.76,9.72,0.3554
6867,Gutierrez-Richardson,False,GB,Port Timothybury,IoT,2018,https://gutierrez-richardson.com,Traditional effect cup section you exactly stop.,20,gutierrez-richardson,2023,USD,326036,127984,198052,201673,-3621,35244,-38865,3260,6520,-45385,91477,431125,316737,114388,,326036,998.44,3738.05,0.0218,223,121.33,1000.0,91.48,0.6075
6868,Robinson Walker and Rodriguez,False,ZA,Kristinside,Mobility,2022,https://robinsonwalkerandrodriguez.com,Realize subject style rise world simple reflect.,16,robinson-walker-and-rodriguez,2023,USD,1910354,886321,1024033,95517,928516,12130,916386,19103,38207,878179,61043,1040597,300903,739694,,1910354,20.0,68.59,0.0827,658,241.93,1000.0,61.04,0.536
6869,Freeman LLC,False,DE,Port Brian,Energy,2015,https://freemanllc.com,Car bag phone rich mention necessary play skill down still.,19,freeman-llc,2023,EUR,277507,146449,131058,238422,-107364,1560,-108924,2775,5550,-114474,7185,225179,11258,213921,,277507,20.0,30.15,0.0581,169,136.73,10554.04,0.68,0.4723
6870,Thompson Ltd,False,NG,Port Sarahborough,EdTech,2011,https://thompsonltd.com,Bag each behavior war attention age.,15,thompson-ltd,2023,USD,580740,217067,363673,250938,112735,31415,81320,5807,11614,69706,17557,316279,15813,300466,48395.0,580740,345.48,778.01,0.0181,9679,5.0,12621.01,1.39,0.6262
6871,Cox-Benson,False,NG,Castrofurt,HealthTech,2018,https://cox-benson.com,More executive look race recognize training.,20,cox-benson,2023,USD,1068048,651190,416858,379023,37835,1820,36015,10680,21360,14655,38566,636305,553993,82312,89004.0,1068048,10.0,13.5,0.031,2437,36.51,52155.94,0.74,0.3903
6872,Garza Ross and Bell,False,TN,Ericland,SaaS,2018,https://garzarossandbell.com,Recognize person inside phone memory better pick participant commercial.,13,garza-ross-and-bell,2023,USD,675656,211054,464602,419234,45368,0,45368,6756,13513,31855,10632,481927,158153,323774,56304.67,675656,56.09,536.7,0.022,3904,14.42,74805.6,0.14,0.6876
6873,Lara Quinn and Martin,False,DE,North Melinda,IoT,2022,https://laraquinnandmartin.com,Task explain join page game remain view represent much.,26,lara-quinn-and-martin,2023,EUR,887147,276839,610308,321730,288578,24401,264177,8871,17742,246435,78244,599870,133948,465922,,887147,258.34,1107.1,0.031,3696,20.0,23309.91,3.36,0.6879
6874,Robinson and Sons,False,ZA,Clarkside,SaaS,2023,https://robinsonandsons.com,Pressure worry relationship likely save stop.,9,robinson-and-sons,2023,USD,1236938,431698,805240,962826,-157586,15726,-173312,12369,24738,-198050,98452,752169,497443,254726,103078.17,1236938,746.47,1986.05,0.097,1845,55.84,89817.01,1.1,0.651
6875,Sanchez Ltd,False,AU,Hallland,Cybersecurity,2021,https://sanchezltd.com,Subject material manager heavy for blue occur already push fire factor.,20,sanchez-ltd,2023,USD,2722072,268649,2453423,2245587,207836,0,207836,27220,54441,153395,282112,1794168,550333,1243835,,2722072,20.0,10.0,0.001,1688,134.34,192565.42,1.47,0.9013
6876,Anderson Jones and Montgomery,False,TN,Joshuastad,Marketplaces,2011,https://andersonjonesandmontgomery.com,Ago job relationship PM reason everything move.,23,anderson-jones-and-montgomery,2023,USD,4540314,696231,3844083,227015,3617068,0,3617068,45403,90806,3526262,180251,2609233,1056788,1552445,,4540314,393.39,614.9,0.1019,2339,161.74,15807.5,11.4,0.8467
6877,Wheeler PLC,False,EG,Johnsonfurt,Mobility,2009,https://wheelerplc.com,Role stay great green born.,18,wheeler-plc,2023,USD,640839,117095,523744,401913,121831,13317,108514,6408,12816,95698,55843,459114,127124,331990,,640839,1209.12,2682.02,0.0826,2670,20.0,8015.44,6.97,0.8173
6878,Dunn Ltd,False,TN,Jillbury,Mobility,2015,https://dunnltd.com,Particularly in through thousand shake.,15,dunn-ltd,2023,USD,1246527,474652,771875,388171,383704,2752,380952,12465,24930,356022,112109,823229,551576,271653,,1246527,128.44,497.88,0.001,477,217.43,44506.82,2.52,0.6192
6879,Norris-Arnold,False,TN,Gabriellastad,AI/ML,2012,https://norris-arnold.com,Media someone wrong design land.,25,norris-arnold,2023,USD,960792,48039,912753,388603,524150,1660,522490,9607,19215,503275,43469,650341,32517,617824,,960792,553.3,332.35,0.0121,2198,36.42,37178.83,1.17,0.95
6880,Joyce Gordon and Hammond,False,AU,Ballardstad,SaaS,2019,https://joycegordonandhammond.com,Claim its very garden single not.,20,joyce-gordon-and-hammond,2023,USD,101114,37128,63986,44787,19199,0,19199,1011,2022,17177,7325,205423,109718,95705,8426.17,101114,438.02,1823.59,0.0143,177,47.47,28262.22,0.26,0.6328
6881,French Ltd,False,AU,South Sheriton,SaaS,2020,https://frenchltd.com,About remember wonder available stock star myself their anything director.,22,french-ltd,2023,USD,5264694,1660249,3604445,1314052,2290393,0,2290393,52646,105293,2185100,202112,2841019,2250595,590424,438724.5,5264694,560.74,3238.34,0.0523,14374,30.52,119265.8,1.69,0.6846
6882,Best Cox and Hill,False,NG,Port Roy,HealthTech,2010,https://bestcoxandhill.com,Itself how question full no ask.,19,best-cox-and-hill,2023,USD,341790,44122,297668,208763,88905,1988,86917,3417,6835,80082,3074,298286,124906,173380,28482.5,341790,423.55,2439.01,0.0348,795,35.8,14851.5,0.21,0.8709
6883,Sanchez Ltd,False,BR,West Jesseview,HealthTech,2013,https://sanchezltd.com,Every foreign because tend behavior south meet begin table.,24,sanchez-ltd,2023,USD,1077893,377564,700329,215976,484353,6892,477461,10778,21557,455904,57024,626033,101189,524844,89824.42,1077893,150.65,630.55,0.0084,17964,5.0,24396.55,2.34,0.6497
6884,Ho Russell and Jones,False,DE,Lisaside,Marketplaces,2019,https://horussellandjones.com,Once fight outside from.,15,ho-russell-and-jones,2023,EUR,8602937,4098185,4504752,5957775,-1453023,28033,-1481056,86029,172058,-1653114,610745,4943673,1875546,3068127,,8602937,466.7,1120.24,0.0084,35845,20.0,490538.59,1.25,0.5236
6885,Gomez-Yates,False,CA,Stevenbury,Marketplaces,2013,https://gomez-yates.com,Social art show ground end affect individual other together low.,26,gomez-yates,2023,USD,1870319,801161,1069158,93515,975643,11790,963853,18703,37406,926447,235914,1280374,311426,968948,,1870319,20.0,52.37,0.1016,2806,55.54,1000.0,235.91,0.5716
6886,Mathews-Clay,False,FR,Michaelmouth,Energy,2019,https://mathews-clay.com,Senior service paper catch threat notice age act.,21,mathews-clay,2023,EUR,971137,278102,693035,302057,390978,2609,388369,9711,19422,368947,47667,619199,184788,434411,,971137,549.23,1499.92,0.001,415,194.67,10029.56,4.75,0.7136
6887,Wood Roberts and Roberts,False,US,Loriton,E-commerce,2022,https://woodrobertsandroberts.com,It half girl attorney manage strategy stock behind.,31,wood-roberts-and-roberts,2023,USD,874356,234977,639379,328812,310567,48061,262506,8743,17487,245019,5663,455489,130781,324708,,874356,655.72,3636.16,0.055,490,148.45,15379.38,0.37,0.7313
6888,Perez Ltd,False,FR,East Elizabethton,Marketplaces,2016,https://perezltd.com,Mouth buy to record maintain probably sport magazine another.,17,perez-ltd,2023,EUR,1169987,357149,812838,564952,247886,30525,217361,11699,23399,193962,35637,779297,192677,586620,,1169987,836.42,3628.92,0.001,4874,20.0,77256.26,0.46,0.6947
6889,Gray Ltd,False,TN,Joshuaberg,IoT,2012,https://grayltd.com,Likely candidate that meeting partner artist center professor black.,19,gray-ltd,2023,USD,623154,278327,344827,31157,313670,8670,305000,6231,12463,292537,68929,401724,305565,96159,,623154,20.0,41.04,0.0563,279,185.73,4262.22,16.17,0.5534
6890,Walls PLC,False,ZA,West Sarah,Fintech,2024,https://wallsplc.com,Manage interest force deep skill politics team final movement.,25,walls-plc,2023,USD,1514846,800712,714134,251565,462569,0,462569,15148,30296,432273,11519,785556,377505,408051,,1514846,1086.08,1371.35,0.1587,982,128.5,25325.45,0.45,0.4714
6891,Edwards Christian and Barrera,False,BR,Wellsfurt,HealthTech,2010,https://edwardschristianandbarrera.com,Morning after someone list.,21,edwards-christian-and-barrera,2023,USD,2657684,943893,1713791,2017243,-303452,0,-303452,26576,53153,-356605,374558,1804001,373011,1430990,221473.67,2657684,81.45,252.09,0.0067,44294,5.0,189325.53,1.98,0.6448
6892,Charles Ltd,False,KE,East Heather,HealthTech,2018,https://charlesltd.com,Sense share training would forward.,23,charles-ltd,2023,USD,1048765,399079,649686,52438,597248,0,597248,10487,20975,576273,32856,685720,324434,361286,87397.08,1048765,389.47,795.15,0.0384,1260,69.36,13134.09,2.5,0.6195
6893,Knight Martin and Sherman,False,KE,South Shelbystad,Energy,2022,https://knightmartinandsherman.com,Son real both include.,24,knight-martin-and-sherman,2023,USD,1543985,782591,761394,963515,-202121,18632,-220753,15439,30879,-251632,46732,954424,623716,330708,,1543985,1107.31,3788.65,0.1115,3179,40.47,126737.26,0.37,0.4931
6894,Hernandez-Williams,False,AU,New Donnamouth,IoT,2009,https://hernandez-williams.com,Doctor sure generation new past idea really class.,19,hernandez-williams,2023,USD,1272637,196600,1076037,1140217,-64180,50821,-115001,12726,25452,-140453,25033,845956,478713,367243,,1272637,1031.02,2474.08,0.0949,5302,20.0,95697.01,0.26,0.8455
6895,Leon-Williams,False,NG,South Madelineborough,IoT,2016,https://leon-williams.com,Despite should federal amount art approach down standard.,20,leon-williams,2023,USD,47346,18759,28587,13079,15508,30481,-14973,473,946,-15919,6846,87646,59287,28359,,47346,20.0,13.73,0.1251,23,169.67,1000.0,6.85,0.6038
6896,Romero Allen and Lopez,False,DE,Hamiltonview,Energy,2017,https://romeroallenandlopez.com,Church southern they people once none film enjoy.,19,romero-allen-and-lopez,2023,EUR,1022909,402528,620381,421696,198685,0,198685,10229,20458,178227,36037,640165,315099,325066,,1022909,604.9,2016.34,0.001,4262,20.0,11060.48,3.26,0.6065
6897,Brown-Goodman,False,AU,Doristown,AI/ML,2008,https://brown-goodman.com,Say per guy bank travel ball.,21,brown-goodman,2023,USD,1811544,775588,1035956,193629,842327,12241,830086,18115,36230,793856,63321,989896,460271,529625,,1811544,1018.64,2354.02,0.0763,858,175.83,1000.0,63.32,0.5719
6898,Mcknight LLC,False,GB,North Adam,HealthTech,2009,https://mcknightllc.com,Total save defense animal pick play.,26,mcknight-llc,2023,USD,1061818,323216,738602,329845,408757,28602,380155,10618,21236,358919,162144,817443,325349,492094,88484.83,1061818,272.05,558.76,0.0099,1135,77.91,23687.38,6.85,0.6956
6899,Neal-Vazquez,False,CA,New Nicole,SaaS,2015,https://neal-vazquez.com,Land gas finally agent phone mission.,16,neal-vazquez,2023,USD,3182903,600490,2582413,1577059,1005354,21458,983896,31829,63658,920238,139227,1759564,751924,1007640,265241.92,3182903,10.0,73.18,0.0137,6836,38.8,135304.54,1.03,0.8113
6900,Rodriguez-Durham,False,BR,East Ronaldshire,AI/ML,2021,https://rodriguez-durham.com,Until opportunity probably gun fill fact couple season more.,14,rodriguez-durham,2023,USD,3661417,1142601,2518816,1520179,998637,21253,977384,36614,73228,904156,104007,2076737,103836,1972901,,3661417,20.0,117.21,0.0968,2065,147.71,130374.96,0.8,0.6879
6901,Russo Strong and Sullivan,False,ZA,Troyport,IoT,2016,https://russostrongandsullivan.com,Market must require wish father herself.,30,russo-strong-and-sullivan,2023,USD,1585505,1010773,574732,693547,-118815,11894,-130709,15855,31710,-162419,22810,851120,150488,700632,,1585505,20.0,88.54,0.0703,1211,109.08,39690.31,0.57,0.3625
6902,Moore Ltd,False,NG,Mirandafurt,AgriTech,2012,https://mooreltd.com,Mean media issue choice hospital Republican couple still.,21,moore-ltd,2023,USD,373902,208406,165496,75737,89759,0,89759,3739,7478,82281,61321,407380,293164,114216,,373902,3100.29,8867.03,0.0723,141,219.68,14310.73,4.28,0.4426
6903,Pope Group,False,IN,Edgarstad,IoT,2018,https://popegroup.com,Billion trial product face cultural little system score ahead region rule.,20,pope-group,2023,USD,407256,87960,319296,20362,298934,36867,262067,4072,8145,253922,9877,303290,147686,155604,,407256,20.0,93.24,0.0021,405,83.64,19286.87,0.51,0.784
6904,Farrell-Schwartz,False,ZA,Austinhaven,IoT,2024,https://farrell-schwartz.com,Side different stand south yes man project.,22,farrell-schwartz,2023,USD,660562,200147,460415,358979,101436,5189,96247,6605,13211,83036,7195,485344,161201,324143,,660562,266.3,1097.32,0.0616,385,142.97,15793.74,0.46,0.697
6905,Carroll PLC,False,NG,Wallaceberg,Marketplaces,2010,https://carrollplc.com,As student safe weight west else success traditional here change.,29,carroll-plc,2023,USD,661373,232207,429166,529707,-100541,8362,-108903,6613,13227,-122130,33770,378186,154792,223394,,661373,450.34,2179.43,0.0414,374,147.04,29963.67,1.13,0.6489
6906,Thomas-Hicks,False,BR,Stephanietown,Fintech,2017,https://thomas-hicks.com,Defense chair dog peace center instead media black design citizen.,23,thomas-hicks,2023,USD,1794493,620252,1174241,988970,185271,40350,144921,17944,35889,109032,143230,1190744,59537,1131207,,1794493,98.19,759.56,0.0492,964,154.98,68188.98,2.1,0.6544
6907,Rodriguez PLC,False,CA,East Kelly,Mobility,2024,https://rodriguezplc.com,Player front southern month all news.,18,rodriguez-plc,2023,USD,1166000,276810,889190,495373,393817,31814,362003,11660,23320,338683,108640,710014,283489,426525,,1166000,477.05,2190.09,0.0473,823,117.96,34508.13,3.15,0.7626
6908,Powers-Freeman,False,EG,Rodneystad,SaaS,2022,https://powers-freeman.com,Second article job though model run front scientist right just.,20,powers-freeman,2023,USD,794845,379720,415125,461232,-46107,37354,-83461,7948,15896,-99357,119018,652101,335411,316690,66237.08,794845,276.75,1378.24,0.0371,1202,55.08,36372.41,3.27,0.5223
6909,Chase and Sons,False,FR,North Theresahaven,E-commerce,2013,https://chaseandsons.com,Everything over picture culture investment treatment truth.,33,chase-and-sons,2023,EUR,910993,216851,694142,403901,290241,0,290241,9109,18219,272022,411670,953358,600635,352723,,910993,357.5,1442.83,0.001,581,130.46,23412.27,17.58,0.762
6910,Hunt LLC,False,DE,West Victoria,AI/ML,2020,https://huntllc.com,All bit kind former trip will.,11,hunt-llc,2023,EUR,1241393,509678,731715,772469,-40754,17872,-58626,12413,24827,-83453,39324,679802,276746,403056,,1241393,20.0,53.24,0.0275,411,251.44,43260.15,0.91,0.5894
6911,Schultz and Sons,False,EG,Lake Alexandraborough,Energy,2023,https://schultzandsons.com,Follow believe wear general institution debate such more anyone.,15,schultz-and-sons,2023,USD,1388780,449983,938797,490619,448178,0,448178,13887,27775,420403,87852,917591,100370,817221,,1388780,528.26,1788.07,0.0534,1163,99.51,37164.39,2.36,0.676
6912,Barnett-Smith,False,DE,South Ashley,AI/ML,2013,https://barnett-smith.com,Put entire third second large character.,23,barnett-smith,2023,EUR,537416,151406,386010,84304,301706,27174,274532,5374,10748,263784,28063,477165,229150,248015,,537416,20.0,28.96,0.0727,236,189.05,3908.33,7.18,0.7183
6913,Reyes Fischer and Rodriguez,False,US,Bradstad,IoT,2022,https://reyesfischerandrodriguez.com,Have hand color hair I travel reflect.,18,reyes-fischer-and-rodriguez,2023,USD,1408241,412332,995909,865646,130263,0,130263,14082,28164,102099,24172,757954,258282,499672,,1408241,20.0,86.19,0.1396,5867,20.0,57081.34,0.42,0.7072
6914,Hoffman PLC,False,IN,South Michael,Energy,2010,https://hoffmanplc.com,Else task fish morning point.,19,hoffman-plc,2023,USD,8728685,4263184,4465501,3387746,1077755,2405,1075350,87286,174573,900777,332862,4721854,2989147,1732707,,8728685,626.06,1768.82,0.0571,3856,188.61,288038.26,1.16,0.5116
6915,Martin-Adams,False,KE,Port Stevenview,Fintech,2022,https://martin-adams.com,Development risk might pick other somebody first.,14,martin-adams,2023,USD,571894,172887,399007,417453,-18446,19050,-37496,5718,11437,-48933,31738,404085,135258,268827,,571894,1007.41,1221.72,0.1917,594,80.17,16985.97,1.87,0.6977
6916,Jackson-Lee,False,EG,New Christina,IoT,2023,https://jackson-lee.com,At role approach recently.,21,jackson-lee,2023,USD,303578,178479,125099,263025,-137926,21313,-159239,3035,6071,-165310,2986,282565,64919,217646,,303578,20.0,44.38,0.0632,144,175.01,1000.0,2.99,0.4121
6917,Taylor Inc,False,TN,Andrewside,AI/ML,2012,https://taylorinc.com,Season night citizen social soldier social where.,21,taylor-inc,2023,USD,928630,315345,613285,271251,342034,25579,316455,9286,18572,297883,44741,551285,37575,513710,,928630,638.02,1297.8,0.001,1578,49.03,37399.02,1.2,0.6604
6918,Perkins-Watson,False,KE,New Vickie,IoT,2021,https://perkins-watson.com,Trouble imagine simple rate book stock.,25,perkins-watson,2023,USD,1101686,334239,767447,177638,589809,13966,575843,11016,22033,553810,189866,782902,427259,355643,,1101686,1025.6,1254.49,0.001,1653,55.51,51695.96,3.67,0.6966
6919,Jackson-Gutierrez,False,NG,West Destinyberg,Mobility,2012,https://jackson-gutierrez.com,College form sea and theory take window north world everyone.,15,jackson-gutierrez,2023,USD,538176,192220,345956,273472,72484,0,72484,5381,10763,61721,58980,377799,50965,326834,,538176,20.0,43.2,0.001,426,105.19,16230.88,3.63,0.6428
6920,Thomas Galloway and Hunter,False,GB,Fullerton,E-commerce,2024,https://thomasgallowayandhunter.com,Tell certain character page rich finally face surface compare.,17,thomas-galloway-and-hunter,2023,USD,515955,206602,309353,346511,-37158,8029,-45187,5159,10319,-55506,82019,403481,172343,231138,,515955,1819.37,3429.62,0.001,2149,20.0,41575.61,1.97,0.5996
6921,Hamilton Inc,False,KE,Smithchester,EdTech,2023,https://hamiltoninc.com,Gas operation modern role everything above senior of.,12,hamilton-inc,2023,USD,810495,202148,608347,106218,502129,41660,460469,8104,16209,444260,439122,1024047,548556,475491,67541.25,810495,10.0,10.0,0.0612,13508,5.0,58686.31,7.48,0.7506
6922,Norton Moore and Jackson,False,ZA,East Jonathantown,SaaS,2018,https://nortonmooreandjackson.com,Treat majority most back despite trouble simply control.,26,norton-moore-and-jackson,2023,USD,1219082,319139,899943,428400,471543,37127,434416,12190,24381,410035,118914,757987,37899,720088,101590.17,1219082,50.1,150.88,0.0428,2127,47.74,1000.0,118.91,0.7382
6923,Phillips Anderson and Cole,False,BR,Jonesfurt,AI/ML,2008,https://phillipsandersonandcole.com,Team sure military card arm social no record.,21,phillips-anderson-and-cole,2023,USD,1066932,279873,787059,826608,-39549,25473,-65022,10669,21338,-86360,75414,693751,49299,644452,,1066932,1112.86,8010.93,0.0797,2704,32.87,82321.45,0.92,0.7377
6924,Whitaker Weber and Melendez,False,TN,Hannahburgh,Marketplaces,2013,https://whitakerweberandmelendez.com,Wish office character customer since current thought dog success beautiful.,17,whitaker-weber-and-melendez,2023,USD,1351251,410968,940283,486895,453388,0,453388,13512,27025,426363,37418,897175,459386,437789,,1351251,20.0,91.07,0.0544,418,269.35,45676.02,0.82,0.6959
6925,Mccarthy and Sons,False,BR,West Robert,Marketplaces,2015,https://mccarthyandsons.com,Military relate human everyone look authority investment.,21,mccarthy-and-sons,2023,USD,3344858,1210391,2134467,1407527,726940,13562,713378,33448,66897,646481,503350,2371394,949265,1422129,,3344858,20.0,39.71,0.0788,3695,75.42,146982.24,3.42,0.6381
6926,Long Inc,False,CA,New Jon,SaaS,2016,https://longinc.com,Boy government west level low position whole though.,24,long-inc,2023,USD,4736699,1675105,3061594,2685746,375848,17929,357919,47366,94733,263186,312179,2681528,1172579,1508949,394724.92,4736699,259.22,1396.68,0.0816,4705,83.88,197501.97,1.58,0.6464
6927,Cook-Lamb,False,US,Danielchester,Marketplaces,2019,https://cook-lamb.com,Pick ask character cold pull big machine course.,21,cook-lamb,2023,USD,1833546,369156,1464390,1583213,-118823,4673,-123496,18335,36670,-160166,167049,1156466,645529,510937,,1833546,20.0,108.99,0.0706,7639,20.0,164907.22,1.01,0.7987
6928,Lopez-Perez,False,AU,East Gregoryburgh,Energy,2020,https://lopez-perez.com,Him church budget name star a tend.,17,lopez-perez,2023,USD,474170,246119,228051,333762,-105711,0,-105711,4741,9483,-115194,22478,454043,22702,431341,,474170,20.0,68.53,0.0227,1975,20.0,52104.69,0.43,0.4809
6929,Humphrey Garcia and Simpson,False,ZA,South Andrewfort,IoT,2018,https://humphreygarciaandsimpson.com,He turn school director investment kitchen wonder car moment mother main.,22,humphrey-garcia-and-simpson,2023,USD,309525,151764,157761,193535,-35774,0,-35774,3095,6190,-41964,15116,209008,42161,166847,,309525,1232.65,6508.87,0.0284,338,76.26,1000.0,15.12,0.5097
6930,Munoz-Burch,False,BR,Harrisonton,Mobility,2009,https://munoz-burch.com,Into traditional focus do parent threat majority fund.,22,munoz-burch,2023,USD,6733605,2950920,3782685,2182871,1599814,0,1599814,67336,134672,1465142,166483,3722684,1115857,2606827,,6733605,20.0,146.63,0.0915,3148,178.2,201292.91,0.83,0.5618
6931,Cruz Ltd,False,US,Jamesburgh,Marketplaces,2011,https://cruzltd.com,Data end leader believe still table likely.,15,cruz-ltd,2023,USD,359825,71984,287841,287083,758,18682,-17924,3598,7196,-25120,11897,244918,56187,188731,,359825,325.64,1118.41,0.112,56,526.08,49177.81,0.24,0.7999
6932,Gilmore and Sons,False,GB,Johnhaven,AgriTech,2013,https://gilmoreandsons.com,Whole treatment financial win day international.,27,gilmore-and-sons,2023,USD,249241,67917,181324,154071,27253,0,27253,2492,4984,22269,12712,327451,126671,200780,,249241,93.51,120.69,0.0989,128,161.57,22097.33,0.58,0.7275
6933,Mcmillan Benton and Martin,False,AU,East Scottshire,Cybersecurity,2018,https://mcmillanbentonandmartin.com,Number budget federal serve large and.,24,mcmillan-benton-and-martin,2023,USD,591355,229574,361781,414154,-52373,58660,-111033,5913,11827,-122860,32353,353254,191583,161671,,591355,89.91,301.49,0.0519,2463,20.0,1000.0,32.35,0.6118
6934,Macdonald Fleming and Gonzalez,False,CA,South Jobury,AgriTech,2016,https://macdonaldflemingandgonzalez.com,Together management myself little again deal themselves behavior wide serve.,21,macdonald-fleming-and-gonzalez,2023,USD,322398,133456,188942,16119,172823,12168,160655,3223,6447,154208,75102,310600,114296,196304,,322398,20.0,37.3,0.0821,266,100.76,11379.5,6.6,0.5861
6935,Shaw PLC,False,GB,South Amberfort,AI/ML,2020,https://shawplc.com,Here because scientist by red tough you coach perhaps really only.,7,shaw-plc,2023,USD,626296,320406,305890,31314,274576,0,274576,6262,12525,262051,12808,470254,274348,195906,,626296,864.08,2433.34,0.0078,290,179.42,15603.07,0.82,0.4884
6936,Allen Group,False,EG,Lake Patriciafurt,IoT,2020,https://allengroup.com,Despite poor ready us.,19,allen-group,2023,USD,531729,156083,375646,109117,266529,14098,252431,5317,10634,241797,61459,463241,164643,298598,,531729,640.09,2790.6,0.0112,2215,20.0,17931.52,3.43,0.7065
6937,Martin Norton and Spencer,False,DE,New Anthonybury,HealthTech,2019,https://martinnortonandspencer.com,Another over no ahead prevent ball.,22,martin-norton-and-spencer,2023,EUR,1537220,750960,786260,1044150,-257890,17276,-275166,15372,30744,-305910,170525,1000550,570223,430327,128101.67,1537220,10.0,30.63,0.0181,3623,35.35,115217.51,1.48,0.5115
6938,Benitez-Patel,False,KE,Juliechester,AgriTech,2013,https://benitez-patel.com,Against because space even air image level ago effort.,15,benitez-patel,2023,USD,283867,39973,243894,198208,45686,0,45686,2838,5677,40009,22807,352447,56779,295668,,283867,332.88,1482.93,0.0755,221,106.66,4009.37,5.69,0.8592
6939,Moore-Wade,False,BR,Odonnellview,EdTech,2012,https://moore-wade.com,Despite section heart value people little game sing.,26,moore-wade,2023,USD,537726,185844,351882,153664,198218,0,198218,5377,10754,187464,234147,591883,66978,524905,44810.5,537726,87.28,105.87,0.0093,705,63.49,7627.98,30.7,0.6544
6940,Shannon-White,False,BR,Miamouth,AI/ML,2016,https://shannon-white.com,Yard hand voice fire about rule up animal plan civil.,17,shannon-white,2023,USD,594075,139348,454727,29703,425024,22642,402382,5940,11881,390501,5016,350539,146918,203621,,594075,20.0,28.17,0.1029,1772,27.93,33108.2,0.15,0.7654
6941,Miller-Hall,False,AU,Port Wesley,Energy,2015,https://miller-hall.com,Fund quite reason seat few.,27,miller-hall,2023,USD,756084,241922,514162,484868,29294,0,29294,7560,15121,14173,26753,495837,77407,418430,,756084,1046.82,3039.28,0.0986,3150,20.0,42348.48,0.63,0.68
6942,Williams Roberts and Garrett,False,DE,Reedfort,AI/ML,2011,https://williamsrobertsandgarrett.com,Order remember individual language threat.,11,williams-roberts-and-garrett,2023,EUR,408136,160082,248054,151267,96787,0,96787,4081,8162,88625,124386,527813,153121,374692,,408136,1232.03,3001.5,0.0433,276,122.98,1000.0,124.39,0.6078
6943,Zimmerman-Johnson,False,CA,New Courtney,Energy,2013,https://zimmerman-johnson.com,Training speech smile respond interview skin.,24,zimmerman-johnson,2023,USD,2545010,876401,1668609,1742767,-74158,5427,-79585,25450,50900,-130485,111156,1511787,770890,740897,,2545010,133.29,484.61,0.0058,1091,194.37,144284.95,0.77,0.6556
6944,Hunter-Mcguire,False,IN,Rileyport,Fintech,2018,https://hunter-mcguire.com,Official first gas expert mind lawyer partner charge form.,19,hunter-mcguire,2023,USD,293813,148962,144851,143859,992,40398,-39406,2938,5876,-45282,5733,329132,162244,166888,,293813,217.24,303.17,0.1506,1224,20.0,1000.0,5.73,0.493
6945,Collins Ltd,False,GB,East Latoyamouth,AI/ML,2018,https://collinsltd.com,Newspaper source office moment when catch data month best assume.,29,collins-ltd,2023,USD,302360,145075,157285,70344,86941,0,86941,3023,6047,80894,30546,221177,70615,150562,,302360,1961.81,10048.57,0.0999,152,165.22,16015.62,1.91,0.5202
6946,Davis Inc,False,ZA,Brianborough,Mobility,2013,https://davisinc.com,Sit allow measure news rock run just rest.,20,davis-inc,2023,USD,1743655,718194,1025461,87182,938279,7741,930538,17436,34873,895665,88207,1081613,361145,720468,,1743655,271.87,604.9,0.0618,4915,29.56,1000.0,88.21,0.5881
6947,Dixon-Oliver,False,CA,Lake Michael,Energy,2013,https://dixon-oliver.com,Teach again practice view who doctor page act.,21,dixon-oliver,2023,USD,782091,200097,581994,185466,396528,0,396528,7820,15641,380887,223495,728450,171072,557378,,782091,515.3,2132.75,0.1012,2527,25.79,1000.0,223.5,0.7442
6948,Butler Group,False,KE,South Amberbury,HealthTech,2020,https://butlergroup.com,Window sell pattern fill type idea region success present.,21,butler-group,2023,USD,174410,69136,105274,45110,60164,22391,37773,1744,3488,34285,4874,215737,20378,195359,14534.17,174410,10.0,63.85,0.0102,133,109.07,1000.0,4.87,0.6036
6949,Booker Robinson and Sullivan,False,KE,South Dominicbury,EdTech,2015,https://bookerrobinsonandsullivan.com,Need raise trouble position sing.,27,booker-robinson-and-sullivan,2023,USD,124872,36486,88386,53272,35114,7350,27764,1248,2497,25267,15302,83247,29005,54242,10406.0,124872,10.0,67.02,0.0603,104,99.8,1000.0,15.3,0.7078
6950,Sullivan Russo and Brown,False,CA,Michaelmouth,AI/ML,2019,https://sullivanrussoandbrown.com,Candidate indicate song partner everybody bad central.,20,sullivan-russo-and-brown,2023,USD,898293,395328,502965,329470,173495,9555,163940,8982,17965,145975,49788,631739,31586,600153,,898293,1046.51,523.26,0.0576,3742,20.0,34155.29,1.46,0.5599
6951,Gonzalez-Robertson,False,FR,West Mark,EdTech,2024,https://gonzalez-robertson.com,Machine tell relate choice enjoy rather.,15,gonzalez-robertson,2023,EUR,460669,96253,364416,172800,191616,22298,169318,4606,9213,160105,9817,429686,195884,233802,38389.08,460669,10.0,13.35,0.001,274,140.04,5636.84,1.74,0.7911
6952,Jennings and Sons,False,FR,Lyonsstad,AI/ML,2020,https://jenningsandsons.com,Value white out pull thus top our.,18,jennings-and-sons,2023,EUR,114078,37864,76214,50897,25317,0,25317,1140,2281,23036,6787,140508,30727,109781,,114078,1127.59,4224.99,0.0179,254,37.35,31999.11,0.21,0.6681
6953,Odonnell-Lowe,False,CA,Ryanville,E-commerce,2008,https://odonnell-lowe.com,Over hit civil source set nothing model.,22,odonnell-lowe,2023,USD,1465436,458319,1007117,859087,148030,0,148030,14654,29308,118722,141290,877353,550682,326671,,1465436,859.2,2221.43,0.061,6105,20.0,51873.08,2.72,0.6872
6954,Rios-Perez,False,BR,Port Kristinabury,Mobility,2024,https://rios-perez.com,Role memory improve four stuff computer.,20,rios-perez,2023,USD,727703,212625,515078,70845,444233,9977,434256,7277,14554,419702,26129,402875,138947,263928,,727703,2067.86,1033.93,0.001,395,153.31,22881.19,1.14,0.7078
6955,Stokes LLC,False,IN,Wilkinsonstad,Energy,2018,https://stokesllc.com,Degree produce notice can agree let front vote coach.,15,stokes-llc,2023,USD,1094309,368441,725868,610994,114874,18217,96657,10943,21886,74771,133552,816026,498099,317927,,1094309,936.89,468.44,0.0052,437,208.23,54744.07,2.44,0.6633
6956,Williams-Conley,False,US,Lake Kristin,IoT,2018,https://williams-conley.com,Activity upon crime never return plant look realize situation light.,18,williams-conley,2023,USD,3955432,197771,3757661,526760,3230901,0,3230901,39554,79108,3151793,171568,2263455,736856,1526599,,3955432,20.0,81.67,0.001,2773,118.84,53354.82,3.22,0.95
6957,Roman Inc,False,AU,Santiagofort,Mobility,2017,https://romaninc.com,Computer plant imagine authority about prepare understand order east arrive.,20,roman-inc,2023,USD,1088694,415333,673361,265842,407519,0,407519,10886,21773,385746,85266,667240,159590,507650,,1088694,20.0,10.0,0.0315,4536,20.0,5116.45,16.67,0.6185
6958,Rocha Mendez and Fuentes,False,IN,North Ruthview,EdTech,2008,https://rochamendezandfuentes.com,Through leg police might factor store special political management.,16,rocha-mendez-and-fuentes,2023,USD,536002,142577,393425,310351,83074,0,83074,5360,10720,72354,4318,374050,214390,159660,44666.83,536002,210.68,554.47,0.015,711,62.8,1000.0,4.32,0.734
6959,Fletcher Inc,False,DE,Josephborough,AgriTech,2011,https://fletcherinc.com,Line figure front plant voice suffer concern figure point whole.,15,fletcher-inc,2023,EUR,213376,100160,113216,108489,4727,11090,-6363,2133,4267,-10630,35303,341260,164118,177142,,213376,1066.3,5801.17,0.063,124,142.31,11922.65,2.96,0.5306
6960,Carpenter PLC,False,BR,East Amanda,AI/ML,2010,https://carpenterplc.com,Order position find general computer center loss or write above.,23,carpenter-plc,2023,USD,796396,331805,464591,574370,-109779,12056,-121835,7963,15927,-137762,7213,427466,123894,303572,,796396,20.0,68.38,0.0507,3318,20.0,72972.25,0.1,0.5834
6961,Martinez-Fisher,False,FR,Danielland,Mobility,2023,https://martinez-fisher.com,American air individual senior reason into garden against send.,26,martinez-fisher,2023,EUR,992628,402248,590380,427292,163088,40621,122467,9926,19852,102615,76994,724103,39054,685049,,992628,257.85,777.92,0.0545,1743,47.44,28442.78,2.71,0.5948
6962,Brown-Smith,False,GB,Simpsonburgh,SaaS,2014,https://brown-smith.com,Begin interview game model message quite.,18,brown-smith,2023,USD,1035160,586172,448988,383189,65799,12047,53752,10351,20703,33049,115863,696742,231226,465516,86263.33,1035160,261.3,1080.93,0.0303,1469,58.69,52307.41,2.22,0.4337
6963,Powell Calhoun and Weaver,False,NG,Christinafurt,Cybersecurity,2018,https://powellcalhounandweaver.com,Structure expect church again then rule his citizen.,14,powell-calhoun-and-weaver,2023,USD,1505591,670107,835484,1431324,-595840,0,-595840,15055,30111,-625951,34146,919705,380074,539631,,1505591,20.0,19.52,0.0365,317,395.55,125018.67,0.27,0.5549
6964,Owens-Hayes,False,KE,Annehaven,EdTech,2016,https://owens-hayes.com,Follow can floor mouth act inside speak.,23,owens-hayes,2023,USD,595389,207744,387645,192158,195487,0,195487,5953,11907,183580,14135,498489,189009,309480,49615.75,595389,176.14,922.46,0.0428,967,51.29,19013.12,0.74,0.6511
6965,Meyers-Zuniga,False,AU,Zacharyland,SaaS,2010,https://meyers-zuniga.com,Deal measure join note fight main space.,24,meyers-zuniga,2023,USD,2578409,1612072,966337,1436632,-470295,0,-470295,25784,51568,-521863,109216,1594558,772797,821761,214867.42,2578409,956.77,1839.15,0.001,3528,60.89,107955.21,1.01,0.3748
6966,Thomas Armstrong and Riley,False,CA,West Monica,EdTech,2020,https://thomasarmstrongandriley.com,Need total reach relationship vote less industry concern begin wish forget.,19,thomas-armstrong-and-riley,2023,USD,26052,12661,13391,2919,10472,0,10472,260,521,9951,4299,32113,9431,22682,2171.0,26052,766.58,3544.81,0.001,28,76.0,13838.57,0.31,0.514
6967,Good Jones and Simpson,False,IN,Lucasmouth,Fintech,2018,https://goodjonesandsimpson.com,Low exist successful good daughter six allow.,17,good-jones-and-simpson,2023,USD,1038994,174030,864964,271699,593265,20013,573252,10389,20779,552473,205115,759936,281252,478684,,1038994,20.0,47.39,0.0329,316,273.47,14793.39,13.87,0.8325
6968,Sweeney Inc,False,IN,North Thomasville,Mobility,2011,https://sweeneyinc.com,Despite whose authority culture worker sometimes leader worker artist.,15,sweeney-inc,2023,USD,568076,76693,491383,427669,63714,16746,46968,5680,11361,35607,16044,363761,159441,204320,,568076,775.12,387.56,0.0312,162,290.63,43247.74,0.37,0.865
6969,Mayer Walker and Guerrero,False,CA,West Edwinmouth,E-commerce,2014,https://mayerwalkerandguerrero.com,Discover history pretty heart.,21,mayer-walker-and-guerrero,2023,USD,1089155,488961,600194,512691,87503,0,87503,10891,21783,65720,45860,598095,38971,559124,,1089155,274.45,404.13,0.1124,252,358.86,41141.93,1.11,0.5511
6970,Hall Group,False,FR,Thomasstad,EdTech,2013,https://hallgroup.com,Hand check war official system four.,21,hall-group,2023,EUR,803392,317118,486274,507609,-21335,31934,-53269,8033,16067,-69336,15436,433715,168436,265279,66949.33,803392,215.96,975.08,0.089,2130,31.42,11287.03,1.37,0.6053
6971,Yoder-Trevino,False,CA,Thomaston,IoT,2014,https://yoder-trevino.com,President goal security blood nice increase rather tend movement.,19,yoder-trevino,2023,USD,250958,55849,195109,185835,9274,11963,-2689,2509,5019,-7708,12970,296349,64983,231366,,250958,20.0,71.49,0.001,122,171.01,31072.11,0.42,0.7775
6972,Watson Fleming and Brown,False,TN,Benjaminberg,Mobility,2024,https://watsonflemingandbrown.com,Mean rather want money since training almost would character Republican why.,25,watson-fleming-and-brown,2023,USD,1018584,120013,898571,532372,366199,14316,351883,10185,20371,331512,14484,695060,426273,268787,,1018584,20.0,82.96,0.001,4244,20.0,78651.09,0.18,0.8822
6973,Obrien-Baker,False,FR,Port Joseph,EdTech,2021,https://obrien-baker.com,Fine foreign lead nothing former you head such present.,26,obrien-baker,2023,EUR,1196122,390952,805170,764782,40388,12215,28173,11961,23922,4251,61263,677114,265168,411946,99676.83,1196122,10.0,39.93,0.0761,1704,58.49,58772.56,1.04,0.6732
6974,Jordan-Hunt,False,EG,Tracytown,E-commerce,2009,https://jordan-hunt.com,Power body understand decade day true her need present.,22,jordan-hunt,2023,USD,1916700,708040,1208660,1694866,-486206,26195,-512401,19167,38334,-550735,93861,1125678,594062,531616,,1916700,20.0,67.76,0.001,853,187.18,153712.52,0.61,0.6306
6975,Jones-Matthews,False,US,Timothyside,IoT,2016,https://jones-matthews.com,Thought Congress tree yard might forward several.,21,jones-matthews,2023,USD,557531,130480,427051,346321,80730,0,80730,5575,11150,69580,28687,401562,202123,199439,,557531,923.47,5130.87,0.0529,2323,20.0,18369.07,1.56,0.766
6976,Smith Inc,False,GB,South Jaime,Cybersecurity,2011,https://smithinc.com,Today staff then full others happen go baby all.,25,smith-inc,2023,USD,3872577,1735383,2137194,953208,1183986,18268,1165718,38725,77451,1088267,192734,2316879,1284875,1032004,,3872577,20.0,10.0,0.077,2158,149.53,44361.56,4.34,0.5519
6977,Miller Ltd,False,IN,Chelseaborough,Fintech,2009,https://millerltd.com,Company citizen never what behind parent school great lot machine.,14,miller-ltd,2023,USD,882262,347670,534592,817874,-283282,1788,-285070,8822,17645,-302715,35447,630488,51761,578727,,882262,576.36,949.93,0.0863,340,216.02,53846.42,0.66,0.6059
6978,Turner Gonzales and Jones,False,AU,Roseside,E-commerce,2013,https://turnergonzalesandjones.com,Begin official report activity professor.,17,turner-gonzales-and-jones,2023,USD,950865,319730,631135,716366,-85231,27903,-113134,9508,19017,-132151,99546,717058,158290,558768,,950865,1169.38,3201.63,0.001,492,160.84,81339.25,1.22,0.6637
6979,Wright Inc,False,EG,Hardinmouth,Energy,2024,https://wrightinc.com,Knowledge never community best explain loss suggest down relate hour.,27,wright-inc,2023,USD,765880,513501,252379,332876,-80497,36310,-116807,7658,15317,-132124,51554,451191,148362,302829,,765880,496.43,1980.46,0.0564,3191,20.0,1000.0,51.55,0.3295
6980,Miller-Gregory,False,FR,Wilsonmouth,Cybersecurity,2024,https://miller-gregory.com,Heavy ready with would social blood south million build.,21,miller-gregory,2023,EUR,642741,168565,474176,262376,211800,239,211561,6427,12854,198707,3125,394862,194809,200053,,642741,1541.4,6971.68,0.001,212,251.5,1000.0,3.12,0.7377
6981,Williams Group,False,EG,South Matthew,AI/ML,2009,https://williamsgroup.com,Force fire yard be put answer collection us early.,16,williams-group,2023,USD,339077,155262,183815,96305,87510,0,87510,3390,6781,80729,11417,241625,143205,98420,,339077,20.0,97.98,0.1726,225,125.39,9942.79,1.15,0.5421
6982,Coleman Horne and Turner,False,KE,Dannyhaven,Cybersecurity,2012,https://colemanhorneandturner.com,Because way develop three claim degree peace your.,21,coleman-horne-and-turner,2023,USD,1024377,419837,604540,499615,104925,0,104925,10243,20487,84438,40154,688806,283551,405255,,1024377,830.27,1729.35,0.0703,340,250.56,35755.67,1.12,0.5902
6983,Beasley Inc,False,AU,Mendozaborough,Mobility,2008,https://beasleyinc.com,Wonder get instead herself decade either relationship number.,18,beasley-inc,2023,USD,975029,547412,427617,339005,88612,26217,62395,9750,19500,42895,60911,730180,420010,310170,,975029,993.18,4536.11,0.0765,2022,40.17,19483.16,3.13,0.4386
6984,Wright-Park,False,IN,East Robert,E-commerce,2012,https://wright-park.com,American his record voice material attention them focus country.,17,wright-park,2023,USD,2144997,446197,1698800,1555528,143272,5905,137367,21449,42899,94468,66880,1235552,455016,780536,,2144997,20.0,117.72,0.001,885,201.85,145095.16,0.46,0.792
6985,Miller Inc,False,DE,Haynesshire,AI/ML,2024,https://millerinc.com,A us economic professor west threat note nature draw.,25,miller-inc,2023,EUR,3100609,1401280,1699329,2220963,-521634,0,-521634,31006,62012,-583646,325810,2015227,100761,1914466,,3100609,657.21,2816.94,0.001,12919,20.0,163527.01,1.99,0.5481
6986,Morales Inc,False,NG,New Brandonchester,E-commerce,2020,https://moralesinc.com,Choice through public see be oil.,21,morales-inc,2023,USD,403196,197434,205762,76771,128991,15297,113694,4031,8063,105631,24799,281326,130626,150700,,403196,20.0,57.22,0.001,1679,20.0,1000.0,24.8,0.5103
6987,Warner Lawrence and Yang,False,GB,Danielchester,HealthTech,2018,https://warnerlawrenceandyang.com,Serve identify maintain feel player book even parent garden.,23,warner-lawrence-and-yang,2023,USD,3376867,1252324,2124543,1965018,159525,0,159525,33768,67537,91988,167386,2024415,149541,1874874,281405.58,3376867,750.56,5164.42,0.001,8432,33.37,181728.57,0.92,0.6291
6988,Nichols Taylor and Mcbride,False,NG,East Jared,Energy,2021,https://nicholstaylorandmcbride.com,Inside record staff thing read Mr send commercial represent.,25,nichols-taylor-and-mcbride,2023,USD,871519,168748,702771,352107,350664,0,350664,8715,17430,333234,24319,552293,107145,445148,,871519,20.0,17.23,0.0502,1081,67.13,67509.88,0.36,0.8064
6989,Leach Campbell and Wilson,False,US,North Paulmouth,E-commerce,2024,https://leachcampbellandwilson.com,Positive relate though glass.,30,leach-campbell-and-wilson,2023,USD,229391,114360,115031,93435,21596,19629,1967,2293,4587,-2620,9774,168742,75217,93525,,229391,20.0,19.25,0.047,839,22.78,19684.06,0.5,0.5015
6990,Jackson-Sanders,False,TN,Murrayfort,Mobility,2022,https://jackson-sanders.com,Former fly measure size only include able.,14,jackson-sanders,2023,USD,4587680,2066850,2520830,2425752,95078,14843,80235,45876,91753,-11518,62460,2373929,1143019,1230910,,4587680,2523.03,1261.52,0.0224,19115,20.0,191953.49,0.33,0.5495
6991,Delgado Reed and Harris,False,IN,Andreamouth,AgriTech,2013,https://delgadoreedandharris.com,Room cold cover option paper us behavior style hard thousand write.,18,delgado-reed-and-harris,2023,USD,226002,55316,170686,11300,159386,28592,130794,2260,4520,126274,6748,239621,11981,227640,,226002,20.0,35.53,0.0319,116,162.06,31288.32,0.22,0.7552
6992,Vasquez-Miller,False,GB,Hernandezchester,Mobility,2018,https://vasquez-miller.com,Window best tell sport Congress third artist pick.,21,vasquez-miller,2023,USD,1920633,1120936,799697,1155475,-355778,0,-355778,19206,38412,-394190,77077,1235771,650086,585685,,1920633,20.0,68.15,0.0256,949,168.6,119857.71,0.64,0.4164
6993,Gomez PLC,False,NG,Lake Lorifort,E-commerce,2016,https://gomezplc.com,Simply under school arm discussion price debate voice.,22,gomez-plc,2023,USD,154050,65902,88148,99149,-11001,0,-11001,1540,3081,-14082,23773,250576,81406,169170,,154050,290.14,1457.48,0.001,351,36.51,28336.07,0.84,0.5722
6994,Davis and Sons,False,NG,Mortonview,Marketplaces,2018,https://davisandsons.com,Western body own happy rather skill.,20,davis-and-sons,2023,USD,380949,46708,334241,347285,-13044,2460,-15504,3809,7618,-23122,7859,311009,169947,141062,,380949,374.32,668.42,0.0841,824,38.52,26512.42,0.3,0.8774
6995,Juarez Hurst and Villarreal,False,ZA,East Kayla,IoT,2021,https://juarezhurstandvillarreal.com,At scene box tax simply rate some TV southern staff.,17,juarez-hurst-and-villarreal,2023,USD,158661,71644,87017,38390,48627,0,48627,1586,3173,45454,4194,215053,83879,131174,,158661,240.46,884.0,0.0296,179,73.74,1000.0,4.19,0.5484
6996,Johnson LLC,False,CA,Lake Justin,E-commerce,2017,https://johnsonllc.com,Yourself movie by image month either suffer.,14,johnson-llc,2023,USD,477569,207228,270341,258660,11681,0,11681,4775,9551,2130,82405,402040,20102,381938,,477569,398.42,693.43,0.0588,247,161.02,57878.1,1.42,0.5661
6997,Sanders-Lewis,False,GB,Christensenbury,AI/ML,2012,https://sanders-lewis.com,Need support great necessary garden accept rich truth girl much.,21,sanders-lewis,2023,USD,2007380,1148067,859313,462045,397268,46088,351180,20073,40147,311033,273667,1395787,837993,557794,,2007380,1730.13,5177.72,0.0916,3394,49.28,50244.69,5.45,0.4281
6998,Wilson-Hanson,False,IN,Port Emily,IoT,2011,https://wilson-hanson.com,Kid college despite close despite mother last.,23,wilson-hanson,2023,USD,3145021,1216720,1928301,157251,1771050,0,1771050,31450,62900,1708150,105702,1686393,207525,1478868,,3145021,20.0,122.53,0.0398,13104,20.0,38546.83,2.74,0.6131
6999,Henderson-Andrews,False,FR,New Natalie,Cybersecurity,2021,https://henderson-andrews.com,Arm million at challenge hair forget term lawyer now wear.,18,henderson-andrews,2023,EUR,1163087,514931,648156,210750,437406,0,437406,11630,23261,414145,96197,801100,88759,712341,,1163087,1499.13,2013.33,0.001,796,121.65,15997.67,6.01,0.5573
7000,Ray-Robinson,False,CA,Onealborough,SaaS,2012,https://ray-robinson.com,Music most agency over appear soldier air plan remain.,16,ray-robinson,2023,USD,1217658,207834,1009824,790534,219290,15509,203781,12176,24353,179428,237664,992672,204790,787882,101471.5,1217658,770.61,4844.24,0.0961,1141,88.86,76691.8,3.1,0.8293
7001,Jones Snyder and Howe,False,US,New Robertborough,SaaS,2009,https://jonessnyderandhowe.com,Truth public whole building clear because five claim think to.,21,jones-snyder-and-howe,2023,USD,286193,141502,144691,77611,67080,0,67080,2861,5723,61357,10286,162268,70438,91830,23849.42,286193,356.93,1359.45,0.0461,814,29.29,7361.57,1.4,0.5056
7002,Morrison-Tran,False,GB,Annchester,AgriTech,2019,https://morrison-tran.com,Military conference under very ball last owner medical choose.,11,morrison-tran,2023,USD,95496,30129,65367,53627,11740,3341,8399,954,1909,6490,3972,165425,86803,78622,,95496,670.28,3933.61,0.0063,64,123.14,1000.0,3.97,0.6845
7003,Christian-Dorsey,False,BR,Sarahburgh,EdTech,2015,https://christian-dorsey.com,Project shoulder win mouth.,25,christian-dorsey,2023,USD,895794,341986,553808,723185,-169377,0,-169377,8957,17915,-187292,29353,538216,227483,310733,74649.5,895794,10.0,18.97,0.016,1387,53.81,48792.92,0.6,0.6182
7004,Roth-Guzman,False,FR,Clarkton,EdTech,2012,https://roth-guzman.com,Price culture do group executive include.,17,roth-guzman,2023,EUR,419182,147427,271755,229687,42068,15348,26720,4191,8383,18337,3242,359441,32918,326523,34931.83,419182,112.59,126.17,0.001,562,62.11,1000.0,3.24,0.6483
7005,Ballard Group,False,BR,Erikton,Fintech,2018,https://ballardgroup.com,Three early also animal professional media executive agreement.,29,ballard-group,2023,USD,663645,147738,515907,445691,70216,0,70216,6636,13272,56944,17911,514792,369895,144897,,663645,592.91,413.91,0.0937,2765,20.0,40540.66,0.44,0.7774
7006,Salas PLC,False,CA,North Lonnie,Fintech,2014,https://salasplc.com,Kind firm ground physical capital similar this husband protect national child.,24,salas-plc,2023,USD,7165954,2246903,4919051,4761846,157205,0,157205,71659,143319,13886,174382,3831135,1041786,2789349,,7165954,20.0,54.65,0.1623,6397,93.34,412284.18,0.42,0.6864
7007,Williams Jackson and Carter,False,US,North Jeffreymouth,E-commerce,2018,https://williamsjacksonandcarter.com,Many wall beautiful garden.,20,williams-jackson-and-carter,2023,USD,1213928,258998,954930,939363,15567,0,15567,12139,24278,-8711,20236,725993,228373,497620,,1213928,771.98,1249.71,0.0601,378,267.19,94686.14,0.21,0.7866
7008,Powell LLC,False,EG,East Christianside,SaaS,2024,https://powellllc.com,Me west customer medical buy same with.,20,powell-llc,2023,USD,1496684,74834,1421850,1145854,275996,15911,260085,14966,29933,230152,272735,1076403,534699,541704,124723.67,1496684,10.0,55.9,0.0476,2180,57.21,80245.75,3.4,0.95
7009,Tucker PLC,False,DE,North Vincentchester,Marketplaces,2021,https://tuckerplc.com,Thus professor free treatment my thus big technology father however.,20,tucker-plc,2023,EUR,799842,350066,449776,234871,214905,12705,202200,7998,15996,186204,106641,507328,25366,481962,,799842,204.46,975.5,0.1327,3332,20.0,34325.33,3.11,0.5623
7010,Shelton-Fuller,False,NG,East Gregory,Cybersecurity,2013,https://shelton-fuller.com,Total TV take beat southern parent debate full.,24,shelton-fuller,2023,USD,972095,200561,771534,48604,722930,40250,682680,9720,19441,663239,126872,752580,138799,613781,,972095,20.0,36.28,0.0066,2487,32.57,1000.0,126.87,0.7937
7011,Wood-Torres,False,BR,South Donald,Fintech,2017,https://wood-torres.com,Nature during moment rise not.,22,wood-torres,2023,USD,2560928,763371,1797557,467191,1330366,9050,1321316,25609,51218,1270098,167819,1453306,302403,1150903,,2560928,896.52,1557.2,0.0336,1434,148.8,77115.19,2.18,0.7019
7012,Hardin LLC,False,IN,Danielland,AgriTech,2024,https://hardinllc.com,Light but item center how fire rock page matter.,22,hardin-llc,2023,USD,99325,28156,71169,12032,59137,18724,40413,993,1986,38427,5830,82895,14509,68386,,99325,20.0,73.6,0.001,104,79.35,12003.44,0.49,0.7165
7013,Navarro Spencer and Woods,False,NG,Pearsonstad,IoT,2020,https://navarrospencerandwoods.com,Growth across everybody through others thank here it particularly although window.,28,navarro-spencer-and-woods,2023,USD,432686,150170,282516,240326,42190,27322,14868,4326,8653,6215,14526,294694,147870,146824,,432686,594.76,297.38,0.0258,293,122.8,16825.41,0.86,0.6529
7014,Zavala-Knight,False,TN,Hendersonberg,IoT,2023,https://zavala-knight.com,Especially indeed off rate other former report.,16,zavala-knight,2023,USD,972750,230978,741772,1017316,-275544,0,-275544,9727,19455,-294999,11439,576778,47566,529212,,972750,1449.65,724.82,0.0524,1027,78.86,71544.09,0.16,0.7626
7015,Lee-Morrison,False,GB,South Kaitlynmouth,Mobility,2015,https://lee-morrison.com,Near nearly successful to tough indeed relationship according decade ball interview.,14,lee-morrison,2023,USD,618083,289507,328576,197531,131045,6055,124990,6180,12361,112629,36635,475798,100764,375034,,618083,20.0,77.27,0.001,358,143.54,1000.0,36.64,0.5316
7016,Weaver-Gilmore,False,TN,Garciachester,Mobility,2022,https://weaver-gilmore.com,Order fight bar not speech cut model.,19,weaver-gilmore,2023,USD,3339898,1344882,1995016,1001792,993224,0,993224,33398,66797,926427,738140,2516338,1898970,617368,,3339898,511.27,2691.07,0.0845,5110,54.46,92650.51,7.97,0.5973
7017,Larson Ltd,False,ZA,West Donaldville,AgriTech,2021,https://larsonltd.com,Research visit again least tough station moment.,19,larson-ltd,2023,USD,254688,140048,114640,68650,45990,1753,44237,2546,5093,39144,5950,312140,110394,201746,,254688,2327.16,6823.07,0.0316,78,270.94,4176.31,1.42,0.4501
7018,Simmons and Sons,False,GB,East Donaldport,Cybersecurity,2008,https://simmonsandsons.com,Pull writer manager sea able tell remember well look learn crime.,22,simmons-and-sons,2023,USD,1946591,685267,1261324,1229436,31888,0,31888,19465,38931,-7043,38976,1150040,623291,526749,,1946591,1605.4,4839.94,0.001,1580,102.62,110905.39,0.35,0.648
7019,Harris Jimenez and Fitzpatrick,False,GB,West Joseland,E-commerce,2024,https://harrisjimenezandfitzpatrick.com,Again half wind others tax second upon simple.,19,harris-jimenez-and-fitzpatrick,2023,USD,916796,343185,573611,443211,130400,0,130400,9167,18335,112065,20723,532289,473457,58832,,916796,20.0,10.0,0.001,1123,67.99,51505.33,0.4,0.6257
7020,Mack Lambert and Ramirez,False,ZA,Bonniemouth,Cybersecurity,2013,https://macklambertandramirez.com,Democrat majority nature learn source attack place per.,19,mack-lambert-and-ramirez,2023,USD,1078157,53907,1024250,224981,799269,2342,796927,10781,21563,775364,72286,685345,326460,358885,,1078157,20.0,34.38,0.001,403,222.72,1000.0,72.29,0.95
7021,Beck-Ingram,False,CA,Hallland,AgriTech,2014,https://beck-ingram.com,Size nor run guy beyond just chair color newspaper.,17,beck-ingram,2023,USD,666243,236853,429390,252258,177132,2434,174698,6662,13324,161374,103352,593919,91681,502238,,666243,20.0,54.2,0.001,240,230.87,22834.37,4.53,0.6445
7022,Sullivan-Barajas,False,FR,South Codychester,AI/ML,2014,https://sullivan-barajas.com,Because political recently art hold.,23,sullivan-barajas,2023,EUR,970794,575097,395697,325092,70605,0,70605,9707,19415,51190,96652,731097,253188,477909,,970794,20.0,104.36,0.001,4044,20.0,40854.64,2.37,0.4076
7023,Smith-Williams,False,AU,North Kristine,HealthTech,2011,https://smith-williams.com,Despite standard most west out begin.,19,smith-williams,2023,USD,1269467,671809,597658,877129,-279471,0,-279471,12694,25389,-304860,29936,717416,312192,405224,105788.92,1269467,708.07,2333.49,0.037,1529,69.16,60987.99,0.49,0.4708
7024,Jackson Harrison and Vega,False,ZA,Gomezmouth,HealthTech,2014,https://jacksonharrisonandvega.com,Add sport him site right adult paper young speak bag.,19,jackson-harrison-and-vega,2023,USD,1625535,920057,705478,1551180,-845702,21598,-867300,16255,32510,-899810,131518,962656,127701,834955,135461.25,1625535,399.44,1347.44,0.0614,7576,17.88,154296.53,0.85,0.434
7025,Rubio Bennett and James,False,FR,Port Gabrielleberg,HealthTech,2014,https://rubiobennettandjames.com,More good court must start clearly me.,12,rubio-bennett-and-james,2023,EUR,609587,239114,370473,548361,-177888,12893,-190781,6095,12191,-202972,8831,482207,84483,397724,50798.92,609587,10.0,23.0,0.0161,698,72.77,1000.0,8.83,0.6077
7026,Baker-Douglas,False,KE,West Robinside,HealthTech,2008,https://baker-douglas.com,Nothing school enough I off smile.,15,baker-douglas,2023,USD,598443,195850,402593,380623,21970,20159,1811,5984,11968,-10157,11386,410211,88824,321387,49870.25,598443,474.14,1058.47,0.001,763,65.3,6895.08,1.65,0.6727
7027,Hunter Inc,False,BR,Debbiebury,AgriTech,2010,https://hunterinc.com,Relate here few near others spend just fine.,22,hunter-inc,2023,USD,54776,22546,32230,17836,14394,0,14394,547,1095,13299,7674,182850,76404,106446,,54776,842.17,2367.07,0.1302,102,44.53,20526.16,0.37,0.5884
7028,Johnson-Harris,False,US,North Monicabury,Energy,2008,https://johnson-harris.com,Myself act article fact anyone.,20,johnson-harris,2023,USD,808369,378537,429832,395902,33930,0,33930,8083,16167,17763,17319,542980,174110,368870,,808369,1526.53,4401.91,0.0147,3368,20.0,12206.86,1.42,0.5317
7029,Morton Goodman and Fuentes,False,FR,West Maria,AI/ML,2015,https://mortongoodmanandfuentes.com,Think enter feel front work dark per hard party summer movie.,20,morton-goodman-and-fuentes,2023,EUR,1820125,491356,1328769,1865556,-536787,18246,-555033,18201,36402,-591435,252318,1192322,59616,1132706,,1820125,20.0,87.62,0.001,510,297.3,171330.79,1.47,0.73
7030,Odom Kelly and Christian,False,TN,Jonathanport,AgriTech,2023,https://odomkellyandchristian.com,Sense simply painting stay let live player treatment go nothing.,17,odom-kelly-and-christian,2023,USD,182298,75270,107028,9114,97914,2792,95122,1822,3645,91477,10827,168471,19980,148491,,182298,382.98,1249.11,0.1426,759,20.0,13747.37,0.79,0.5871
7031,Riley-Smith,False,GB,Craigville,EdTech,2022,https://riley-smith.com,Everyone security rate financial forward then group.,25,riley-smith,2023,USD,259738,81267,178471,108659,69812,6682,63130,2597,5194,57936,7519,225949,53010,172939,21644.83,259738,314.37,1800.83,0.0093,340,63.55,1000.0,7.52,0.6871
7032,Howard Inc,False,CA,Port Andrew,SaaS,2013,https://howardinc.com,Administration story decision respond.,20,howard-inc,2023,USD,821489,262500,558989,288767,270222,13238,256984,8214,16429,240555,7841,508183,25409,482774,68457.42,821489,248.39,769.89,0.001,1878,36.44,47391.99,0.17,0.6805
7033,Thompson-Graves,False,AU,Katrinamouth,Mobility,2020,https://thompson-graves.com,Model late discover show sign difference PM response.,22,thompson-graves,2023,USD,3224378,779742,2444636,1280945,1163691,28405,1135286,32243,64487,1070799,189455,1836341,1267592,568749,,3224378,1098.17,2627.28,0.0437,4952,54.25,64919.59,2.92,0.7582
7034,White Ltd,False,NG,Davidshire,Cybersecurity,2010,https://whiteltd.com,Quite down partner measure expert between sit first include stop health.,19,white-ltd,2023,USD,2551585,1041935,1509650,559125,950525,0,950525,25515,51031,899494,109711,1510755,712307,798448,,2551585,20.0,48.21,0.1072,10631,20.0,37791.76,2.9,0.5917
7035,Jones-Miller,False,BR,North Benjaminberg,Mobility,2013,https://jones-miller.com,Either team key western drive turn everybody movement local single.,26,jones-miller,2023,USD,2523968,989755,1534213,734519,799694,26678,773016,25239,50479,722537,175732,1517774,231739,1286035,,2523968,999.1,4269.43,0.1008,10516,20.0,50578.43,3.47,0.6079
7036,Kelley-Wilson,False,AU,East Michelle,HealthTech,2019,https://kelley-wilson.com,Local will later throughout husband movement story.,18,kelley-wilson,2023,USD,1202824,568956,633868,894465,-260597,7469,-268066,12028,24056,-292122,118535,722461,279318,443143,100235.33,1202824,10.0,21.48,0.0278,1322,75.78,105648.62,1.12,0.527
7037,Levine Ltd,False,EG,East Jason,Mobility,2018,https://levineltd.com,Image young operation class position.,17,levine-ltd,2023,USD,2039837,696886,1342951,523209,819742,6030,813712,20398,40796,772916,246952,1306328,700758,605570,,2039837,1867.66,6519.82,0.0301,2070,82.1,35742.86,6.91,0.6584
7038,Wallace-Richmond,False,IN,Vernonhaven,Cybersecurity,2019,https://wallace-richmond.com,Value bed by whose manage culture politics thousand meet smile.,20,wallace-richmond,2023,USD,391169,169784,221385,244186,-22801,0,-22801,3911,7823,-30624,29357,401056,140258,260798,,391169,609.13,2541.9,0.0539,1629,20.0,1000.0,29.36,0.566
7039,Lopez-Smith,False,NG,Perryville,Marketplaces,2016,https://lopez-smith.com,End large top thousand history compare their they key.,17,lopez-smith,2023,USD,341835,70736,271099,253677,17422,19545,-2123,3418,6836,-8959,172701,439034,238565,200469,,341835,20.0,34.4,0.001,157,180.9,7470.55,23.12,0.7931
7040,Garcia-King,False,EG,East Jennifer,HealthTech,2020,https://garcia-king.com,Republican voice under argue prove beautiful.,19,garcia-king,2023,USD,179694,73607,106087,42693,63394,15401,47993,1796,3593,44400,16203,161745,84483,77262,14974.5,179694,10.0,75.39,0.0356,187,79.8,1000.0,16.2,0.5904
7041,Hatfield Lozano and Key,False,GB,South Reginaldshire,IoT,2009,https://hatfieldlozanoandkey.com,Wall program manager production add without he.,21,hatfield-lozano-and-key,2023,USD,544356,240047,304309,168899,135410,0,135410,5443,10887,124523,25442,384996,73519,311477,,544356,210.85,105.42,0.0028,211,214.11,2801.51,9.08,0.559
7042,Middleton Inc,False,CA,North Ryanstad,HealthTech,2010,https://middletoninc.com,We son piece people step mind can onto report every.,17,middleton-inc,2023,USD,4752537,1216933,3535604,3495640,39964,0,39964,47525,95050,-55086,113300,2507820,272694,2235126,396044.75,4752537,10.0,27.61,0.0764,7057,56.12,306780.27,0.37,0.7439
7043,Miller-Hernandez,False,NG,Lake Christopher,Marketplaces,2022,https://miller-hernandez.com,Election become report treat against draw.,17,miller-hernandez,2023,USD,725605,331662,393943,368451,25492,19990,5502,7256,14512,-9010,19453,463988,89969,374019,,725605,920.86,4044.05,0.0918,442,136.68,38949.7,0.5,0.5429
7044,Woods Perez and Rodriguez,False,TN,Baileyton,Marketplaces,2015,https://woodsperezandrodriguez.com,War forget among return board soldier force physical western.,22,woods-perez-and-rodriguez,2023,USD,1716679,211889,1504790,1141092,363698,0,363698,17166,34333,329365,298508,1347425,237724,1109701,,1716679,967.73,3306.39,0.0184,7152,20.0,60746.26,4.91,0.8766
7045,Martinez PLC,False,ZA,Jacksonborough,Fintech,2020,https://martinezplc.com,Key common kind catch hold.,18,martinez-plc,2023,USD,6084946,2709665,3375281,4645860,-1270579,0,-1270579,60849,121698,-1392277,62803,3120656,1471818,1648838,,6084946,1491.89,1740.22,0.0153,2317,218.85,371138.8,0.17,0.5547
7046,Davidson-Bell,False,US,Lake Claireport,AI/ML,2013,https://davidson-bell.com,Start decide important interesting relationship city behind stand term live.,17,davidson-bell,2023,USD,1132698,289738,842960,227644,615316,0,615316,11326,22653,592663,10072,742063,368586,373477,,1132698,987.66,4971.56,0.0303,4719,20.0,44134.75,0.23,0.7442
7047,Crane Thomas and Sellers,False,ZA,Lake Amy,Mobility,2011,https://cranethomasandsellers.com,Born network strong seven all research.,17,crane-thomas-and-sellers,2023,USD,1431434,559772,871662,450990,420672,0,420672,14314,28628,392044,232097,1136169,56808,1079361,,1431434,1216.0,4322.56,0.1004,5964,20.0,35539.92,6.53,0.6089
7048,Brown-Gonzalez,False,BR,Warnerport,Mobility,2013,https://brown-gonzalez.com,Direction effect her create feeling.,19,brown-gonzalez,2023,USD,1022888,236364,786524,149562,636962,0,636962,10228,20457,616505,48931,642268,208377,433891,,1022888,405.67,1616.9,0.0861,4262,20.0,1000.0,48.93,0.7689
7049,Padilla-Ashley,False,FR,Stephanieborough,Mobility,2014,https://padilla-ashley.com,Develop these owner hand sister next.,25,padilla-ashley,2023,EUR,369882,52728,317154,85497,231657,14406,217251,3698,7397,209854,13719,233360,57827,175533,,369882,830.94,2579.37,0.0765,1541,20.0,1274.17,10.77,0.8574
7050,Guerrero LLC,False,DE,South Patricia,Mobility,2014,https://guerrerollc.com,Across property my less receive.,21,guerrero-llc,2023,EUR,926253,367244,559009,446314,112695,23324,89371,9262,18525,70846,253903,773565,130096,643469,,926253,705.97,3934.62,0.0279,1214,63.58,20071.27,12.65,0.6035
7051,English PLC,False,KE,Jessicahaven,Marketplaces,2013,https://englishplc.com,Control nothing there build now rate address movie prevent result.,26,english-plc,2023,USD,1032262,320545,711717,734341,-22624,8726,-31350,10322,20645,-51995,85842,716679,430520,286159,,1032262,591.46,3150.87,0.1093,4301,20.0,62765.81,1.37,0.6895
7052,Williams LLC,False,US,North Madison,E-commerce,2013,https://williamsllc.com,Meeting discuss agree image organization million sea lose field.,25,williams-llc,2023,USD,1209967,239334,970633,654454,316179,0,316179,12099,24199,291980,224376,872000,322354,549646,,1209967,131.95,665.96,0.0348,5041,20.0,70569.13,3.18,0.8022
7053,Lewis Anthony and Ford,False,GB,Amandaport,HealthTech,2014,https://lewisanthonyandford.com,Single none cost design dream letter else player consider.,19,lewis-anthony-and-ford,2023,USD,187296,14366,172930,9364,163566,1710,161856,1872,3745,158111,42789,157922,7896,150026,15608.0,187296,508.1,934.97,0.0656,3121,5.0,1000.0,42.79,0.9233
7054,Goodman LLC,False,ZA,Johnsonmouth,Energy,2013,https://goodmanllc.com,Kid question worker for note eye animal class pick table.,18,goodman-llc,2023,USD,5759119,3746431,2012688,1998997,13691,7020,6671,57591,115182,-108511,376857,3415173,391392,3023781,,5759119,706.11,6073.42,0.001,4960,96.75,209171.72,1.8,0.3495
7055,Miller-Thornton,False,FR,Port Angel,Cybersecurity,2021,https://miller-thornton.com,Describe begin respond war political seven couple she.,12,miller-thornton,2023,EUR,396871,95675,301196,303128,-1932,28930,-30862,3968,7937,-38799,21232,357487,142131,215356,,396871,840.58,5495.2,0.001,90,363.57,34533.74,0.61,0.7589
7056,Benson Brown and Morales,False,AU,Matthewfort,E-commerce,2010,https://bensonbrownandmorales.com,Than shoulder government how activity various age each leg strategy.,15,benson-brown-and-morales,2023,USD,2487259,839194,1648065,1338165,309900,457,309443,24872,49745,259698,153188,1596632,634211,962421,,2487259,20.0,52.76,0.0477,5928,34.96,139978.65,1.09,0.6626
7057,Kim Group,False,BR,New Shannon,AgriTech,2015,https://kimgroup.com,Wonder old fill conference poor indeed network explain.,16,kim-group,2023,USD,423827,91005,332822,41686,291136,23531,267605,4238,8476,259129,11931,244860,69621,175239,,423827,20.0,79.2,0.041,1765,20.0,1000.0,11.93,0.7853
7058,Williams Sutton and Castaneda,False,NG,Amandafort,AI/ML,2012,https://williamssuttonandcastaneda.com,Debate financial plan site break allow technology chair about.,19,williams-sutton-and-castaneda,2023,USD,760907,229429,531478,38045,493433,13389,480044,7609,15218,464826,56449,618878,177453,441425,,760907,20.0,40.14,0.0561,458,138.4,9002.23,6.27,0.6985
7059,Ramirez Inc,False,DE,Kleinside,HealthTech,2018,https://ramirezinc.com,Focus second enough responsibility coach capital account political enjoy.,24,ramirez-inc,2023,EUR,762466,365700,396766,186275,210491,19127,191364,7624,15249,176115,18277,564503,118495,446008,63538.83,762466,10.0,37.69,0.0158,12707,5.0,28867.84,0.63,0.5204
7060,Reyes Ltd,False,BR,Nelsonmouth,E-commerce,2015,https://reyesltd.com,Without herself instead claim notice seem gun.,19,reyes-ltd,2023,USD,212753,42112,170641,97768,72873,0,72873,2127,4255,68618,3708,273523,77217,196306,,212753,669.96,3451.68,0.0544,127,139.18,7116.46,0.52,0.8021
7061,Woods Cummings and Franklin,False,AU,Port Kelly,IoT,2014,https://woodscummingsandfranklin.com,Lot rise good service lay sense evening student where.,18,woods-cummings-and-franklin,2023,USD,1571740,666423,905317,692836,212481,3976,208505,15717,31434,177071,37151,869087,383162,485925,,1571740,277.88,1367.64,0.0361,1074,121.92,47361.28,0.78,0.576
7062,Johnson-Black,False,CA,Nicholasburgh,AI/ML,2017,https://johnson-black.com,Its pick allow place decade.,13,johnson-black,2023,USD,286527,180636,105891,22823,83068,67323,15745,2865,5730,10015,28009,300142,152896,147246,,286527,343.88,171.94,0.0687,181,131.44,1000.0,28.01,0.3696
7063,Kelley Ltd,False,IN,East Thomas,Energy,2011,https://kelleyltd.com,Drop audience line gas poor various.,19,kelley-ltd,2023,USD,1573676,708013,865663,597270,268393,0,268393,15736,31473,236920,84638,1060774,565804,494970,,1573676,20.0,95.7,0.093,569,230.47,31111.4,2.72,0.5501
7064,Campbell and Sons,False,EG,Moralesmouth,Cybersecurity,2022,https://campbellandsons.com,Teach office one various travel writer local account subject.,17,campbell-and-sons,2023,USD,772996,341546,431450,499572,-68122,21311,-89433,7729,15459,-104892,31615,544701,190455,354246,,772996,1127.46,563.73,0.1079,307,209.52,62086.97,0.51,0.5582
7065,Patterson Lewis and Collier,False,ZA,Ramirezfort,Cybersecurity,2023,https://pattersonlewisandcollier.com,Care nothing or drug thus leg as point American.,18,patterson-lewis-and-collier,2023,USD,1358330,327227,1031103,147716,883387,1863,881524,13583,27166,854358,7678,735549,242159,493390,,1358330,629.46,2198.98,0.0637,667,169.5,9362.61,0.82,0.7591
7066,Williams-Mcdowell,False,DE,Ramirezland,HealthTech,2020,https://williams-mcdowell.com,Kind cost despite wide high occur into prove impact generation.,16,williams-mcdowell,2023,EUR,731863,226670,505193,536966,-31773,35921,-67694,7318,14637,-82331,103655,576399,103778,472621,60988.58,731863,1100.76,6929.0,0.0767,12197,5.0,50940.54,2.03,0.6903
7067,Dalton Sheppard and Johnson,False,IN,Garyburgh,EdTech,2008,https://daltonsheppardandjohnson.com,News nearly positive break I soon.,19,dalton-sheppard-and-johnson,2023,USD,129388,25760,103628,56186,47442,8330,39112,1293,2587,36525,12556,179225,14214,165011,10782.33,129388,636.56,2710.93,0.03,293,36.69,1000.0,12.56,0.8009
7068,Austin Ltd,False,KE,Margarethaven,E-commerce,2016,https://austinltd.com,Action score drug pay design character few sister.,15,austin-ltd,2023,USD,1173884,258239,915645,452385,463260,13518,449742,11738,23477,426265,164862,874225,329981,544244,,1173884,1221.96,8587.37,0.001,387,252.25,31657.19,5.21,0.78
7069,Jackson Hayes and Riddle,False,IN,New Kimberlybury,IoT,2023,https://jacksonhayesandriddle.com,Question main weight across win soldier particularly.,23,jackson-hayes-and-riddle,2023,USD,802376,378274,424102,340338,83764,0,83764,8023,16047,67717,49758,522526,90863,431663,,802376,463.35,809.8,0.1505,495,134.84,11047.84,4.5,0.5286
7070,Donovan-White,False,KE,Port Jordan,Cybersecurity,2011,https://donovan-white.com,Economic consumer safe deep focus himself room but Republican around.,19,donovan-white,2023,USD,1250445,294765,955680,115522,840158,2079,838079,12504,25008,813071,225768,854420,244993,609427,,1250445,265.48,132.74,0.001,4641,22.45,21282.17,10.61,0.7643
7071,Harris Inc,False,GB,Lake Rebecca,Mobility,2022,https://harrisinc.com,May possible hold attack.,23,harris-inc,2023,USD,550789,111948,438841,27539,411302,0,411302,5507,11015,400287,12764,341888,17094,324794,,550789,716.78,2739.0,0.0814,363,126.21,1000.0,12.76,0.7967
7072,Henderson PLC,False,US,East Stephanieborough,HealthTech,2013,https://hendersonplc.com,System another read class media future whether party.,11,henderson-plc,2023,USD,111965,47683,64282,71910,-7628,0,-7628,1119,2239,-9867,23908,132001,10127,121874,9330.42,111965,589.69,3059.53,0.0479,198,46.9,42720.55,0.56,0.5741
7073,Williams and Sons,False,EG,Thompsonbury,Fintech,2013,https://williamsandsons.com,Win huge small tell police.,15,williams-and-sons,2023,USD,1008653,319466,689187,516163,173024,0,173024,10086,20173,152851,86960,688404,93013,595391,,1008653,349.16,2277.85,0.0206,563,149.2,44102.72,1.97,0.6833
7074,Powell LLC,False,US,Masonview,E-commerce,2015,https://powellllc.com,Half but city kind far parent likely house analysis it.,17,powell-llc,2023,USD,1089263,417927,671336,710867,-39531,16411,-55942,10892,21785,-77727,112271,666576,347419,319157,,1089263,20.0,46.34,0.1071,3191,28.44,93925.53,1.2,0.6163
7075,Casey-Green,False,BR,Port Craigfort,IoT,2022,https://casey-green.com,Nation part before increase by on.,20,casey-green,2023,USD,835362,438939,396423,410761,-14338,8699,-23037,8353,16707,-39744,29285,539902,85940,453962,,835362,1313.37,6821.56,0.0375,3480,20.0,59375.98,0.49,0.4746
7076,Clarke Harris and Wilson,False,AU,West Gary,AI/ML,2023,https://clarkeharrisandwilson.com,Brother defense involve able environmental seat simple.,21,clarke-harris-and-wilson,2023,USD,909633,203577,706056,125431,580625,13763,566862,9096,18192,548670,36663,661376,311283,350093,,909633,728.3,364.15,0.0102,915,82.77,12645.26,2.9,0.7762
7077,Sanchez Ltd,False,ZA,Port Mckenzieburgh,Fintech,2014,https://sanchezltd.com,Bad top letter direction face.,27,sanchez-ltd,2023,USD,2133072,999997,1133075,729186,403889,0,403889,21330,42661,361228,122627,1270684,194791,1075893,,2133072,1226.81,5600.57,0.0778,1806,98.41,43862.33,2.8,0.5312
7078,Thomas-Bray,False,EG,Maddenview,Cybersecurity,2018,https://thomas-bray.com,Building firm man buy.,18,thomas-bray,2023,USD,660163,228885,431278,300186,131092,0,131092,6601,13203,117889,11845,463178,227478,235700,,660163,160.24,369.39,0.001,418,131.45,19679.84,0.6,0.6533
7079,Lewis Sanders and Mason,False,GB,Michellestad,IoT,2024,https://lewissandersandmason.com,Affect drive item amount building piece give.,14,lewis-sanders-and-mason,2023,USD,1448832,654427,794405,534417,259988,18412,241576,14488,28976,212600,23716,876043,281469,594574,,1448832,20.0,93.84,0.158,753,160.21,44990.08,0.53,0.5483
7080,Baker-Salazar,False,DE,Perryview,HealthTech,2012,https://baker-salazar.com,Memory lawyer present pay identify side capital response author.,19,baker-salazar,2023,EUR,504129,192599,311530,310772,758,0,758,5041,10082,-9324,115010,522189,229705,292484,42010.75,504129,10.0,59.11,0.0328,811,51.77,45855.12,2.51,0.618
7081,Burke-Singh,False,US,New Charlesport,Marketplaces,2011,https://burke-singh.com,Middle either assume school manage alone my mission indicate rock.,15,burke-singh,2023,USD,333483,118847,214636,126943,87693,0,87693,3334,6669,81024,6394,241142,34475,206667,,333483,476.63,562.12,0.0157,367,75.62,39593.48,0.16,0.6436
7082,Price-Gonzalez,False,GB,Adamsview,E-commerce,2020,https://price-gonzalez.com,Situation firm adult nor eye big simply movement nature else phone.,17,price-gonzalez,2023,USD,711703,227122,484581,502304,-17723,0,-17723,7117,14234,-31957,85080,495708,244628,251080,,711703,167.34,83.67,0.0628,2965,20.0,67203.57,1.27,0.6809
7083,Miller Foster and Brooks,False,ZA,West Bryceberg,Cybersecurity,2009,https://millerfosterandbrooks.com,Yes finally field executive structure clearly suggest quite thing.,27,miller-foster-and-brooks,2023,USD,800370,204025,596345,465543,130802,7465,123337,8003,16007,107330,44138,469386,148475,320911,,800370,20.0,12.18,0.1737,489,136.34,30496.04,1.45,0.7451
7084,Wilson PLC,False,NG,Lake Danny,EdTech,2013,https://wilsonplc.com,Allow add treat save item set.,15,wilson-plc,2023,USD,331574,16697,314877,99658,215219,3052,212167,3315,6631,205536,5856,257115,101857,155258,27631.17,331574,248.42,1375.59,0.0056,362,76.31,1000.0,5.86,0.9496
7085,Dixon Baker and Gray,False,US,West Joshua,SaaS,2016,https://dixonbakerandgray.com,Message wind outside line Congress those tell politics level.,26,dixon-baker-and-gray,2023,USD,356285,90526,265759,168516,97243,6954,90289,3562,7125,83164,26063,335475,157943,177532,29690.42,356285,181.08,493.09,0.0512,1250,23.74,1000.0,26.06,0.7459
7086,Brown-Johnson,False,AU,Colehaven,AI/ML,2023,https://brown-johnson.com,Cup including could hundred avoid moment find idea.,29,brown-johnson,2023,USD,328196,111831,216365,143315,73050,17595,55455,3281,6563,48892,47401,233989,98281,135708,,328196,1194.8,7726.18,0.0443,826,33.08,18517.92,2.56,0.6593
7087,White Group,False,KE,Lawrencefort,Marketplaces,2022,https://whitegroup.com,Employee yard section save or television toward concern professor.,14,white-group,2023,USD,1057010,401301,655709,255436,400273,13800,386473,10570,21140,365333,19003,572858,332507,240351,,1057010,1818.96,8346.64,0.0751,4404,20.0,43270.34,0.44,0.6203
7088,Velez Mason and Chavez,False,NG,Ricardoside,AI/ML,2024,https://velezmasonandchavez.com,Return bill end my strong certainly best offer.,14,velez-mason-and-chavez,2023,USD,935007,310332,624675,391069,233606,0,233606,9350,18700,214906,93634,749367,48626,700741,,935007,663.74,2160.78,0.0549,3895,20.0,36015.24,2.6,0.6681
7089,Taylor Inc,False,KE,South Molly,Mobility,2019,https://taylorinc.com,Around region laugh to doctor.,15,taylor-inc,2023,USD,7396950,3659385,3737565,4451816,-714251,0,-714251,73969,147939,-862190,126517,4018540,1133727,2884813,,7396950,772.62,571.16,0.0894,11932,51.66,367460.63,0.34,0.5053
7090,Prince Hawkins and Watson,False,BR,South Kevin,EdTech,2019,https://princehawkinsandwatson.com,Number race actually maintain.,15,prince-hawkins-and-watson,2023,USD,428717,217153,211564,419610,-208046,26679,-234725,4287,8574,-243299,139208,456471,195619,260852,35726.42,428717,702.43,2182.4,0.0206,914,39.07,39932.7,3.49,0.4935
7091,Parker Group,False,BR,Laurenshire,AI/ML,2019,https://parkergroup.com,Newspaper section network go.,11,parker-group,2023,USD,2233938,1047510,1186428,628613,557815,0,557815,22339,44678,513137,76978,1273442,288850,984592,,2233938,2325.48,8979.4,0.0503,9308,20.0,37636.08,2.05,0.5311
7092,Sullivan-Townsend,False,GB,Campbellfurt,EdTech,2020,https://sullivan-townsend.com,My reality huge article recognize management safe opportunity system.,13,sullivan-townsend,2023,USD,613029,180558,432471,191792,240679,0,240679,6130,12260,228419,51283,549247,100744,448503,51085.75,613029,475.86,3796.11,0.0964,2489,20.52,18496.6,2.77,0.7055
7093,Li Group,False,US,Madisonstad,SaaS,2014,https://ligroup.com,North ready hand officer behavior discover.,18,li-group,2023,USD,174432,39717,134715,69090,65625,7861,57764,1744,3488,54276,20395,201670,108884,92786,14536.0,174432,62.01,349.26,0.0086,180,80.7,21534.95,0.95,0.7723
7094,Ramirez-Humphrey,False,US,Dawnberg,AgriTech,2017,https://ramirez-humphrey.com,Blood center enjoy mission film month just course chair share.,25,ramirez-humphrey,2023,USD,511416,216058,295358,163875,131483,35306,96177,5114,10228,85949,80552,473012,137014,335998,,511416,2103.78,4650.15,0.0229,723,58.92,1000.0,80.55,0.5775
7095,Green Tapia and Kirk,False,DE,Tracyport,Energy,2010,https://greentapiaandkirk.com,Drop Mr choose who investment attack ability city expert shake week.,15,green-tapia-and-kirk,2023,EUR,457609,186329,271280,96053,175227,10796,164431,4576,9152,155279,98559,330695,69008,261687,,457609,742.78,1903.42,0.0929,1906,20.0,1000.0,98.56,0.5928
7096,Scott PLC,False,KE,Michaelberg,IoT,2018,https://scottplc.com,Remember onto feeling or instead easy size matter.,15,scott-plc,2023,USD,421013,33159,387854,256570,131284,13985,117299,4210,8420,108879,8727,334202,213384,120818,,421013,356.59,2229.62,0.0177,1754,20.0,33671.28,0.26,0.9212
7097,Gonzalez Inc,False,FR,South Catherinebury,Mobility,2010,https://gonzalezinc.com,Newspaper beat issue get music mean lead also.,26,gonzalez-inc,2023,EUR,1846196,499031,1347165,171797,1175368,0,1175368,18461,36923,1138445,35268,1110797,437840,672957,,1846196,1272.58,3222.76,0.0813,709,216.76,1000.0,35.27,0.7297
7098,Williams PLC,False,CA,Leslieview,HealthTech,2014,https://williamsplc.com,This realize suggest less could.,14,williams-plc,2023,USD,179797,100749,79048,67600,11448,12432,-984,1797,3595,-4579,12346,163308,74576,88732,14983.08,179797,150.97,656.7,0.0327,253,59.05,1000.0,12.35,0.4397
7099,Nichols-Stevens,False,ZA,New Jamesfurt,IoT,2010,https://nichols-stevens.com,Side spend education assume your change land.,20,nichols-stevens,2023,USD,400626,77155,323471,20031,303440,726,302714,4006,8012,294702,20672,256017,76059,179958,,400626,20.0,53.74,0.0964,136,244.62,21261.74,0.97,0.8074
7100,Lopez-Hughes,False,US,Port Danielfurt,HealthTech,2013,https://lopez-hughes.com,Beautiful mean of music who begin key ever agency.,13,lopez-hughes,2023,USD,617011,317389,299622,453769,-154147,23818,-177965,6170,12340,-190305,15123,326991,120270,206721,51417.58,617011,334.31,2499.73,0.029,527,97.41,33615.32,0.45,0.4856
7101,Parker Gonzalez and Waters,False,AU,South Anthony,Cybersecurity,2019,https://parkergonzalezandwaters.com,Condition indicate manager moment long not building reality.,17,parker-gonzalez-and-waters,2023,USD,887476,237035,650441,541093,109348,0,109348,8874,17749,91599,18661,484091,24204,459887,,887476,866.2,1680.52,0.001,3263,22.66,47405.06,0.39,0.7329
7102,Miller Atkinson and Schroeder,False,BR,Port Kimberly,SaaS,2010,https://milleratkinsonandschroeder.com,Suffer against company feel pull.,29,miller-atkinson-and-schroeder,2023,USD,1676706,690086,986620,2123305,-1136685,9056,-1145741,16767,33534,-1179275,81866,1016452,291586,724866,139725.5,1676706,114.72,179.36,0.001,1955,71.47,177360.65,0.46,0.5884
7103,Hawkins LLC,False,IN,New Aaronhaven,EdTech,2023,https://hawkinsllc.com,Before growth morning institution provide big.,28,hawkins-llc,2023,USD,333208,164573,168635,115645,52990,0,52990,3332,6664,46326,35058,401019,106257,294762,27767.33,333208,799.32,4129.48,0.001,858,32.33,22322.48,1.57,0.5061
7104,Lowery and Sons,False,IN,North Pamela,Marketplaces,2024,https://loweryandsons.com,Food source west can list suddenly reason likely.,18,lowery-and-sons,2023,USD,198539,86372,112167,77268,34899,0,34899,1985,3970,30929,2169,209796,34970,174826,,198539,632.55,2844.86,0.0344,88,186.45,27102.04,0.08,0.565
7105,Davis-Clarke,False,DE,East Jason,SaaS,2014,https://davis-clarke.com,Among truth or outside art teach ability something maintain.,24,davis-clarke,2023,EUR,1564930,577102,987828,1105660,-117832,27097,-144929,15649,31298,-176227,155054,1110710,783281,327429,130410.83,1564930,10.0,38.63,0.0433,10301,12.66,125598.8,1.23,0.6312
7106,Wyatt Inc,False,US,Port Victoriamouth,IoT,2021,https://wyattinc.com,Pass oil short for line research Democrat civil.,22,wyatt-inc,2023,USD,306557,43291,263266,143957,119309,0,119309,3065,6131,113178,6583,278863,83513,195350,,306557,97.84,287.09,0.0422,396,64.48,27230.57,0.24,0.8588
7107,Schneider Le and Smith,False,EG,Port Chelsea,Fintech,2014,https://schneiderleandsmith.com,View whose add serve example bring under school thing trial.,20,schneider-le-and-smith,2023,USD,594046,217995,376051,190098,185953,15343,170610,5940,11880,158730,4448,436311,137094,299217,,594046,20.0,47.99,0.0392,363,136.25,15885.01,0.28,0.633
7108,Reese-Cook,False,BR,West Nathanburgh,IoT,2023,https://reese-cook.com,Word born hospital particularly prove at step media parent.,17,reese-cook,2023,USD,540280,91800,448480,410345,38135,0,38135,5402,10805,27330,94725,427863,133938,293925,,540280,553.37,1076.13,0.0587,2251,20.0,33040.83,2.87,0.8301
7109,Lewis LLC,False,FR,East Anthonyborough,IoT,2011,https://lewisllc.com,Identify successful my tonight woman perform.,17,lewis-llc,2023,EUR,4212397,1031279,3181118,1387145,1793973,0,1793973,42123,84247,1709726,155593,2292384,1206252,1086132,,4212397,20.0,10.0,0.0384,17551,20.0,133208.56,1.17,0.7552
7110,Watts Wade and Miranda,False,GB,Josephfurt,Energy,2009,https://wattswadeandmiranda.com,Have writer help marriage arm.,15,watts-wade-and-miranda,2023,USD,3953700,579667,3374033,197685,3176348,0,3176348,39537,79074,3097274,36955,2124955,468585,1656370,,3953700,1115.03,2618.45,0.0922,1478,222.89,1000.0,36.96,0.8534
7111,Porter-Moore,False,BR,New Samantha,HealthTech,2012,https://porter-moore.com,City sit lead bit middle live send help.,16,porter-moore,2023,USD,542872,196258,346614,419077,-72463,21270,-93733,5428,10857,-104590,32440,454344,185559,268785,45239.33,542872,295.86,295.86,0.0574,554,81.55,1000.0,32.44,0.6385
7112,Atkins Kim and Smith,False,FR,Port Crystalchester,EdTech,2013,https://atkinskimandsmith.com,Some participant hold boy course.,17,atkins-kim-and-smith,2023,EUR,726477,293628,432849,275234,157615,14260,143355,7264,14529,128826,11920,492736,242980,249756,60539.75,726477,615.57,2113.93,0.0162,2869,21.1,1000.0,11.92,0.5958
7113,Walter Group,False,FR,Wardville,Marketplaces,2022,https://waltergroup.com,More answer PM range lead bed.,21,walter-group,2023,EUR,539839,230180,309659,198598,111061,15878,95183,5398,10796,84387,30918,449317,91767,357550,,539839,20.0,54.75,0.0052,2249,20.0,1000.0,30.92,0.5736
7114,Thomas and Sons,False,TN,Hamiltonberg,Mobility,2012,https://thomasandsons.com,Bad finally international responsibility nothing raise sit democratic.,16,thomas-and-sons,2023,USD,541934,130422,411512,457445,-45933,6687,-52620,5419,10838,-63458,6051,292319,40804,251515,,541934,512.47,3471.79,0.0358,286,157.65,17437.91,0.35,0.7593
7115,Wilson Taylor and Campbell,False,US,South Justinfurt,Fintech,2010,https://wilsontaylorandcampbell.com,There read live staff information day former one if town front.,21,wilson-taylor-and-campbell,2023,USD,5760675,1965292,3795383,4468057,-672674,0,-672674,57606,115213,-787887,497250,3426264,928867,2497397,,5760675,20.0,93.18,0.1065,24002,20.0,362191.15,1.37,0.6588
7116,Anderson-Black,False,FR,Hannahville,Fintech,2020,https://anderson-black.com,Today still well cold score leave young.,21,anderson-black,2023,EUR,1513734,738766,774968,261586,513382,0,513382,15137,30274,483108,29493,973532,156229,817303,,1513734,20.0,11.92,0.0374,516,244.01,18879.98,1.56,0.512
7117,Watson-Garcia,False,TN,New Lisastad,Fintech,2012,https://watson-garcia.com,Though property another with cultural glass argue light receive every.,18,watson-garcia,2023,USD,2012685,394278,1618407,1760809,-142402,0,-142402,20126,40253,-182655,565910,1607548,627905,979643,,2012685,1784.64,4351.89,0.0248,8386,20.0,187584.9,3.02,0.8041
7118,Waters Lopez and Deleon,False,GB,Christinaborough,SaaS,2011,https://waterslopezanddeleon.com,If necessary toward magazine white few let system.,16,waters-lopez-and-deleon,2023,USD,758219,265819,492400,382217,110183,22675,87508,7582,15164,72344,76066,575450,41923,533527,63184.92,758219,10.0,53.59,0.0218,922,68.48,33819.96,2.25,0.6494
7119,Williams Inc,False,KE,Thomasberg,Cybersecurity,2009,https://williamsinc.com,Our home current feel type cut room word agreement.,17,williams-inc,2023,USD,1857346,757758,1099588,735719,363869,19679,344190,18573,37146,307044,490218,1491429,1026409,465020,,1857346,1063.82,4201.23,0.0666,1097,141.07,33461.46,14.65,0.592
7120,Lee Inc,False,EG,North Stephaniestad,HealthTech,2018,https://leeinc.com,Himself door avoid free form.,23,lee-inc,2023,USD,3092526,1413586,1678940,830782,848158,0,848158,30925,61850,786308,66251,1705754,1026175,679579,257710.5,3092526,10.0,64.75,0.0228,4376,58.88,79531.34,0.83,0.5429
7121,Gonzalez LLC,False,BR,Port Ian,Cybersecurity,2024,https://gonzalezllc.com,Social recognize event music cold instead attention start again garden.,9,gonzalez-llc,2023,USD,618647,120079,498568,85191,413377,33424,379953,6186,12372,367581,29728,444119,219996,224123,,618647,20.0,75.48,0.0354,2577,20.0,24718.39,1.2,0.8059
7122,Weiss-Davis,False,AU,Adamburgh,Mobility,2015,https://weiss-davis.com,Model thousand opportunity trial close kid security.,19,weiss-davis,2023,USD,708659,212205,496454,412180,84274,3547,80727,7086,14173,66554,31476,549762,354765,194997,,708659,556.26,3148.2,0.1059,264,223.52,54430.09,0.58,0.7006
7123,Hudson and Sons,False,DE,Port Gailport,IoT,2014,https://hudsonandsons.com,She allow you relate activity building.,13,hudson-and-sons,2023,EUR,2943449,1051208,1892241,1897431,-5190,18943,-24133,29434,58868,-83001,77883,1717817,722805,995012,,2943449,1449.23,8002.11,0.001,9679,25.34,149413.71,0.52,0.6429
7124,Hernandez-Mora,False,US,Reedton,AgriTech,2014,https://hernandez-mora.com,Other foot outside peace stop police shake.,20,hernandez-mora,2023,USD,470289,183776,286513,181874,104639,3466,101173,4702,9405,91768,109911,473160,219981,253179,,470289,687.9,1779.02,0.093,561,69.84,2805.71,39.17,0.6092
7125,Roberts-Burns,False,TN,Port Marymouth,Energy,2018,https://roberts-burns.com,More product scene during goal it gas answer.,26,roberts-burns,2023,USD,397372,167423,229949,271491,-41542,0,-41542,3973,7947,-49489,24320,388062,91379,296683,,397372,753.1,577.22,0.0466,280,118.11,9810.72,2.48,0.5787
7126,Browning-Preston,False,DE,Maysfurt,AI/ML,2008,https://browning-preston.com,New deep especially design public father consider.,29,browning-preston,2023,EUR,3927090,1298923,2628167,1889175,738992,0,738992,39270,78541,660451,30648,2004172,652456,1351716,,3927090,1719.94,859.97,0.0194,1397,234.11,170266.69,0.18,0.6692
7127,Krueger PLC,False,BR,Port Sarah,HealthTech,2022,https://kruegerplc.com,Add affect act act important important level reach.,15,krueger-plc,2023,USD,2005051,339963,1665088,313275,1351813,3535,1348278,20050,40101,1308177,89910,1182729,504497,678232,167087.58,2005051,373.97,1220.45,0.0836,5360,31.17,23617.59,3.81,0.8304
7128,Hodge-Ochoa,False,BR,Perezton,Marketplaces,2017,https://hodge-ochoa.com,Lead best after sing individual carry paper trade claim.,16,hodge-ochoa,2023,USD,291280,116357,174923,156048,18875,25531,-6656,2912,5825,-12481,17704,213127,146031,67096,,291280,136.13,341.27,0.0592,1213,20.0,31120.46,0.57,0.6005
7129,Barry-Lopez,False,AU,Port Cameron,AI/ML,2011,https://barry-lopez.com,Account among service likely vote role him big.,15,barry-lopez,2023,USD,1224377,577804,646573,875827,-229254,56193,-285447,12243,24487,-309934,159731,937671,52513,885158,,1224377,20.0,52.09,0.0646,408,250.04,54855.89,2.91,0.5281
7130,Scott Group,False,GB,Port Allison,AgriTech,2013,https://scottgroup.com,Door fish when mention establish part idea group research.,22,scott-group,2023,USD,233905,77625,156280,112722,43558,0,43558,2339,4678,38880,5105,274387,104160,170227,,233905,787.03,4506.62,0.0835,91,213.95,1000.0,5.11,0.6681
7131,Meyer Inc,False,FR,West Aaron,Fintech,2017,https://meyerinc.com,Institution civil expect drive challenge.,19,meyer-inc,2023,EUR,6333062,2732668,3600394,3428132,172262,39475,132787,63330,126661,6126,567410,3847494,2097122,1750372,,6333062,20.0,63.76,0.0996,3415,154.5,273270.83,2.08,0.5685
7132,Larson PLC,False,US,East Amy,AI/ML,2020,https://larsonplc.com,Agency start wall whole hot realize today check safe remember.,23,larson-plc,2023,USD,865455,344628,520827,333096,187731,6473,181258,8654,17309,163949,493460,1077707,533672,544035,,865455,125.86,713.23,0.0808,219,328.15,12938.66,38.14,0.6018
7133,Carpenter-Johnson,False,BR,North Jorge,AI/ML,2012,https://carpenter-johnson.com,These benefit leave group realize turn list writer by base.,26,carpenter-johnson,2023,USD,991877,440495,551382,354736,196646,0,196646,9918,19837,176809,14493,701555,204040,497515,,991877,798.56,1518.8,0.0708,1681,49.16,53547.46,0.27,0.5559
7134,Fernandez Ltd,False,CA,New Amanda,SaaS,2018,https://fernandezltd.com,Blue recognize summer front necessary time carry.,19,fernandez-ltd,2023,USD,469233,132862,336371,285696,50675,0,50675,4692,9384,41291,44017,382342,109289,273053,39102.75,469233,10.0,67.54,0.076,472,82.72,28486.35,1.55,0.7169
7135,Boyer Ltd,False,GB,North Brittneyfort,HealthTech,2017,https://boyerltd.com,Age she near affect happy rate machine spring.,28,boyer-ltd,2023,USD,222932,35268,187664,112764,74900,0,74900,2229,4458,70442,5550,169509,60723,108786,18577.67,222932,10.4,10.59,0.1145,217,85.47,29432.13,0.19,0.8418
7136,Petersen-Hansen,False,TN,Lake Joshua,HealthTech,2008,https://petersen-hansen.com,Population itself second operation those read dinner.,23,petersen-hansen,2023,USD,436567,118959,317608,309870,7738,15376,-7638,4365,8731,-16369,29179,250154,79254,170900,36380.58,436567,306.94,948.16,0.0483,720,50.5,9677.56,3.02,0.7275
7137,Hobbs Adams and Sexton,False,KE,West Sarah,EdTech,2019,https://hobbsadamsandsexton.com,Consider follow sometimes treatment customer know soon reality respond.,18,hobbs-adams-and-sexton,2023,USD,143413,56084,87329,60580,26749,9905,16844,1434,2868,13976,8607,96014,4800,91214,11951.08,143413,336.11,3056.46,0.0357,187,63.58,16382.66,0.53,0.6089
7138,Sawyer Smith and Flores,False,CA,North Deborah,Cybersecurity,2020,https://sawyersmithandflores.com,Scene somebody speech skin wish shake first.,20,sawyer-smith-and-flores,2023,USD,248878,62382,186496,61993,124503,0,124503,2488,4977,119526,77929,304143,128646,175497,,248878,1983.59,991.8,0.1657,154,134.04,43638.25,1.79,0.7493
7139,Barnes-Jarvis,False,AU,North Desireehaven,Fintech,2008,https://barnes-jarvis.com,Change myself occur social his firm final when.,18,barnes-jarvis,2023,USD,2909615,415389,2494226,145480,2348746,0,2348746,29096,58192,2290554,55015,1568510,78425,1490085,,2909615,1355.55,1783.45,0.0451,1292,187.64,35870.03,1.53,0.8572
7140,Gross Ltd,False,AU,Wilkinsonview,EdTech,2019,https://grossltd.com,Door too likely age officer between consider history power chair fire.,25,gross-ltd,2023,USD,1067065,284954,782111,446067,336044,1809,334235,10670,21341,312894,5911,684959,192244,492715,88922.08,1067065,10.0,45.86,0.0424,1493,59.53,16860.15,0.35,0.733
7141,Lewis-Miller,False,GB,Wilsonfurt,Cybersecurity,2023,https://lewis-miller.com,Final become enter try between least mean station group.,16,lewis-miller,2023,USD,3622485,1463577,2158908,1204402,954506,2978,951528,36224,72449,879079,680118,2648371,1505702,1142669,,3622485,620.79,3213.53,0.0524,2757,109.46,82910.26,8.2,0.596
7142,Butler Group,False,US,Johnnyton,Fintech,2015,https://butlergroup.com,Difference nearly both last social.,21,butler-group,2023,USD,2611637,715713,1895924,1437883,458041,17101,440940,26116,52232,388708,102170,1573847,775316,798531,,2611637,528.86,1920.35,0.0526,10881,20.0,98954.69,1.03,0.726
7143,Green-Griffin,False,EG,Heatherchester,Fintech,2012,https://green-griffin.com,Fight man piece music turn.,25,green-griffin,2023,USD,1739733,686985,1052748,1142604,-89856,591,-90447,17397,34794,-125241,117624,1016569,470166,546403,,1739733,624.62,312.31,0.0936,5748,25.22,109750.16,1.07,0.6051
7144,Evans Reynolds and Quinn,False,IN,East Johntown,EdTech,2021,https://evansreynoldsandquinn.com,Cold lot simple hair nation usually child activity.,17,evans-reynolds-and-quinn,2023,USD,50171,16146,34025,4599,29426,6997,22429,501,1003,21426,62765,282646,92552,190094,4180.92,50171,179.46,834.66,0.0252,199,20.99,8378.72,7.49,0.6782
7145,Camacho Mcbride and Dennis,False,CA,North Erika,AI/ML,2018,https://camachomcbrideanddennis.com,Manage alone choose than next prevent bit financial.,20,camacho-mcbride-and-dennis,2023,USD,452128,209167,242961,138365,104596,28856,75740,4521,9042,66698,9445,368842,18442,350400,,452128,903.46,4470.74,0.0377,229,164.2,1000.0,9.44,0.5374
7146,Ortiz Holmes and Alexander,False,NG,Morganside,E-commerce,2020,https://ortizholmesandalexander.com,Another let thought training card strategy sell break information mother response.,22,ortiz-holmes-and-alexander,2023,USD,1925287,526279,1399008,1182599,216409,2701,213708,19252,38505,175203,195161,1228885,130213,1098672,,1925287,935.1,2519.72,0.077,850,188.75,117312.76,1.66,0.7266
7147,Moon Allen and Wang,False,IN,East Jacob,HealthTech,2014,https://moonallenandwang.com,Image suffer perform group whatever our magazine air.,20,moon-allen-and-wang,2023,USD,1165891,272446,893445,313852,579593,0,579593,11658,23317,556276,69103,749857,179719,570138,97157.58,1165891,120.79,470.13,0.0792,6659,14.59,43989.83,1.57,0.7663
7148,Romero Inc,False,US,Goodmanmouth,AgriTech,2010,https://romeroinc.com,Daughter true behavior staff now project crime.,22,romero-inc,2023,USD,224499,58037,166462,130182,36280,14067,22213,2244,4489,17724,20292,175674,114853,60821,,224499,435.94,897.48,0.0569,122,152.42,1000.0,20.29,0.7415
7149,Turner Ltd,False,ZA,East Ryan,HealthTech,2008,https://turnerltd.com,Miss yourself attention meet condition road on themselves early cell.,26,turner-ltd,2023,USD,1130755,388766,741989,56537,685452,0,685452,11307,22615,662837,343225,941578,503396,438182,94229.58,1130755,633.03,1160.99,0.0629,3308,28.48,42693.46,8.04,0.6562
7150,Green-Sheppard,False,GB,Port Kevin,Mobility,2009,https://green-sheppard.com,Explain mother Mrs present network who space two commercial.,23,green-sheppard,2023,USD,3524973,1069136,2455837,176248,2279589,0,2279589,35249,70499,2209090,184535,1955656,769792,1185864,,3524973,394.24,197.12,0.0015,14687,20.0,1000.0,184.54,0.6967
7151,Price Group,False,TN,Lake Jamesview,Fintech,2019,https://pricegroup.com,Never skin finally such remember fast company specific enough.,19,price-group,2023,USD,3103904,1174412,1929492,637545,1291947,2051,1289896,31039,62078,1227818,165345,1803723,1013304,790419,,3103904,1457.24,5348.69,0.0746,12932,20.0,39799.85,4.15,0.6216
7152,Shea Ltd,False,KE,New Brittany,HealthTech,2023,https://shealtd.com,Themselves article about increase again wear college argue also.,28,shea-ltd,2023,USD,1168572,563488,605084,180179,424905,13464,411441,11685,23371,388070,33923,627041,332933,294108,97381.0,1168572,10.0,48.49,0.04,19476,5.0,11766.1,2.88,0.5178
7153,Martin-Miller,False,DE,Masonview,AI/ML,2023,https://martin-miller.com,Price away voice they term newspaper cold girl sister.,22,martin-miller,2023,EUR,817843,231119,586724,422397,164327,8772,155555,8178,16356,139199,134095,725995,225367,500628,,817843,259.25,614.01,0.0649,3407,20.0,36492.46,3.67,0.7174
7154,Jordan Group,False,IN,East Anthony,SaaS,2013,https://jordangroup.com,Law throw great sit reach plant.,17,jordan-group,2023,USD,176305,62531,113774,81557,32217,1478,30739,1763,3526,27213,26434,216723,48432,168291,14692.08,176305,194.47,1384.11,0.0262,151,97.21,1000.0,26.43,0.6453
7155,Miranda Group,False,KE,New Christopherhaven,IoT,2009,https://mirandagroup.com,Owner describe nor quickly word college class responsibility ball collection effort.,12,miranda-group,2023,USD,453018,110894,342124,91863,250261,0,250261,4530,9060,241201,12203,404489,257047,147442,,453018,20.0,57.18,0.0846,306,123.19,1325.23,9.21,0.7552
7156,Young Ltd,False,EG,West Maria,Cybersecurity,2010,https://youngltd.com,Performance language at history anything travel course science guy store human.,25,young-ltd,2023,USD,499006,243596,255410,235518,19892,6286,13606,4990,9980,3626,110816,559530,229621,329909,,499006,330.86,793.13,0.118,509,81.57,9312.56,11.9,0.5118
7157,Brown Lopez and Saunders,False,TN,Donnashire,Energy,2008,https://brownlopezandsaunders.com,Care official above a size on such itself prevent sense.,20,brown-lopez-and-saunders,2023,USD,706295,199737,506558,195847,310711,0,310711,7062,14125,296586,10556,431441,86559,344882,,706295,20.0,21.69,0.052,2942,20.0,21848.78,0.48,0.7172
7158,Nichols-Williams,False,TN,West Morgan,EdTech,2012,https://nichols-williams.com,Bed kitchen key enough star sort describe management already chair.,17,nichols-williams,2023,USD,547397,151590,395807,120177,275630,0,275630,5473,10947,264683,4766,338340,131448,206892,45616.42,547397,10.0,55.28,0.0256,339,134.23,43768.27,0.11,0.7231
7159,Davis-Chase,False,GB,Estradamouth,AgriTech,2024,https://davis-chase.com,Go happen let find program traditional behind place course.,13,davis-chase,2023,USD,251351,138400,112951,113879,-928,0,-928,2513,5027,-5955,34929,266217,67951,198266,,251351,20.0,62.48,0.031,125,167.52,1000.0,34.93,0.4494
7160,Wright Wallace and Powers,False,BR,East Jessicafurt,Fintech,2018,https://wrightwallaceandpowers.com,Change play organization lot collection since system boy arrive.,12,wright-wallace-and-powers,2023,USD,2674769,847876,1826893,1653549,173344,0,173344,26747,53495,119849,45454,1399982,447409,952573,,2674769,741.58,1744.13,0.0273,2283,97.62,121304.59,0.37,0.683
7161,Shaw-Douglas,False,CA,Mariaport,AgriTech,2013,https://shaw-douglas.com,Save enter go central present simple subject.,23,shaw-douglas,2023,USD,190842,77028,113814,148864,-35050,0,-35050,1908,3816,-38866,57835,238506,39052,199454,,190842,20.0,94.81,0.0898,795,20.0,37165.01,1.56,0.5964
7162,Lee Carson and Jordan,False,BR,Vanessafurt,Marketplaces,2008,https://leecarsonandjordan.com,Dinner nice many center sound hotel they sort wrong give.,22,lee-carson-and-jordan,2023,USD,974172,130581,843591,586984,256607,19365,237242,9741,19483,217759,44735,615400,30770,584630,,974172,20.0,62.24,0.0229,4059,20.0,43037.73,1.04,0.866
7163,Stokes-King,False,DE,New Edwardborough,Cybersecurity,2017,https://stokes-king.com,Then simple thousand region.,23,stokes-king,2023,EUR,905974,315758,590216,318402,271814,792,271022,9059,18119,252903,8901,577959,28897,549062,,905974,589.65,2762.42,0.0718,1797,41.99,33648.96,0.26,0.6515
7164,Burns Smith and Daniel,False,US,North Megan,EdTech,2009,https://burnssmithanddaniel.com,Land eye fast simply process.,27,burns-smith-and-daniel,2023,USD,1379377,737783,641594,681315,-39721,10868,-50589,13793,27587,-78176,67262,782246,461093,321153,114948.08,1379377,10.0,43.16,0.046,2280,50.4,73761.56,0.91,0.4651
7165,Garcia-Sawyer,False,FR,Lake Jonathanside,SaaS,2019,https://garcia-sawyer.com,Have player concern place teach approach I open seven.,20,garcia-sawyer,2023,EUR,2642621,1323395,1319226,1770301,-451075,0,-451075,26426,52852,-503927,86945,1556891,720136,836755,220218.42,2642621,161.41,204.82,0.0651,2725,80.79,140772.03,0.62,0.4992
7166,Smith PLC,False,TN,North Sara,Mobility,2022,https://smithplc.com,Daughter listen myself throw everything nice.,16,smith-plc,2023,USD,305238,130873,174365,81630,92735,7143,85592,3052,6104,79488,21839,261287,81723,179564,,305238,215.23,271.18,0.0772,1271,20.0,3926.14,5.56,0.5712
7167,Ritter PLC,False,CA,New Angelaview,Energy,2017,https://ritterplc.com,Every less start common recognize book win conference any.,15,ritter-plc,2023,USD,1806555,570747,1235808,574314,661494,9904,651590,18065,36131,615459,165405,1244293,329501,914792,,1806555,1373.34,3958.0,0.001,1657,90.84,51394.37,3.22,0.6841
7168,Clayton Payne and Green,False,KE,Thomashaven,Fintech,2019,https://claytonpayneandgreen.com,Fill figure attention six hear most yourself.,15,clayton-payne-and-green,2023,USD,985080,314202,670878,236574,434304,44687,389617,9850,19701,369916,122005,641593,136899,504694,,985080,316.31,440.56,0.0389,4104,20.0,5313.55,22.96,0.681
7169,Atkins PLC,False,EG,Thomasside,IoT,2019,https://atkinsplc.com,Stay three throughout special.,25,atkins-plc,2023,USD,1588855,79442,1509413,497811,1011602,141,1011461,15888,31777,979684,36458,876868,444913,431955,,1588855,915.1,457.55,0.0178,4876,27.15,72206.08,0.5,0.95
7170,Russell Guerra and Dunn,False,CA,Gabrielashire,AgriTech,2021,https://russellguerraanddunn.com,Must authority room item address book run.,10,russell-guerra-and-dunn,2023,USD,1951349,817540,1133809,948246,185563,0,185563,19513,39026,146537,156245,1289525,607443,682082,,1951349,1144.36,1222.77,0.0563,1431,113.58,43401.98,3.6,0.581
7171,Baker LLC,False,GB,New Robinborough,EdTech,2016,https://bakerllc.com,Which attorney hair remember care over.,27,baker-llc,2023,USD,167821,31468,136353,68870,67483,0,67483,1678,3356,64127,5428,92927,7691,85236,13985.08,167821,493.36,1180.83,0.0504,417,33.52,56755.65,0.1,0.8125
7172,Richardson White and Young,False,EG,South Bruceville,Fintech,2012,https://richardsonwhiteandyoung.com,Road capital last ago watch suggest claim.,19,richardson-white-and-young,2023,USD,349241,160318,188923,313922,-124999,7884,-132883,3492,6984,-139867,3652,298885,183200,115685,,349241,20.0,71.17,0.1384,919,31.64,33645.76,0.11,0.541
7173,Johnson Inc,False,AU,Frosttown,AgriTech,2022,https://johnsoninc.com,Then church deep word dream similar during.,10,johnson-inc,2023,USD,114314,55326,58988,69647,-10659,0,-10659,1143,2286,-12945,10759,150725,7536,143189,,114314,366.82,1029.24,0.029,476,20.0,21549.59,0.5,0.516
7174,Bradley Inc,False,TN,Lake Brenda,SaaS,2011,https://bradleyinc.com,Bring probably citizen off summer education star can analysis full.,17,bradley-inc,2023,USD,819191,359278,459913,175881,284032,0,284032,8191,16383,267649,33293,598399,369453,228946,68265.92,819191,615.41,3619.69,0.0481,798,85.48,1000.0,33.29,0.5614
7175,Nichols-Perez,False,US,Lake Loganland,AI/ML,2009,https://nichols-perez.com,Education explain true sell myself base term bill and modern.,20,nichols-perez,2023,USD,1144268,346090,798178,196487,601691,1248,600443,11442,22885,577558,116063,704623,284336,420287,,1144268,744.77,372.38,0.1788,2958,32.23,39477.0,2.94,0.6975
7176,Odom Group,False,AU,East Robertmouth,Fintech,2024,https://odomgroup.com,Yes senior show site bed.,14,odom-group,2023,USD,2093891,680348,1413543,1144962,268581,0,268581,20938,41877,226704,132429,1318454,756271,562183,,2093891,504.77,1276.45,0.0307,4353,40.08,128427.46,1.03,0.6751
7177,Thomas LLC,False,FR,South Lauren,SaaS,2014,https://thomasllc.com,Choose debate trouble west person management then PM.,17,thomas-llc,2023,EUR,160621,65191,95430,38321,57109,9965,47144,1606,3212,43932,7943,237738,143857,93881,13385.08,160621,10.0,22.34,0.1012,225,59.34,22100.98,0.36,0.5941
7178,Smith Drake and Golden,False,US,New Melissaburgh,Cybersecurity,2021,https://smithdrakeandgolden.com,Fast surface study fall order outside behind loss.,16,smith-drake-and-golden,2023,USD,638152,314658,323494,236837,86657,0,86657,6381,12763,73894,35205,528325,210981,317344,,638152,1113.49,2928.11,0.0607,237,224.15,1000.0,35.2,0.5069
7179,Mcclain-Black,False,NG,East Kimberlymouth,EdTech,2011,https://mcclain-black.com,Education sister modern whole lay help.,28,mcclain-black,2023,USD,42271,18422,23849,6083,17766,0,17766,422,845,16921,15721,147410,35402,112008,3522.58,42271,131.33,693.37,0.0592,704,5.0,1000.0,15.72,0.5642
7180,Strong LLC,False,EG,Wellsbury,Energy,2016,https://strongllc.com,Catch even technology local expect moment just.,22,strong-llc,2023,USD,889607,148153,741454,598218,143236,0,143236,8896,17792,125444,13833,631908,349582,282326,,889607,1665.01,3586.33,0.1192,239,309.28,67784.4,0.2,0.8335
7181,Bates LLC,False,AU,Alexandertown,Fintech,2023,https://batesllc.com,Political without hand clearly some animal happen west me.,19,bates-llc,2023,USD,3071348,1011956,2059392,1061724,997668,0,997668,30713,61426,936242,269741,1914025,809594,1104431,,3071348,1064.44,5298.2,0.0562,1008,253.74,90746.71,2.97,0.6705
7182,Black and Sons,False,GB,West Juan,Energy,2024,https://blackandsons.com,Television various lose born local hit how college.,14,black-and-sons,2023,USD,477828,154498,323330,82279,241051,20782,220269,4778,9556,210713,75194,362075,101728,260347,,477828,560.74,1703.68,0.089,127,311.1,1000.0,75.19,0.6767
7183,Lester-Hood,False,US,North Brooke,AI/ML,2008,https://lester-hood.com,Computer whose become into front property.,27,lester-hood,2023,USD,869105,382539,486566,323674,162892,13329,149563,8691,17382,132181,97395,665003,368326,296677,,869105,20.0,54.04,0.0588,3621,20.0,14017.25,6.95,0.5598
7184,Carr-Martin,False,NG,East Jesseberg,Fintech,2019,https://carr-martin.com,Force energy tough single receive century agency life important particularly everything.,19,carr-martin,2023,USD,1964479,525339,1439140,784146,654994,0,654994,19644,39289,615705,50830,1112978,804465,308513,,1964479,20.0,13.99,0.0682,900,181.86,86624.5,0.59,0.7326
7185,Hernandez-Hansen,False,EG,Lozanohaven,Fintech,2012,https://hernandez-hansen.com,Listen identify perhaps make general not medical own.,15,hernandez-hansen,2023,USD,1059234,486144,573090,52961,520129,6878,513251,10592,21184,492067,59361,679245,76843,602402,,1059234,20.0,69.6,0.0332,512,172.08,10031.71,5.92,0.541
7186,Smith-Porter,False,KE,Dianastad,SaaS,2011,https://smith-porter.com,Character save red audience interesting enjoy that music age.,20,smith-porter,2023,USD,804330,327897,476433,316371,160062,0,160062,8043,16086,143976,78491,626744,298467,328277,67027.5,804330,364.08,923.13,0.038,564,118.76,28387.89,2.76,0.5923
7187,Morgan and Sons,False,CA,West Richardville,Cybersecurity,2009,https://morganandsons.com,Whom explain tonight look glass he become billion however involve.,14,morgan-and-sons,2023,USD,8203623,2611760,5591863,410181,5181682,0,5181682,82036,164072,5017610,190064,4428851,1330225,3098626,,8203623,381.59,991.52,0.0092,34181,20.0,50991.82,3.73,0.6816
7188,Keller Smith and Sanders,False,EG,Lake Ryan,Fintech,2014,https://kellersmithandsanders.com,Significant room cut score like.,22,keller-smith-and-sanders,2023,USD,931111,193112,737999,634229,103770,16292,87478,9311,18622,68856,123310,611178,152736,458442,,931111,1426.82,713.41,0.001,827,93.8,93439.13,1.32,0.7926
7189,Howard-Cobb,False,NG,New Lisa,SaaS,2021,https://howard-cobb.com,Understand stage left charge foot especially time individual adult property.,16,howard-cobb,2023,USD,264212,32602,231610,79290,152320,12250,140070,2642,5284,134786,3795,192829,16457,176372,22017.67,264212,10.0,62.63,0.0754,1221,18.02,1000.0,3.8,0.8766
7190,Harrington-Baker,False,EG,East Jacquelinefort,Fintech,2015,https://harrington-baker.com,Stage military fine outside manager learn finally front woman every.,22,harrington-baker,2023,USD,2446570,833616,1612954,155225,1457729,0,1457729,24465,48931,1408798,373996,1620364,432334,1188030,,2446570,325.02,742.0,0.0489,5581,36.53,32334.7,11.57,0.6593
7191,Martinez LLC,False,US,Ginashire,Mobility,2015,https://martinezllc.com,Sister yet nor ok course cup film than serve.,21,martinez-llc,2023,USD,854530,397720,456810,558689,-101879,21480,-123359,8545,17090,-140449,372640,806503,278091,528412,,854530,220.38,110.19,0.0658,697,102.14,54469.17,6.84,0.5346
7192,Carrillo Ltd,False,CA,Markburgh,Fintech,2009,https://carrilloltd.com,Available feeling cup true religious spring.,25,carrillo-ltd,2023,USD,200022,69812,130210,88921,41289,10256,31033,2000,4000,27033,587,169614,8480,161134,,200022,774.45,1161.58,0.001,833,20.0,1000.0,0.59,0.651
7193,Harrison Gardner and Savage,False,IN,North Rodneymouth,E-commerce,2024,https://harrisongardnerandsavage.com,Tend possible prepare speech billion give measure wait church political.,22,harrison-gardner-and-savage,2023,USD,424848,173744,251104,202421,48683,21437,27246,4248,8496,18750,76245,399789,19989,379800,,424848,466.42,1994.04,0.1735,365,96.88,18227.72,4.18,0.591
7194,Perez LLC,False,IN,Lake Robertfurt,Mobility,2017,https://perezllc.com,Area wear experience face education.,16,perez-llc,2023,USD,947667,443814,503853,329239,174614,4170,170444,9476,18953,151491,49335,639356,332980,306376,,947667,1139.9,996.79,0.0992,3948,20.0,17005.92,2.9,0.5317
7195,Buchanan Frank and Smith,False,DE,Martinezland,Energy,2013,https://buchananfrankandsmith.com,Especially sense really if many.,24,buchanan-frank-and-smith,2023,EUR,1347661,596193,751468,67383,684085,703,683382,13476,26953,656429,49330,841210,42060,799150,,1347661,20.0,75.17,0.0628,5615,20.0,1000.0,49.33,0.5576
7196,Harvey Ltd,False,FR,Stephenfort,Cybersecurity,2014,https://harveyltd.com,Forward according black baby address hear possible always feel.,26,harvey-ltd,2023,EUR,1513796,606100,907696,252169,655527,8660,646867,15137,30275,616592,35122,957791,321917,635874,,1513796,1200.56,2107.77,0.001,1897,66.48,7238.34,4.85,0.5996
7197,Martin LLC,False,US,Tinamouth,SaaS,2021,https://martinllc.com,Make goal tree foot laugh pull.,24,martin-llc,2023,USD,2034903,819771,1215132,159025,1056107,15757,1040350,20349,40698,999652,176545,1366447,715726,650721,169575.25,2034903,194.53,1358.52,0.0547,1983,85.49,17195.25,10.27,0.5971
7198,Webb Inc,False,GB,Lake Dawnland,E-commerce,2024,https://webbinc.com,American wrong mouth trouble thousand everybody stay usually air.,22,webb-inc,2023,USD,1277337,577807,699530,1088558,-389028,30095,-419123,12773,25546,-444669,46800,711091,180473,530618,,1277337,20.0,94.2,0.001,475,223.93,74055.03,0.63,0.5476
7199,Hanna-Reed,False,BR,Diaztown,E-commerce,2022,https://hanna-reed.com,Security throw design age at customer system those American quality.,16,hanna-reed,2023,USD,531330,119245,412085,88362,323723,29110,294613,5313,10626,283987,14830,360451,125647,234804,,531330,20.0,92.49,0.001,966,45.8,1000.0,14.83,0.7756
7200,Galloway-Petty,False,TN,North Paulaborough,Cybersecurity,2021,https://galloway-petty.com,Exist after remain serve institution act.,17,galloway-petty,2023,USD,574657,63074,511583,223503,288080,0,288080,5746,11493,276587,38042,330110,16505,313605,,574657,20.0,20.29,0.024,613,78.07,40859.42,0.93,0.8902
7201,Carter PLC,False,KE,Lake Johnland,AgriTech,2023,https://carterplc.com,American cell begin nothing cell up step support bag writer.,12,carter-plc,2023,USD,112974,39309,73665,19191,54474,28932,25542,1129,2259,23283,5668,246167,12865,233302,,112974,140.6,70.3,0.0346,59,157.02,1000.0,5.67,0.6521
7202,Miller Mcdonald and Camacho,False,US,Harrisonburgh,EdTech,2011,https://millermcdonaldandcamacho.com,Sell many resource night.,21,miller-mcdonald-and-camacho,2023,USD,72444,21676,50768,49713,1055,61288,-60233,724,1448,-61681,7194,88457,48325,40132,6037.0,72444,43.81,111.9,0.0141,771,7.83,1000.0,7.19,0.7008
7203,Chen LLC,False,NG,West Riley,SaaS,2018,https://chenllc.com,Beyond home real business develop.,17,chen-llc,2023,USD,2377513,1122975,1254538,118875,1135663,11543,1124120,23775,47550,1076570,2011737,3275222,1454082,1821140,198126.08,2377513,131.04,397.42,0.001,39625,5.0,3700.62,543.62,0.5277
7204,Hunt Case and Davis,False,DE,New Sherylbury,Marketplaces,2014,https://huntcaseanddavis.com,Worker nearly could job little would sort late dream.,23,hunt-case-and-davis,2023,EUR,278503,88304,190199,139107,51092,0,51092,2785,5570,45522,36090,341542,78000,263542,,278503,1142.96,4455.52,0.1241,57,406.4,23688.28,1.52,0.6829
7205,Johnson-Lee,False,KE,South Rachelberg,Energy,2013,https://johnson-lee.com,Instead table training tough land through down can who go.,17,johnson-lee,2023,USD,1309449,414144,895305,1278909,-383604,2711,-386315,13094,26188,-412503,376153,1102049,469228,632821,,1309449,391.42,948.52,0.0653,2461,44.33,87848.31,4.28,0.6837
7206,Chen Black and Barton,False,AU,Brianmouth,Mobility,2016,https://chenblackandbarton.com,Study try recent above medical note physical.,25,chen-black-and-barton,2023,USD,2119122,802779,1316343,1196402,119941,0,119941,21191,42382,77559,42496,1291090,631651,659439,,2119122,186.57,385.79,0.0149,8829,20.0,156472.27,0.27,0.6212
7207,Fields PLC,False,TN,New Kathrynstad,Energy,2021,https://fieldsplc.com,Network student effect consumer student everybody let main than begin.,16,fields-plc,2023,USD,3658562,1052139,2606423,1734587,871836,39418,832418,36585,73171,759247,21195,1988012,349458,1638554,,3658562,344.33,491.64,0.0368,15244,20.0,174147.85,0.12,0.7124
7208,White Garcia and Garcia,False,GB,Jasonside,Fintech,2019,https://whitegarciaandgarcia.com,Compare when past including.,19,white-garcia-and-garcia,2023,USD,648286,364585,283701,189419,94282,12915,81367,6482,12965,68402,31045,444242,113958,330284,,648286,20.0,120.5,0.0301,2021,26.73,45552.59,0.68,0.4376
7209,Fuentes Inc,False,KE,South Brandonshire,Fintech,2024,https://fuentesinc.com,Skill hold offer society fund.,26,fuentes-inc,2023,USD,482853,75370,407483,142290,265193,12376,252817,4828,9657,243160,31720,389817,112890,276927,,482853,866.22,433.11,0.0253,2011,20.0,6522.93,4.86,0.8439
7210,Oconnor Leonard and Robinson,False,DE,South Anthony,HealthTech,2023,https://oconnorleonardandrobinson.com,Item general color ball decide door why loss spend hair.,18,oconnor-leonard-and-robinson,2023,EUR,657666,227312,430354,608645,-178291,0,-178291,6576,13153,-191444,13427,400258,20012,380246,54805.5,657666,329.09,1751.82,0.0037,1157,47.35,71430.65,0.19,0.6544
7211,Garza PLC,False,US,New Lorichester,SaaS,2009,https://garzaplc.com,Point win business party plant first think.,20,garza-plc,2023,USD,3543749,1127401,2416348,3084746,-668398,36363,-704761,35437,70874,-775635,138694,1972779,569018,1403761,295312.42,3543749,368.59,1281.53,0.0423,2473,119.39,280641.25,0.49,0.6819
7212,Villegas-Miller,False,IN,Randyside,Energy,2021,https://villegas-miller.com,Lead decade grow animal after about region community box road forward.,21,villegas-miller,2023,USD,3691489,2081702,1609787,1333088,276699,33911,242788,36914,73829,168959,375079,2394011,119700,2274311,,3691489,20.0,55.44,0.0887,2525,121.8,137463.82,2.73,0.4361
7213,Anderson Lee and Smith,False,TN,Cooperside,Fintech,2017,https://andersonleeandsmith.com,Involve office bed student music production agree perform likely.,20,anderson-lee-and-smith,2023,USD,786774,226865,559909,239275,320634,29055,291579,7867,15735,275844,8922,561759,52594,509165,,786774,1760.87,7960.37,0.001,349,187.69,27140.79,0.33,0.7117
7214,Bentley Group,False,CA,Lake Theresamouth,Marketplaces,2008,https://bentleygroup.com,Television media single step body condition however factor star news.,19,bentley-group,2023,USD,258605,58121,200484,115471,85013,23066,61947,2586,5172,56775,11025,293123,187824,105299,,258605,57.83,221.86,0.0931,156,137.95,25416.31,0.43,0.7753
7215,Cardenas Graham and Nielsen,False,AU,New Dalechester,Fintech,2011,https://cardenasgrahamandnielsen.com,Mind protect least also animal.,21,cardenas-graham-and-nielsen,2023,USD,232036,111532,120504,69636,50868,0,50868,2320,4640,46228,8716,133734,49488,84246,,232036,80.0,156.6,0.0523,87,220.28,19986.75,0.44,0.5193
7216,Clements-Stone,False,US,Port Debraland,Mobility,2023,https://clements-stone.com,Quickly fly your task himself price easy show teacher.,16,clements-stone,2023,USD,4043064,1423224,2619840,1619988,999852,16701,983151,40430,80861,902290,55163,2170047,1122940,1047107,,4043064,734.1,367.05,0.0232,4748,70.96,176876.1,0.31,0.648
7217,Zuniga-Cummings,False,BR,East Michaelland,Mobility,2011,https://zuniga-cummings.com,Apply way what become college.,21,zuniga-cummings,2023,USD,318748,95947,222801,180891,41910,0,41910,3187,6374,35536,19676,208658,84795,123863,,318748,132.92,101.99,0.0155,356,74.6,9329.87,2.11,0.699
7218,Dixon and Sons,False,IN,South Mark,SaaS,2008,https://dixonandsons.com,Two time back activity serve experience.,21,dixon-and-sons,2023,USD,389415,124249,265166,254604,10562,0,10562,3894,7788,2774,185636,433162,192331,240831,32451.25,389415,260.28,1549.01,0.001,6490,5.0,1000.0,185.64,0.6809
7219,Campbell PLC,False,ZA,Cantufurt,Marketplaces,2016,https://campbellplc.com,It sit power operation at during make light career responsibility.,19,campbell-plc,2023,USD,233099,29224,203875,39949,163926,28179,135747,2330,4661,131086,49716,180735,10695,170040,,233099,241.35,437.7,0.0389,971,20.0,32720.98,1.52,0.8746
7220,Chavez-Stone,False,KE,Reedberg,EdTech,2010,https://chavez-stone.com,For training describe south.,23,chavez-stone,2023,USD,202509,102704,99805,86904,12901,31972,-19071,2025,4050,-23121,2486,171489,81944,89545,16875.75,202509,83.98,263.81,0.049,348,48.38,1000.0,2.49,0.4928
7221,Ross-Obrien,False,ZA,South Katelynfort,IoT,2016,https://ross-obrien.com,Edge health a point experience actually necessary eat.,20,ross-obrien,2023,USD,1132298,195511,936787,56614,880173,0,880173,11322,22645,857528,124612,702332,369343,332989,,1132298,713.19,1984.09,0.001,493,191.32,15389.03,8.1,0.8273
7222,Fitzgerald Richards and Hernandez,False,KE,Maryberg,SaaS,2018,https://fitzgeraldrichardsandhernandez.com,American practice something final beyond cause action end.,21,fitzgerald-richards-and-hernandez,2023,USD,2066460,229223,1837237,1218621,618616,0,618616,20664,41329,577287,85705,1290616,554720,735896,172205.0,2066460,10.0,32.47,0.0059,3565,48.3,117851.1,0.73,0.8891
7223,Bowman Hall and Wyatt,False,DE,Johnathanmouth,Marketplaces,2010,https://bowmanhallandwyatt.com,Popular history window allow money.,23,bowman-hall-and-wyatt,2023,EUR,781566,244793,536773,225713,311060,6778,304282,7815,15631,288651,41907,631831,124185,507646,,781566,786.31,3123.71,0.0481,640,101.63,1000.0,41.91,0.6868
7224,Mcdonald-Mccullough,False,CA,West Amy,HealthTech,2009,https://mcdonald-mccullough.com,Enter enter buy find behind speech foot.,30,mcdonald-mccullough,2023,USD,165794,74150,91644,128120,-36476,34505,-70981,1657,3315,-74296,12259,203073,86968,116105,13816.17,165794,275.07,609.33,0.001,249,55.29,17446.34,0.7,0.5528
7225,Richards and Sons,False,IN,Andersontown,IoT,2024,https://richardsandsons.com,Nothing open decision senior movie could half shake my success.,17,richards-and-sons,2023,USD,255722,75525,180197,61134,119063,2106,116957,2557,5114,111843,4271,212516,84906,127610,,255722,551.52,275.76,0.0496,178,119.68,1000.0,4.27,0.7047
7226,Jennings and Sons,False,US,Port Marthashire,IoT,2017,https://jenningsandsons.com,Morning resource color policy thousand western measure seven federal radio.,15,jennings-and-sons,2023,USD,217620,44552,173068,52476,120592,0,120592,2176,4352,116240,903,173800,96399,77401,,217620,528.67,2667.08,0.0622,128,141.26,4623.68,0.2,0.7953
7227,Scott-Glenn,False,BR,Nicolefurt,IoT,2023,https://scott-glenn.com,Prevent throughout father forward forward party you field apply.,15,scott-glenn,2023,USD,908415,331142,577273,295613,281660,12097,269563,9084,18168,251395,24287,645703,116307,529396,,908415,252.0,156.62,0.028,3785,20.0,9180.29,2.65,0.6355
7228,Bailey-Frey,False,TN,Charlesmouth,IoT,2024,https://bailey-frey.com,Final start forward open another article beat perhaps college yes.,23,bailey-frey,2023,USD,1203352,424954,778398,1004839,-226441,25956,-252397,12033,24067,-276464,210942,922659,158309,764350,,1203352,20.0,10.0,0.001,1892,53.0,102826.82,2.05,0.6469
7229,Schaefer Cooke and Simon,False,EG,Port Kevin,Marketplaces,2015,https://schaefercookeandsimon.com,Guy manager sometimes each history.,19,schaefer-cooke-and-simon,2023,USD,366334,152634,213700,190132,23568,0,23568,3663,7326,16242,40298,389256,181739,207517,,366334,1272.23,5096.83,0.0908,232,131.38,29434.36,1.37,0.5833
7230,Roth Johnson and Tran,False,BR,West Michaelside,Fintech,2014,https://rothjohnsonandtran.com,Specific per edge line star leg.,26,roth-johnson-and-tran,2023,USD,1387547,611065,776482,760844,15638,0,15638,13875,27750,-12112,25670,723340,170384,552956,,1387547,588.39,576.12,0.1005,1060,109.05,50762.99,0.51,0.5596
7231,Diaz Boone and Gonzalez,False,EG,Danielsberg,IoT,2022,https://diazbooneandgonzalez.com,Close now medical mission six subject.,24,diaz-boone-and-gonzalez,2023,USD,1095614,261655,833959,952701,-118742,0,-118742,10956,21912,-140654,17641,625642,82888,542754,,1095614,20.0,84.72,0.0637,592,153.97,52877.72,0.33,0.7612
7232,Castillo Walker and Sullivan,False,BR,Deannahaven,Fintech,2021,https://castillowalkerandsullivan.com,Defense hair stage push go.,23,castillo-walker-and-sullivan,2023,USD,680696,312998,367698,176160,191538,0,191538,6806,13613,177925,11042,503028,25151,477877,,680696,20.0,87.95,0.0334,2836,20.0,10198.7,1.08,0.5402
7233,Middleton Group,False,TN,Candicestad,IoT,2017,https://middletongroup.com,Wonder arm option Democrat remain family own lose.,14,middleton-group,2023,USD,352774,139884,212890,130989,81901,38244,43657,3527,7055,36602,15049,360050,18002,342048,,352774,20.0,61.24,0.014,174,168.12,18038.71,0.83,0.6035
7234,Krause-Kennedy,False,FR,Lake Jeffreyport,Energy,2020,https://krause-kennedy.com,Free rate ok entire.,17,krause-kennedy,2023,EUR,779125,194427,584698,346524,238174,1822,236352,7791,15582,220770,40221,540845,273889,266956,,779125,163.28,434.03,0.001,3246,20.0,58041.3,0.69,0.7505
7235,Rodriguez York and Campbell,False,FR,Sharonburgh,HealthTech,2014,https://rodriguezyorkandcampbell.com,Laugh poor suddenly collection unit allow imagine war alone whose if.,16,rodriguez-york-and-campbell,2023,EUR,1067387,229806,837581,563713,273868,0,273868,10673,21347,252521,57212,788719,339491,449228,88948.92,1067387,330.07,1705.6,0.0688,2448,36.33,51581.96,1.11,0.7847
7236,Myers Group,False,EG,Lake Debbie,AgriTech,2009,https://myersgroup.com,Relationship blue American back imagine ground audience.,16,myers-group,2023,USD,156410,77658,78752,106820,-28068,0,-28068,1564,3128,-31196,3555,166617,63375,103242,,156410,252.66,1632.34,0.0477,67,192.89,1000.0,3.56,0.5035
7237,Parks-Stafford,False,EG,Patrickside,Mobility,2016,https://parks-stafford.com,Discover program important worker not American field people play.,18,parks-stafford,2023,USD,1185675,397112,788563,417218,371345,0,371345,11856,23713,347632,26936,817412,323374,494038,,1185675,1197.79,3080.06,0.0161,576,171.53,20219.39,1.33,0.6651
7238,Phillips-Ramirez,False,DE,New Ashleyfort,EdTech,2013,https://phillips-ramirez.com,Social total report draw turn kitchen dinner democratic.,20,phillips-ramirez,2023,EUR,1173067,309087,863980,475397,388583,4123,384460,11730,23461,360999,6132,775087,144496,630591,97755.58,1173067,81.43,355.06,0.06,2464,39.66,33016.82,0.19,0.7365
7239,Reed PLC,False,AU,Lake Karlamouth,E-commerce,2021,https://reedplc.com,Also character important hear want.,23,reed-plc,2023,USD,1210213,496848,713365,1046175,-332810,943,-333753,12102,24204,-357957,115280,887416,158813,728603,,1210213,20.0,62.38,0.1059,5042,20.0,85970.23,1.34,0.5895
7240,Jackson Calhoun and Murillo,False,GB,North Brian,EdTech,2024,https://jacksoncalhounandmurillo.com,Fast left training wide short cause appear improve threat major space.,24,jackson-calhoun-and-murillo,2023,USD,196314,46023,150291,127181,23110,8365,14745,1963,3926,10819,84321,197002,64415,132587,16359.5,196314,10.0,44.83,0.001,1691,9.67,9215.44,9.15,0.7656
7241,Pena-Hunt,False,BR,West Margaret,IoT,2017,https://pena-hunt.com,Quite yet green need whose decide heavy course trouble type.,20,pena-hunt,2023,USD,220289,67904,152385,68739,83646,9103,74543,2202,4405,70138,2171,121052,26053,94999,,220289,72.45,152.17,0.0714,91,201.01,1000.0,2.17,0.6918
7242,Anderson-Gibson,False,KE,New James,IoT,2011,https://anderson-gibson.com,Better order that hold dream rule heart these study happy.,20,anderson-gibson,2023,USD,219549,115986,103563,41880,61683,0,61683,2195,4390,57293,12342,249229,145243,103986,,219549,883.94,3790.31,0.041,230,79.53,17453.78,0.71,0.4717
7243,Anderson Group,False,KE,Cunninghamshire,Mobility,2008,https://andersongroup.com,Small last authority history would write idea fact machine behind.,21,anderson-group,2023,USD,232909,76602,156307,64522,91785,29074,62711,2329,4658,58053,11614,276480,88528,187952,,232909,377.91,1257.64,0.1234,970,20.0,1000.0,11.61,0.6711
7244,Nguyen Group,False,FR,Lake Amy,Cybersecurity,2016,https://nguyengroup.com,Learn father glass law garden determine.,19,nguyen-group,2023,EUR,282215,52934,229281,190065,39216,8166,31050,2822,5644,25406,33927,264686,141854,122832,,282215,1201.32,4537.99,0.0294,133,175.9,1000.0,33.93,0.8124
7245,Schultz Hernandez and Hensley,False,GB,West Carrie,Energy,2012,https://schultzhernandezandhensley.com,Science official here bit bed control.,18,schultz-hernandez-and-hensley,2023,USD,462878,133575,329303,185149,144154,13488,130666,4628,9257,121409,31277,372042,179140,192902,,462878,20.0,83.27,0.1878,245,156.83,1000.0,31.28,0.7114
7246,Perry-Miller,False,US,East Chelsea,EdTech,2022,https://perry-miller.com,Government image similar coach power trial parent.,16,perry-miller,2023,USD,775629,462677,312952,554746,-241794,0,-241794,7756,15512,-257306,5640,451094,22554,428540,64635.75,775629,192.3,576.56,0.001,3371,19.17,66409.18,0.08,0.4035
7247,Parrish Group,False,US,Deanbury,AI/ML,2022,https://parrishgroup.com,Happen culture seem president fear fish none need trade into.,26,parrish-group,2023,USD,3126532,819821,2306711,1338563,968148,11724,956424,31265,62530,893894,371528,1962043,1113579,848464,,3126532,1056.99,4382.3,0.001,953,273.38,75792.54,4.9,0.7378
7248,Howard-Wilson,False,NG,South Codychester,HealthTech,2011,https://howard-wilson.com,No year statement especially someone send break.,20,howard-wilson,2023,USD,1845855,361215,1484640,987380,497260,5579,491681,18458,36917,454764,156632,1189175,129993,1059182,153821.25,1845855,207.66,1087.4,0.001,4609,33.37,93649.11,1.67,0.8043
7249,Smith Thompson and Allison,False,FR,South Heather,Energy,2009,https://smiththompsonandallison.com,Better popular responsibility money class site defense remain take.,18,smith-thompson-and-allison,2023,EUR,1178552,427963,750589,273960,476629,0,476629,11785,23571,453058,55879,663443,228742,434701,,1178552,1591.33,3667.91,0.0338,1116,87.97,31679.65,1.76,0.6369
7250,Martin Dillon and Lester,False,GB,North Kristina,Marketplaces,2008,https://martindillonandlester.com,Often run know federal home understand when card plan.,16,martin-dillon-and-lester,2023,USD,275838,159273,116565,157586,-41021,6453,-47474,2758,5516,-52990,3749,269115,137346,131769,,275838,20.0,76.53,0.001,215,106.67,1000.0,3.75,0.4226
7251,Torres LLC,False,BR,Randyborough,Marketplaces,2016,https://torresllc.com,Music may although recent.,23,torres-llc,2023,USD,1580744,402627,1178117,1160594,17523,16937,586,15807,31614,-31028,151719,1033035,654587,378448,,1580744,715.22,357.61,0.0269,552,238.51,105957.2,1.43,0.7453
7252,Thomas LLC,False,FR,Lake Jaime,AI/ML,2010,https://thomasllc.com,Soon prove drug machine work add responsibility.,18,thomas-llc,2023,EUR,562152,349614,212538,444335,-231797,13290,-245087,5621,11243,-256330,21088,475434,85538,389896,,562152,2349.95,9408.16,0.0931,319,146.59,51777.34,0.41,0.3781
7253,Sweeney Inc,False,DE,East Joseph,E-commerce,2024,https://sweeneyinc.com,Benefit study discover some conference send song.,15,sweeney-inc,2023,EUR,788295,277122,511173,610980,-99807,0,-99807,7882,15765,-115572,40628,609307,213052,396255,,788295,1037.05,5231.36,0.0167,294,222.96,62139.94,0.65,0.6485
7254,Ruiz-Galloway,False,KE,East Rose,AI/ML,2022,https://ruiz-galloway.com,Easy about however mention cell strong nation glass card tree.,16,ruiz-galloway,2023,USD,404524,213339,191185,20226,170959,15559,155400,4045,8090,147310,41397,409379,25041,384338,,404524,20.0,87.48,0.0742,112,298.81,23793.85,1.74,0.4726
7255,Berry Sanders and Chavez,False,GB,North Christopher,Fintech,2010,https://berrysandersandchavez.com,Way ability black food check often.,16,berry-sanders-and-chavez,2023,USD,96431,26496,69935,24361,45574,4669,40905,964,1928,38977,15870,216469,66131,150338,,96431,525.95,3107.44,0.0595,138,57.82,1000.0,15.87,0.7252
7256,Smith-Davenport,False,EG,Palmerchester,SaaS,2024,https://smith-davenport.com,Week do seem investment become would news building usually crime.,22,smith-davenport,2023,USD,1531441,622649,908792,732318,176474,22452,154022,15314,30628,123394,25546,864983,505004,359979,127620.08,1531441,989.35,2101.08,0.0157,9181,13.9,56031.58,0.46,0.5934
7257,Marshall Bailey and Hodges,False,BR,Adamville,IoT,2017,https://marshallbaileyandhodges.com,Any positive care full develop hour half.,15,marshall-bailey-and-hodges,2023,USD,386100,72791,313309,184601,128708,31865,96843,3861,7722,89121,15668,391715,190694,201021,,386100,20.0,88.6,0.0665,115,277.8,1000.0,15.67,0.8115
7258,Hobbs PLC,False,BR,South Jamie,AI/ML,2008,https://hobbsplc.com,Arrive dream here task somebody live seem himself agree recently.,17,hobbs-plc,2023,USD,983399,592660,390739,323100,67639,4686,62953,9833,19667,43286,31452,685132,341999,343133,,983399,20.0,99.71,0.001,4097,20.0,1000.0,31.45,0.3973
7259,Snyder PLC,False,FR,Jasonbury,AI/ML,2020,https://snyderplc.com,Writer generation across kind among special.,23,snyder-plc,2023,EUR,704197,237068,467129,604856,-137727,0,-137727,7041,14083,-151810,19483,545276,323646,221630,,704197,20.0,83.22,0.0658,2934,20.0,82015.02,0.24,0.6633
7260,Roberts and Sons,False,IN,Powellborough,AgriTech,2012,https://robertsandsons.com,Instead product matter drug husband response go.,20,roberts-and-sons,2023,USD,164203,23097,141106,77520,63586,0,63586,1642,3284,60302,70548,347642,233211,114431,,164203,20.0,92.75,0.1471,158,86.19,26754.62,2.64,0.8593
7261,Curtis-Barry,False,GB,North Susan,Fintech,2022,https://curtis-barry.com,System partner very ago back minute bed agree.,23,curtis-barry,2023,USD,89722,45373,44349,46595,-2246,0,-2246,897,1794,-4040,11726,148272,59075,89197,,89722,20.0,17.41,0.0195,36,203.78,15933.31,0.74,0.4943
7262,Buck-Bean,False,CA,Fordhaven,AI/ML,2024,https://buck-bean.com,Party ten friend understand son.,20,buck-bean,2023,USD,937078,225353,711725,225598,486127,5459,480668,9370,18741,461927,126072,610814,280863,329951,,937078,1909.62,9262.33,0.0471,287,271.54,45819.28,2.75,0.7595
7263,Webster Hayes and Jones,False,ZA,New Antonio,EdTech,2022,https://websterhayesandjones.com,Door enter learn not finally often century say.,16,webster-hayes-and-jones,2023,USD,139031,44473,94558,25247,69311,11664,57647,1390,2780,54867,18965,236997,170032,66965,11585.92,139031,138.35,687.08,0.0281,140,82.74,6625.32,2.86,0.6801
7264,Crawford-Bailey,False,NG,East Abigailburgh,E-commerce,2022,https://crawford-bailey.com,Expert whatever person do sound food someone.,22,crawford-bailey,2023,USD,1441046,340402,1100644,72052,1028592,38054,990538,14410,28820,961718,36132,919035,178369,740666,,1441046,20.0,117.63,0.135,517,231.99,42762.53,0.84,0.7638
7265,Duarte Group,False,US,Brandtfort,AI/ML,2013,https://duartegroup.com,Expect before thought analysis finally above answer store.,21,duarte-group,2023,USD,344543,93905,250638,158645,91993,2186,89807,3445,6890,82917,22369,319863,222456,97407,,344543,280.64,447.7,0.001,1435,20.0,36716.52,0.61,0.7275
7266,Archer-Gomez,False,US,Ravenville,SaaS,2016,https://archer-gomez.com,Black increase rate oil whom course arm.,16,archer-gomez,2023,USD,2418286,817769,1600517,1603140,-2623,31290,-33913,24182,48365,-82278,27812,1283447,864038,419409,201523.83,2418286,321.09,439.51,0.001,2422,83.18,128580.72,0.22,0.6618
7267,Martinez Inc,False,NG,Lake Patriciamouth,SaaS,2021,https://martinezinc.com,Step charge benefit class your expect.,17,martinez-inc,2023,USD,288869,144446,144423,55818,88605,16478,72127,2888,5777,66350,14293,217918,48312,169606,24072.42,288869,772.73,6184.04,0.0184,4814,5.0,1000.0,14.29,0.5
7268,Torres Ltd,False,EG,West Ashleymouth,E-commerce,2023,https://torresltd.com,Many control dark practice research.,14,torres-ltd,2023,USD,627694,196289,431405,309668,121737,0,121737,6276,12553,109184,89532,484183,162435,321748,,627694,804.48,3216.91,0.0085,254,205.86,62821.43,1.43,0.6873
7269,Willis Cortez and Wood,False,BR,Sarahside,Fintech,2013,https://williscortezandwood.com,Hotel best open cold administration.,16,willis-cortez-and-wood,2023,USD,2048777,664951,1383826,1420387,-36561,9484,-46045,20487,40975,-87020,117327,1213424,312572,900852,,2048777,20.0,42.03,0.0201,3695,46.2,119098.54,0.99,0.6754
7270,Barnes PLC,False,DE,Dannyton,Energy,2010,https://barnesplc.com,Ground miss bar production assume issue town chair box.,20,barnes-plc,2023,EUR,1698685,898766,799919,1028040,-228121,0,-228121,16986,33973,-262094,56779,948474,409483,538991,,1698685,755.11,4725.47,0.0763,7077,20.0,83350.93,0.68,0.4709
7271,Olson Ltd,False,IN,East Misty,IoT,2020,https://olsonltd.com,Cut bag me miss build building.,24,olson-ltd,2023,USD,990446,312596,677850,601880,75970,4899,71071,9904,19808,51263,103243,752359,185637,566722,,990446,706.23,962.06,0.0812,366,225.27,77574.2,1.33,0.6844
7272,Hernandez Inc,False,FR,Kevinberg,Marketplaces,2010,https://hernandezinc.com,Imagine finish hot American ground arm senior strong husband.,14,hernandez-inc,2023,EUR,111759,52373,59386,63460,-4074,47434,-51508,1117,2235,-53743,19945,240188,43971,196217,,111759,2407.09,10684.35,0.0995,108,85.79,3093.4,6.45,0.5314
7273,Torres-Graham,False,GB,Ryanborough,AI/ML,2023,https://torres-graham.com,Reflect design exactly western program gas.,13,torres-graham,2023,USD,3125887,500847,2625040,2285695,339345,127,339218,31258,62517,276701,79399,1708928,342468,1366460,,3125887,45.35,22.68,0.001,735,353.96,193306.74,0.41,0.8398
7274,Cunningham LLC,False,BR,West Kevin,IoT,2016,https://cunninghamllc.com,Wide nation security power answer magazine theory truth participant.,15,cunningham-llc,2023,USD,1914284,616796,1297488,297837,999651,0,999651,19142,38285,961366,39382,1071381,284741,786640,,1914284,1195.99,598.0,0.001,7976,20.0,14075.01,2.8,0.6778
7275,Jones Group,False,AU,West Maryland,HealthTech,2021,https://jonesgroup.com,Change deal move price west ten choice arm attorney result.,25,jones-group,2023,USD,7992196,2207933,5784263,4089993,1694270,0,1694270,79921,159843,1534427,443568,4454419,1199860,3254559,666016.33,7992196,742.87,3205.57,0.0677,133203,5.0,341294.96,1.3,0.7237
7276,Solomon Group,False,NG,Julieport,AI/ML,2012,https://solomongroup.com,Size sometimes others war arrive because feeling wall successful.,19,solomon-group,2023,USD,2910212,610503,2299709,1060681,1239028,5565,1233463,29102,58204,1175259,354504,1814692,1633222,181470,,2910212,322.2,1436.48,0.066,12125,20.0,83819.97,4.23,0.7902
7277,Silva Mcgee and Hill,False,EG,West Thomasburgh,Cybersecurity,2020,https://silvamcgeeandhill.com,Need word send cup over also.,17,silva-mcgee-and-hill,2023,USD,2583812,717432,1866380,1349545,516835,0,516835,25838,51676,465159,1425343,2722761,1196886,1525875,,2583812,20.0,118.81,0.1081,3371,63.86,123133.92,11.58,0.7223
7278,Howe-Mendez,False,KE,Tamaramouth,Marketplaces,2023,https://howe-mendez.com,Each serve yourself laugh power girl couple guy hit cell away.,18,howe-mendez,2023,USD,275686,86376,189310,140571,48739,0,48739,2756,5513,43226,17625,230639,89803,140836,,275686,768.67,4273.92,0.0484,1148,20.0,1000.0,17.62,0.6867
7279,Molina Smith and King,False,BR,Garciafort,Marketplaces,2009,https://molinasmithandking.com,Your rich drop top simple strong.,18,molina-smith-and-king,2023,USD,2532514,1605342,927172,1256360,-329188,0,-329188,25325,50650,-379838,54366,1413720,925971,487749,,2532514,20.0,54.68,0.0131,10552,20.0,109286.01,0.5,0.3661
7280,Martin Anderson and Johnson,False,IN,Fernandezton,SaaS,2019,https://martinandersonandjohnson.com,Campaign religious between whether go treat become recently while.,18,martin-anderson-and-johnson,2023,USD,616491,315426,301065,441147,-140082,29057,-169139,6164,12329,-181468,54952,389816,143884,245932,51374.25,616491,346.29,742.68,0.0559,678,75.69,44070.81,1.25,0.4884
7281,Hicks LLC,False,DE,North Patricia,Cybersecurity,2011,https://hicksllc.com,Court member prevent film response property right if during way region.,18,hicks-llc,2023,EUR,1399710,465394,934316,192608,741708,29344,712364,13997,27994,684370,110937,838955,371181,467774,,1399710,417.68,2340.61,0.001,1691,68.96,1000.0,110.94,0.6675
7282,Lopez-Guzman,False,IN,Kaylamouth,Fintech,2021,https://lopez-guzman.com,Congress west social add never its late house but seek.,19,lopez-guzman,2023,USD,844909,323743,521166,520729,437,9076,-8639,8449,16898,-25537,23910,631020,279300,351720,,844909,512.74,1344.28,0.001,396,177.4,45220.1,0.53,0.6168
7283,Riley Ltd,False,FR,Jasonburgh,E-commerce,2021,https://rileyltd.com,Six base character draw list fear out because party.,19,riley-ltd,2023,EUR,758109,346034,412075,302419,109656,14183,95473,7581,15162,80311,88191,570623,179496,391127,,758109,2345.17,1172.58,0.1073,1948,32.43,41848.5,2.11,0.5436
7284,Lopez PLC,False,US,Brendaland,Mobility,2015,https://lopezplc.com,I treatment who college think religious project up.,23,lopez-plc,2023,USD,1956072,1145711,810361,1251875,-441514,0,-441514,19560,39121,-480635,124496,1225296,287693,937603,,1956072,805.15,402.58,0.1674,8150,20.0,65938.4,1.89,0.4143
7285,Williams PLC,False,GB,Craigland,Mobility,2017,https://williamsplc.com,Test wonder would power tree with voice I build series off.,22,williams-plc,2023,USD,790355,208012,582343,93508,488835,6472,482363,7903,15807,466556,13643,586291,202806,383485,,790355,41.29,140.93,0.0874,745,88.3,19006.02,0.72,0.7368
7286,Phillips Ltd,False,BR,West Luisfurt,Cybersecurity,2015,https://phillipsltd.com,So from policy send popular law rest born career.,24,phillips-ltd,2023,USD,5840796,1334727,4506069,292039,4214030,15613,4198417,58407,116815,4081602,1313830,4383071,1442962,2940109,,5840796,887.39,6332.04,0.0615,6416,75.86,1000.0,1313.83,0.7715
7287,Harris Hernandez and Mitchell,False,CA,South Kimberly,Cybersecurity,2020,https://harrishernandezandmitchell.com,Consumer through fear allow audience understand.,22,harris-hernandez-and-mitchell,2023,USD,1631412,341086,1290326,1301104,-10778,12588,-23366,16314,32628,-55994,31429,891131,44556,846575,,1631412,988.47,5204.82,0.0581,6797,20.0,98461.1,0.32,0.7909
7288,Mendoza and Sons,False,CA,Ryanborough,Fintech,2022,https://mendozaandsons.com,Able onto attention animal prepare everybody.,18,mendoza-and-sons,2023,USD,1865176,888368,976808,490882,485926,0,485926,18651,37303,448623,166022,1183014,415056,767958,,1865176,431.61,215.8,0.0658,680,228.49,14751.31,11.25,0.5237
7289,Gray Price and Aguilar,False,KE,Sullivanville,Marketplaces,2020,https://graypriceandaguilar.com,Worker outside hot paper itself whom former.,20,gray-price-and-aguilar,2023,USD,1027772,481949,545823,296602,249221,0,249221,10277,20555,228666,105855,622268,436621,185647,,1027772,20.0,47.39,0.001,533,160.67,1000.0,105.86,0.5311
7290,Mueller-Green,False,GB,East Hollyville,AgriTech,2009,https://mueller-green.com,Detail there protect management realize street different yes hospital.,17,mueller-green,2023,USD,91905,32337,59568,29527,30041,5851,24190,919,1838,22352,5824,208191,115673,92518,,91905,757.3,3019.02,0.0869,382,20.0,1000.0,5.82,0.6481
7291,Smith PLC,False,KE,North Jacobfurt,Energy,2017,https://smithplc.com,Throw behavior also table not food firm question.,25,smith-plc,2023,USD,3666422,1044139,2622283,876341,1745942,0,1745942,36664,73328,1672614,124413,2131392,1435417,695975,,3666422,537.47,2279.48,0.001,3559,85.83,94835.27,1.31,0.7152
7292,Maxwell Mclean and Hanson,False,KE,Cranestad,Energy,2020,https://maxwellmcleanandhanson.com,Soon moment policy believe lawyer too worker admit.,20,maxwell-mclean-and-hanson,2023,USD,2226300,825552,1400748,298917,1101831,3367,1098464,22263,44526,1053938,36233,1343972,600617,743355,,2226300,1344.44,3170.2,0.001,1675,110.75,13163.37,2.75,0.6292
7293,Kane Taylor and Bruce,False,NG,Mezashire,EdTech,2016,https://kanetaylorandbruce.com,Against together improve property.,17,kane-taylor-and-bruce,2023,USD,129408,78773,50635,23477,27158,20431,6727,1294,2588,4139,12189,131319,27016,104303,10784.0,129408,178.91,1091.29,0.0268,258,41.77,12030.88,1.01,0.3913
7294,King-Adams,False,KE,North Devon,Energy,2008,https://king-adams.com,Major prepare receive interest finish region.,20,king-adams,2023,USD,2555799,946302,1609497,1673753,-64256,5324,-69580,25557,51115,-120695,36800,1467664,650447,817217,,2555799,20.0,57.45,0.0656,1510,140.96,160345.17,0.23,0.6297
7295,Wilson Group,False,IN,North Sarahbury,Mobility,2024,https://wilsongroup.com,Guess likely yourself its collection drug view.,10,wilson-group,2023,USD,1604864,359677,1245187,749423,495764,13087,482677,16048,32097,450580,129676,982995,463999,518996,,1604864,679.19,789.12,0.056,6686,20.0,68679.93,1.89,0.7759
7296,Ryan Inc,False,IN,Lake Michael,HealthTech,2010,https://ryaninc.com,Difficult cup section have loss back.,21,ryan-inc,2023,USD,506519,252378,254141,361613,-107472,15504,-122976,5065,10130,-133106,18324,403734,102187,301547,42209.92,506519,1014.66,1014.66,0.0304,532,79.2,15978.33,1.15,0.5017
7297,Atkins-Lowery,False,EG,Amberville,SaaS,2012,https://atkins-lowery.com,Prevent send occur carry feeling method must seat.,19,atkins-lowery,2023,USD,2681225,960280,1720945,242835,1478110,0,1478110,26812,53624,1424486,224333,1717599,600099,1117500,223435.42,2681225,388.69,3266.97,0.0231,44687,5.0,22929.52,9.78,0.6419
7298,Nelson-Marks,False,NG,West Mark,E-commerce,2011,https://nelson-marks.com,Fire social fall item prevent.,26,nelson-marks,2023,USD,1394457,293690,1100767,568695,532072,0,532072,13944,27889,504183,43391,882609,491645,390964,,1394457,20.0,12.47,0.0631,5810,20.0,46686.26,0.93,0.7894
7299,Ward Group,False,TN,Lake Kennethfort,HealthTech,2013,https://wardgroup.com,Middle couple choose support ever game member.,23,ward-group,2023,USD,560742,206177,354565,324918,29647,0,29647,5607,11214,18433,30960,479027,202295,276732,46728.5,560742,522.73,2916.29,0.0745,668,69.9,17620.01,1.76,0.6323
7300,Smith PLC,False,CA,Robertfurt,IoT,2015,https://smithplc.com,Protect feel yourself society law sense moment if our.,16,smith-plc,2023,USD,1488887,269982,1218905,876139,342766,21756,321010,14888,29777,291233,57442,850892,305375,545517,,1488887,20.0,68.77,0.0446,6203,20.0,64639.43,0.89,0.8187
7301,Welch LLC,False,BR,Christopherburgh,Energy,2016,https://welchllc.com,Card allow course into opportunity quickly certain mean.,19,welch-llc,2023,USD,3332056,625070,2706986,434861,2272125,7776,2264349,33320,66641,2197708,62372,1743823,497272,1246551,,3332056,472.32,236.16,0.0995,5069,54.77,49729.14,1.25,0.8124
7302,Graham Ortiz and Bridges,False,NG,Port Roberto,AI/ML,2012,https://grahamortizandbridges.com,Save successful any college decide until.,19,graham-ortiz-and-bridges,2023,USD,368144,134926,233218,100462,132756,11528,121228,3681,7362,113866,57885,438422,49461,388961,,368144,20.0,19.9,0.0832,1533,20.0,1000.0,57.88,0.6335
7303,Ruiz Ltd,False,US,East Shawnborough,AI/ML,2015,https://ruizltd.com,Else summer change former teach section page popular.,21,ruiz-ltd,2023,USD,298444,131595,166849,155225,11624,23349,-11725,2984,5968,-17693,3733,215082,72366,142716,,298444,20.0,113.64,0.0349,150,165.52,1404.01,2.66,0.5591
7304,Aguirre Walter and Hull,False,IN,West Ashley,AI/ML,2020,https://aguirrewalterandhull.com,Nation identify argue draw television performance.,16,aguirre-walter-and-hull,2023,USD,615433,289825,325608,332550,-6942,44440,-51382,6154,12308,-63690,90470,462949,23147,439802,,615433,20.0,59.68,0.0238,499,102.61,29420.12,3.08,0.5291
7305,Baxter PLC,False,NG,East Kaylaview,Cybersecurity,2024,https://baxterplc.com,Scientist daughter scientist successful continue once.,19,baxter-plc,2023,USD,1636806,420075,1216731,656630,560101,25770,534331,16368,32736,501595,22664,1005536,403214,602322,,1636806,1307.37,9251.84,0.0908,1297,105.16,74684.52,0.3,0.7434
7306,Berry-Mendez,False,DE,Jillhaven,IoT,2009,https://berry-mendez.com,Data establish usually direction realize.,24,berry-mendez,2023,EUR,265454,39244,226210,253289,-27079,0,-27079,2654,5309,-32388,1952,315583,136997,178586,,265454,386.27,1687.68,0.001,197,112.15,4389.9,0.44,0.8522
7307,Vasquez-Sanders,False,TN,Lewisbury,HealthTech,2016,https://vasquez-sanders.com,Magazine east leave mother example probably.,26,vasquez-sanders,2023,USD,222802,105087,117715,179124,-61409,9305,-70714,2228,4456,-75170,3902,122965,6148,116817,18566.83,222802,205.25,409.6,0.1114,463,40.03,44615.02,0.09,0.5283
7308,Weaver White and Smith,False,TN,Katherineville,Mobility,2012,https://weaverwhiteandsmith.com,Believe animal military myself throughout our improve.,15,weaver-white-and-smith,2023,USD,1731963,951447,780516,612229,168287,0,168287,17319,34639,133648,26389,1028177,289305,738872,,1731963,20.0,36.43,0.0495,708,203.83,76302.81,0.35,0.4507
7309,Burke-Chavez,False,AU,Mcfarlandville,AI/ML,2022,https://burke-chavez.com,Himself when sort early increase.,19,burke-chavez,2023,USD,160207,34913,125294,69836,55458,0,55458,1602,3204,52254,8821,164812,121461,43351,,160207,989.64,5113.18,0.0597,51,259.43,1000.0,8.82,0.7821
7310,Franco-Johnson,False,KE,Woodsbury,IoT,2010,https://franco-johnson.com,Image establish election enough never reality name oil.,21,franco-johnson,2023,USD,1104461,273302,831159,139558,691601,0,691601,11044,22089,669512,109241,842453,60426,782027,,1104461,1291.76,3908.85,0.0695,484,189.82,38393.79,2.85,0.7525
7311,Shaw-Boyd,False,TN,East Ashleymouth,SaaS,2010,https://shaw-boyd.com,Another respond especially thus quickly present employee identify threat something it.,22,shaw-boyd,2023,USD,814820,212204,602616,58294,544322,0,544322,8148,16296,528026,129414,690035,466047,223988,67901.67,814820,67.12,232.3,0.0401,1354,50.13,8310.54,15.57,0.7396
7312,Mahoney-Delacruz,False,FR,Stantonmouth,AgriTech,2010,https://mahoney-delacruz.com,Heart increase thing some arm report.,15,mahoney-delacruz,2023,EUR,747373,397807,349566,189267,160299,39770,120529,7473,14947,105582,172562,705596,167273,538323,,747373,1231.81,615.9,0.001,458,135.78,46587.7,3.7,0.4677
7313,Snyder Lyons and Mccarthy,False,DE,Stewartborough,Fintech,2015,https://snyderlyonsandmccarthy.com,Popular mouth crime radio around realize fly lead heart.,33,snyder-lyons-and-mccarthy,2023,EUR,3280031,465068,2814963,817692,1997271,64701,1932570,32800,65600,1866970,497169,2208330,602968,1605362,,3280031,20.0,73.11,0.0333,10719,25.5,62684.0,7.93,0.8582
7314,Medina-Johnson,False,CA,Port Tyler,Marketplaces,2013,https://medina-johnson.com,Impact discussion necessary these attention along them parent western nation.,30,medina-johnson,2023,USD,2202404,341771,1860633,529001,1331632,0,1331632,22024,44048,1287584,57817,1299413,203788,1095625,,2202404,566.01,1805.1,0.0815,9176,20.0,46652.6,1.24,0.8448
7315,Newton-Jones,False,DE,Nicolebury,Cybersecurity,2021,https://newton-jones.com,Line indeed should require one investment so.,22,newton-jones,2023,EUR,507196,240416,266780,350145,-83365,0,-83365,5071,10143,-93508,11050,310223,34014,276209,,507196,362.52,814.64,0.001,2113,20.0,47334.63,0.23,0.526
7316,Villarreal LLC,False,FR,New Timothy,EdTech,2014,https://villarrealllc.com,Special down live early ball power.,24,villarreal-llc,2023,EUR,287831,105236,182595,64849,117746,15975,101771,2878,5756,96015,3278,269715,90581,179134,23985.92,287831,10.0,30.5,0.0054,639,37.51,4044.31,0.81,0.6344
7317,Morris Inc,False,EG,East Adrienne,Cybersecurity,2021,https://morrisinc.com,Message face what herself television.,17,morris-inc,2023,USD,456828,208067,248761,316434,-67673,34266,-101939,4568,9136,-111075,11606,412951,196830,216121,,456828,217.71,1211.19,0.001,817,46.59,33578.71,0.35,0.5445
7318,Harris Inc,False,US,Joshuaville,E-commerce,2013,https://harrisinc.com,Collection no animal seven value if.,23,harris-inc,2023,USD,2946089,867899,2078190,423048,1655142,0,1655142,29460,58921,1596221,331389,1857521,904194,953327,,2946089,779.5,4474.7,0.0772,12275,20.0,6758.4,49.03,0.7054
7319,Adams Group,False,DE,Port Deannashire,SaaS,2016,https://adamsgroup.com,Professional range heavy machine report side.,29,adams-group,2023,EUR,2661892,1527613,1134279,1687825,-553546,10826,-564372,26618,53237,-617609,182498,1584367,397714,1186653,221824.33,2661892,10.0,46.61,0.0089,44364,5.0,145058.14,1.26,0.4261
7320,Werner-Krause,False,CA,South Nicole,AI/ML,2024,https://werner-krause.com,Anything end resource former around production especially fund now friend.,14,werner-krause,2023,USD,1523747,878924,644823,427259,217564,31054,186510,15237,30474,156036,64427,977801,90249,887552,,1523747,1272.06,2309.14,0.031,505,251.15,40371.23,1.6,0.4232
7321,Riggs Riley and Hughes,False,FR,West Joseph,Energy,2018,https://riggsrileyandhughes.com,Cut parent recent can style despite training light toward teach.,18,riggs-riley-and-hughes,2023,EUR,536464,94156,442308,53273,389035,15897,373138,5364,10729,362409,157364,612488,187670,424818,,536464,359.29,598.75,0.1067,409,109.08,26128.84,6.02,0.8245
7322,Pierce-Coffey,False,AU,Stewartton,Cybersecurity,2008,https://pierce-coffey.com,Require happen financial state amount girl.,20,pierce-coffey,2023,USD,4606094,963385,3642709,2289772,1352937,25930,1327007,46060,92121,1234886,214160,2596440,1435866,1160574,,4606094,20.0,38.19,0.0144,2264,169.52,169455.72,1.26,0.7908
7323,Mendez-Case,False,GB,Jennamouth,E-commerce,2016,https://mendez-case.com,Hospital girl couple common morning trial us street right benefit.,14,mendez-case,2023,USD,4607568,2467196,2140372,1819459,320913,21856,299057,46075,92151,206906,227680,2662753,938694,1724059,,4607568,20.0,69.78,0.1089,19198,20.0,156841.04,1.45,0.4645
7324,Moreno and Sons,False,AU,Williamsside,AgriTech,2023,https://morenoandsons.com,Indeed unit happy table every player official.,26,moreno-and-sons,2023,USD,344776,215043,129733,134497,-4764,0,-4764,3447,6895,-11659,12531,195086,68956,126130,,344776,20.0,93.32,0.1047,1436,20.0,1000.0,12.53,0.3763
7325,Baker LLC,False,GB,Bryanland,AgriTech,2011,https://bakerllc.com,Back certain region commercial region article garden he collection.,25,baker-llc,2023,USD,95348,53563,41785,37635,4150,5810,-1660,953,1906,-3566,36852,250176,56057,194119,,95348,1241.98,4169.17,0.0784,100,79.01,1000.0,36.85,0.4382
7326,Potter-Jones,False,KE,Hammondchester,Fintech,2021,https://potter-jones.com,Perform crime large visit.,20,potter-jones,2023,USD,2617512,1032494,1585018,905026,679992,5851,674141,26175,52350,621791,259048,1637618,377533,1260085,,2617512,291.3,558.39,0.0439,10906,20.0,68546.4,3.78,0.6055
7327,Ortiz Gonzales and Chen,False,CA,Thompsonshire,Marketplaces,2009,https://ortizgonzalesandchen.com,Send true mean after serious garden under draw road.,14,ortiz-gonzales-and-chen,2023,USD,996661,238403,758258,776988,-18730,41072,-59802,9966,19933,-79735,85360,658717,187760,470957,,996661,427.38,2002.06,0.001,303,273.72,85094.22,1.0,0.7608
7328,Moore-Guzman,False,DE,East Thomasfurt,Cybersecurity,2017,https://moore-guzman.com,Often director white understand simply how with.,21,moore-guzman,2023,EUR,2687769,134388,2553381,929271,1624110,0,1624110,26877,53755,1570355,135744,1643477,693467,950010,,2687769,1393.29,2030.73,0.1063,1052,212.89,41748.11,3.25,0.95
7329,Lozano Howard and Gonzalez,False,IN,Greenville,SaaS,2021,https://lozanohowardandgonzalez.com,Former past oil continue tough ever anything it.,22,lozano-howard-and-gonzalez,2023,USD,1318217,515569,802648,899295,-96647,20125,-116772,13182,26364,-143136,36131,751336,342351,408985,109851.42,1318217,682.95,3674.56,0.059,1535,71.56,104302.37,0.35,0.6089
7330,Thomas Velasquez and Davis,False,TN,Bakerville,Fintech,2023,https://thomasvelasquezanddavis.com,Top hand senior together difficult month any.,20,thomas-velasquez-and-davis,2023,USD,1779779,471887,1307892,433412,874480,0,874480,17797,35595,838885,19103,1063876,334001,729875,,1779779,1023.66,511.83,0.001,930,159.32,17150.26,1.11,0.7349
7331,Barker LLC,False,AU,Lake Lisastad,Cybersecurity,2023,https://barkerllc.com,Down whom let ok heart.,23,barker-llc,2023,USD,2316810,930405,1386405,2304709,-918304,4134,-922438,23168,46336,-968774,76904,1379510,617196,762314,,2316810,20.0,76.07,0.1316,1430,134.96,154476.62,0.5,0.5984
7332,Stephens-Hicks,False,ZA,New Catherineview,Fintech,2024,https://stephens-hicks.com,Which all seat sell five.,15,stephens-hicks,2023,USD,3365566,1458347,1907219,2016528,-109309,13411,-122720,33655,67311,-190031,103891,1874629,525928,1348701,,3365566,1334.95,2602.63,0.0786,1500,186.88,158972.11,0.65,0.5667
7333,Miller-Lamb,False,GB,West Bradleyburgh,Cybersecurity,2016,https://miller-lamb.com,Billion painting artist who TV especially fact factor method certainly.,22,miller-lamb,2023,USD,558459,197201,361258,135906,225352,26745,198607,5584,11169,187438,13264,295468,118518,176950,,558459,20.0,10.0,0.1354,179,258.83,8509.61,1.56,0.6469
7334,Schmitt Group,False,KE,Johnathanville,AI/ML,2009,https://schmittgroup.com,Official drive white model child.,23,schmitt-group,2023,USD,2109727,680729,1428998,1174075,254923,162,254761,21097,42194,212567,26195,1179220,894267,284953,,2109727,811.11,2908.51,0.0342,1083,162.19,110992.44,0.24,0.6773
7335,Ramirez-Phelps,False,NG,Kingfort,AI/ML,2008,https://ramirez-phelps.com,We rule test computer carry.,20,ramirez-phelps,2023,USD,1387121,622168,764953,682543,82410,27228,55182,13871,27742,27440,50454,852832,219091,633741,,1387121,569.72,2247.75,0.001,1119,103.22,28606.44,1.76,0.5515
7336,Jones Leonard and Craig,False,TN,Victorland,Mobility,2012,https://jonesleonardandcraig.com,Type suggest amount affect American senior create none.,23,jones-leonard-and-craig,2023,USD,349339,74934,274405,169557,104848,0,104848,3493,6986,97862,14502,321848,71230,250618,,349339,346.47,173.24,0.0774,506,57.53,53664.63,0.27,0.7855
7337,Carrillo Freeman and Robinson,False,FR,Kathleenstad,AgriTech,2010,https://carrillofreemanandrobinson.com,Machine some discussion somebody enjoy character attack decade.,17,carrillo-freeman-and-robinson,2023,EUR,943236,214680,728556,281664,446892,11611,435281,9432,18864,416417,4126,490730,265666,225064,,943236,20.0,69.85,0.044,3930,20.0,19962.4,0.21,0.7724
7338,Jensen-Rodriguez,False,EG,Paulshire,AgriTech,2021,https://jensen-rodriguez.com,The unit word various alone no simply almost image staff.,18,jensen-rodriguez,2023,USD,73653,17115,56538,8531,48007,18987,29020,736,1473,27547,11898,241410,115548,125862,,73653,20.0,121.84,0.0034,40,151.51,1000.0,11.9,0.7676
7339,Lawson-Owen,False,NG,Schmidtmouth,Fintech,2015,https://lawson-owen.com,How society walk maybe second professional surface.,19,lawson-owen,2023,USD,1993158,445817,1547341,670917,876424,0,876424,19931,39863,836561,173308,1364842,68242,1296600,,1993158,356.65,1265.63,0.0448,1834,90.54,62983.25,2.75,0.7763
7340,Zuniga Ltd,False,CA,Schneiderborough,IoT,2013,https://zunigaltd.com,Always life board this heavy.,20,zuniga-ltd,2023,USD,1257149,441662,815487,1104979,-289492,0,-289492,12571,25142,-314634,84559,730026,134056,595970,,1257149,759.99,3198.25,0.0349,770,136.05,57768.12,1.46,0.6487
7341,Pham Jenkins and Smith,False,TN,Justinhaven,Marketplaces,2020,https://phamjenkinsandsmith.com,Last stay consumer admit rate life.,16,pham-jenkins-and-smith,2023,USD,802942,287766,515176,91264,423912,4487,419425,8029,16058,403367,56357,563256,288303,274953,,802942,966.3,2544.66,0.0659,528,126.49,7059.57,7.98,0.6416
7342,Mejia French and Campbell,False,IN,Port Brianside,AI/ML,2021,https://mejiafrenchandcampbell.com,Thank investment ground near learn exist term whom.,19,mejia-french-and-campbell,2023,USD,1729332,565070,1164262,1353189,-188927,6269,-195196,17293,34586,-229782,474270,1351974,1027743,324231,,1729332,527.05,1282.05,0.0972,931,154.75,73061.76,6.49,0.6732
7343,Warner and Sons,False,KE,Hudsonhaven,Marketplaces,2015,https://warnerandsons.com,Gas play without television design race development buy next than.,17,warner-and-sons,2023,USD,107320,21218,86102,81064,5038,7738,-2700,1073,2146,-4846,90958,293326,56825,236501,,107320,20.0,110.88,0.083,104,85.73,1000.0,90.96,0.8023
7344,Levine Inc,False,ZA,Anthonyview,IoT,2020,https://levineinc.com,It behind rest for point answer set part.,18,levine-inc,2023,USD,277659,138181,139478,31269,108209,0,108209,2776,5553,102656,5750,146754,21130,125624,,277659,20.0,54.87,0.001,953,24.27,1000.0,5.75,0.5023
7345,Thornton Wagner and Burch,False,ZA,New Erica,IoT,2022,https://thorntonwagnerandburch.com,Central operation career including build nature foreign study management.,33,thornton-wagner-and-burch,2023,USD,3429937,1048166,2381771,171496,2210275,25071,2185204,34299,68598,2116606,94320,1964508,98225,1866283,,3429937,20.0,112.47,0.001,5022,56.91,6429.14,14.67,0.6944
7346,Vargas-Morris,False,IN,Lake Kenneth,AI/ML,2020,https://vargas-morris.com,Low push pattern themselves size.,12,vargas-morris,2023,USD,573529,186974,386555,271511,115044,0,115044,5735,11470,103574,148472,584466,399375,185091,,573529,20.0,108.6,0.0822,178,267.51,34912.69,4.25,0.674
7347,Gamble Ltd,False,KE,North Deborah,AgriTech,2010,https://gambleltd.com,Feeling street born coach step.,23,gamble-ltd,2023,USD,581517,187110,394407,518026,-123619,0,-123619,5815,11630,-135249,30127,419714,80560,339154,,581517,20.0,35.88,0.0918,2422,20.0,44590.25,0.68,0.6782
7348,Hardy-Smith,False,CA,Scottburgh,E-commerce,2016,https://hardy-smith.com,Some final industry laugh all maybe available.,16,hardy-smith,2023,USD,601969,147375,454594,237966,216628,3088,213540,6019,12039,201501,12072,374119,28928,345191,,601969,20.0,122.19,0.0886,2508,20.0,23197.3,0.52,0.7552
7349,Cook-Soto,False,CA,Port Davidtown,Marketplaces,2009,https://cook-soto.com,Realize people either hotel left indicate sure day choose economy.,18,cook-soto,2023,USD,282771,104171,178600,87964,90636,29780,60856,2827,5655,55201,307667,453930,258745,195185,,282771,1397.36,2970.77,0.0092,197,119.33,32817.61,9.38,0.6316
7350,Rojas Group,False,FR,East Amandabury,Fintech,2012,https://rojasgroup.com,You day big community American candidate throw run service yet.,22,rojas-group,2023,EUR,202548,60334,142214,37849,104365,0,104365,2025,4050,100315,78076,270853,120965,149888,,202548,739.01,3844.86,0.0525,843,20.0,2002.07,39.0,0.7021
7351,Garcia Leonard and Contreras,False,ZA,Larsonside,IoT,2013,https://garcialeonardandcontreras.com,Race high population owner situation.,15,garcia-leonard-and-contreras,2023,USD,2033294,579893,1453401,899278,554123,0,554123,20332,40665,513458,97181,1172270,644294,527976,,2033294,20.0,26.79,0.1037,2247,75.39,82143.08,1.18,0.7148
7352,Henderson Coleman and Rice,False,US,Hughesport,Marketplaces,2023,https://hendersoncolemanandrice.com,Somebody region listen forget whom real those paper although.,19,henderson-coleman-and-rice,2023,USD,1836232,723547,1112685,780984,331701,0,331701,18362,36724,294977,22103,1111955,660793,451162,,1836232,866.74,2924.78,0.0533,574,266.46,54395.71,0.41,0.606
7353,Schwartz Murphy and Carter,False,CA,Kristiton,EdTech,2020,https://schwartzmurphyandcarter.com,Wish avoid new keep land.,17,schwartz-murphy-and-carter,2023,USD,137954,24850,113104,92190,20914,0,20914,1379,2759,18155,2288,131651,6582,125069,11496.17,137954,172.33,1293.07,0.0511,182,63.07,6209.54,0.37,0.8199
7354,Hughes Inc,False,ZA,Murphyfurt,SaaS,2019,https://hughesinc.com,Father again wonder affect exist tough.,23,hughes-inc,2023,USD,1763527,699293,1064234,1796264,-732030,0,-732030,17635,35270,-767300,11286,1069941,443037,626904,146960.58,1763527,673.16,3179.94,0.0431,29392,5.0,117046.92,0.1,0.6035
7355,Hicks-Wagner,False,FR,Jessicashire,Fintech,2023,https://hicks-wagner.com,Point difficult nothing might step network follow.,26,hicks-wagner,2023,EUR,3254134,967507,2286627,906897,1379730,26528,1353202,32541,65082,1288120,356599,2086531,162856,1923675,,3254134,596.68,1907.64,0.001,736,368.0,69429.34,5.14,0.7027
7356,Elliott Group,False,FR,East Shane,Energy,2009,https://elliottgroup.com,Project remain health wind live.,21,elliott-group,2023,EUR,1519891,671148,848743,606525,242218,26068,216150,15198,30397,185753,326869,1161475,512404,649071,,1519891,1812.39,8760.86,0.1172,6332,20.0,61354.1,5.33,0.5584
7357,Holland LLC,False,DE,Lake Edward,IoT,2020,https://hollandllc.com,Black rule result Democrat send.,17,holland-llc,2023,EUR,475858,115861,359997,237323,122674,0,122674,4758,9517,113157,32770,317257,154253,163004,,475858,1007.47,6291.38,0.0079,1982,20.0,42288.09,0.77,0.7565
7358,Torres-Coleman,False,DE,Turnershire,Energy,2018,https://torres-coleman.com,Officer party floor charge lead ask discussion chance rule role.,16,torres-coleman,2023,EUR,10695190,2869075,7826115,4747328,3078787,2100,3076687,106951,213903,2862784,445276,5910318,2415436,3494882,,10695190,1504.21,2076.34,0.0972,15250,58.44,389102.07,1.14,0.7317
7359,Carr Ltd,False,DE,North Kristishire,Energy,2012,https://carrltd.com,Man challenge court former understand relationship purpose present.,20,carr-ltd,2023,EUR,2025807,1050080,975727,1765891,-790164,14676,-804840,20258,40516,-845356,15833,1156566,475014,681552,,2025807,20.0,54.71,0.0603,775,217.67,161618.05,0.1,0.4816
7360,Robinson-Garrett,False,FR,Sierraton,AI/ML,2016,https://robinson-garrett.com,During power to send situation group fear.,22,robinson-garrett,2023,EUR,373764,175173,198591,148768,49823,12223,37600,3737,7475,30125,1720,304245,20758,283487,,373764,20.0,61.58,0.0573,1557,20.0,28318.96,0.06,0.5313
7361,Torres Inc,False,CA,West Shawnshire,E-commerce,2009,https://torresinc.com,Purpose capital interest what use sit.,21,torres-inc,2023,USD,2047292,577743,1469549,615019,854530,15707,838823,20472,40945,797878,58287,1229390,242844,986546,,2047292,20.0,71.14,0.0518,576,296.0,52494.33,1.11,0.7178
7362,Williams Thornton and Brown,False,TN,South Tyrone,Mobility,2008,https://williamsthorntonandbrown.com,Near at evening attack.,23,williams-thornton-and-brown,2023,USD,1512166,615187,896979,75608,821371,3448,817923,15121,30243,787680,95251,873878,195938,677940,,1512166,236.85,1211.14,0.0401,1301,96.79,32507.18,2.93,0.5932
7363,Ward and Sons,False,US,New Emily,SaaS,2017,https://wardandsons.com,International officer others call manager follow growth.,21,ward-and-sons,2023,USD,13418366,6995649,6422717,670918,5751799,9058,5742741,134183,268367,5474374,521305,7304801,3116029,4188772,1118197.17,13418366,646.5,1593.26,0.0092,18164,61.56,49350.14,10.56,0.4787
7364,Martin LLC,False,AU,West John,HealthTech,2017,https://martinllc.com,Nearly adult charge drug always program administration.,19,martin-llc,2023,USD,929721,189771,739950,213175,526775,0,526775,9297,18594,508181,8245,633235,291757,341478,77476.75,929721,972.14,10226.46,0.0115,7979,9.71,15150.97,0.54,0.7959
7365,Leblanc Abbott and Alexander,False,NG,West Sean,IoT,2016,https://leblancabbottandalexander.com,May agree compare factor travel.,24,leblanc-abbott-and-alexander,2023,USD,381614,166981,214633,156217,58416,0,58416,3816,7632,50784,13985,254540,104495,150045,,381614,558.46,2574.74,0.1146,1590,20.0,18328.54,0.76,0.5624
7366,Carter Spears and Tucker,False,GB,South Lisafort,SaaS,2017,https://carterspearsandtucker.com,Environment project top air every face allow.,24,carter-spears-and-tucker,2023,USD,1668005,732217,935788,696362,239426,13513,225913,16680,33360,192553,55804,991261,334344,656917,139000.42,1668005,10.0,10.0,0.0478,1336,103.99,47041.57,1.19,0.561
7367,Levine Inc,False,TN,Port Samanthabury,Energy,2016,https://levineinc.com,Now present physical lawyer bank shoulder much at television.,24,levine-inc,2023,USD,2418143,677793,1740350,1271319,469031,0,469031,24181,48362,420669,36399,1426129,482125,944004,,2418143,53.94,131.84,0.0055,2030,99.26,89078.74,0.41,0.7197
7368,Lopez-Baker,False,AU,Margarethaven,Cybersecurity,2021,https://lopez-baker.com,Attention his sell without speech.,21,lopez-baker,2023,USD,193212,54243,138969,130418,8551,4131,4420,1932,3864,556,10428,110855,5542,105313,,193212,626.23,2083.25,0.0408,805,20.0,37090.81,0.28,0.7193
7369,Montgomery-Thompson,False,TN,New Davidfurt,Mobility,2021,https://montgomery-thompson.com,Vote note pass free capital discover it.,20,montgomery-thompson,2023,USD,518303,159974,358329,202229,156100,0,156100,5183,10366,145734,2085,367048,168224,198824,,518303,20.0,55.44,0.1198,2159,20.0,26569.38,0.08,0.6914
7370,Martin Tucker and Brown,False,US,Lake Richardport,E-commerce,2021,https://martintuckerandbrown.com,Live PM authority surface positive present whatever letter.,16,martin-tucker-and-brown,2023,USD,788237,195250,592987,202272,390715,8179,382536,7882,15764,366772,104729,574974,238871,336103,,788237,1476.2,3227.11,0.1419,3284,20.0,29888.0,3.5,0.7523
7371,Parks Gallegos and Mcneil,False,IN,West Cory,HealthTech,2008,https://parksgallegosandmcneil.com,Scene conference will early meet wish spend.,18,parks-gallegos-and-mcneil,2023,USD,353536,77707,275829,292303,-16474,0,-16474,3535,7070,-23544,21507,377661,142148,235513,29461.33,353536,22.65,130.18,0.0664,1109,26.55,32420.49,0.66,0.7802
7372,Gregory PLC,False,AU,Davidburgh,AgriTech,2018,https://gregoryplc.com,Real significant should bar finish material window authority save forward.,27,gregory-plc,2023,USD,379048,158291,220757,249201,-28444,0,-28444,3790,7580,-36024,174871,452430,101876,350554,,379048,1705.21,852.6,0.0449,192,163.77,6079.34,28.76,0.5824
7373,Harris-Yates,False,TN,West Kathryn,E-commerce,2023,https://harris-yates.com,Even grow program market wish sit word back manage activity.,14,harris-yates,2023,USD,1481882,312288,1169594,787745,381849,30585,351264,14818,29637,321627,85993,848214,542546,305668,,1481882,866.87,433.44,0.001,793,155.53,46356.77,1.86,0.7893
7374,Marsh Inc,False,AU,New Brandon,Mobility,2018,https://marshinc.com,Lot understand develop state play sure sing.,23,marsh-inc,2023,USD,932043,458105,473938,157297,316641,19941,296700,9320,18640,278060,175253,722516,96598,625918,,932043,20.0,79.52,0.1085,3339,23.26,1000.0,175.25,0.5085
7375,Jones-Vasquez,False,NG,Michellefurt,SaaS,2022,https://jones-vasquez.com,Less article development game to couple.,15,jones-vasquez,2023,USD,687409,297431,389978,720636,-330658,14983,-345641,6874,13748,-359389,99340,558733,353249,205484,57284.08,687409,10.0,39.61,0.0447,11456,5.0,53699.66,1.85,0.5673
7376,Lee LLC,False,AU,Huangton,AgriTech,2018,https://leellc.com,Others either follow accept between career.,21,lee-llc,2023,USD,486819,193891,292928,28027,264901,0,264901,4868,9736,255165,13441,368821,61730,307091,,486819,20.0,10.0,0.074,2028,20.0,21238.54,0.63,0.6017
7377,Wilson and Sons,False,DE,South Jesus,EdTech,2024,https://wilsonandsons.com,Century bit affect eight again understand approach effort suddenly training heavy.,26,wilson-and-sons,2023,EUR,352046,80178,271868,122885,148983,48249,100734,3520,7040,93694,50916,341849,86633,255216,29337.17,352046,83.55,366.59,0.001,730,40.17,1000.0,50.92,0.7723
7378,Harris Ltd,False,AU,East Mary,IoT,2008,https://harrisltd.com,Hold score painting kitchen young small.,16,harris-ltd,2023,USD,826082,432255,393827,535151,-141324,0,-141324,8260,16521,-157845,21711,532065,296863,235202,,826082,1561.96,4279.27,0.001,422,162.96,32297.65,0.67,0.4767
7379,Lucero PLC,False,TN,New Justinstad,HealthTech,2015,https://luceroplc.com,Candidate entire no social those.,23,lucero-plc,2023,USD,603933,198190,405743,104350,301393,45347,256046,6039,12078,243968,39782,342226,76390,265836,50327.75,603933,10.0,14.74,0.0444,10065,5.0,17503.25,2.27,0.6718
7380,Mcbride Lucas and Kim,False,AU,West Lukebury,E-commerce,2016,https://mcbridelucasandkim.com,Find budget discover build position wonder relate product fish.,24,mcbride-lucas-and-kim,2023,USD,1081677,433214,648463,377064,271399,397,271002,10816,21633,249369,43175,636882,263862,373020,,1081677,20.0,150.62,0.0621,4506,20.0,23173.51,1.86,0.5995
7381,Munoz Buchanan and Cobb,False,AU,Schultzstad,Energy,2020,https://munozbuchananandcobb.com,General relationship part somebody seven form probably public different control.,24,munoz-buchanan-and-cobb,2023,USD,1484436,594752,889684,773492,116192,43971,72221,14844,29688,42533,35922,783979,87418,696561,,1484436,20.0,141.53,0.001,6185,20.0,47524.08,0.76,0.5993
7382,Nichols Group,False,AU,East Andrew,HealthTech,2013,https://nicholsgroup.com,You themselves yourself relate woman blue also career understand.,23,nichols-group,2023,USD,2166901,888872,1278029,1120420,157609,0,157609,21669,43338,114271,15060,1239377,61968,1177409,180575.08,2166901,10.0,49.34,0.0694,9119,19.8,83868.33,0.18,0.5898
7383,Bell-Jackson,False,AU,Michelleland,Energy,2018,https://bell-jackson.com,Often live wear most family bag.,23,bell-jackson,2023,USD,5392228,2304439,3087789,3259750,-171961,0,-171961,53922,107844,-279805,92587,2797469,323578,2473891,,5392228,20.0,68.22,0.0717,1199,374.72,325276.17,0.28,0.5726
7384,Fischer Wright and Garcia,False,ZA,Valerieland,AgriTech,2009,https://fischerwrightandgarcia.com,Return us over production seven race personal final.,21,fischer-wright-and-garcia,2023,USD,1209112,537235,671877,923218,-251341,0,-251341,12091,24182,-275523,56962,748090,363238,384852,,1209112,561.5,2703.03,0.0682,975,103.3,66556.82,0.86,0.5557
7385,Hall-Hansen,False,FR,Julianside,Energy,2018,https://hall-hansen.com,Probably continue avoid national choice radio.,23,hall-hansen,2023,EUR,1692558,666495,1026063,440887,585176,0,585176,16925,33851,551325,256923,1213083,392474,820609,,1692558,644.39,1712.19,0.0057,761,185.17,59566.75,4.31,0.6062
7386,Sullivan Malone and Davis,False,KE,Andrewville,IoT,2019,https://sullivanmaloneanddavis.com,Technology arrive society difficult give environment sister president experience.,21,sullivan-malone-and-davis,2023,USD,520798,205123,315675,26039,289636,22167,267469,5207,10415,257054,76963,461960,191551,270409,,520798,20.0,68.48,0.1128,148,293.02,1000.0,76.96,0.6061
7387,Roberts-Brooks,False,DE,West Angela,SaaS,2008,https://roberts-brooks.com,Feel fund challenge anyone easy throw story risk a assume design.,20,roberts-brooks,2023,EUR,661628,180427,481201,92748,388453,6573,381880,6616,13232,368648,13350,391664,37545,354119,55135.67,661628,10.0,71.71,0.0388,11027,5.0,14194.69,0.94,0.7273
7388,Morrison-Freeman,False,ZA,East Jonathan,Marketplaces,2021,https://morrison-freeman.com,Necessary make risk writer system prevent reach five.,25,morrison-freeman,2023,USD,2878555,1051152,1827403,1873527,-46124,5268,-51392,28785,57571,-108963,172244,1751820,743460,1008360,,2878555,20.0,10.0,0.0902,7365,32.57,159721.93,1.08,0.6348
7389,Whitney LLC,False,GB,Masonport,HealthTech,2011,https://whitneyllc.com,Cover conference could ten car forget tend upon moment there spend.,21,whitney-llc,2023,USD,1181452,554072,627380,809093,-181713,12176,-193889,11814,23629,-217518,68429,672343,170511,501832,98454.33,1181452,10.0,63.31,0.0543,1084,90.79,48071.77,1.42,0.531
7390,Robinson LLC,False,GB,Lake Michellefort,HealthTech,2017,https://robinsonllc.com,Major one activity night produce add.,19,robinson-llc,2023,USD,980435,359036,621399,411872,209527,0,209527,9804,19608,189919,452901,1071306,305526,765780,81702.92,980435,704.03,2546.65,0.0107,3186,25.64,38168.42,11.87,0.6338
7391,Wilson Group,False,GB,Andersonfurt,Mobility,2021,https://wilsongroup.com,Return trip perform policy always put subject.,15,wilson-group,2023,USD,1617639,444979,1172660,129057,1043603,2306,1041297,16176,32352,1008945,73901,1057949,220920,837029,,1617639,95.73,730.81,0.0311,377,356.74,1000.0,73.9,0.7249
7392,Sampson LLC,False,EG,New Kimberlychester,Cybersecurity,2023,https://sampsonllc.com,Force dream painting clear customer order picture put end.,22,sampson-llc,2023,USD,1178482,501551,676931,415080,261851,0,261851,11784,23569,238282,20005,681745,225455,456290,,1178482,364.12,1520.69,0.0504,480,204.56,15263.7,1.31,0.5744
7393,Marsh-Baker,False,IN,Lake Brittany,Energy,2012,https://marsh-baker.com,Executive pattern response step listen modern sport.,14,marsh-baker,2023,USD,773839,280095,493744,435709,58035,0,58035,7738,15476,42559,11187,480881,262590,218291,,773839,1983.42,11923.76,0.001,430,149.87,40426.91,0.28,0.638
7394,Dyer Horn and Guzman,False,AU,West Marystad,E-commerce,2010,https://dyerhornandguzman.com,Her indeed be owner season improve through.,36,dyer-horn-and-guzman,2023,USD,1996737,1038377,958360,780672,177688,2633,175055,19967,39934,135121,131905,1253856,331300,922556,,1996737,471.26,2045.84,0.009,8319,20.0,96240.46,1.37,0.48
7395,Cox-Hill,False,TN,South Stephanie,SaaS,2011,https://cox-hill.com,Book throughout look but language bad better consumer entire.,16,cox-hill,2023,USD,1195714,142137,1053577,783144,270433,0,270433,11957,23914,246519,16799,778619,389520,389099,99642.83,1195714,168.49,574.57,0.0071,863,115.45,52820.41,0.32,0.8811
7396,Nunez-Reyes,False,FR,East Jamesside,HealthTech,2016,https://nunez-reyes.com,Wonder opportunity cost however participant hundred several single the.,19,nunez-reyes,2023,EUR,1170399,231278,939121,535551,403570,0,403570,11703,23407,380163,14704,797500,210843,586657,97533.25,1170399,210.35,524.04,0.0187,1210,80.54,45653.53,0.32,0.8024
7397,Hernandez Wright and Richmond,False,ZA,Nicholasland,Fintech,2010,https://hernandezwrightandrichmond.com,Wrong read despite whom fill develop last TV American real region.,24,hernandez-wright-and-richmond,2023,USD,6018668,2197844,3820824,3370099,450725,0,450725,60186,120373,330352,89898,3282916,1605427,1677489,,6018668,830.6,2912.25,0.001,1873,267.72,286452.08,0.31,0.6348
7398,Hines-Sherman,False,CA,Port Belindatown,AI/ML,2016,https://hines-sherman.com,Your theory whatever himself find statement research best onto big.,15,hines-sherman,2023,USD,1359298,205367,1153931,563118,590813,0,590813,13592,27185,563628,75197,893452,549015,344437,,1359298,479.36,239.68,0.099,5663,20.0,26555.18,2.83,0.8489
7399,Brown Inc,False,NG,South Tracymouth,AI/ML,2020,https://browninc.com,Help research this data parent little travel.,14,brown-inc,2023,USD,2283926,1099550,1184376,525492,658884,5932,652952,22839,45678,607274,41109,1297789,443956,853833,,2283926,20.0,62.11,0.0872,1267,150.14,39561.6,1.04,0.5186
7400,Blankenship-Martinez,False,US,New Donna,SaaS,2008,https://blankenship-martinez.com,Office project program same arrive certainly we trip shake back everything.,24,blankenship-martinez,2023,USD,460410,84134,376276,143930,232346,19339,213007,4604,9208,203799,34333,446708,220142,226566,38367.5,460410,952.38,2817.32,0.03,412,92.95,30900.98,1.11,0.8173
7401,Morris-Gutierrez,False,FR,Port Matthewmouth,Mobility,2024,https://morris-gutierrez.com,Theory per three sound good heavy quite cover almost.,13,morris-gutierrez,2023,EUR,748144,37407,710737,361055,349682,0,349682,7481,14962,334720,15644,557865,155510,402355,,748144,28.97,61.31,0.1463,704,88.48,39623.06,0.39,0.95
7402,Carpenter Moody and Boyle,False,TN,New Cynthiaton,Mobility,2023,https://carpentermoodyandboyle.com,Sometimes under spring Democrat answer travel north.,16,carpenter-moody-and-boyle,2023,USD,286471,137708,148763,186801,-38038,0,-38038,2864,5729,-43767,7755,324593,185260,139333,,286471,1538.14,6907.99,0.001,230,103.75,2361.7,3.28,0.5193
7403,Cooper Lyons and Ellis,False,NG,Rachaelport,HealthTech,2014,https://cooperlyonsandellis.com,American might air right even need type would the learn.,18,cooper-lyons-and-ellis,2023,USD,83755,29015,54740,46387,8353,0,8353,837,1675,6678,17775,160865,32980,127885,6979.58,83755,298.01,1518.68,0.0196,88,78.94,1000.0,17.77,0.6536
7404,Kirby-Davis,False,FR,East Terri,HealthTech,2019,https://kirby-davis.com,Need data view interview but kind open after listen war.,21,kirby-davis,2023,EUR,342927,143361,199566,128885,70681,0,70681,3429,6858,63823,12710,185429,107361,78068,28577.25,342927,545.52,2676.08,0.026,583,48.96,3962.58,3.21,0.5819
7405,Brown Miller and Salas,False,EG,Mannhaven,SaaS,2016,https://brownmillerandsalas.com,Tell staff rest movement moment.,20,brown-miller-and-salas,2023,USD,248333,72274,176059,100081,75978,0,75978,2483,4966,71012,2662,134974,45120,89854,20694.42,248333,251.35,984.6,0.001,211,97.64,6699.27,0.4,0.709
7406,Nelson Ltd,False,EG,Port Jasontown,HealthTech,2021,https://nelsonltd.com,Oil stuff somebody cut understand read tree make.,15,nelson-ltd,2023,USD,982785,434182,548603,240180,308423,22679,285744,9827,19655,266089,110094,767472,241745,525727,81898.75,982785,133.42,313.85,0.0793,1337,61.23,31706.71,3.47,0.5582
7407,Burke-Walker,False,AU,North Jeremytown,AgriTech,2013,https://burke-walker.com,Collection hospital other cut.,15,burke-walker,2023,USD,518973,186084,332889,197169,135720,5146,130574,5189,10379,120195,13379,345194,162273,182921,,518973,221.74,757.71,0.1235,2162,20.0,12194.0,1.1,0.6414
7408,Ford Rodriguez and Nunez,False,BR,Rowlandborough,Energy,2010,https://fordrodriguezandnunez.com,Two old weight authority mission.,23,ford-rodriguez-and-nunez,2023,USD,340196,102855,237341,25133,212208,3622,208586,3401,6803,201783,11117,306700,106231,200469,,340196,20.0,47.65,0.1017,1417,20.0,18040.9,0.62,0.6977
7409,Duncan Brown and Cochran,False,GB,Smithfort,Cybersecurity,2011,https://duncanbrownandcochran.com,Clear American right hold once begin week.,17,duncan-brown-and-cochran,2023,USD,893864,239600,654264,356369,297895,3669,294226,8938,17877,276349,58436,537131,172100,365031,,893864,709.64,3380.09,0.094,809,92.07,1000.0,58.44,0.732
7410,Williams PLC,False,GB,Langstad,SaaS,2014,https://williamsplc.com,Production tough ahead point news author maybe.,22,williams-plc,2023,USD,8497550,2403187,6094363,4514933,1579430,0,1579430,84975,169951,1409479,458793,4728166,2498221,2229945,708129.17,8497550,10.0,46.81,0.0748,18969,37.33,366620.89,1.25,0.7172
7411,Braun-Johnson,False,NG,West Briantown,AgriTech,2015,https://braun-johnson.com,Option top carry without actually letter father area natural property.,20,braun-johnson,2023,USD,127623,31758,95865,95972,-107,24407,-24514,1276,2552,-27066,59647,306029,191349,114680,,127623,838.93,6500.86,0.001,531,20.0,14609.82,4.08,0.7512
7412,Rodriguez LLC,False,ZA,Matthewland,Mobility,2018,https://rodriguezllc.com,Pay player effort trade not stand little.,21,rodriguez-llc,2023,USD,541276,135778,405498,318330,87168,38347,48821,5412,10825,37996,131414,487130,166281,320849,,541276,20.0,45.81,0.0899,257,175.39,18916.91,6.95,0.7492
7413,Ramirez-Powell,False,DE,Mendozaberg,Energy,2019,https://ramirez-powell.com,Management executive similar smile prepare life.,23,ramirez-powell,2023,EUR,5132498,1465104,3667394,931930,2735464,17089,2718375,51324,102649,2615726,220673,2986020,977903,2008117,,5132498,20.0,10.0,0.0412,21385,20.0,87149.9,2.53,0.7145
7414,Allen-Williams,False,ZA,Catherineland,IoT,2020,https://allen-williams.com,Create be bit positive together body raise move.,22,allen-williams,2023,USD,299008,156377,142631,178392,-35761,11890,-47651,2990,5980,-53631,9154,302847,140070,162777,,299008,1155.59,3317.94,0.1,144,171.89,61741.22,0.15,0.477
7415,Sanders LLC,False,AU,Lake Morgan,AI/ML,2009,https://sandersllc.com,Wrong foreign today size first pressure argue interesting create return.,21,sanders-llc,2023,USD,932994,300496,632498,334970,297528,24595,272933,9329,18659,254274,36805,580603,181372,399231,,932994,20.0,10.0,0.1016,306,253.64,42320.61,0.87,0.6779
7416,Allen-Garcia,False,EG,New Jamesborough,AI/ML,2019,https://allen-garcia.com,Movement there development radio station yet.,27,allen-garcia,2023,USD,161308,62087,99221,60457,38764,342,38422,1613,3226,35196,11301,289297,107936,181361,,161308,1890.74,5312.38,0.074,672,20.0,6732.38,1.68,0.6151
7417,Hoffman Group,False,BR,Eugeneland,HealthTech,2019,https://hoffmangroup.com,Large style own up scene.,20,hoffman-group,2023,USD,164670,36134,128536,99817,28719,11664,17055,1646,3293,13762,6421,129456,16235,113221,13722.5,164670,83.65,567.33,0.058,131,104.48,46888.04,0.14,0.7806
7418,Salinas Bernard and Meza,False,IN,Murrayfort,AI/ML,2013,https://salinasbernardandmeza.com,Federal hit power his positive and ball technology stage.,16,salinas-bernard-and-meza,2023,USD,287398,47011,240387,141444,98943,0,98943,2873,5747,93196,4512,185576,91280,94296,,287398,20.0,47.83,0.0443,1197,20.0,1000.0,4.51,0.8364
7419,Garza Gomez and Wang,False,IN,New Christopherville,HealthTech,2011,https://garzagomezandwang.com,Than cut relate look positive present decade nature.,22,garza-gomez-and-wang,2023,USD,502538,178786,323752,273100,50652,0,50652,5025,10050,40602,10719,313430,95499,217931,41878.17,502538,409.21,2689.2,0.0147,545,76.83,17116.56,0.63,0.6442
7420,Osborn-Schmidt,False,BR,Port Lindsayview,AI/ML,2015,https://osborn-schmidt.com,Company research under hard author place management college according.,22,osborn-schmidt,2023,USD,2705519,1257366,1448153,1218148,230005,8907,221098,27055,54110,166988,143825,1694845,1075182,619663,,2705519,20.0,47.84,0.0602,11272,20.0,85964.18,1.67,0.5353
7421,Kent Jackson and Williams,False,NG,North Michaelview,E-commerce,2016,https://kentjacksonandwilliams.com,Her wind already sense law myself computer guess debate.,23,kent-jackson-and-williams,2023,USD,749189,292945,456244,414046,42198,0,42198,7491,14983,27215,231252,659473,215616,443857,,749189,1060.74,2729.56,0.0607,352,177.27,60812.28,3.8,0.609
7422,Vazquez Miller and Powell,False,CA,Meaganmouth,AgriTech,2009,https://vazquezmillerandpowell.com,Amount according little thing sit PM model material seat threat.,27,vazquez-miller-and-powell,2023,USD,244956,68986,175970,135288,40682,778,39904,2449,4899,35005,13810,246481,166328,80153,,244956,973.04,486.52,0.0449,538,37.9,25984.41,0.53,0.7184
7423,Sanders Adams and Gonzalez,False,US,Tonyview,Marketplaces,2021,https://sandersadamsandgonzalez.com,Themselves here always out this whole.,25,sanders-adams-and-gonzalez,2023,USD,5943272,3263654,2679618,3280776,-601158,0,-601158,59432,118865,-720023,1743559,4795410,3321726,1473684,,5943272,91.89,45.94,0.0538,24763,20.0,272309.06,6.4,0.4509
7424,Maldonado Inc,False,IN,Erikashire,AgriTech,2019,https://maldonadoinc.com,Because red type late but goal response say child question.,17,maldonado-inc,2023,USD,1263198,179454,1083744,885341,198403,8589,189814,12631,25263,164551,224004,1008561,554587,453974,,1263198,289.51,1574.19,0.0623,5263,20.0,91875.87,2.44,0.8579
7425,Acosta LLC,False,IN,Roweshire,Marketplaces,2022,https://acostallc.com,Face church word hot include growth.,14,acosta-llc,2023,USD,192165,69092,123073,129396,-6323,0,-6323,1921,3843,-10166,5669,124718,60212,64506,,192165,971.62,485.81,0.0804,72,220.38,11145.64,0.51,0.6405
7426,Cardenas Ponce and Silva,False,CA,East Melanie,Cybersecurity,2012,https://cardenasponceandsilva.com,Himself prepare large seek peace help send.,21,cardenas-ponce-and-silva,2023,USD,1020408,243494,776914,622381,154533,0,154533,10204,20408,134125,21273,621776,31088,590688,,1020408,20.0,14.7,0.0866,343,247.35,61130.6,0.35,0.7614
7427,King PLC,False,DE,Justinchester,Fintech,2011,https://kingplc.com,Film worker without lead practice hard career.,13,king-plc,2023,EUR,3608727,1340044,2268683,1677329,591354,0,591354,36087,72174,519180,165541,2101984,765177,1336807,,3608727,1457.08,4285.83,0.0857,1476,203.7,131242.19,1.26,0.6287
7428,Bell Andrews and Campos,False,GB,Port Noahfurt,EdTech,2012,https://bellandrewsandcampos.com,Agree class drug way speech ten employee participant mission.,30,bell-andrews-and-campos,2023,USD,93929,38552,55377,45333,10044,41290,-31246,939,1878,-33124,11814,250064,59288,190776,7827.42,93929,546.03,2827.14,0.001,77,100.94,8734.04,1.35,0.5896
7429,Martin Inc,False,ZA,Jacobsshire,Mobility,2017,https://martininc.com,Natural and put memory professional particular yard read region play.,25,martin-inc,2023,USD,602277,150952,451325,325330,125995,29270,96725,6022,12045,84680,87612,531800,324320,207480,,602277,595.05,3154.23,0.0921,2509,20.0,12858.17,6.81,0.7494
7430,White-Williams,False,AU,Cisnerosland,AI/ML,2023,https://white-williams.com,Nice quite behavior she assume camera assume respond phone strategy.,19,white-williams,2023,USD,686063,203190,482873,324268,158605,6892,151713,6860,13721,137992,19066,547796,288362,259434,,686063,213.99,978.64,0.0915,948,60.29,1000.0,19.07,0.7038
7431,Smith Huang and Molina,False,BR,Meghanburgh,IoT,2010,https://smithhuangandmolina.com,Ready not quality back base good.,19,smith-huang-and-molina,2023,USD,306443,90030,216413,33353,183060,55942,127118,3064,6128,120990,4154,353691,17778,335913,,306443,1296.93,4558.92,0.001,1276,20.0,28111.11,0.15,0.7062
7432,Walls-Wilson,False,EG,Jamesmouth,Mobility,2020,https://walls-wilson.com,Various thing property technology now training age.,27,walls-wilson,2023,USD,717678,145669,572009,177741,394268,0,394268,7176,14353,379915,78989,537279,104669,432610,,717678,20.0,20.72,0.0725,283,210.67,40105.77,1.97,0.797
7433,Reed Gutierrez and Parker,False,AU,Coopertown,EdTech,2015,https://reedgutierrezandparker.com,Some happen Mrs least before wear capital.,16,reed-gutierrez-and-parker,2023,USD,389364,127926,261438,156568,104870,33402,71468,3893,7787,63681,29722,340039,103979,236060,32447.0,389364,542.05,1525.97,0.0419,2939,11.04,8176.18,3.64,0.6714
7434,Garcia and Sons,False,BR,Port Timothymouth,AgriTech,2013,https://garciaandsons.com,Beyond commercial growth leader author vote coach wear table.,20,garcia-and-sons,2023,USD,1590864,706662,884202,193484,690718,0,690718,15908,31817,658901,12116,951470,548911,402559,,1590864,992.51,3089.35,0.0889,1730,76.63,37889.21,0.32,0.5558
7435,Harrison Banks and Brown,False,EG,Kristyhaven,HealthTech,2008,https://harrisonbanksandbrown.com,Statement collection meeting use two area.,19,harrison-banks-and-brown,2023,USD,1089124,551665,537459,457159,80300,0,80300,10891,21782,58518,55493,688475,271155,417320,90760.33,1089124,309.54,1927.46,0.0237,2154,42.12,3772.74,14.71,0.4935
7436,Ray Inc,False,DE,East Derek,AI/ML,2020,https://rayinc.com,Before science watch his then herself structure well decide.,12,ray-inc,2023,EUR,439063,178427,260636,265762,-5126,0,-5126,4390,8781,-13907,9113,385246,193273,191973,,439063,20.0,46.02,0.0843,164,222.99,9839.75,0.93,0.5936
7437,Savage Inc,False,BR,Boydville,HealthTech,2010,https://savageinc.com,Season state group represent memory among subject race discover hit.,18,savage-inc,2023,USD,1674085,496240,1177845,1193056,-15211,10391,-25602,16740,33481,-59083,35939,977098,502211,474887,139507.08,1674085,533.6,1509.07,0.0909,6808,20.49,78045.29,0.46,0.7036
7438,Bautista Group,False,EG,East Jenniferborough,E-commerce,2008,https://bautistagroup.com,More culture around still owner hit knowledge into yeah third.,12,bautista-group,2023,USD,600956,267141,333815,56885,276930,1667,275263,6009,12019,263244,9188,502467,170108,332359,,600956,900.42,2307.65,0.0787,317,157.57,3528.64,2.6,0.5555
7439,Cook Decker and Anderson,False,BR,South Brandon,AI/ML,2009,https://cookdeckerandanderson.com,Attention brother past develop assume sea because short impact.,17,cook-decker-and-anderson,2023,USD,495640,200925,294715,303123,-8408,15046,-23454,4956,9912,-33366,16190,356670,95589,261081,,495640,372.6,692.71,0.0422,129,319.44,52932.92,0.31,0.5946
7440,Knight Ltd,False,AU,New Elizabeth,Fintech,2020,https://knightltd.com,Term four minute machine do large themselves.,13,knight-ltd,2023,USD,505153,276897,228256,370704,-142448,16649,-159097,5051,10103,-169200,20472,437276,190374,246902,,505153,203.54,101.77,0.001,227,185.2,52024.28,0.39,0.4519
7441,Salazar Inc,False,DE,East Lisahaven,SaaS,2016,https://salazarinc.com,Class so material upon everything by level bag responsibility choice.,25,salazar-inc,2023,EUR,959382,569312,390070,415887,-25817,14897,-40714,9593,19187,-59901,310628,896580,115144,781436,79948.5,959382,10.0,62.32,0.0437,1315,60.79,36262.8,8.57,0.4066
7442,Roberts Ayala and Vazquez,False,CA,New Stephanieville,Cybersecurity,2014,https://robertsayalaandvazquez.com,Discover other attention officer thing research prevent suggest color.,18,roberts-ayala-and-vazquez,2023,USD,272848,88005,184843,227061,-42218,10925,-53143,2728,5456,-58599,9300,239421,156675,82746,,272848,1480.48,7019.88,0.0536,229,99.26,1000.0,9.3,0.6775
7443,Duncan Mclean and West,False,US,Port Ashleyland,Energy,2015,https://duncanmcleanandwest.com,Risk usually significant factor question personal history hope friend.,28,duncan-mclean-and-west,2023,USD,2227114,408788,1818326,1244458,573868,0,573868,22271,44542,529326,15838,1265522,316657,948865,,2227114,1029.42,3179.79,0.0813,5171,35.89,85276.13,0.19,0.8164
7444,French and Sons,False,CA,Port Andrew,Cybersecurity,2024,https://frenchandsons.com,President you interview keep feeling seem second let produce here.,30,french-and-sons,2023,USD,1356190,558330,797860,628736,169124,0,169124,13561,27123,142001,60538,831819,41590,790229,,1356190,20.0,56.66,0.001,872,129.59,78090.1,0.78,0.5883
7445,Diaz Ball and Andrade,False,GB,Lake Robert,AgriTech,2015,https://diazballandandrade.com,Some mention finish religious economic mind anything.,19,diaz-ball-and-andrade,2023,USD,60243,12874,47369,42512,4857,13713,-8856,602,1204,-10060,12386,228528,37492,191036,,60243,20.0,41.47,0.001,129,38.73,19323.56,0.64,0.7863
7446,Rogers Ltd,False,CA,South Michaelton,EdTech,2017,https://rogersltd.com,Work condition bank wrong about though market skill environmental friend admit.,14,rogers-ltd,2023,USD,279136,124749,154387,183828,-29441,31893,-61334,2791,5582,-66916,16663,187975,9398,178577,23261.33,279136,602.5,2754.85,0.0804,240,96.9,1000.0,16.66,0.5531
7447,Oliver Group,False,US,Port Kimberlyland,SaaS,2011,https://olivergroup.com,Need than until finish would everybody age learn weight take.,19,oliver-group,2023,USD,969009,251839,717170,74525,642645,0,642645,9690,19380,623265,31344,637941,246065,391876,80750.75,969009,478.48,3327.36,0.0399,1423,56.72,9846.66,3.18,0.7401
7448,Ibarra Oliver and Logan,False,NG,Larryfurt,Fintech,2020,https://ibarraoliverandlogan.com,Special fish old meeting probably.,25,ibarra-oliver-and-logan,2023,USD,2772251,803396,1968855,506735,1462120,37032,1425088,27722,55445,1369643,81664,1607620,1003879,603741,,2772251,1090.15,6257.61,0.0528,2422,95.36,70877.15,1.15,0.7102
7449,Simpson Inc,False,EG,Maryside,Mobility,2024,https://simpsoninc.com,The energy during top hair indeed quickly happen fact population.,22,simpson-inc,2023,USD,6811767,3283813,3527954,4170239,-642285,8696,-650981,68117,136235,-787216,141969,3627220,1199595,2427625,,6811767,20.0,39.17,0.001,2075,273.45,309104.12,0.46,0.5179
7450,Ramirez Reed and Richardson,False,IN,Coltonburgh,AI/ML,2010,https://ramirezreedandrichardson.com,Stand step station structure direction social fire per.,22,ramirez-reed-and-richardson,2023,USD,1188845,569114,619731,785157,-165426,0,-165426,11888,23776,-189202,65027,791073,277920,513153,,1188845,2578.55,7796.64,0.1304,371,266.79,51685.0,1.26,0.5213
7451,Brown LLC,False,TN,Jonesville,E-commerce,2013,https://brownllc.com,Compare century two later military this certain suddenly.,17,brown-llc,2023,USD,654415,225876,428539,32720,395819,0,395819,6544,13088,382731,13975,424007,260663,163344,,654415,152.82,470.07,0.1248,2726,20.0,3864.98,3.62,0.6548
7452,Johnson-Mcconnell,False,IN,Christianstad,AgriTech,2016,https://johnson-mcconnell.com,She discuss wind month red really keep poor too address.,9,johnson-mcconnell,2023,USD,295274,92390,202884,68245,134639,29849,104790,2952,5905,98885,3176,174251,8712,165539,,295274,288.78,1157.68,0.0744,239,102.78,1000.0,3.18,0.6871
7453,Harris Ltd,False,BR,Christopherborough,E-commerce,2016,https://harrisltd.com,Customer Democrat support good kind government.,29,harris-ltd,2023,USD,702768,347088,355680,193914,161766,3709,158057,7027,14055,144002,115303,602205,309612,292593,,702768,20.0,104.71,0.0646,2928,20.0,25590.33,4.51,0.5061
7454,Harmon-Baldwin,False,IN,East Amy,Energy,2009,https://harmon-baldwin.com,Dinner our meeting sit her one thought.,24,harmon-baldwin,2023,USD,771728,286908,484820,473512,11308,0,11308,7717,15434,-4126,321612,797388,39869,757519,,771728,864.01,4601.87,0.0621,3215,20.0,34903.1,9.21,0.6282
7455,Luna Ltd,False,NG,Edwardshaven,EdTech,2019,https://lunaltd.com,Without seem reason teacher under oil ball.,31,luna-ltd,2023,USD,417782,139042,278740,114543,164197,0,164197,4177,8355,155842,5461,264863,56300,208563,34815.17,417782,214.4,1796.28,0.0102,905,38.45,32282.21,0.17,0.6672
7456,Kelley-Villarreal,False,ZA,Nortonville,Fintech,2023,https://kelley-villarreal.com,Phone plant away nature bad.,15,kelley-villarreal,2023,USD,761924,198285,563639,402733,160906,16300,144606,7619,15238,129368,24435,409427,84344,325083,,761924,20.0,65.08,0.0767,834,76.06,39961.24,0.61,0.7398
7457,Hunter Jimenez and James,False,KE,Michaelmouth,IoT,2014,https://hunterjimenezandjames.com,Statement everyone best subject recent executive cell close.,18,hunter-jimenez-and-james,2023,USD,925341,405734,519607,303231,216376,548,215828,9253,18506,197322,34169,573647,251665,321982,,925341,20.0,69.85,0.0167,3855,20.0,1000.0,34.17,0.5615
7458,Ortega Ritter and Norris,False,EG,Hayesstad,Cybersecurity,2011,https://ortegaritterandnorris.com,I recent old other despite family community.,26,ortega-ritter-and-norris,2023,USD,7442701,4307960,3134741,2376610,758131,3293,754838,74427,148854,605984,401884,4314705,2373970,1940735,,7442701,154.35,723.46,0.0813,3576,173.4,203370.26,1.98,0.4212
7459,Buchanan-Moreno,False,US,North Jon,Marketplaces,2018,https://buchanan-moreno.com,Whom sign out rise debate.,23,buchanan-moreno,2023,USD,336980,166957,170023,126219,43804,8155,35649,3369,6739,28910,5340,219688,157298,62390,,336980,47.59,189.59,0.044,131,213.07,31136.54,0.17,0.5045
7460,Smith Inc,False,DE,Leeborough,Marketplaces,2011,https://smithinc.com,Newspaper wind light account statement among majority.,25,smith-inc,2023,EUR,737709,172138,565571,215042,350529,0,350529,7377,14754,335775,21213,530468,51931,478537,,737709,391.48,313.15,0.019,331,185.31,46385.08,0.46,0.7667
7461,Mullins Miller and Liu,False,GB,New Melissastad,AI/ML,2022,https://mullinsmillerandliu.com,Exactly cause admit generation property.,23,mullins-miller-and-liu,2023,USD,6012220,3188546,2823674,2759791,63883,0,63883,60122,120244,-56361,3987586,7051815,4168755,2883060,,6012220,291.77,785.85,0.108,3044,164.55,257886.44,15.46,0.4697
7462,Daniels Ltd,False,NG,Sarahland,AI/ML,2016,https://danielsltd.com,Great business research family film money main speech trouble easy.,19,daniels-ltd,2023,USD,626871,200736,426135,329133,97002,0,97002,6268,12537,84465,192764,677163,370757,306406,,626871,967.42,2973.32,0.001,495,105.44,33185.12,5.81,0.6798
7463,Johnson-Huerta,False,NG,Romanland,Cybersecurity,2020,https://johnson-huerta.com,Financial message money candidate common.,25,johnson-huerta,2023,USD,265218,141593,123625,37626,85999,0,85999,2652,5304,80695,3005,329753,182318,147435,,265218,29.18,103.22,0.0181,188,117.51,8430.49,0.36,0.4661
7464,Yates-Stevens,False,AU,Dorseyberg,IoT,2021,https://yates-stevens.com,Seat development may common threat.,20,yates-stevens,2023,USD,878330,340961,537369,849300,-311931,0,-311931,8783,17566,-329497,29547,472932,111392,361540,,878330,282.15,1680.92,0.0372,238,306.89,95284.78,0.31,0.6118
7465,Brown Vazquez and Chambers,False,KE,South Samuel,AI/ML,2024,https://brownvazquezandchambers.com,Whom company strong respond toward study skill price option.,15,brown-vazquez-and-chambers,2023,USD,586755,100203,486552,321842,164710,0,164710,5867,11735,152975,94664,470622,212969,257653,,586755,305.5,152.75,0.0979,622,78.49,68601.5,1.38,0.8292
7466,Castro LLC,False,AU,Doughertytown,HealthTech,2009,https://castrollc.com,Few cause chance for specific stage project represent manager stay.,14,castro-llc,2023,USD,292984,109657,183327,121874,61453,38504,22949,2929,5859,17090,26139,207310,56450,150860,24415.33,292984,10.0,58.55,0.0958,539,45.24,34165.54,0.77,0.6257
7467,Martin-Lewis,False,IN,North Kayla,E-commerce,2023,https://martin-lewis.com,Far detail less fire fight edge trouble cold.,17,martin-lewis,2023,USD,220876,85396,135480,125973,9507,0,9507,2208,4417,5090,6352,259495,12974,246521,,220876,368.0,810.43,0.0743,253,72.47,1000.0,6.35,0.6134
7468,Silva Ruiz and Price,False,KE,East Caleb,Cybersecurity,2012,https://silvaruizandprice.com,Wait audience stand dog door owner where despite natural employee.,21,silva-ruiz-and-price,2023,USD,578285,284725,293560,321708,-28148,6291,-34439,5782,11565,-46004,9124,364967,254790,110177,,578285,932.81,4661.23,0.0315,992,48.55,24802.91,0.37,0.5076
7469,Sutton PLC,False,EG,Staceymouth,Fintech,2016,https://suttonplc.com,Lot use morning side sit media face.,14,sutton-plc,2023,USD,562052,208631,353421,28102,325319,0,325319,5620,11241,314078,23121,421817,99116,322701,,562052,183.75,866.63,0.0067,1337,35.01,1000.0,23.12,0.6288
7470,Andersen-George,False,EG,Davisport,Marketplaces,2012,https://andersen-george.com,Each just right arrive.,18,andersen-george,2023,USD,418520,126712,291808,159442,132366,16056,116310,4185,8370,107940,59506,389241,149124,240117,,418520,879.95,598.8,0.001,590,59.02,1000.0,59.51,0.6972
7471,Sanford-Hernandez,False,IN,East Rogerhaven,Energy,2015,https://sanford-hernandez.com,Edge happen ten live this speak five all tonight into.,16,sanford-hernandez,2023,USD,831227,289866,541361,585581,-44220,0,-44220,8312,16624,-60844,42858,637770,50921,586849,,831227,1251.3,757.93,0.0716,461,150.08,55324.49,0.77,0.6513
7472,Sanchez-Adams,False,US,West Paul,Fintech,2020,https://sanchez-adams.com,Necessary political choose cost generation our heart.,15,sanchez-adams,2023,USD,3244710,427070,2817640,1368851,1448789,0,1448789,32447,64894,1383895,130423,1877914,939897,938017,,3244710,268.18,1326.23,0.0441,2736,98.81,126855.8,1.03,0.8684
7473,Rogers Group,False,ZA,West Thomashaven,AgriTech,2013,https://rogersgroup.com,State center of team continue try wide low.,16,rogers-group,2023,USD,2302369,1379264,923105,868654,54451,6131,48320,23023,46047,2273,9230,1240375,350480,889895,,2302369,383.26,1282.12,0.016,3619,53.01,44244.17,0.21,0.4009
7474,Aguilar PLC,False,IN,North Jennifer,HealthTech,2014,https://aguilarplc.com,Special fight everybody even smile pattern.,20,aguilar-plc,2023,USD,1595909,226645,1369264,622651,746613,19329,727284,15959,31918,695366,109430,1020310,89270,931040,132992.42,1595909,10.0,14.52,0.0395,6427,20.69,24486.9,4.47,0.858
7475,Garcia Phillips and Whitaker,False,NG,Emilyview,Marketplaces,2015,https://garciaphillipsandwhitaker.com,Phone also require administration impact if model her store.,19,garcia-phillips-and-whitaker,2023,USD,645830,251321,394509,46596,347913,66,347847,6458,12916,334931,7878,429445,21472,407973,,645830,20.0,57.26,0.1076,2690,20.0,1000.0,7.88,0.6109
7476,Smith-Powers,False,KE,South Amyshire,Mobility,2013,https://smith-powers.com,Social morning skin city difficult partner international consumer.,23,smith-powers,2023,USD,530784,250210,280574,268402,12172,0,12172,5307,10615,1557,13973,422092,247936,174156,,530784,20.0,52.48,0.001,568,77.83,22559.65,0.62,0.5286
7477,Baker Inc,False,NG,North Joseburgh,EdTech,2015,https://bakerinc.com,Mr might rule himself that page.,13,baker-inc,2023,USD,768713,246518,522195,233851,288344,7894,280450,7687,15374,265076,29093,565903,182246,383657,64059.42,768713,10.0,33.82,0.001,1213,52.77,6828.06,4.26,0.6793
7478,Jones Group,False,KE,West Amandashire,Fintech,2012,https://jonesgroup.com,Wall low draw final of song.,21,jones-group,2023,USD,161694,33985,127709,98333,29376,0,29376,1616,3233,26143,9296,257400,80658,176742,,161694,227.57,465.06,0.001,155,86.67,11909.49,0.78,0.7898
7479,Roach-Ho,False,FR,North Lauraview,Marketplaces,2023,https://roach-ho.com,Nearly why off between them ok idea important activity.,13,roach-ho,2023,EUR,1221980,289478,932502,769964,162538,11147,151391,12219,24439,126952,68968,717532,277499,440033,,1221980,20.0,11.16,0.001,475,214.36,58129.6,1.19,0.7631
7480,Brewer and Sons,False,US,South Jamesville,Energy,2013,https://brewerandsons.com,Deep knowledge manage someone right place.,28,brewer-and-sons,2023,USD,344959,97684,247275,290052,-42777,0,-42777,3449,6899,-49676,38670,350375,41737,308638,,344959,386.19,1388.89,0.0883,1437,20.0,5600.32,6.9,0.7168
7481,Ayers Simpson and Fischer,False,KE,Lake Jose,EdTech,2013,https://ayerssimpsonandfischer.com,Rule once wear three contain play soldier mission compare into.,23,ayers-simpson-and-fischer,2023,USD,576000,223324,352676,195152,157524,31325,126199,5760,11520,114679,83248,483457,166303,317154,48000.0,576000,10.0,80.6,0.0731,885,54.19,23088.02,3.61,0.6123
7482,Sullivan-Lambert,False,NG,Michelleport,AI/ML,2009,https://sullivan-lambert.com,Above admit radio him group second hand.,23,sullivan-lambert,2023,USD,1311130,445558,865572,565659,299913,0,299913,13111,26222,273691,111216,866122,155994,710128,,1311130,1318.54,3747.04,0.1059,5463,20.0,53579.56,2.08,0.6602
7483,White Ltd,False,ZA,Coleport,IoT,2014,https://whiteltd.com,Difference deal lot success lot generation physical be become.,23,white-ltd,2023,USD,751304,437338,313966,398333,-84367,0,-84367,7513,15026,-99393,36325,466653,72645,394008,,751304,293.69,475.52,0.0286,192,325.75,49358.78,0.74,0.4179
7484,Erickson PLC,False,GB,West Michelleton,HealthTech,2011,https://ericksonplc.com,Last community at even letter former.,20,erickson-plc,2023,USD,5528817,961101,4567716,2887904,1679812,0,1679812,55288,110576,1569236,99186,2866254,403235,2463019,460734.75,5528817,177.47,728.72,0.001,22322,20.64,235421.74,0.42,0.8262
7485,Romero-Mcpherson,False,US,West Phillip,Fintech,2008,https://romero-mcpherson.com,Position moment peace moment cost business home.,22,romero-mcpherson,2023,USD,604495,190085,414410,333433,80977,0,80977,6044,12089,68888,133014,503655,172678,330977,,604495,20.0,134.29,0.0394,449,112.14,24837.44,5.36,0.6855
7486,Perez Group,False,GB,Erichaven,EdTech,2013,https://perezgroup.com,Mind machine ten factor.,26,perez-group,2023,USD,98938,46869,52069,66013,-13944,1817,-15761,989,1978,-17739,4801,195558,22872,172686,8244.83,98938,734.66,3471.93,0.0115,74,111.02,1000.0,4.8,0.5263
7487,Johnson Madden and White,False,US,South Andre,SaaS,2010,https://johnsonmaddenandwhite.com,Strategy role want the before security.,22,johnson-madden-and-white,2023,USD,1652305,646344,1005961,251195,754766,0,754766,16523,33046,721720,142284,979494,264500,714994,137692.08,1652305,369.96,1195.4,0.0248,27538,5.0,17459.09,8.15,0.6088
7488,Rodriguez Gonzales and Berry,False,ZA,Rossberg,AI/ML,2020,https://rodriguezgonzalesandberry.com,Dinner score reflect everything report notice oil.,23,rodriguez-gonzales-and-berry,2023,USD,961235,170493,790742,902592,-111850,5403,-117253,9612,19224,-136477,150977,746992,37349,709643,,961235,918.04,459.02,0.0076,691,115.86,86410.25,1.75,0.8226
7489,Griffin-Davidson,False,EG,Lake Margaretchester,Energy,2020,https://griffin-davidson.com,Whether apply some break town.,24,griffin-davidson,2023,USD,22301414,5325508,16975906,1115070,15860836,0,15860836,223014,446028,15414808,195713,11432898,3804051,7628847,,22301414,1431.31,6712.98,0.001,24023,77.36,67653.91,2.89,0.7612
7490,Jackson Garcia and Riley,False,FR,West Stephanie,SaaS,2008,https://jacksongarciaandriley.com,Trial leg box address range beyond group significant.,18,jackson-garcia-and-riley,2023,EUR,618438,216355,402083,250708,151375,8425,142950,6184,12368,130582,22145,360456,273201,87255,51536.5,618438,434.52,2355.85,0.0014,1889,27.28,49386.38,0.45,0.6502
7491,Taylor Garcia and Robertson,False,NG,South Bobbyshire,Marketplaces,2023,https://taylorgarciaandrobertson.com,Himself education political tonight fine.,14,taylor-garcia-and-robertson,2023,USD,1393033,69651,1323382,685124,638258,16365,621893,13930,27860,594033,194924,944484,460259,484225,,1393033,879.46,3525.69,0.0065,883,131.43,19437.26,10.03,0.95
7492,Fisher-Kramer,False,ZA,New Edwardtown,Energy,2011,https://fisher-kramer.com,Pull bank catch our price return pass center general section.,12,fisher-kramer,2023,USD,421341,189136,232205,21067,211138,0,211138,4213,8426,202712,48356,412243,88331,323912,,421341,20.0,10.0,0.001,167,209.82,10175.25,4.75,0.5511
7493,Hudson PLC,False,US,North Kayla,AI/ML,2010,https://hudsonplc.com,Consumer find down smile.,27,hudson-plc,2023,USD,965836,398423,567413,467166,100247,11129,89118,9658,19316,69802,76695,654069,119956,534113,,965836,684.49,3480.23,0.1425,488,164.87,59213.73,1.3,0.5875
7494,Garner Inc,False,IN,Pamelaville,EdTech,2019,https://garnerinc.com,Sell run exactly director discover however.,18,garner-inc,2023,USD,360900,111009,249891,262274,-12383,11025,-23408,3609,7218,-30626,36030,315349,163024,152325,30075.0,360900,448.87,3144.07,0.0362,300,100.21,1000.0,36.03,0.6924
7495,Turner-Graham,False,TN,South Andrew,Fintech,2017,https://turner-graham.com,Anyone else care give will coach event many.,27,turner-graham,2023,USD,879096,146207,732889,354075,378814,0,378814,8790,17581,361233,151577,754184,215801,538383,,879096,1783.98,12251.56,0.0038,3662,20.0,28209.77,5.37,0.8337
7496,Henderson-Chapman,False,US,East Jeffreyport,Cybersecurity,2015,https://henderson-chapman.com,Full animal theory long property social spring.,26,henderson-chapman,2023,USD,1191131,330469,860662,530756,329906,39068,290838,11911,23822,267016,15045,718230,432169,286061,,1191131,776.22,4243.81,0.0397,432,229.62,33110.98,0.45,0.7226
7497,Hancock Ltd,False,NG,North Dominique,AgriTech,2018,https://hancockltd.com,Better value choice person.,21,hancock-ltd,2023,USD,561931,222538,339393,522223,-182830,15124,-197954,5619,11238,-209192,16201,484470,185197,299273,,561931,819.87,2920.95,0.001,307,152.53,30986.24,0.52,0.604
7498,Wilcox-Thompson,False,BR,New Daniel,EdTech,2010,https://wilcox-thompson.com,Start case Republican sort civil above positive like.,22,wilcox-thompson,2023,USD,863308,314259,549049,219450,329599,8985,320614,8633,17266,303348,74370,661836,75317,586519,71942.33,863308,10.0,28.47,0.0011,818,87.86,13119.11,5.67,0.636
7499,Harris-Williams,False,KE,South Kim,AI/ML,2009,https://harris-williams.com,Either short hear program method season evidence arrive performance whom.,23,harris-williams,2023,USD,1078020,348279,729741,53901,675840,0,675840,10780,21560,654280,74608,658128,228395,429733,,1078020,20.0,101.2,0.001,548,163.65,1000.0,74.61,0.6769
7500,Reyes-Holder,False,AU,New Stephanieshire,Mobility,2016,https://reyes-holder.com,Yes blue tell toward music.,20,reyes-holder,2023,USD,855164,459194,395970,491165,-95195,5601,-100796,8551,17103,-117899,5369,433049,212941,220108,,855164,922.95,1931.82,0.0421,3563,20.0,35929.03,0.15,0.463
7501,Wilson Duke and Alexander,False,TN,South Alexisfort,AI/ML,2012,https://wilsondukeandalexander.com,Room hard available opportunity travel sure mention.,24,wilson-duke-and-alexander,2023,USD,261440,13072,248368,81088,167280,1205,166075,2614,5228,160847,5824,233791,37433,196358,,261440,20.0,41.76,0.0835,96,226.58,5358.63,1.09,0.95
7502,Keller-Vincent,False,DE,Brendashire,E-commerce,2017,https://keller-vincent.com,Resource may condition eight blood long own green special.,29,keller-vincent,2023,EUR,2282846,557536,1725310,1506323,218987,0,218987,22828,45656,173331,351766,1507678,862603,645075,,2282846,763.27,2353.88,0.0592,3113,61.1,132911.27,2.65,0.7558
7503,Nelson and Sons,False,TN,West Susanton,IoT,2018,https://nelsonandsons.com,Sure environmental series record husband us us.,14,nelson-and-sons,2023,USD,5421786,1816031,3605755,2835609,770146,12400,757746,54217,108435,649311,230431,3054878,731954,2322924,,5421786,20.0,57.6,0.0817,1914,235.96,221478.63,1.04,0.665
7504,Bishop Ltd,False,BR,Port Juliefort,Fintech,2009,https://bishopltd.com,Add attention look list anything indicate main soldier better.,17,bishop-ltd,2023,USD,481767,222423,259344,176290,83054,0,83054,4817,9635,73419,94375,442937,135610,307327,,481767,926.97,5767.1,0.0811,177,225.87,17938.71,5.26,0.5383
7505,Tran-Martinez,False,US,West Alexa,EdTech,2008,https://tran-martinez.com,Become apply now tell.,18,tran-martinez,2023,USD,84804,9017,75787,67900,7887,0,7887,848,1696,6191,31836,118595,40683,77912,7067.0,84804,10.0,19.39,0.001,102,68.66,6967.05,4.57,0.8937
7506,Hughes-Wallace,False,EG,Hicksstad,Energy,2013,https://hughes-wallace.com,New bit oil raise shoulder west language.,24,hughes-wallace,2023,USD,304421,94836,209585,31993,177592,4074,173518,3044,6088,167430,10548,267701,110265,157436,,304421,866.63,3033.74,0.1202,309,82.09,1000.0,10.55,0.6885
7507,Williams Inc,False,US,Thomaschester,E-commerce,2016,https://williamsinc.com,Actually suffer movie likely some speech protect worker.,30,williams-inc,2023,USD,967474,308493,658981,329228,329753,0,329753,9674,19349,310404,31152,554177,92216,461961,,967474,511.55,1814.44,0.0967,2164,37.25,4622.81,6.74,0.6811
7508,Ball Baker and Foster,False,CA,West Josephville,Cybersecurity,2020,https://ballbakerandfoster.com,Staff hold painting scene far shoulder be manage.,19,ball-baker-and-foster,2023,USD,733365,145236,588129,552848,35281,0,35281,7333,14667,20614,212691,655620,231263,424357,,733365,415.81,1695.31,0.0255,252,241.88,48298.56,4.4,0.802
7509,Caldwell Group,False,EG,North Tanya,Fintech,2018,https://caldwellgroup.com,Up knowledge quickly during stock chair.,18,caldwell-group,2023,USD,954381,356888,597493,47719,549774,28443,521331,9543,19087,502244,50157,598046,166326,431720,,954381,20.0,10.0,0.0707,3465,22.95,32012.5,1.57,0.6261
7510,Smith Ltd,False,US,Michaelborough,Cybersecurity,2009,https://smithltd.com,Street front practice audience scientist fly daughter receive federal.,22,smith-ltd,2023,USD,1868515,768451,1100064,93425,1006639,0,1006639,18685,37370,969269,47438,1032388,357156,675232,,1868515,265.73,931.21,0.001,667,233.21,1000.0,47.44,0.5887
7511,Delgado-Ramirez,False,TN,East Kellyside,Energy,2020,https://delgado-ramirez.com,During usually act prove hospital field owner hold.,11,delgado-ramirez,2023,USD,6785385,2252925,4532460,5137352,-604892,34398,-639290,67853,135707,-774997,529931,3940457,1867040,2073417,,6785385,20.0,57.5,0.001,28272,20.0,436866.11,1.21,0.668
7512,Garcia LLC,False,TN,Hinesview,AgriTech,2010,https://garciallc.com,Social whole agency action organization seat future trouble employee.,22,garcia-llc,2023,USD,379114,132391,246723,177629,69094,18280,50814,3791,7582,43232,11258,342198,143819,198379,,379114,144.06,384.04,0.001,185,169.97,11641.91,0.97,0.6508
7513,Holmes Robinson and Barron,False,FR,Port Catherine,SaaS,2020,https://holmesrobinsonandbarron.com,Reflect try huge character agent out.,18,holmes-robinson-and-barron,2023,EUR,677491,275433,402058,33874,368184,0,368184,6774,13549,354635,7864,388980,301543,87437,56457.58,677491,695.56,3393.16,0.001,1250,45.16,8646.22,0.91,0.5935
7514,Franco-Francis,False,CA,South Sarahchester,AgriTech,2010,https://franco-francis.com,Main effect hit stay local anything institution account house.,19,franco-francis,2023,USD,90971,25978,64993,42900,22093,0,22093,909,1819,20274,26122,202861,86857,116004,,90971,1542.6,10153.84,0.0334,64,118.01,1000.0,26.12,0.7144
7515,Smith Moore and Cobb,False,ZA,Lake Rachaelside,Fintech,2015,https://smithmooreandcobb.com,Short compare indicate Republican hair choice green someone.,21,smith-moore-and-cobb,2023,USD,2013833,321746,1692087,698824,993263,22728,970535,20138,40276,930259,60455,1085966,516789,569177,,2013833,20.0,157.75,0.0467,738,227.32,24012.13,2.52,0.8402
7516,Martin LLC,False,IN,South Jeffreyport,SaaS,2022,https://martinllc.com,Behavior idea thought unit practice million old.,24,martin-llc,2023,USD,1032303,369831,662472,505513,156959,6569,150390,10323,20646,129744,15454,540943,362887,178056,86025.25,1032303,609.71,1578.9,0.0358,1509,56.98,23998.23,0.64,0.6417
7517,Peterson-Kramer,False,NG,Lake Mark,E-commerce,2011,https://peterson-kramer.com,Allow young heavy between religious.,20,peterson-kramer,2023,USD,4773606,1354550,3419056,1500684,1918372,21332,1897040,47736,95472,1801568,50349,2547973,484181,2063792,,4773606,527.75,1092.61,0.0806,19890,20.0,135619.17,0.37,0.7162
7518,Anderson Deleon and Gill,False,TN,Cooperhaven,IoT,2016,https://andersondeleonandgill.com,Teacher question always concern open follow state cause picture.,20,anderson-deleon-and-gill,2023,USD,587915,272374,315541,390518,-74977,31384,-106361,5879,11758,-118119,7318,301566,37270,264296,,587915,20.0,83.8,0.001,2449,20.0,49744.23,0.15,0.5367
7519,Yates Mccarty and Watson,False,AU,Port Dennisville,IoT,2023,https://yatesmccartyandwatson.com,Hotel maintain during vote.,14,yates-mccarty-and-watson,2023,USD,478545,212079,266466,369843,-103377,19724,-123101,4785,9570,-132671,62352,306060,107782,198278,,478545,84.24,287.74,0.0239,293,135.97,28110.68,2.22,0.5568
7520,Ray-Murray,False,US,North Matthew,AI/ML,2008,https://ray-murray.com,Instead west charge all mouth authority beat budget become bring treatment.,15,ray-murray,2023,USD,336952,145806,191146,172043,19103,0,19103,3369,6739,12364,21095,228301,115313,112988,,336952,20.0,114.15,0.0666,692,40.57,14716.01,1.43,0.5673
7521,Crawford-Chandler,False,CA,Port Alicia,AI/ML,2014,https://crawford-chandler.com,Always red this important often until.,18,crawford-chandler,2023,USD,379975,156987,222988,200742,22246,13846,8400,3799,7599,801,34226,257249,118879,138370,,379975,1323.2,3601.7,0.1115,113,278.42,13740.12,2.49,0.5868
7522,Austin Foley and Williams,False,TN,Lake Thomas,Energy,2014,https://austinfoleyandwilliams.com,Several chair energy senior range general fund people.,19,austin-foley-and-williams,2023,USD,13037266,8365145,4672121,6400216,-1728095,3820,-1731915,130372,260745,-1992660,81333,6649705,1481336,5168369,,13037266,1492.62,1491.94,0.1451,54321,20.0,527114.79,0.15,0.3584
7523,Rodgers-Miller,False,IN,West Lori,AI/ML,2012,https://rodgers-miller.com,Them remember result act likely police deal direction.,23,rodgers-miller,2023,USD,85790,24820,60970,26959,34011,0,34011,857,1715,32296,2385,53216,16002,37214,,85790,20.0,27.3,0.0837,357,20.0,6483.21,0.37,0.7107
7524,Lam-Kennedy,False,TN,East Martin,AI/ML,2020,https://lam-kennedy.com,Scientist seek spend scientist president star room partner standard.,23,lam-kennedy,2023,USD,281944,142195,139749,14097,125652,10558,115094,2819,5638,109456,33224,270401,25777,244624,,281944,20.0,81.36,0.031,83,279.87,23341.39,1.42,0.4957
7525,Simmons-Gomez,False,GB,East Natashaland,Energy,2022,https://simmons-gomez.com,Bag develop support which man kind another among.,18,simmons-gomez,2023,USD,480509,145502,335007,49688,285319,8452,276867,4805,9610,267257,62164,302982,60040,242942,,480509,779.19,3255.3,0.0727,238,167.57,1302.56,47.72,0.6972
7526,Lee-Porter,False,AU,Lake Joseph,SaaS,2024,https://lee-porter.com,Yourself act peace point card.,19,lee-porter,2023,USD,1070805,585674,485131,688280,-203149,25301,-228450,10708,21416,-249866,48749,595064,256032,339032,89233.75,1070805,381.06,2193.94,0.0529,17846,5.0,52580.73,0.93,0.4531
7527,Aguirre-Miller,False,DE,South Matthew,AI/ML,2021,https://aguirre-miller.com,Dog hear every suggest thus operation statement.,20,aguirre-miller,2023,EUR,167242,48551,118691,65419,53272,16541,36731,1672,3344,33387,9128,253982,124511,129471,,167242,891.33,3039.33,0.0854,101,136.99,13937.65,0.65,0.7097
7528,Mason Rogers and Shannon,False,NG,South John,AI/ML,2024,https://masonrogersandshannon.com,Interest need worry girl use affect these father enough.,26,mason-rogers-and-shannon,2023,USD,879084,272548,606536,511330,95206,51707,43499,8790,17581,25918,59946,668225,337925,330300,,879084,20.0,40.07,0.097,323,226.49,39906.21,1.5,0.69
7529,Rodriguez Inc,False,BR,Huntertown,IoT,2011,https://rodriguezinc.com,Budget message shoulder include stuff energy.,26,rodriguez-inc,2023,USD,1588111,584879,1003232,552109,451123,6940,444183,15881,31762,412421,44234,882927,534843,348084,,1588111,113.51,449.48,0.0382,480,275.48,24984.48,1.77,0.6317
7530,Rivera PLC,False,EG,Port Cheryl,AI/ML,2023,https://riveraplc.com,Grow performance safe while center protect term billion.,16,rivera-plc,2023,USD,2791258,1253942,1537316,2381221,-843905,10763,-854668,27912,55825,-910493,362584,1768462,724859,1043603,,2791258,1494.37,4646.42,0.0855,1165,199.52,179891.4,2.02,0.5508
7531,Green-Lee,False,AU,Wilsonchester,IoT,2010,https://green-lee.com,Bit second fear daughter organization.,26,green-lee,2023,USD,168903,93370,75533,108417,-32884,0,-32884,1689,3378,-36262,27037,266234,71149,195085,,168903,731.09,1914.29,0.0862,128,109.32,1000.0,27.04,0.4472
7532,Brown Scott and Barnett,False,CA,West Natalie,SaaS,2019,https://brownscottandbarnett.com,Specific west democratic memory follow serve character course begin know.,19,brown-scott-and-barnett,2023,USD,1140187,373805,766382,149561,616821,0,616821,11401,22803,594018,48550,739802,305011,434791,95015.58,1140187,242.72,1219.66,0.001,998,95.17,1000.0,48.55,0.6722
7533,Carpenter-Johnson,False,AU,West Danachester,IoT,2021,https://carpenter-johnson.com,Admit society poor at run social likely heavy economic fill.,23,carpenter-johnson,2023,USD,275528,30885,244643,196024,48619,5474,43145,2755,5510,37635,30043,277606,41771,235835,,275528,673.75,484.21,0.001,254,90.28,8406.61,3.57,0.8879
7534,Schwartz Group,False,GB,Lake Christopherborough,E-commerce,2022,https://schwartzgroup.com,Party lose decade unit agent hotel available participant another.,24,schwartz-group,2023,USD,668000,232701,435299,100909,334390,5172,329218,6680,13360,315858,39229,419185,167037,252148,,668000,1052.41,3085.83,0.0089,2783,20.0,1000.0,39.23,0.6516
7535,Richardson Bailey and Taylor,False,FR,Torresside,IoT,2022,https://richardsonbaileyandtaylor.com,Itself feel traditional method ground education spring current yard.,23,richardson-bailey-and-taylor,2023,EUR,256417,105261,151156,146741,4415,44874,-40459,2564,5128,-45587,54443,336788,64134,272654,,256417,20.0,13.34,0.001,112,190.75,7619.37,7.15,0.5895
7536,Diaz Ltd,False,TN,Jeffreychester,SaaS,2015,https://diazltd.com,Group wish large section doctor around then.,14,diaz-ltd,2023,USD,688338,145803,542535,575413,-32878,0,-32878,6883,13766,-46644,88284,599451,386404,213047,57361.5,688338,10.0,29.59,0.0482,1414,40.56,40826.26,2.16,0.7882
7537,Brown Inc,False,GB,North Julieland,SaaS,2010,https://browninc.com,Rise TV five computer.,22,brown-inc,2023,USD,261157,75732,185425,72695,112730,6545,106185,2611,5223,100962,10882,324488,150860,173628,21763.08,261157,10.0,10.0,0.0378,226,96.22,1000.0,10.88,0.71
7538,Garcia Bishop and Copeland,False,GB,North Terrence,Energy,2019,https://garciabishopandcopeland.com,Sell determine before phone security but face member scene.,20,garcia-bishop-and-copeland,2023,USD,1661751,380004,1281747,439083,842664,19754,822910,16617,33235,789675,106382,1026469,923822,102647,,1661751,20.0,88.58,0.1334,693,199.74,45736.15,2.33,0.7713
7539,Payne Andrews and Taylor,False,EG,Keithside,Marketplaces,2024,https://payneandrewsandtaylor.com,Anything conference spend away early wonder.,20,payne-andrews-and-taylor,2023,USD,964050,51816,912234,412664,499570,0,499570,9640,19281,480289,29832,688839,421289,267550,,964050,1330.65,3897.44,0.069,1892,42.46,31217.93,0.96,0.9463
7540,Jackson Thompson and Johnson,False,KE,Cameronmouth,AI/ML,2013,https://jacksonthompsonandjohnson.com,Concern TV teach benefit make suffer treatment sea miss region.,27,jackson-thompson-and-johnson,2023,USD,1425875,626457,799418,71293,728125,58303,669822,14258,28517,641305,244626,1078129,405546,672583,,1425875,100.32,172.05,0.001,2286,51.97,16211.61,15.09,0.5607
7541,Henderson Hunt and Jones,False,TN,Whitneyfort,SaaS,2017,https://hendersonhuntandjones.com,Receive enter yard fish follow care artist eat between direction.,20,henderson-hunt-and-jones,2023,USD,604951,318628,286323,364525,-78202,0,-78202,6049,12099,-90301,34128,478526,23926,454600,50412.58,604951,10.0,59.51,0.0352,910,55.35,31192.89,1.09,0.4733
7542,Scott Jones and Monroe,False,FR,Marieville,AI/ML,2008,https://scottjonesandmonroe.com,Spend president service amount sort learn enter with plant you.,21,scott-jones-and-monroe,2023,EUR,1741125,590544,1150581,182131,968450,0,968450,17411,34822,933628,169224,1057240,388514,668726,,1741125,20.0,71.38,0.0428,1275,113.77,42082.38,4.02,0.6608
7543,Glover Dominguez and Yoder,False,AU,Brettshire,IoT,2019,https://gloverdominguezandyoder.com,Fall somebody show our population.,19,glover-dominguez-and-yoder,2023,USD,1938480,725112,1213368,425522,787846,3704,784142,19384,38769,745373,14391,1027241,488904,538337,,1938480,871.82,6380.53,0.0356,589,274.17,22749.23,0.63,0.6259
7544,Wood LLC,False,GB,Ethanbury,Fintech,2022,https://woodllc.com,Until film hair thing expect plan.,20,wood-llc,2023,USD,1613123,368392,1244731,887941,356790,2630,354160,16131,32262,321898,55622,1038244,705628,332616,,1613123,1250.14,2359.7,0.001,1847,72.78,92943.35,0.6,0.7716
7545,Lowery and Sons,False,CA,South Bridgetfurt,E-commerce,2024,https://loweryandsons.com,Interview above argue moment you fund successful again couple address.,12,lowery-and-sons,2023,USD,263291,158061,105230,106773,-1543,13767,-15310,2632,5265,-20575,6471,292324,109965,182359,,263291,1416.84,2001.56,0.0636,83,262.8,1000.0,6.47,0.3997
7546,Pitts Mccall and Taylor,False,CA,Lake Allison,Fintech,2022,https://pittsmccallandtaylor.com,Movie ground economy serve business.,20,pitts-mccall-and-taylor,2023,USD,782628,349473,433155,393065,40090,8803,31287,7826,15652,15635,142592,637907,276199,361708,,782628,331.33,647.99,0.0114,3260,20.0,52051.01,2.74,0.5535
7547,Patel Taylor and Montgomery,False,EG,South Philip,Mobility,2017,https://pateltaylorandmontgomery.com,Church even thus another station view rock country oil.,23,patel-taylor-and-montgomery,2023,USD,4103539,1179190,2924349,3584649,-660300,23306,-683606,41035,82070,-765676,1982094,4071333,2891283,1180050,,4103539,20.0,20.86,0.006,1587,215.41,292104.18,6.79,0.7126
7548,Walker-Wells,False,ZA,Port Joshuaville,Fintech,2012,https://walker-wells.com,Read meet wind none force.,20,walker-wells,2023,USD,2421323,877372,1543951,765866,778085,18429,759656,24213,48426,711230,108338,1424252,144576,1279676,,2421323,560.05,1444.86,0.0125,1019,197.83,62880.76,1.72,0.6376
7549,Williamson-Johnson,False,EG,West Gregoryborough,AgriTech,2020,https://williamson-johnson.com,Model politics dream thousand under huge require.,24,williamson-johnson,2023,USD,82321,4116,78205,23162,55043,0,55043,823,1646,53397,5896,193801,48886,144915,,82321,20.0,10.0,0.0329,42,163.04,1000.0,5.9,0.95
7550,Deleon-Ferguson,False,KE,Meghanfurt,HealthTech,2010,https://deleon-ferguson.com,Into group and still mouth environment part man left.,19,deleon-ferguson,2023,USD,600898,93415,507483,328954,178529,10015,168514,6008,12017,156497,17384,373459,18943,354516,50074.83,600898,82.85,225.94,0.001,2968,16.87,60696.78,0.29,0.8445
7551,Freeman-Becker,False,FR,Lisaburgh,AI/ML,2012,https://freeman-becker.com,Listen clear else opportunity bad newspaper.,18,freeman-becker,2023,EUR,7582637,5293465,2289172,6624468,-4335296,25024,-4360320,75826,151652,-4511972,259623,4148287,207414,3940873,,7582637,341.37,1342.96,0.0644,4090,154.48,553926.57,0.47,0.3019
7552,Jackson-Harris,False,IN,New Danielbury,Fintech,2020,https://jackson-harris.com,Success station federal sound least white lot part.,21,jackson-harris,2023,USD,1209932,637455,572477,688547,-116070,7587,-123657,12099,24198,-147855,295899,940291,47014,893277,,1209932,138.36,343.34,0.0942,1048,96.16,63923.43,4.63,0.4731
7553,Ward Wiley and Benjamin,False,GB,South Melissa,Energy,2016,https://wardwileyandbenjamin.com,Side future enter better large.,21,ward-wiley-and-benjamin,2023,USD,610353,110430,499923,302319,197604,0,197604,6103,12207,185397,98775,536812,26840,509972,,610353,825.52,4573.03,0.1044,189,268.13,19986.17,4.94,0.8191
7554,Patterson Ltd,False,GB,Port Johnport,HealthTech,2012,https://pattersonltd.com,Technology article out low article again environment cold event outside.,22,patterson-ltd,2023,USD,579579,328652,250927,485880,-234953,16936,-251889,5795,11591,-263480,23001,484330,188742,295588,48298.25,579579,100.64,451.65,0.001,9659,5.0,47092.84,0.49,0.4329
7555,Phillips Drake and Rios,False,KE,Lake Richardborough,Mobility,2018,https://phillipsdrakeandrios.com,Quality necessary student money require.,19,phillips-drake-and-rios,2023,USD,3182080,529766,2652314,1415922,1236392,0,1236392,31820,63641,1172751,171222,1918723,421927,1496796,,3182080,1009.03,1245.77,0.017,6958,38.11,106468.14,1.61,0.8335
7556,Graves and Sons,False,NG,New Sarahfurt,IoT,2010,https://gravesandsons.com,Voice represent itself return market nor compare.,27,graves-and-sons,2023,USD,452028,126798,325230,67886,257344,17419,239925,4520,9040,230885,8314,407737,47509,360228,,452028,476.74,1439.57,0.0376,1883,20.0,9678.25,0.86,0.7195
7557,King Group,False,EG,Morganport,SaaS,2016,https://kinggroup.com,Box wonder thought class fire Democrat.,14,king-group,2023,USD,1001050,363952,637098,630014,7084,20101,-13017,10010,20021,-33038,59699,590120,173773,416347,83420.83,1001050,427.8,3087.7,0.0379,839,99.36,66531.25,0.9,0.6364
7558,Rush Gonzalez and Waters,False,ZA,West Elizabeth,Cybersecurity,2019,https://rushgonzalezandwaters.com,Garden yes politics hospital seven oil.,21,rush-gonzalez-and-waters,2023,USD,346695,133378,213317,156213,57104,0,57104,3466,6933,50171,105775,442690,22134,420556,,346695,20.0,65.35,0.0261,1444,20.0,9131.92,11.58,0.6153
7559,Holmes-Robinson,False,IN,Huberburgh,HealthTech,2011,https://holmes-robinson.com,Election sport million imagine sure above.,16,holmes-robinson,2023,USD,1100936,246615,854321,497793,356528,0,356528,11009,22018,334510,275667,839729,174337,665392,91744.67,1100936,859.65,859.65,0.0259,1598,57.4,43184.57,6.38,0.776
7560,Warren Stevenson and Bryant,False,NG,Michelleside,E-commerce,2017,https://warrenstevensonandbryant.com,Family way bring be analysis plant us sort foreign.,16,warren-stevenson-and-bryant,2023,USD,1556944,586617,970327,586880,383447,32495,350952,15569,31138,319814,123618,912083,272475,639608,,1556944,20.0,48.04,0.1212,572,226.51,20527.3,6.02,0.6232
7561,Hanson Cox and Tate,False,CA,East Maria,Mobility,2009,https://hansoncoxandtate.com,One admit specific nearly information.,25,hanson-cox-and-tate,2023,USD,675611,132727,542884,469281,73603,43797,29806,6756,13512,16294,112750,578532,244934,333598,,675611,20.0,10.0,0.1097,2815,20.0,19185.49,5.88,0.8035
7562,Smith-Williams,False,CA,Sandrafort,Energy,2024,https://smith-williams.com,Significant international control usually individual behind collection item.,22,smith-williams,2023,USD,1127171,383660,743511,582520,160991,0,160991,11271,22543,138448,80006,696156,34807,661349,,1127171,573.62,3033.11,0.1017,1432,65.58,49677.54,1.61,0.6596
7563,Taylor and Sons,False,GB,South Kellyshire,SaaS,2012,https://taylorandsons.com,Sell magazine never much seat yeah.,16,taylor-and-sons,2023,USD,692101,220799,471302,330035,141267,12005,129262,6921,13842,115420,42944,556434,128985,427449,57675.08,692101,246.65,355.65,0.0516,675,85.38,45412.62,0.95,0.681
7564,Butler-Marshall,False,GB,South Tabithaport,E-commerce,2023,https://butler-marshall.com,Site we available economy sign.,17,butler-marshall,2023,USD,400540,184781,215759,83199,132560,17604,114956,4005,8010,106946,45757,373855,300045,73810,,400540,33.23,89.38,0.001,411,81.07,1000.0,45.76,0.5387
7565,Perez-Nguyen,False,US,Dennisport,Cybersecurity,2008,https://perez-nguyen.com,Tell various blood everybody share politics attack just.,19,perez-nguyen,2023,USD,1567888,831561,736327,720895,15432,0,15432,15678,31357,-15925,22831,832898,362404,470494,,1567888,45.48,174.81,0.0196,766,170.49,58222.75,0.39,0.4696
7566,Powers Shannon and Lawrence,False,ZA,Port Jessica,SaaS,2010,https://powersshannonandlawrence.com,Stand food reduce condition actually movie.,25,powers-shannon-and-lawrence,2023,USD,706096,345947,360149,380790,-20641,16917,-37558,7060,14121,-51679,19829,558822,243961,314861,58841.33,706096,118.84,335.25,0.001,749,78.47,27963.29,0.71,0.5101
7567,Beltran LLC,False,BR,Darylfurt,Energy,2015,https://beltranllc.com,Can him case great peace born dark appear yourself.,18,beltran-llc,2023,USD,1025978,262021,763957,813490,-49533,20884,-70417,10259,20519,-90936,166607,863923,163554,700369,,1025978,20.0,95.23,0.1209,4274,20.0,92870.07,1.79,0.7446
7568,Lewis LLC,False,ZA,East James,E-commerce,2021,https://lewisllc.com,Move political seven especially idea operation between.,20,lewis-llc,2023,USD,1338252,690127,648125,758101,-109976,4645,-114621,13382,26765,-141386,188660,1050067,161055,889012,,1338252,20.0,10.0,0.0945,432,257.59,20896.99,9.03,0.4843
7569,King-Boyd,False,IN,New Alexander,SaaS,2022,https://king-boyd.com,Production per everything rest someone doctor can next.,20,king-boyd,2023,USD,1396501,800607,595894,662411,-66517,0,-66517,13965,27930,-94447,137241,999226,351326,647900,116375.08,1396501,51.8,307.19,0.0062,2252,51.67,59496.76,2.31,0.4267
7570,Peters-Rodriguez,False,GB,Port Ronald,EdTech,2012,https://peters-rodriguez.com,Mr sport month consider admit.,23,peters-rodriguez,2023,USD,721187,378711,342476,319001,23475,17859,5616,7211,14423,-8807,73310,434709,21735,412974,60098.92,721187,376.43,376.43,0.0598,610,98.52,22089.23,3.32,0.4749
7571,Eaton Cox and Peterson,False,IN,Michaelport,Mobility,2013,https://eatoncoxandpeterson.com,Interesting present test manager response sea.,22,eaton-cox-and-peterson,2023,USD,695203,240968,454235,136105,318130,0,318130,6952,13904,304226,16935,424806,188836,235970,,695203,98.41,49.2,0.001,2896,20.0,12718.69,1.33,0.6534
7572,Yang LLC,False,NG,Hernandezside,HealthTech,2018,https://yangllc.com,To family heart yard avoid save.,23,yang-llc,2023,USD,140012,54292,85720,58728,26992,23202,3790,1400,2800,990,8665,154851,37283,117568,11667.67,140012,119.07,491.15,0.0618,159,73.24,1000.0,8.66,0.6122
7573,Fuller Inc,False,ZA,South Ashley,AgriTech,2008,https://fullerinc.com,Building very certainly market town cover fast.,14,fuller-inc,2023,USD,755258,252319,502939,621351,-118412,49110,-167522,7552,15105,-182627,10016,439668,21983,417685,,755258,2345.59,8609.79,0.0161,3146,20.0,87498.02,0.11,0.6659
7574,Smith LLC,False,US,West Jacob,Fintech,2023,https://smithllc.com,Congress occur official lead card this.,11,smith-llc,2023,USD,416191,172102,244089,154745,89344,7145,82199,4161,8323,73876,17265,424566,108145,316421,,416191,1078.18,5443.83,0.001,1734,20.0,19767.68,0.87,0.5865
7575,Chapman-Mitchell,False,NG,Dunnview,Marketplaces,2024,https://chapman-mitchell.com,Particular black again consumer run direction rather opportunity.,19,chapman-mitchell,2023,USD,3242945,2051652,1191293,1665207,-473914,15208,-489122,32429,64858,-553980,76527,1751161,871379,879782,,3242945,1100.96,4600.65,0.001,974,277.43,116673.12,0.66,0.3673
7576,Foster Ltd,False,GB,New Christopherbury,HealthTech,2016,https://fosterltd.com,Conference save control event our camera weight very see conference.,12,foster-ltd,2023,USD,778077,460451,317626,257408,60218,29429,30789,7780,15561,15228,1403276,1966866,822884,1143982,64839.75,778077,635.13,1548.29,0.001,675,95.93,1000.0,1403.28,0.4082
7577,Chapman Knight and Green,False,ZA,Howechester,Mobility,2015,https://chapmanknightandgreen.com,Live follow class suffer practice Congress start.,23,chapman-knight-and-green,2023,USD,1604492,548939,1055553,870912,184641,18056,166585,16044,32089,134496,43922,902800,240645,662155,,1604492,1161.66,2190.56,0.0321,921,145.06,49314.03,0.89,0.6579
7578,Jenkins and Sons,False,FR,North Sherryfort,HealthTech,2021,https://jenkinsandsons.com,Wait very far plant feeling light lay we place whether.,15,jenkins-and-sons,2023,EUR,913560,378320,535240,301265,233975,0,233975,9135,18271,215704,58612,617220,238774,378446,76130.0,913560,162.53,575.4,0.0028,1805,42.17,33036.0,1.77,0.5859
7579,Crosby English and Cabrera,False,FR,Lake Donald,Energy,2019,https://crosbyenglishandcabrera.com,Difference well cultural represent just care soon push unit.,22,crosby-english-and-cabrera,2023,EUR,2863225,1134832,1728393,1561673,166720,0,166720,28632,57264,109456,112362,1615106,689687,925419,,2863225,20.0,77.35,0.001,11930,20.0,90693.83,1.24,0.6037
7580,Martinez Mccormick and Graham,False,US,Angelaberg,Mobility,2010,https://martinezmccormickandgraham.com,Successful they ground executive cut stand.,21,martinez-mccormick-and-graham,2023,USD,5199008,1578260,3620748,3009494,611254,18027,593227,51990,103980,489247,454507,3184202,990709,2193493,,5199008,1265.0,4958.08,0.0142,13573,31.92,242804.54,1.87,0.6964
7581,Barnes-Compton,False,US,Lake Erinland,E-commerce,2009,https://barnes-compton.com,Economic card eat stuff after.,26,barnes-compton,2023,USD,239101,84932,154169,108618,45551,0,45551,2391,4782,40769,5794,149908,7495,142413,,239101,20.0,15.97,0.1303,112,177.11,40343.03,0.14,0.6448
7582,Sheppard and Sons,False,FR,Coreyport,Fintech,2019,https://sheppardandsons.com,Property tell general three simple role company lead phone production.,13,sheppard-and-sons,2023,EUR,2047521,981169,1066352,102376,963976,15485,948491,20475,40950,907541,10429,1098245,220056,878189,,2047521,148.55,214.13,0.0657,585,291.53,31922.41,0.33,0.5208
7583,Butler-Jimenez,False,US,New Danielleshire,IoT,2013,https://butler-jimenez.com,Concern history scientist catch mention might before.,19,butler-jimenez,2023,USD,673869,244532,429337,224684,204653,10044,194609,6738,13477,181132,58875,540091,223416,316675,,673869,20.0,40.62,0.1157,1609,34.89,49870.06,1.18,0.6371
7584,Young-Harris,False,EG,South Matthewbury,Fintech,2010,https://young-harris.com,Cover each serious you should beat rather attack present style produce.,21,young-harris,2023,USD,1155452,375219,780233,134518,645715,0,645715,11554,23109,622606,66817,736444,119418,617026,,1155452,20.0,61.27,0.001,334,287.43,18102.86,3.69,0.6753
7585,Gonzalez-Blake,False,CA,Wendyfort,HealthTech,2021,https://gonzalez-blake.com,Team management home above girl add necessary house several large marriage.,25,gonzalez-blake,2023,USD,1499077,414721,1084356,1508046,-423690,1524,-425214,14990,29981,-455195,5814,888695,248903,639792,124923.08,1499077,424.63,1226.59,0.0086,4552,27.44,133490.71,0.04,0.7233
7586,Cohen Smith and Mclaughlin,False,FR,South Laurenland,Cybersecurity,2009,https://cohensmithandmclaughlin.com,Power heart will not up speak form.,21,cohen-smith-and-mclaughlin,2023,EUR,694535,262715,431820,342622,89198,20864,68334,6945,13890,54444,33489,488356,328679,159677,,694535,20.0,54.02,0.001,837,69.07,1000.0,33.49,0.6217
7587,Brown-Kelly,False,ZA,New Josephfurt,E-commerce,2015,https://brown-kelly.com,Order evening source these opportunity trade idea scene exactly.,15,brown-kelly,2023,USD,516435,173347,343088,73173,269915,16061,253854,5164,10328,243526,9200,269643,66498,203145,,516435,719.8,793.27,0.0365,275,156.22,1000.0,9.2,0.6643
7588,Mcmahon Roberts and Bentley,False,AU,North Amanda,Mobility,2009,https://mcmahonrobertsandbentley.com,Author sister tend race age process.,17,mcmahon-roberts-and-bentley,2023,USD,293973,64884,229089,81525,147564,0,147564,2939,5879,141685,63015,370162,128646,241516,,293973,20.0,12.69,0.076,1224,20.0,12317.75,5.12,0.7793
7589,Flores Group,False,KE,Mannville,HealthTech,2014,https://floresgroup.com,Public something either new wife animal themselves among boy.,22,flores-group,2023,USD,5569553,1531909,4037644,2157723,1879921,12940,1866981,55695,111391,1755590,152773,3124833,1044456,2080377,464129.42,5569553,90.59,315.9,0.0102,5221,88.88,197313.85,0.77,0.7249
7590,Hall-Cunningham,False,US,Bridgetville,SaaS,2022,https://hall-cunningham.com,Person tough beautiful field create collection open truth man.,28,hall-cunningham,2023,USD,1160033,497701,662332,484203,178129,0,178129,11600,23200,154929,24293,726317,185370,540947,96669.42,1160033,63.73,523.93,0.0235,3203,30.18,37449.44,0.65,0.571
7591,Williams Group,False,FR,Kellyborough,Energy,2018,https://williamsgroup.com,Happy production chair fact yourself team performance.,15,williams-group,2023,EUR,2000819,415280,1585539,427944,1157595,8242,1149353,20008,40016,1109337,197220,1357825,1002573,355252,,2000819,20.0,81.48,0.0864,478,348.68,48321.56,4.08,0.7924
7592,Lane Bean and Brown,False,BR,North Coreyfurt,SaaS,2008,https://lanebeanandbrown.com,Pay this get spend.,13,lane-bean-and-brown,2023,USD,1058949,321091,737858,863000,-125142,0,-125142,10589,21178,-146320,59030,673761,34267,639494,88245.75,1058949,88.05,463.6,0.0269,1184,74.51,80289.2,0.74,0.6968
7593,Stout PLC,False,EG,Bellborough,AgriTech,2010,https://stoutplc.com,Rich five reduce American PM.,19,stout-plc,2023,USD,904963,109931,795032,171865,623167,14519,608648,9049,18099,590549,73538,595774,327272,268502,,904963,232.39,777.47,0.0163,482,156.31,15295.64,4.81,0.8785
7594,Reyes-Pierce,False,NG,Port Jenniferton,IoT,2017,https://reyes-pierce.com,Leave ground these people agent.,29,reyes-pierce,2023,USD,585768,272845,312923,115059,197864,0,197864,5857,11715,186149,78692,422919,193480,229439,,585768,20.0,70.4,0.0555,311,156.56,1000.0,78.69,0.5342
7595,Brown-Wilson,False,NG,East Roger,Cybersecurity,2018,https://brown-wilson.com,West feeling sense ok lawyer station TV common.,27,brown-wilson,2023,USD,1089944,683905,406039,352189,53850,0,53850,10899,21798,32052,16902,681052,216799,464253,,1089944,697.16,2821.42,0.0711,4541,20.0,24481.78,0.69,0.3725
7596,Holden-Cruz,False,ZA,South Charlesmouth,AgriTech,2015,https://holden-cruz.com,Number himself commercial these after thank win interesting small new.,20,holden-cruz,2023,USD,203449,88997,114452,84216,30236,7218,23018,2034,4068,18950,12850,231026,109845,121181,,203449,20.0,129.13,0.0239,402,42.15,28370.92,0.45,0.5626
7597,Brown Inc,False,AU,Cameronfurt,Marketplaces,2012,https://browninc.com,More model information share reveal husband why lawyer financial country.,19,brown-inc,2023,USD,375604,156045,219559,32006,187553,22599,164954,3756,7512,157442,8224,344957,40835,304122,,375604,20.0,92.03,0.0514,882,35.46,1000.0,8.22,0.5845
7598,Turner LLC,False,AU,Jamesfort,IoT,2024,https://turnerllc.com,Area likely floor interest chance tell concern live.,23,turner-llc,2023,USD,354537,100103,254434,250134,4300,0,4300,3545,7090,-2790,656,273553,42286,231267,,354537,20.0,51.65,0.0266,136,216.86,56501.52,0.01,0.7177
7599,Jackson Wallace and Wells,False,EG,Malonemouth,Energy,2014,https://jacksonwallaceandwells.com,Might according example financial authority Republican clearly size which price.,20,jackson-wallace-and-wells,2023,USD,567615,175129,392486,269874,122612,0,122612,5676,11352,111260,29981,495440,106982,388458,,567615,896.68,1381.79,0.025,509,92.79,74407.86,0.4,0.6915
7600,Acosta Group,False,TN,Daniellehaven,E-commerce,2012,https://acostagroup.com,Hotel score history box land color record available name.,18,acosta-group,2023,USD,758547,165310,593237,37927,555310,1729,553581,7585,15170,538411,21472,512081,273329,238752,,758547,455.17,1934.8,0.1567,643,98.23,1000.0,21.47,0.7821
7601,Carroll and Sons,False,KE,Gibbsland,AgriTech,2016,https://carrollandsons.com,Future require task mean might word three second say.,27,carroll-and-sons,2023,USD,97470,41702,55768,17210,38558,8071,30487,974,1949,28538,10476,236780,68814,167966,,97470,20.0,15.27,0.001,38,212.4,32700.0,0.32,0.5722
7602,Caldwell Robinson and West,False,EG,Bradyland,Fintech,2021,https://caldwellrobinsonandwest.com,Moment phone question under program.,25,caldwell-robinson-and-west,2023,USD,194735,84563,110172,175238,-65066,248,-65314,1947,3894,-69208,35236,270823,135299,135524,,194735,508.67,391.46,0.0502,811,20.0,51073.6,0.69,0.5658
7603,Zavala Bernard and Jones,False,ZA,Port William,Fintech,2024,https://zavalabernardandjones.com,He will firm which similar situation.,20,zavala-bernard-and-jones,2023,USD,83710,34774,48936,28043,20893,28478,-7585,837,1674,-9259,8199,212562,96700,115862,,83710,20.0,124.55,0.0552,82,84.18,9011.64,0.91,0.5846
7604,Schultz PLC,False,GB,Antoniomouth,Mobility,2014,https://schultzplc.com,Spend activity front thousand world green oil.,21,schultz-plc,2023,USD,1406671,449349,957322,540056,417266,0,417266,14066,28133,389133,45468,790962,195218,595744,,1406671,435.26,1862.22,0.0092,5861,20.0,52701.2,0.86,0.6806
7605,Barrett-Chen,False,AU,South Sheilafurt,AgriTech,2010,https://barrett-chen.com,Join whose herself market key.,18,barrett-chen,2023,USD,615896,134909,480987,392095,88892,38911,49981,6158,12317,37664,6277,467547,142623,324924,,615896,1271.97,2430.98,0.001,213,240.66,1000.0,6.28,0.781
7606,Hendricks Bell and Fuller,False,DE,Carolynport,Cybersecurity,2010,https://hendricksbellandfuller.com,Final war local election data evening military.,26,hendricks-bell-and-fuller,2023,EUR,2047663,823226,1224437,1346474,-122037,28019,-150056,20476,40953,-191009,53732,1079613,219514,860099,,2047663,20.0,64.45,0.1364,1290,132.18,132237.44,0.41,0.598
7607,Choi-Goodwin,False,US,New Anthony,AgriTech,2018,https://choi-goodwin.com,Soldier main measure choose protect whatever.,19,choi-goodwin,2023,USD,453915,149894,304021,342577,-38556,3048,-41604,4539,9078,-50682,66138,348978,54104,294874,,453915,1006.53,3923.13,0.001,139,270.63,18441.21,3.59,0.6698
7608,Hamilton PLC,False,US,New Kelly,HealthTech,2019,https://hamiltonplc.com,Memory song management economic source allow trade south country partner.,15,hamilton-plc,2023,USD,1117145,545269,571876,74065,497811,0,497811,11171,22342,475469,10299,579499,148185,431314,93095.42,1117145,506.03,3004.67,0.0301,10495,8.87,1000.0,10.3,0.5119
7609,Barnett Thomas and Obrien,False,AU,Howardstad,AI/ML,2020,https://barnettthomasandobrien.com,Less method start heavy chance treatment which paper.,24,barnett-thomas-and-obrien,2023,USD,1183546,503822,679724,456789,222935,0,222935,11835,23670,199265,80644,688973,275923,413050,,1183546,20.0,66.91,0.0595,4931,20.0,36929.0,2.18,0.5743
7610,Hart-Allen,False,DE,Singletonshire,Marketplaces,2013,https://hart-allen.com,Fall soldier strategy head room country different question.,24,hart-allen,2023,EUR,874389,332866,541523,302345,239178,0,239178,8743,17487,221691,19825,500648,218256,282392,,874389,1689.29,6056.78,0.001,2430,29.98,20661.16,0.96,0.6193
7611,Lopez Baldwin and Arnold,False,FR,East Stevenfort,Mobility,2017,https://lopezbaldwinandarnold.com,Answer feel reduce outside painting painting.,19,lopez-baldwin-and-arnold,2023,EUR,5707242,3818485,1888757,1082708,806049,9964,796085,57072,114144,681941,178755,3079320,1695289,1384031,,5707242,440.55,1892.02,0.001,4202,113.17,79229.24,2.26,0.3309
7612,Henderson PLC,False,DE,West Alishaville,Cybersecurity,2019,https://hendersonplc.com,What magazine reveal yeah environment against.,29,henderson-plc,2023,EUR,1148657,319258,829399,687600,141799,37619,104180,11486,22973,81207,24971,736545,306705,429840,,1148657,20.0,10.0,0.0477,590,162.07,103619.55,0.24,0.7221
7613,Wright Inc,False,EG,East Tammytown,AgriTech,2024,https://wrightinc.com,Admit watch player difference road wish nothing left company I.,16,wright-inc,2023,USD,4091824,1821842,2269982,1468066,801916,0,801916,40918,81836,720080,215581,2351726,149003,2202723,,4091824,1190.8,5554.78,0.0384,6298,54.14,147217.53,1.46,0.5548
7614,Schneider-Arroyo,False,AU,South Steventon,EdTech,2018,https://schneider-arroyo.com,Six deal official decide management.,20,schneider-arroyo,2023,USD,120253,64774,55479,41723,13756,0,13756,1202,2405,11351,43194,265148,73759,191389,10021.08,120253,536.48,2676.09,0.001,185,53.89,21665.38,1.99,0.4614
7615,Harrison Patton and Yoder,False,GB,Murphymouth,Energy,2024,https://harrisonpattonandyoder.com,Interest information plan eight learn fly us.,20,harrison-patton-and-yoder,2023,USD,1114247,295916,818331,55712,762619,1575,761044,11142,22284,738760,44563,801132,121863,679269,,1114247,946.7,1431.01,0.0643,1763,52.65,1000.0,44.56,0.7344
7616,Fuentes-Collier,False,US,West Christopher,Energy,2016,https://fuentes-collier.com,Outside benefit gas generation develop never value family find born.,19,fuentes-collier,2023,USD,1408211,497851,910360,491535,418825,0,418825,14082,28164,390661,49278,847009,151623,695386,,1408211,1264.11,7408.68,0.0141,1152,101.82,44038.8,1.12,0.6465
7617,Hoffman Daniel and Davis,False,NG,Adamsland,Energy,2009,https://hoffmandanielanddavis.com,Throw conference mission lead serious traditional must exist know task.,18,hoffman-daniel-and-davis,2023,USD,215989,87348,128641,133929,-5288,0,-5288,2159,4319,-9607,28769,284064,175707,108357,,215989,301.71,1168.58,0.0149,65,274.08,1000.0,28.77,0.5956
7618,Mcmahon Inc,False,ZA,North Scottmouth,Energy,2022,https://mcmahoninc.com,Bed race lose two movie sister TV lot couple order.,24,mcmahon-inc,2023,USD,1320308,245962,1074346,624680,449666,15378,434288,13203,26406,407882,87076,803808,254946,548862,,1320308,408.91,1993.93,0.0677,5501,20.0,45564.26,1.91,0.8137
7619,Vega Inc,False,DE,Mooreborough,IoT,2015,https://vegainc.com,Anything modern experience free piece wall record ground daughter.,19,vega-inc,2023,EUR,840543,242144,598399,394816,203583,0,203583,8405,16810,186773,149977,573974,236843,337131,,840543,2262.92,4869.83,0.0366,263,266.23,58491.35,2.56,0.7119
7620,Davis and Sons,False,ZA,East Sierra,AgriTech,2017,https://davisandsons.com,Particular bag church Mrs save see system health plan form.,22,davis-and-sons,2023,USD,188976,37833,151143,68971,82172,19358,62814,1889,3779,59035,43201,319363,52490,266873,,188976,20.0,117.94,0.001,62,253.62,35022.82,1.23,0.7998
7621,Ramirez-Medina,False,NG,Marquezside,AI/ML,2014,https://ramirez-medina.com,Before pressure list camera condition produce.,15,ramirez-medina,2023,USD,344111,164923,179188,373865,-194677,10572,-205249,3441,6882,-212131,12717,368146,198579,169567,,344111,252.14,671.01,0.1227,1433,20.0,6786.81,1.87,0.5207
7622,Hoover Small and Ward,False,NG,Lake Charlesville,AgriTech,2013,https://hooversmallandward.com,Speak magazine agency arrive situation law.,33,hoover-small-and-ward,2023,USD,285861,106852,179009,115833,63176,0,63176,2858,5717,57459,13623,315992,54628,261364,,285861,1023.05,511.52,0.0443,69,343.72,5292.61,2.57,0.6262
7623,Mitchell and Sons,False,CA,Lake Emilyland,EdTech,2020,https://mitchellandsons.com,Large provide since small tell bit score candidate movie raise.,18,mitchell-and-sons,2023,USD,690519,302640,387879,151972,235907,0,235907,6905,13810,222097,35132,471911,344685,127226,57543.25,690519,412.22,1875.7,0.0447,1014,56.73,28424.68,1.24,0.5617
7624,Brown and Sons,False,AU,Leonardborough,Marketplaces,2017,https://brownandsons.com,Build item writer give anyone that wind seek lawyer rock.,13,brown-and-sons,2023,USD,589340,240156,349184,291180,58004,0,58004,5893,11786,46218,81290,499994,66189,433805,,589340,298.44,699.62,0.0724,681,72.11,19962.51,4.07,0.5925
7625,Parker-Shaw,False,TN,Kennethtown,HealthTech,2009,https://parker-shaw.com,Lead she kid popular tough.,14,parker-shaw,2023,USD,335812,162342,173470,179198,-5728,0,-5728,3358,6716,-12444,2803,197779,104560,93219,27984.33,335812,750.55,750.55,0.0142,377,74.13,16371.45,0.17,0.5166
7626,Carter PLC,False,CA,Michellefurt,E-commerce,2009,https://carterplc.com,Character land treat whose end worry recognize share detail top.,26,carter-plc,2023,USD,2531008,875320,1655688,1236205,419483,20186,399297,25310,50620,348677,118569,1511711,756703,755008,,2531008,960.6,4898.73,0.0345,10545,20.0,95980.66,1.24,0.6542
7627,Perez Bailey and Dickerson,False,EG,Lake Timothy,Mobility,2016,https://perezbaileyanddickerson.com,Seat page mind when score fact who challenge range great.,25,perez-bailey-and-dickerson,2023,USD,3373184,1278244,2094940,827327,1267613,0,1267613,33731,67463,1200150,238234,2055017,102750,1952267,,3373184,2682.71,9853.63,0.0572,1704,164.9,105140.97,2.27,0.6211
7628,Clark Hamilton and Kelly,False,ZA,West Jason,SaaS,2020,https://clarkhamiltonandkelly.com,True smile thus respond politics during year language.,15,clark-hamilton-and-kelly,2023,USD,2673317,856678,1816639,1770431,46208,13451,32757,26733,53466,-20709,117803,1461864,768896,692968,222776.42,2673317,10.0,10.0,0.0123,5464,40.77,151609.76,0.78,0.6795
7629,Lee PLC,False,CA,Frenchland,Mobility,2018,https://leeplc.com,Audience have whether behavior gas.,25,lee-plc,2023,USD,3649863,728558,2921305,1828799,1092506,0,1092506,36498,72997,1019509,84423,1991950,482465,1509485,,3649863,352.59,236.71,0.0632,15207,20.0,147554.96,0.57,0.8004
7630,Green-Wise,False,CA,Stephenbury,Fintech,2019,https://green-wise.com,Public why add chair career chance.,24,green-wise,2023,USD,417683,101433,316250,44325,271925,15793,256132,4176,8353,247779,55543,426564,233776,192788,,417683,2312.92,1156.46,0.0705,1740,20.0,34668.53,1.6,0.7572
7631,Peters-Jones,False,TN,Anthonymouth,HealthTech,2014,https://peters-jones.com,Price never worry conference present cover town why.,14,peters-jones,2023,USD,7363036,3227211,4135825,5055339,-919514,406,-919920,73630,147260,-1067180,807929,4585718,1643129,2942589,613586.33,7363036,264.46,1352.55,0.001,122717,5.0,439565.9,1.84,0.5617
7632,Maxwell Group,False,KE,South Stevenburgh,HealthTech,2008,https://maxwellgroup.com,Property affect nearly himself quickly.,18,maxwell-group,2023,USD,594691,296309,298382,78848,219534,25189,194345,5946,11893,182452,17645,408095,215764,192331,49557.58,594691,132.79,256.47,0.028,636,77.85,16459.39,1.07,0.5017
7633,Santiago Ltd,False,KE,Lake Chelseaport,SaaS,2018,https://santiagoltd.com,Design activity central wide office city campaign political term parent.,18,santiago-ltd,2023,USD,16445483,3502792,12942691,4492208,8450483,37295,8413188,164454,328909,8084279,311667,8536490,1224410,7312080,1370456.92,16445483,508.33,2584.03,0.02,274091,5.0,416113.78,0.75,0.787
7634,Miller Myers and Serrano,False,AU,South Robert,E-commerce,2011,https://millermyersandserrano.com,Organization various adult assume chair whether various want play themselves.,15,miller-myers-and-serrano,2023,USD,450838,252439,198399,57631,140768,0,140768,4508,9016,131752,76395,337673,109875,227798,,450838,20.0,13.32,0.0895,1878,20.0,1000.0,76.4,0.4401
7635,Anderson Smith and Frank,False,US,Julieview,Mobility,2017,https://andersonsmithandfrank.com,Bed thought suggest attention sometimes report everything.,23,anderson-smith-and-frank,2023,USD,558317,251308,307009,233435,73574,0,73574,5583,11166,62408,123282,496863,249675,247188,,558317,559.24,1775.04,0.0793,2326,20.0,1000.0,123.28,0.5499
7636,Burke-Gray,False,ZA,Danielhaven,SaaS,2011,https://burke-gray.com,Open never view material economic even concern apply.,23,burke-gray,2023,USD,204074,119367,84707,53285,31422,24720,6702,2040,4081,2621,14941,155935,67326,88609,17006.17,204074,360.66,1552.64,0.001,660,25.75,1000.0,14.94,0.4151
7637,Hooper Ramos and Green,False,DE,West Shane,Fintech,2010,https://hooperramosandgreen.com,Manage popular daughter pull between of resource reach magazine yeah.,23,hooper-ramos-and-green,2023,EUR,602765,273129,329636,181588,148048,3860,144188,6027,12055,132133,20171,431492,318191,113301,,602765,20.0,23.46,0.0491,284,176.63,20461.68,0.99,0.5469
7638,Conner Ltd,False,FR,Nicholaschester,Mobility,2024,https://connerltd.com,Line least cold out include stay pattern mission his.,21,conner-ltd,2023,EUR,1249649,495869,753780,764056,-10276,0,-10276,12496,24992,-35268,57702,690024,461073,228951,,1249649,2068.89,1118.34,0.0528,5206,20.0,99392.06,0.58,0.6032
7639,Lewis Andersen and Schneider,False,TN,Jenniferfurt,Fintech,2008,https://lewisandersenandschneider.com,Charge also any bar sport whatever cultural culture factor.,13,lewis-andersen-and-schneider,2023,USD,1579721,806090,773631,884392,-110761,10852,-121613,15797,31594,-153207,10971,820274,152011,668263,,1579721,347.46,1146.05,0.0363,6582,20.0,77735.81,0.14,0.4897
7640,Cunningham Daniel and Hunt,False,GB,East Jessicaville,E-commerce,2017,https://cunninghamdanielandhunt.com,Money middle ability energy.,27,cunningham-daniel-and-hunt,2023,USD,324274,99809,224465,153761,70704,13027,57677,3242,6485,51192,72108,293110,14655,278455,,324274,20.0,40.35,0.098,192,140.07,6138.72,11.75,0.6922
7641,Chen Dyer and Williamson,False,ZA,Wadeborough,Mobility,2020,https://chendyerandwilliamson.com,Republican mouth evening part person practice office.,23,chen-dyer-and-williamson,2023,USD,2240721,1175339,1065382,311189,754193,0,754193,22407,44814,709379,507541,1708488,155331,1553157,,2240721,20.0,46.75,0.0226,1037,179.98,43036.77,11.79,0.4755
7642,Strickland and Sons,False,US,West Aprilberg,Marketplaces,2013,https://stricklandandsons.com,In test employee shake determine discussion ten fire.,18,strickland-and-sons,2023,USD,2669496,1346594,1322902,833753,489149,39418,449731,26694,53389,396342,40767,1522331,241998,1280333,,2669496,446.28,2897.45,0.001,11122,20.0,74048.12,0.55,0.4956
7643,Goodman Ramirez and Johnson,False,GB,West Brittanyton,Marketplaces,2008,https://goodmanramirezandjohnson.com,Cost future positive writer seven large mission painting author.,16,goodman-ramirez-and-johnson,2023,USD,38834,11550,27284,28482,-1198,0,-1198,388,776,-1974,3261,141065,7053,134012,,38834,20.0,90.97,0.001,29,109.56,35731.34,0.09,0.7026
7644,Olson Mathews and Garrison,False,TN,Millertown,Cybersecurity,2019,https://olsonmathewsandgarrison.com,Pretty hour let note new prepare world community.,14,olson-mathews-and-garrison,2023,USD,299578,105521,194057,286750,-92693,11283,-103976,2995,5991,-109967,67065,372534,76243,296291,,299578,364.11,182.06,0.102,133,186.34,42372.35,1.58,0.6478
7645,Ruiz-Jefferson,False,DE,Lake Michelle,E-commerce,2016,https://ruiz-jefferson.com,Line phone wrong until science modern late write job very public.,20,ruiz-jefferson,2023,EUR,1315735,514371,801364,174352,627012,5027,621985,13157,26314,595671,25407,722815,334584,388231,,1315735,835.27,1315.75,0.011,3964,27.66,31082.84,0.82,0.6091
7646,Wagner-Gutierrez,False,ZA,New Codyside,Fintech,2013,https://wagner-gutierrez.com,Him own fact over really finish.,27,wagner-gutierrez,2023,USD,212376,84644,127732,97976,29756,0,29756,2123,4247,25509,65627,364277,175519,188758,,212376,20.0,51.67,0.001,357,49.44,28839.43,2.28,0.6014
7647,Miller-Garza,False,US,New Jamiefort,Fintech,2012,https://miller-garza.com,Later follow war official present that direction not public.,14,miller-garza,2023,USD,1083925,261564,822361,500958,321403,15571,305832,10839,21678,284154,32421,765080,262599,502481,,1083925,822.07,662.73,0.001,586,154.13,59377.38,0.55,0.7587
7648,Walker Young and Bullock,False,GB,East Michael,Mobility,2018,https://walkeryoungandbullock.com,Of himself social weight nothing personal.,29,walker-young-and-bullock,2023,USD,436071,177018,259053,255075,3978,12465,-8487,4360,8721,-17208,5089,366355,132998,233357,,436071,308.08,997.16,0.0788,1816,20.0,1000.0,5.09,0.5941
7649,Harrison Lin and Santiago,False,AU,Port Tracy,IoT,2019,https://harrisonlinandsantiago.com,Resource rather themselves save account mind manage success smile.,19,harrison-lin-and-santiago,2023,USD,285967,52541,233426,260696,-27270,34982,-62252,2859,5719,-67971,18349,313357,67542,245815,,285967,134.3,262.11,0.0662,1191,20.0,1000.0,18.35,0.8163
7650,Cline and Sons,False,US,Harrisonland,SaaS,2013,https://clineandsons.com,Price relationship onto artist that yet thought which.,17,cline-and-sons,2023,USD,241995,85386,156609,190465,-33856,0,-33856,2419,4839,-38695,20220,305603,103054,202549,20166.25,241995,182.29,1615.55,0.0878,462,43.62,7185.33,2.81,0.6472
7651,Martin Brown and Vasquez,False,TN,East Jamesshire,Cybersecurity,2009,https://martinbrownandvasquez.com,Board follow amount authority leader ago imagine school.,23,martin-brown-and-vasquez,2023,USD,1401174,365700,1035474,1143511,-108037,13187,-121224,14011,28023,-149247,98385,831203,242834,588369,,1401174,20.0,59.35,0.0349,754,154.67,77572.04,1.27,0.739
7652,Ashley Alvarez and Hart,False,FR,Garciaside,E-commerce,2011,https://ashleyalvarezandhart.com,Music task six traditional pretty away they writer.,26,ashley-alvarez-and-hart,2023,EUR,2141759,923960,1217799,1400482,-182683,7262,-189945,21417,42835,-232780,43614,1165359,768068,397291,,2141759,722.96,1500.64,0.0209,2953,60.44,109371.65,0.4,0.5686
7653,Scott Gomez and Mullen,False,CA,Lawrencetown,EdTech,2013,https://scottgomezandmullen.com,Who it management ready plan.,20,scott-gomez-and-mullen,2023,USD,199129,128345,70784,182509,-111725,0,-111725,1991,3982,-115707,5328,193774,128888,64886,16594.08,199129,272.52,1608.75,0.0374,1669,9.94,5902.95,0.9,0.3555
7654,Gill-Lawrence,False,CA,Willisbury,Marketplaces,2016,https://gill-lawrence.com,Memory cold meeting strategy tend mean learn him.,23,gill-lawrence,2023,USD,641274,228009,413265,392425,20840,0,20840,6412,12825,8015,98647,609180,237085,372095,,641274,325.77,3013.39,0.0405,2671,20.0,20526.73,4.81,0.6444
7655,Ortega Inc,False,EG,Millerside,Marketplaces,2018,https://ortegainc.com,Energy four ten impact surface stay loss leave at notice.,19,ortega-inc,2023,USD,490197,167722,322475,244596,77879,26206,51673,4901,9803,41870,36366,295714,35646,260068,,490197,631.75,3793.36,0.0638,1545,26.43,1000.0,36.37,0.6578
7656,Edwards and Sons,False,US,West Cheryl,Mobility,2017,https://edwardsandsons.com,Step majority if color foreign century show.,16,edwards-and-sons,2023,USD,1341821,625387,716434,719785,-3351,43165,-46516,13418,26836,-73352,69323,825235,309850,515385,,1341821,20.0,55.9,0.0931,1372,81.49,62918.92,1.1,0.5339
7657,Eaton Woods and Nguyen,False,US,Palmerview,Mobility,2011,https://eatonwoodsandnguyen.com,Country start enjoy ground few man space draw rather.,24,eaton-woods-and-nguyen,2023,USD,418752,156044,262708,74226,188482,11430,177052,4187,8375,168677,28165,304038,153106,150932,,418752,986.33,2749.39,0.0364,542,64.38,14849.44,1.9,0.6274
7658,Davis May and Martinez,False,AU,East Kylebury,Mobility,2014,https://davismayandmartinez.com,Realize believe report result artist executive consider factor.,15,davis-may-and-martinez,2023,USD,502410,189118,313292,103315,209977,31897,178080,5024,10048,168032,177830,469724,252539,217185,,502410,800.69,2803.56,0.001,2093,20.0,22847.89,7.78,0.6236
7659,Gill Miller and Cabrera,False,GB,North Danielborough,Mobility,2009,https://gillmillerandcabrera.com,Bar parent some agency inside finally red throw authority kitchen.,19,gill-miller-and-cabrera,2023,USD,1273298,334070,939228,490349,448879,9160,439719,12732,25465,414254,179571,847439,374296,473143,,1273298,472.4,447.26,0.0789,5305,20.0,53155.74,3.38,0.7376
7660,Griffin and Sons,False,CA,East Bridgetfort,Cybersecurity,2019,https://griffinandsons.com,Pull often in by we guess discover measure say green analysis.,25,griffin-and-sons,2023,USD,2055970,679807,1376163,602244,773919,1094,772825,20559,41119,731706,41264,1123069,56153,1066916,,2055970,20.0,74.56,0.0514,1193,143.53,22368.71,1.84,0.6693
7661,Hunt Brown and Barnes,False,BR,Jesusborough,SaaS,2015,https://huntbrownandbarnes.com,Lot foot nice ball rock significant cold stuff.,22,hunt-brown-and-barnes,2023,USD,1378815,697478,681337,459599,221738,917,220821,13788,27576,193245,36030,843834,295156,548678,114901.25,1378815,10.0,37.94,0.0213,1383,83.08,31055.98,1.16,0.4941
7662,Riley Jacobson and Lamb,False,BR,New Andrew,Fintech,2009,https://rileyjacobsonandlamb.com,He no also agreement personal.,19,riley-jacobson-and-lamb,2023,USD,2471381,769530,1701851,2306303,-604452,12097,-616549,24713,49427,-665976,530418,1859370,917199,942171,,2471381,20.0,102.26,0.001,7568,27.21,204202.0,2.6,0.6886
7663,Dennis LLC,False,US,Lake Mckenziebury,Energy,2017,https://dennisllc.com,Claim Congress line technology early born.,19,dennis-llc,2023,USD,4765398,1891632,2873766,3364094,-490328,14573,-504901,47653,95307,-600208,73456,2623195,728625,1894570,,4765398,20.0,58.26,0.087,1704,232.92,240039.42,0.31,0.603
7664,Curry Ltd,False,BR,South Timothyborough,IoT,2014,https://curryltd.com,Really picture prepare score word evening painting.,25,curry-ltd,2023,USD,870168,206937,663231,456283,206948,24277,182671,8701,17403,165268,16841,585193,33208,551985,,870168,20.0,10.0,0.0324,465,155.84,44394.44,0.38,0.7622
7665,Burns LLC,False,IN,West Carlos,Cybersecurity,2008,https://burnsllc.com,Answer TV political fall population according really truth.,13,burns-llc,2023,USD,332563,122689,209874,205857,4017,53152,-49135,3325,6651,-55786,3562,174906,45828,129078,,332563,557.51,278.76,0.0839,153,180.39,14282.36,0.25,0.6311
7666,Sandoval Pacheco and Smith,False,DE,Princemouth,Cybersecurity,2011,https://sandovalpachecoandsmith.com,Change left PM hit ago not soon each.,32,sandoval-pacheco-and-smith,2023,EUR,1019311,374122,645189,437013,208176,0,208176,10193,20386,187790,32789,565840,288012,277828,,1019311,269.79,891.01,0.0828,419,202.31,51457.67,0.64,0.633
7667,Fernandez-Small,False,US,South Katelyn,AgriTech,2019,https://fernandez-small.com,Everything of audience western management certainly under short.,27,fernandez-small,2023,USD,202599,99747,102852,120340,-17488,31204,-48692,2025,4051,-52743,1697,187014,59163,127851,,202599,1781.55,11068.95,0.001,412,40.96,1000.0,1.7,0.5077
7668,Davis-Noble,False,GB,New Johnny,SaaS,2014,https://davis-noble.com,Role doctor soon here mother television hold.,20,davis-noble,2023,USD,612063,154622,457441,228811,228630,13006,215624,6120,12241,203383,81216,434577,264011,170566,51005.25,612063,254.87,458.13,0.0279,1291,39.48,19098.91,4.25,0.7474
7669,Hanson Inc,False,TN,North Jonathan,SaaS,2024,https://hansoninc.com,Lead hard prevent example prevent feel watch.,17,hanson-inc,2023,USD,1182987,569737,613250,300891,312359,0,312359,11829,23659,288700,58135,839020,477323,361697,98582.25,1182987,179.57,1217.79,0.001,1886,52.27,51191.42,1.14,0.5184
7670,Young LLC,False,KE,South Juan,Cybersecurity,2017,https://youngllc.com,Rich many possible interest watch thus wind.,17,young-llc,2023,USD,192925,52139,140786,196309,-55523,0,-55523,1929,3858,-59381,3499,122679,14475,108204,,192925,414.21,767.75,0.001,82,193.97,22623.19,0.15,0.7297
7671,Bennett Mendoza and Franco,False,FR,South Derek,Fintech,2017,https://bennettmendozaandfranco.com,Son sing bar should without want else land pull.,17,bennett-mendoza-and-franco,2023,EUR,975869,243241,732628,666288,66340,7,66333,9758,19517,46816,69505,569248,203467,365781,,975869,888.53,6455.06,0.0178,324,250.28,81154.29,0.86,0.7507
7672,Reed PLC,False,BR,New Brittany,IoT,2011,https://reedplc.com,Add character religious evidence someone us exactly daughter maintain receive simply.,15,reed-plc,2023,USD,303558,86479,217079,65269,151810,0,151810,3035,6071,145739,13810,223810,77541,146269,,303558,1175.4,587.7,0.0425,136,185.08,37229.57,0.37,0.7151
7673,Smith Group,False,DE,West Christinehaven,Marketplaces,2018,https://smithgroup.com,Idea visit look police thought half.,20,smith-group,2023,EUR,160760,54706,106054,124391,-18337,0,-18337,1607,3215,-21552,53337,285605,37341,248264,,160760,145.68,483.2,0.0425,77,172.27,27905.4,1.91,0.6597
7674,Gonzalez Wright and Wilson,False,KE,Lake Jose,IoT,2013,https://gonzalezwrightandwilson.com,Term service seem price save form.,24,gonzalez-wright-and-wilson,2023,USD,188287,85649,102638,17182,85456,23314,62142,1882,3765,58377,12685,192915,14756,178159,,188287,498.67,877.88,0.0879,95,165.1,25148.33,0.5,0.5451
7675,Daniel-Davis,False,NG,Lake Katherine,E-commerce,2019,https://daniel-davis.com,Like worker sound fish coach particular idea to perform live.,21,daniel-davis,2023,USD,567158,213743,353415,52104,301311,7728,293583,5671,11343,282240,23290,386728,139240,247488,,567158,484.46,1939.9,0.001,347,136.11,1000.0,23.29,0.6231
7676,Bird Taylor and Ferguson,False,AU,Port Sheila,EdTech,2019,https://birdtaylorandferguson.com,Specific student another smile happen audience hard.,17,bird-taylor-and-ferguson,2023,USD,739735,263778,475957,358246,117711,12984,104727,7397,14794,89933,326178,699126,230903,468223,61644.58,739735,10.0,40.5,0.0785,937,65.72,32116.37,10.16,0.6434
7677,Garcia Horn and Rodriguez,False,BR,North Alexandria,IoT,2018,https://garciahornandrodriguez.com,True player form everyone thousand everyone.,26,garcia-horn-and-rodriguez,2023,USD,1488655,625435,863220,154094,709126,19042,690084,14886,29773,660311,139700,891286,361932,529354,,1488655,996.0,1785.52,0.001,6202,20.0,1164.21,120.0,0.5799
7678,Jordan LLC,False,GB,Morrismouth,SaaS,2019,https://jordanllc.com,Talk note event firm upon avoid movement similar eat.,16,jordan-llc,2023,USD,539701,73790,465911,274192,191719,14526,177193,5397,10794,166399,31158,462138,274055,188083,44975.08,539701,128.95,495.37,0.042,671,66.96,17787.39,1.75,0.8633
7679,Franco Mendoza and Olson,False,TN,Lewisfort,Fintech,2009,https://francomendozaandolson.com,Mention lead response claim owner around responsibility want.,25,franco-mendoza-and-olson,2023,USD,1579609,709227,870382,1554329,-683947,0,-683947,15796,31592,-715539,35792,1004383,50219,954164,,1579609,20.0,111.37,0.0175,6581,20.0,164680.03,0.22,0.551
7680,Johnson Wilkerson and Fernandez,False,US,Jacksonfort,Energy,2023,https://johnsonwilkersonandfernandez.com,Family sound somebody eat leave citizen major result.,22,johnson-wilkerson-and-fernandez,2023,USD,760105,332325,427780,505437,-77657,0,-77657,7601,15202,-92859,22739,539876,48666,491210,,760105,190.26,95.13,0.0843,3167,20.0,28936.58,0.79,0.5628
7681,Gardner-Nichols,False,KE,Lake Sandra,IoT,2008,https://gardner-nichols.com,Way collection before offer yeah only through likely necessary.,15,gardner-nichols,2023,USD,888743,241323,647420,296635,350785,44286,306499,8887,17774,288725,25633,537417,313296,224121,,888743,294.27,792.15,0.0283,572,129.33,1000.0,25.63,0.7285
7682,Bennett-Wright,False,BR,South Jenniferbury,SaaS,2020,https://bennett-wright.com,Hard third sound wonder care.,21,bennett-wright,2023,USD,952368,497061,455307,333801,121506,22312,99194,9523,19047,80147,181165,829807,286475,543332,79364.0,952368,79.37,105.16,0.001,9493,8.36,10811.3,16.76,0.4781
7683,Schaefer Patel and Martinez,False,KE,South Margaret,Energy,2009,https://schaeferpatelandmartinez.com,While power body country really author yet seven race.,24,schaefer-patel-and-martinez,2023,USD,797415,376065,421350,586593,-165243,8414,-173657,7974,15948,-189605,25373,610212,90475,519737,,797415,505.08,1416.0,0.1299,730,90.98,70974.25,0.36,0.5284
7684,Patel and Sons,False,FR,Port Zacharyhaven,AI/ML,2020,https://patelandsons.com,Evening small perform treatment answer.,24,patel-and-sons,2023,EUR,2289498,136399,2153099,1277881,875218,20053,855165,22894,45789,809376,775089,1933374,114939,1818435,,2289498,275.87,683.14,0.001,1161,164.24,121991.28,6.35,0.9404
7685,Rangel Brown and Reed,False,ZA,Longburgh,Mobility,2023,https://rangelbrownandreed.com,Respond event reach avoid story policy teach official forward.,31,rangel-brown-and-reed,2023,USD,784308,341211,443097,490785,-47688,29004,-76692,7843,15686,-92378,18865,418493,132437,286056,,784308,1125.31,2663.5,0.001,3267,20.0,44588.55,0.42,0.565
7686,Brown Group,False,IN,North Williamburgh,SaaS,2015,https://browngroup.com,Black public but fly score.,25,brown-group,2023,USD,329284,66192,263092,109354,153738,0,153738,3292,6585,147153,29530,343228,83166,260062,27440.33,329284,10.0,49.5,0.0093,887,30.91,31418.74,0.94,0.799
7687,Rios Ltd,False,EG,Griffithton,AI/ML,2016,https://riosltd.com,Service husband century get member.,19,rios-ltd,2023,USD,870967,248524,622443,56954,565489,0,565489,8709,17419,548070,43413,490487,225755,264732,,870967,1082.59,1326.97,0.001,313,231.65,32249.79,1.35,0.7147
7688,Torres Vasquez and Lamb,False,ZA,Harrisfort,Marketplaces,2012,https://torresvasquezandlamb.com,Factor join candidate industry eight film including stock.,12,torres-vasquez-and-lamb,2023,USD,560692,195261,365431,142175,223256,4304,218952,5606,11213,207739,16447,304007,102826,201181,,560692,174.92,229.8,0.001,802,58.22,36939.57,0.45,0.6517
7689,Evans PLC,False,ZA,New William,EdTech,2014,https://evansplc.com,Forget treatment general wall dark whose fear traditional.,18,evans-plc,2023,USD,948900,96172,852728,70464,782264,4273,777991,9489,18978,759013,47288,577622,28881,548741,79075.0,948900,173.45,173.45,0.0186,2444,32.35,1000.0,47.29,0.8986
7690,White Group,False,KE,Williamsonville,AgriTech,2017,https://whitegroup.com,Save size key after public thank power community series free.,19,white-group,2023,USD,313710,145892,167818,116724,51094,0,51094,3137,6274,44820,5001,200218,30747,169471,,313710,541.55,496.8,0.0072,270,96.56,1000.0,5.0,0.5349
7691,Copeland-Bridges,False,KE,Rogerstown,Cybersecurity,2019,https://copeland-bridges.com,Food none site study tough five turn financial night enough.,11,copeland-bridges,2023,USD,5279048,1217652,4061396,3893285,168111,18472,149639,52790,105580,44059,1108469,3873392,1506433,2366959,,5279048,20.0,76.62,0.001,1187,370.59,315121.45,3.52,0.7693
7692,Anderson-Perez,False,DE,New Jackport,SaaS,2008,https://anderson-perez.com,Most two despite evidence soon car.,18,anderson-perez,2023,EUR,2736657,540919,2195738,1027914,1167824,9637,1158187,27366,54733,1103454,55818,1623553,897511,726042,228054.75,2736657,33.7,166.07,0.0357,45610,5.0,70291.13,0.79,0.8023
7693,Simmons LLC,False,TN,Nicholschester,Mobility,2022,https://simmonsllc.com,Hold determine range raise I leader.,12,simmons-llc,2023,USD,3901462,1784661,2116801,3894600,-1777799,0,-1777799,39014,78029,-1855828,40742,2190584,829015,1361569,,3901462,991.64,1551.98,0.0333,3458,94.0,358482.67,0.11,0.5426
7694,Morgan Morgan and Day,False,TN,Port Kevin,HealthTech,2018,https://morganmorganandday.com,Before budget business executive total.,19,morgan-morgan-and-day,2023,USD,2574984,1439473,1135511,1134276,1235,18932,-17697,25749,51499,-69196,227679,1521856,950135,571721,214582.0,2574984,10.0,10.0,0.1123,6443,33.3,35910.69,6.34,0.441
7695,Thomas-Hernandez,False,CA,Beckerland,SaaS,2014,https://thomas-hernandez.com,Over key long southern measure if car drug catch party.,13,thomas-hernandez,2023,USD,2108590,678711,1429879,954455,475424,0,475424,21085,42171,433253,77821,1266901,535277,731624,175715.83,2108590,800.33,2684.87,0.0655,2873,61.15,64547.04,1.21,0.6781
7696,Johnston Lopez and Jenkins,False,GB,Robertmouth,Marketplaces,2019,https://johnstonlopezandjenkins.com,Blue upon lead blood appear two.,14,johnston-lopez-and-jenkins,2023,USD,158452,65636,92816,70677,22139,31622,-9483,1584,3169,-12652,34739,236591,36773,199818,,158452,341.66,170.83,0.0559,135,97.3,1000.0,34.74,0.5858
7697,Wagner-Gill,False,US,Lake Kylefurt,Fintech,2023,https://wagner-gill.com,Prepare pattern whom happen seek bed degree assume at.,20,wagner-gill,2023,USD,3133572,1102334,2031238,2218324,-187086,47769,-234855,31335,62671,-297526,148795,1816430,717746,1098684,,3133572,20.0,38.29,0.0908,1370,190.54,192921.77,0.77,0.6482
7698,Hall LLC,False,DE,Port Brandon,Energy,2018,https://hallllc.com,Law than character analysis I now theory identify us sit local.,25,hall-llc,2023,EUR,3569466,1246709,2322757,1026644,1296113,0,1296113,35694,71389,1224724,208932,1995259,606723,1388536,,3569466,208.06,485.32,0.0796,2838,104.8,101454.91,2.06,0.6507
7699,Wilson Wilson and Cobb,False,IN,East Matthewhaven,HealthTech,2020,https://wilsonwilsonandcobb.com,Property other nice such large.,25,wilson-wilson-and-cobb,2023,USD,474143,170443,303700,189378,114322,0,114322,4741,9482,104840,41506,310789,180134,130655,39511.92,474143,178.26,989.7,0.0392,588,67.13,1000.0,41.51,0.6405
7700,Ashley-Jacobs,False,GB,New Peterport,AgriTech,2011,https://ashley-jacobs.com,Before meeting later commercial believe high leader.,15,ashley-jacobs,2023,USD,235038,87404,147634,170328,-22694,29376,-52070,2350,4700,-56770,14708,328728,237904,90824,,235038,766.0,383.0,0.067,979,20.0,36838.35,0.4,0.6281
7701,Park-Wolfe,False,EG,Lake Christopher,AI/ML,2016,https://park-wolfe.com,Whom want customer newspaper.,22,park-wolfe,2023,USD,3039506,901198,2138308,1038172,1100136,0,1100136,30395,60790,1039346,1559900,3166942,822129,2344813,,3039506,490.93,2232.36,0.1037,1452,174.42,118701.5,13.14,0.7035
7702,Campbell Scott and Mckee,False,GB,Ayersfort,IoT,2009,https://campbellscottandmckee.com,Standard central travel four travel.,21,campbell-scott-and-mckee,2023,USD,302725,112723,190002,161033,28969,2354,26615,3027,6054,20561,3062,270559,65166,205393,,302725,950.06,3025.54,0.0738,144,174.42,53143.35,0.06,0.6276
7703,Curtis PLC,False,BR,Velazquezfurt,HealthTech,2012,https://curtisplc.com,That no hit ago bill.,23,curtis-plc,2023,USD,420022,65595,354427,222226,132201,28701,103500,4200,8400,95100,8042,328670,103168,225502,35001.83,420022,575.42,1644.66,0.0315,335,104.19,8119.72,0.99,0.8438
7704,Jones Rowe and Johnson,False,DE,South Julia,EdTech,2017,https://jonesroweandjohnson.com,Huge only audience economic word seat if nice street newspaper shoulder.,25,jones-rowe-and-johnson,2023,EUR,403325,246158,157167,20166,137001,33752,103249,4033,8066,95183,11625,354637,99829,254808,33610.42,403325,82.61,220.74,0.0154,292,114.74,6437.59,1.81,0.3897
7705,Martin-Murray,False,CA,Randybury,Fintech,2010,https://martin-murray.com,Person now action or more card.,22,martin-murray,2023,USD,1542719,287425,1255294,77135,1178159,0,1178159,15427,30854,1147305,31154,914542,70052,844490,,1542719,1151.6,687.16,0.0054,756,170.02,9772.39,3.19,0.8137
7706,Rodriguez Larson and Anderson,False,US,West Eric,Cybersecurity,2009,https://rodriguezlarsonandanderson.com,Million which specific be nor even be public whether scientist leg.,25,rodriguez-larson-and-anderson,2023,USD,3448002,1457795,1990207,1922682,67525,7108,60417,34480,68960,-8543,164471,2024738,284478,1740260,,3448002,2147.86,3621.57,0.0376,1904,150.9,153945.58,1.07,0.5772
7707,Coleman Inc,False,KE,Donnastad,SaaS,2021,https://colemaninc.com,Return face especially recently structure.,13,coleman-inc,2023,USD,786713,379203,407510,481930,-74420,7144,-81564,7867,15734,-97298,43044,613320,277526,335794,65559.42,786713,304.36,1016.05,0.001,13111,5.0,39906.67,1.08,0.518
7708,Stone-Willis,False,BR,West Jocelyn,SaaS,2019,https://stone-willis.com,Citizen material sport whom get different start determine.,18,stone-willis,2023,USD,1637763,386741,1251022,1677069,-426047,37625,-463672,16377,32755,-496427,215120,1038097,119477,918620,136480.25,1637763,10.0,23.47,0.0598,3905,34.95,140222.01,1.53,0.7639
7709,White-Morgan,False,DE,North Michelle,SaaS,2021,https://white-morgan.com,Attack mother yeah bed gun consumer office.,18,white-morgan,2023,EUR,328872,139543,189329,63202,126127,0,126127,3288,6577,119550,9795,346479,146207,200272,27406.0,328872,10.0,10.0,0.0135,398,68.73,1000.0,9.8,0.5757
7710,Lewis-Rocha,False,NG,Timothyshire,AgriTech,2015,https://lewis-rocha.com,Color need high move politics film make responsibility sit common.,11,lewis-rocha,2023,USD,256295,118257,138038,12814,125224,15732,109492,2562,5125,104367,29594,332204,163165,169039,,256295,138.96,584.51,0.0309,109,194.76,4583.5,6.46,0.5386
7711,Kirby Mullins and Simon,False,US,North Ginaside,HealthTech,2011,https://kirbymullinsandsimon.com,Customer character data child another.,21,kirby-mullins-and-simon,2023,USD,233688,65890,167798,64606,103192,32575,70617,2336,4673,65944,38397,243314,128515,114799,19474.0,233688,10.0,18.48,0.039,1110,17.54,1000.0,38.4,0.718
7712,Castillo Garcia and Gonzales,False,FR,Johnsonborough,Energy,2020,https://castillogarciaandgonzales.com,Culture say may build stop different.,17,castillo-garcia-and-gonzales,2023,EUR,1525274,393841,1131433,1460097,-328664,16472,-345136,15252,30505,-375641,687202,1516987,930029,586958,,1525274,1664.66,6012.26,0.0456,765,166.14,130818.22,5.25,0.7418
7713,Sanchez-Cannon,False,EG,New Monicaport,EdTech,2012,https://sanchez-cannon.com,Military strong buy moment with quite summer.,19,sanchez-cannon,2023,USD,501966,107761,394205,25098,369107,13506,355601,5019,10039,345562,40915,383329,140210,243119,41830.5,501966,157.71,932.75,0.001,614,68.11,23524.57,1.74,0.7853
7714,Hunter and Sons,False,KE,Andrealand,SaaS,2017,https://hunterandsons.com,Teacher capital however push might mind yourself treat Mrs ability fund.,25,hunter-and-sons,2023,USD,4155381,1845528,2309853,207769,2102084,8262,2093822,41553,83107,2010715,291087,2417509,873055,1544454,346281.75,4155381,203.6,333.13,0.0422,8711,39.75,12123.58,24.01,0.5559
7715,Johnson-Stone,False,BR,Kimbury,E-commerce,2022,https://johnson-stone.com,Place return question rise since crime section.,13,johnson-stone,2023,USD,4449178,1638080,2811098,1581834,1229264,0,1229264,44491,88983,1140281,278465,2573918,855357,1718561,,4449178,20.0,129.91,0.0624,18538,20.0,136760.13,2.04,0.6318
7716,Stone-Galvan,False,CA,Stanleyport,IoT,2022,https://stone-galvan.com,Culture exist wish behind foot worry rule.,25,stone-galvan,2023,USD,1035034,352848,682186,94730,587456,5268,582188,10350,20700,561488,175217,884130,528196,355934,,1035034,1677.6,3888.12,0.1316,2803,30.77,14536.29,12.05,0.6591
7717,Reynolds Oneill and Bennett,False,CA,Ramirezbury,IoT,2013,https://reynoldsoneillandbennett.com,Likely send indicate move church society despite single.,20,reynolds-oneill-and-bennett,2023,USD,146861,47214,99647,65832,33815,37606,-3791,1468,2937,-6728,1719,158992,26907,132085,,146861,586.03,3439.8,0.0677,130,93.69,6826.03,0.25,0.6785
7718,Glover-Anderson,False,FR,Billfurt,HealthTech,2021,https://glover-anderson.com,Wait see glass if scene car if office.,19,glover-anderson,2023,EUR,774252,353254,420998,328404,92594,0,92594,7742,15485,77109,95334,483824,410173,73651,64521.0,774252,264.06,855.01,0.0235,1789,36.06,25802.14,3.69,0.5437
7719,Thompson Guerra and Garza,False,IN,Joseside,HealthTech,2020,https://thompsonguerraandgarza.com,Or member wait doctor or.,22,thompson-guerra-and-garza,2023,USD,5827787,2720706,3107081,2841330,265751,0,265751,58277,116555,149196,908512,3987397,1162592,2824805,485648.92,5827787,275.32,701.16,0.0255,67264,7.22,241005.25,3.77,0.5331
7720,Figueroa Adams and Jennings,False,US,New Ericborough,EdTech,2015,https://figueroaadamsandjennings.com,Speech her information alone between.,22,figueroa-adams-and-jennings,2023,USD,539132,53574,485558,164153,321405,0,321405,5391,10782,310623,1186,431143,133153,297990,44927.67,539132,849.65,3432.47,0.0459,686,65.47,33909.91,0.03,0.9006
7721,Roberts Summers and Turner,False,TN,Port Krista,Marketplaces,2013,https://robertssummersandturner.com,Alone strong director great discover.,16,roberts-summers-and-turner,2023,USD,1647374,716398,930976,568512,362464,0,362464,16473,32947,329517,224833,1129590,477803,651787,,1647374,235.06,791.94,0.0264,6864,20.0,59516.04,3.78,0.5651
7722,Bowman and Sons,False,AU,Schneiderborough,SaaS,2012,https://bowmanandsons.com,Would citizen investment nature follow four entire region talk side.,15,bowman-and-sons,2023,USD,410428,139080,271348,267070,4278,5497,-1219,4104,8208,-9427,6121,284978,96483,188495,34202.33,410428,721.14,3106.64,0.0834,545,62.67,1000.0,6.12,0.6611
7723,Preston LLC,False,EG,New Ryan,E-commerce,2019,https://prestonllc.com,Power exist less year blue name short.,16,preston-llc,2023,USD,719508,213441,506067,131098,374969,27007,347962,7195,14390,333572,13327,486880,106867,380013,,719508,20.0,86.51,0.0556,478,125.37,10625.62,1.25,0.7034
7724,Hughes-Spencer,False,NG,West Dorothyport,HealthTech,2010,https://hughes-spencer.com,Pressure but rule field own wide travel.,17,hughes-spencer,2023,USD,558093,134514,423579,275203,148376,21544,126832,5580,11161,115671,34879,349149,119341,229808,46507.75,558093,10.0,63.86,0.0574,5909,7.87,33495.06,1.04,0.759
7725,Lewis Flores and Alexander,False,IN,Bradfort,Mobility,2022,https://lewisfloresandalexander.com,Establish record poor test market.,22,lewis-flores-and-alexander,2023,USD,429878,160715,269163,357237,-88074,0,-88074,4298,8597,-96671,15926,268140,114409,153731,,429878,303.07,1092.86,0.001,823,43.48,1000.0,15.93,0.6261
7726,Smith Lopez and Koch,False,US,Thomasborough,Cybersecurity,2012,https://smithlopezandkoch.com,Mission soldier whether teach than arrive at reason tell return.,18,smith-lopez-and-koch,2023,USD,2649675,808964,1840711,2031380,-190669,9653,-200322,26496,52993,-253315,261330,1654676,888864,765812,,2649675,151.31,701.92,0.0198,791,278.89,192452.69,1.36,0.6947
7727,White Jones and Kim,False,US,Bishopchester,Mobility,2011,https://whitejonesandkim.com,Run education low paper stay knowledge senior.,24,white-jones-and-kim,2023,USD,294665,128997,165668,155215,10453,16843,-6390,2946,5893,-12283,20177,366515,157191,209324,,294665,728.31,2011.95,0.001,1227,20.0,32034.9,0.63,0.5622
7728,Watson Ltd,False,FR,Williamsview,E-commerce,2013,https://watsonltd.com,Yeah body glass into understand.,21,watson-ltd,2023,EUR,1948865,294892,1653973,1790004,-136031,0,-136031,19488,38977,-175008,39957,1041557,52077,989480,,1948865,431.09,2418.91,0.066,490,331.4,164270.12,0.24,0.8487
7729,Johnson Williamson and Johnson,False,DE,West Kevinmouth,Cybersecurity,2008,https://johnsonwilliamsonandjohnson.com,Something see outside box factor.,19,johnson-williamson-and-johnson,2023,EUR,3141843,1276842,1865001,997904,867097,0,867097,31418,62836,804261,160062,1841512,240384,1601128,,3141843,468.21,574.6,0.0944,1361,192.29,71469.31,2.24,0.5936
7730,Owens-Higgins,False,GB,New Chelsea,EdTech,2021,https://owens-higgins.com,Dream become market appear nothing.,15,owens-higgins,2023,USD,1411225,394190,1017035,526732,490303,17268,473035,14112,28224,444811,61622,846653,191145,655508,117602.08,1411225,25.39,141.97,0.0308,23520,5.0,58711.09,1.05,0.7207
7731,Villa Group,False,ZA,Nicholasberg,HealthTech,2011,https://villagroup.com,Common get clear without yourself so loss.,27,villa-group,2023,USD,1276983,358238,918745,63849,854896,0,854896,12769,25539,829357,32977,770153,247087,523066,106415.25,1276983,10.0,10.0,0.0222,2068,51.45,1000.0,32.98,0.7195
7732,Smith LLC,False,BR,South Caroline,IoT,2013,https://smithllc.com,Increase public produce fine choice concern if.,13,smith-llc,2023,USD,2614815,1007636,1607179,621733,985446,0,985446,26148,52296,933150,67779,1452047,306993,1145054,,2614815,274.8,1332.5,0.105,2741,79.47,59344.5,1.14,0.6146
7733,Hall and Sons,False,FR,New Matthewhaven,E-commerce,2024,https://hallandsons.com,Eight wrong each mission along analysis first despite.,22,hall-and-sons,2023,EUR,362168,128769,233399,116074,117325,28116,89209,3621,7243,81966,9102,353874,148175,205699,,362168,336.3,1955.13,0.1001,198,152.34,8879.27,1.03,0.6444
7734,Mccann Haney and Grant,False,AU,Lake Davidland,Fintech,2024,https://mccannhaneyandgrant.com,Fall financial doctor camera.,15,mccann-haney-and-grant,2023,USD,4768236,1905969,2862267,1830521,1031746,12815,1018931,47682,95364,923567,1300658,3696320,2160241,1536079,,4768236,1558.12,779.06,0.0106,3944,100.73,130990.7,9.93,0.6003
7735,Gardner-Gibbs,False,KE,North Markburgh,Mobility,2008,https://gardner-gibbs.com,Seat beautiful against people degree court sort assume.,21,gardner-gibbs,2023,USD,562007,179927,382080,273796,108284,24952,83332,5620,11240,72092,155847,546607,212291,334316,,562007,20.0,10.0,0.0257,322,145.12,45446.28,3.43,0.6798
7736,Booker-Johnson,False,BR,Limouth,E-commerce,2011,https://booker-johnson.com,Threat individual will truth wish tough carry type their.,27,booker-johnson,2023,USD,1676651,650429,1026222,464308,561914,0,561914,16766,33533,528381,33799,879993,145500,734493,,1676651,20.0,68.25,0.023,515,271.17,45249.62,0.75,0.6121
7737,Horton LLC,False,TN,Warrenville,Fintech,2011,https://hortonllc.com,Thus really activity stand early.,19,horton-llc,2023,USD,345776,189262,156514,70571,85943,15627,70316,3457,6915,63401,46745,308948,61819,247129,,345776,1039.8,1953.0,0.0892,126,226.99,37677.06,1.24,0.4526
7738,Richardson Carroll and Mayer,False,NG,Granthaven,Energy,2014,https://richardsoncarrollandmayer.com,Per buy finish white chance.,16,richardson-carroll-and-mayer,2023,USD,522604,285432,237172,26130,211042,0,211042,5226,10452,200590,13611,332621,18764,313857,,522604,20.0,11.33,0.001,276,157.58,38324.09,0.36,0.4538
7739,Williams-Lawrence,False,NG,South Davidchester,E-commerce,2018,https://williams-lawrence.com,Note believe each participant less hard really design bit.,23,williams-lawrence,2023,USD,757639,395061,362578,414160,-51582,12208,-63790,7576,15152,-78942,46284,577605,379893,197712,,757639,1283.04,4562.84,0.0056,615,102.54,19373.73,2.39,0.4786
7740,Carr LLC,False,NG,East Sandraport,AI/ML,2010,https://carrllc.com,Against citizen ability paper include themselves cut child involve long policy.,28,carr-llc,2023,USD,1098842,688884,409958,839078,-429120,0,-429120,10988,21976,-451096,58470,711829,416305,295524,,1098842,459.6,3477.01,0.0193,4578,20.0,65799.15,0.89,0.3731
7741,Jones LLC,False,ZA,South Connieport,IoT,2018,https://jonesllc.com,Home beat TV cup.,22,jones-llc,2023,USD,1240950,311614,929336,887447,41889,0,41889,12409,24819,17070,32412,655240,291093,364147,,1240950,180.78,1394.48,0.0418,735,140.67,57655.75,0.56,0.7489
7742,Hester-Montgomery,False,KE,Whitefort,Cybersecurity,2022,https://hester-montgomery.com,Democratic way suggest be practice buy nothing.,26,hester-montgomery,2023,USD,2859936,923420,1936516,1334144,602372,0,602372,28599,57198,545174,75539,1656731,977005,679726,,2859936,933.52,3471.59,0.0955,752,316.73,124220.04,0.61,0.6771
7743,Coleman Hill and Smith,False,ZA,Joelmouth,Mobility,2013,https://colemanhillandsmith.com,Much management message let under piece experience.,17,coleman-hill-and-smith,2023,USD,84263,30240,54023,18660,35363,0,35363,842,1685,33678,50032,226272,52463,173809,,84263,1549.78,1528.8,0.001,21,320.14,7408.04,6.75,0.6411
7744,Thomas-Banks,False,ZA,North Jodyview,Cybersecurity,2011,https://thomas-banks.com,Debate actually new yard admit reality himself include turn standard stuff.,28,thomas-banks,2023,USD,2484051,1001810,1482241,147780,1334461,7264,1327197,24840,49681,1277516,55343,1391999,423798,968201,,2484051,49.66,114.67,0.0034,10350,20.0,26387.68,2.1,0.5967
7745,Smith Fox and King,False,TN,Lake Lisa,AI/ML,2024,https://smithfoxandking.com,Appear perform present plant ahead.,24,smith-fox-and-king,2023,USD,479515,131805,347710,225883,121827,0,121827,4795,9590,112237,36182,325872,68597,257275,,479515,979.25,2677.66,0.001,136,293.33,28661.0,1.26,0.7251
7746,Johnson Coffey and Williams,False,US,Davidhaven,Cybersecurity,2009,https://johnsoncoffeyandwilliams.com,Brother everything including number society artist decade scene operation space return.,17,johnson-coffey-and-williams,2023,USD,2850692,1066483,1784209,1006574,777635,399,777236,28506,57013,720223,41388,1663985,667981,996004,,2850692,1286.35,6834.07,0.1023,837,283.58,97728.01,0.42,0.6259
7747,Anderson-Olson,False,AU,Mooreland,E-commerce,2015,https://anderson-olson.com,Hour student everything job.,15,anderson-olson,2023,USD,526076,228337,297739,313477,-15738,36043,-51781,5260,10521,-62302,21795,414911,90329,324582,,526076,1051.68,525.84,0.1391,2191,20.0,9365.81,2.33,0.566
7748,Kennedy-Hill,False,EG,Anthonyville,AI/ML,2014,https://kennedy-hill.com,Doctor onto cultural sit station.,18,kennedy-hill,2023,USD,994841,284623,710218,343091,367127,18154,348973,9948,19896,329077,45440,687957,113952,574005,,994841,20.0,60.08,0.1312,247,334.95,18770.47,2.42,0.7139
7749,Osborn and Sons,False,FR,Michaelland,AI/ML,2020,https://osbornandsons.com,Language network do professor happy wonder down service water focus.,22,osborn-and-sons,2023,EUR,1507546,503540,1004006,583992,420014,15848,404166,15075,30150,374016,454709,1303689,557877,745812,,1507546,20.0,63.0,0.1361,1285,97.71,13157.54,34.56,0.666
7750,Ellison LLC,False,KE,Debrahaven,HealthTech,2024,https://ellisonllc.com,Just ten example peace within notice street turn population.,21,ellison-llc,2023,USD,179587,62451,117136,121545,-4409,40150,-44559,1795,3591,-48150,13130,293149,119472,173677,14965.58,179587,200.65,437.38,0.001,279,53.57,6581.63,1.99,0.6523
7751,Bell Ltd,False,KE,Michaelborough,Mobility,2013,https://bellltd.com,Nor myself now so prepare herself.,20,bell-ltd,2023,USD,734675,72694,661981,44778,617203,19603,597600,7346,14693,582907,95374,521848,307121,214727,,734675,746.51,1971.54,0.1005,515,118.8,22792.73,4.18,0.9011
7752,Zimmerman Johnson and Mack,False,AU,West Anita,AI/ML,2016,https://zimmermanjohnsonandmack.com,Act themselves point ten have establish floor full rule.,26,zimmerman-johnson-and-mack,2023,USD,2286892,1243028,1043864,1165548,-121684,12582,-134266,22868,45737,-180003,1416333,2561845,1491707,1070138,,2286892,529.32,1889.43,0.001,1122,169.74,110548.48,12.81,0.4565
7753,Medina Cruz and Boyer,False,CA,Hicksshire,AgriTech,2009,https://medinacruzandboyer.com,Number cover only project and leader method enjoy.,18,medina-cruz-and-boyer,2023,USD,268467,161522,106945,72389,34556,0,34556,2684,5369,29187,4887,164820,92692,72128,,268467,920.54,2020.15,0.0284,193,115.67,16682.56,0.29,0.3984
7754,Brown Dominguez and Roberts,False,BR,West Kelsey,Fintech,2024,https://browndominguezandroberts.com,College Mrs official end money who.,24,brown-dominguez-and-roberts,2023,USD,860412,195749,664663,233328,431335,12087,419248,8604,17208,402040,89545,625397,145858,479539,,860412,20.0,31.11,0.0559,1148,62.45,24156.96,3.71,0.7725
7755,Cole-Harris,False,GB,Berrystad,HealthTech,2023,https://cole-harris.com,Name eat major try suffer stay a.,17,cole-harris,2023,USD,3793970,1252515,2541455,189698,2351757,0,2351757,37939,75879,2275878,300503,2241683,1133953,1107730,316164.17,3793970,643.04,3788.87,0.0233,63232,5.0,5382.49,55.83,0.6699
7756,Carlson-Thompson,False,GB,East Danaton,SaaS,2009,https://carlson-thompson.com,Television pressure operation though mission east hour.,19,carlson-thompson,2023,USD,4853693,1722115,3131578,2533055,598523,0,598523,48536,97073,501450,597760,3216077,438887,2777190,404474.42,4853693,456.14,2291.08,0.0737,8131,49.74,201729.04,2.96,0.6452
7757,Berry-Marsh,False,GB,East John,AI/ML,2014,https://berry-marsh.com,Front somebody future medical road pretty and relationship their.,20,berry-marsh,2023,USD,586304,216708,369596,158637,210959,11220,199739,5863,11726,188013,5676,407673,243864,163809,,586304,20.0,80.96,0.0644,1004,48.64,1000.0,5.68,0.6304
7758,Smith and Sons,False,KE,Port Ryan,AgriTech,2012,https://smithandsons.com,Cell everybody turn something explain item.,25,smith-and-sons,2023,USD,356762,122363,234399,174905,59494,12677,46817,3567,7135,39682,30043,295367,18193,277174,,356762,310.64,641.73,0.05,160,185.79,34403.13,0.87,0.657
7759,Bryan Black and Walker,False,BR,North Andrew,EdTech,2012,https://bryanblackandwalker.com,Nation here lot set task already cold state exactly.,23,bryan-black-and-walker,2023,USD,690588,238659,451929,271043,180886,51523,129363,6905,13811,115552,116830,515680,198519,317161,57549.0,690588,413.22,1125.87,0.0812,4922,11.69,43796.43,2.67,0.6544
7760,Chambers Ltd,False,BR,Morganland,HealthTech,2009,https://chambersltd.com,No camera rate interest thousand society if create program six arm.,16,chambers-ltd,2023,USD,1005774,571990,433784,303343,130441,38145,92296,10057,20115,72181,5527,673237,282567,390670,83814.5,1005774,151.17,588.05,0.0536,1296,64.65,28363.71,0.19,0.4313
7761,Jackson Inc,False,IN,Whitefort,Fintech,2016,https://jacksoninc.com,Money share month student information.,12,jackson-inc,2023,USD,3372284,1343184,2029100,1692230,336870,1317,335553,33722,67445,268108,193023,2001250,954898,1046352,,3372284,99.89,304.34,0.1007,4203,66.85,162916.93,1.18,0.6017
7762,Orozco Cohen and Matthews,False,IN,New Amanda,Mobility,2016,https://orozcocohenandmatthews.com,Street research some coach increase style.,23,orozco-cohen-and-matthews,2023,USD,974532,223187,751345,618207,133138,0,133138,9745,19490,113648,97904,743107,286256,456851,,974532,20.0,58.4,0.0323,4060,20.0,74962.36,1.31,0.771
7763,Perez Group,False,BR,Holdenshire,EdTech,2012,https://perezgroup.com,Strategy speak model vote eye street study us.,25,perez-group,2023,USD,1883277,482024,1401253,560800,840453,21231,819222,18832,37665,781557,93474,1212193,390093,822100,156939.75,1883277,107.05,608.87,0.0305,2150,72.97,50510.29,1.85,0.7441
7764,Green Morales and Baird,False,ZA,Wrightport,AI/ML,2011,https://greenmoralesandbaird.com,Second majority must Congress public else outside.,17,green-morales-and-baird,2023,USD,545217,94714,450503,27260,423243,21260,401983,5452,10904,391079,16793,476413,168308,308105,,545217,606.01,3017.9,0.0576,316,143.63,1000.0,16.79,0.8263
7765,Hanna-Lee,False,FR,West Loriside,Energy,2019,https://hanna-lee.com,Summer develop should stock learn final drive off former.,21,hanna-lee,2023,EUR,1235732,746547,489185,245022,244163,10666,233497,12357,24714,208783,74429,752912,37645,715267,,1235732,1093.02,4718.45,0.0242,627,164.04,26315.17,2.83,0.3959
7766,Burton-Campbell,False,KE,East Frances,IoT,2014,https://burton-campbell.com,Itself edge president bank also decade about.,10,burton-campbell,2023,USD,941271,346353,594918,400306,194612,27837,166775,9412,18825,147950,30595,574700,335972,238728,,941271,20.0,80.71,0.0518,3921,20.0,52980.26,0.58,0.632
7767,Cooper Inc,False,ZA,Lake Billyfurt,SaaS,2012,https://cooperinc.com,Better movement traditional particular yes.,21,cooper-inc,2023,USD,1058612,241359,817253,217303,599950,17941,582009,10586,21172,560837,15512,692489,190049,502440,88217.67,1058612,519.55,2867.42,0.0508,1282,68.77,27054.04,0.57,0.772
7768,Duncan-Stevens,False,ZA,South Williamport,Marketplaces,2008,https://duncan-stevens.com,Card time baby war career collection deal hand her.,21,duncan-stevens,2023,USD,1398148,336067,1062081,417719,644362,23932,620430,13981,27962,592468,36361,925783,59380,866403,,1398148,1142.96,571.48,0.0138,5825,20.0,1000.0,36.36,0.7596
7769,Turner-Harris,False,GB,New Danny,SaaS,2014,https://turner-harris.com,Country bit me fast whatever sound note specific station century.,19,turner-harris,2023,USD,1263985,284986,978999,239697,739302,0,739302,12639,25279,714023,291434,929851,154773,775078,105332.08,1263985,479.01,3503.7,0.0364,1630,64.61,68288.3,4.27,0.7745
7770,Deleon-Davila,False,US,Lake Nicholas,AgriTech,2012,https://deleon-davila.com,Level really reflect talk able yes sound land fear break.,28,deleon-davila,2023,USD,590464,215341,375123,386966,-11843,0,-11843,5904,11809,-23652,27336,338736,114241,224495,,590464,309.49,1538.82,0.0167,427,115.14,51790.35,0.53,0.6353
7771,Wilson Palmer and Garcia,False,DE,Edwardport,HealthTech,2012,https://wilsonpalmerandgarcia.com,Speech never message lay international.,28,wilson-palmer-and-garcia,2023,EUR,583366,260509,322857,394192,-71335,13371,-84706,5833,11667,-96373,16218,400903,20045,380858,48613.83,583366,10.0,47.22,0.0206,428,113.34,18931.61,0.86,0.5534
7772,Hicks Inc,False,ZA,West Tabitha,Mobility,2023,https://hicksinc.com,Improve company look your decision.,21,hicks-inc,2023,USD,651586,275729,375857,371054,4803,0,4803,6515,13031,-8228,33120,387554,92703,294851,,651586,20.0,59.73,0.0224,2714,20.0,47223.33,0.7,0.5768
7773,Cooper-Payne,False,CA,Kellerberg,HealthTech,2011,https://cooper-payne.com,Order though beautiful effect machine.,17,cooper-payne,2023,USD,488041,123072,364969,304116,60853,7186,53667,4880,9760,43907,16615,380046,19002,361044,40670.08,488041,10.0,56.43,0.0298,526,77.18,34059.83,0.49,0.7478
7774,Villa-Austin,False,DE,Lutzfort,E-commerce,2014,https://villa-austin.com,Research price concern notice reality skill capital challenge.,23,villa-austin,2023,EUR,663930,382892,281038,347674,-66636,668,-67304,6639,13278,-80582,16788,527949,119721,408228,,663930,20.0,67.68,0.0532,248,222.9,72853.7,0.23,0.4233
7775,Weber Brown and Stephens,False,US,Howeview,HealthTech,2024,https://weberbrownandstephens.com,Almost off growth rule skin message.,21,weber-brown-and-stephens,2023,USD,883228,287874,595354,44161,551193,26277,524916,8832,17664,507252,59149,511647,348540,163107,73602.33,883228,160.9,1126.8,0.0694,917,80.18,7661.73,7.72,0.6741
7776,Cook LLC,False,FR,Samanthatown,Energy,2018,https://cookllc.com,Education sing population soon term gas tend.,27,cook-llc,2023,EUR,2149057,329361,1819696,1123126,696570,7072,689498,21490,42981,646517,100330,1224276,922334,301942,,2149057,77.78,213.1,0.0637,1510,118.58,58667.78,1.71,0.8467
7777,Rangel-Thomas,False,US,Angelashire,Energy,2016,https://rangel-thomas.com,Mention have good successful stock dinner.,18,rangel-thomas,2023,USD,1449195,444057,1005138,953855,51283,2260,49023,14491,28983,20040,51332,790792,39539,751253,,1449195,20.0,10.0,0.079,6038,20.0,90378.87,0.57,0.6936
7778,Stephenson-Vazquez,False,TN,Thompsonshire,EdTech,2008,https://stephenson-vazquez.com,Lot what particular guess eye along.,27,stephenson-vazquez,2023,USD,406407,171353,235054,129116,105938,0,105938,4064,8128,97810,3848,278577,115234,163343,33867.25,406407,493.3,1222.62,0.1092,587,57.67,42343.92,0.09,0.5784
7779,Cannon-Green,False,BR,Michaelburgh,SaaS,2019,https://cannon-green.com,Citizen force writer president so fund check.,13,cannon-green,2023,USD,1409629,601970,807659,697632,110027,0,110027,14096,28192,81835,71974,909565,383740,525825,117469.08,1409629,141.27,1042.89,0.0335,23493,5.0,35865.16,2.01,0.573
7780,Krause Phillips and Morton,False,ZA,Jessicaberg,IoT,2015,https://krausephillipsandmorton.com,Pm run clear letter.,24,krause-phillips-and-morton,2023,USD,595550,243407,352143,292678,59465,0,59465,5955,11911,47554,91749,458377,95046,363331,,595550,243.22,1016.57,0.017,432,114.88,22163.08,4.14,0.5913
7781,Kidd-Singh,False,EG,Reneeburgh,Mobility,2022,https://kidd-singh.com,Thank debate player because walk one news.,15,kidd-singh,2023,USD,476847,106022,370825,349735,21090,0,21090,4768,9536,11554,20977,348734,75473,273261,,476847,20.0,101.84,0.1239,1986,20.0,24849.36,0.84,0.7777
7782,Bennett-Gonzales,False,CA,Montgomeryshire,Energy,2011,https://bennett-gonzales.com,Under culture matter woman card meeting reduce child matter.,18,bennett-gonzales,2023,USD,4473744,1359956,3113788,753648,2360140,14736,2345404,44737,89474,2255930,204186,2622071,1496722,1125349,,4473744,20.0,162.29,0.1067,2611,142.76,72886.91,2.8,0.696
7783,Stanley and Sons,False,KE,West David,AI/ML,2015,https://stanleyandsons.com,Structure case region side better term by.,16,stanley-and-sons,2023,USD,1055364,338850,716514,338958,377556,0,377556,10553,21107,356449,9241,689183,200260,488923,,1055364,696.94,2848.44,0.0771,3037,28.95,33328.68,0.28,0.6789
7784,Johnson-Stein,False,GB,Hernandezberg,Fintech,2008,https://johnson-stein.com,Window risk than develop address TV.,22,johnson-stein,2023,USD,4549582,1742246,2807336,1117266,1690070,8959,1681111,45495,90991,1590120,140145,2498074,1302391,1195683,,4549582,747.7,373.85,0.0513,1173,323.07,95030.55,1.47,0.6171
7785,Dawson Wolf and Herrera,False,BR,West Bruceport,HealthTech,2010,https://dawsonwolfandherrera.com,Live mother early hit pressure name lot central exist TV.,26,dawson-wolf-and-herrera,2023,USD,176463,50711,125752,177937,-52185,0,-52185,1764,3529,-55714,24834,297430,14871,282559,14705.25,176463,174.54,239.35,0.0738,373,39.36,46351.93,0.54,0.7126
7786,Robinson PLC,False,TN,Stevenview,Marketplaces,2010,https://robinsonplc.com,Some think TV agree imagine bring.,21,robinson-plc,2023,USD,474616,181304,293312,116916,176396,10199,166197,4746,9492,156705,24457,355763,154869,200894,,474616,598.68,1525.63,0.0559,1977,20.0,6461.72,3.78,0.618
7787,Johnston Garcia and Bond,False,EG,South Michaelside,AgriTech,2020,https://johnstongarciaandbond.com,How product have civil worry.,20,johnston-garcia-and-bond,2023,USD,19049,6421,12628,5782,6846,0,6846,190,380,6466,12364,59038,3852,55186,,19049,1005.24,502.62,0.0585,79,20.0,1000.0,12.36,0.6629
7788,Mendoza-Dixon,False,KE,Michaeltown,SaaS,2013,https://mendoza-dixon.com,Lead such until best sign.,18,mendoza-dixon,2023,USD,595952,162704,433248,245912,187336,31716,155620,5959,11919,143701,42570,374949,141903,233046,49662.67,595952,10.0,30.45,0.0481,727,68.29,57133.85,0.75,0.727
7789,Herring-Smith,False,KE,Lisaport,Cybersecurity,2024,https://herring-smith.com,Response leader of nor reality describe.,26,herring-smith,2023,USD,976389,325081,651308,145041,506267,43353,462914,9763,19527,443387,161089,777371,208789,568582,,976389,20.0,10.0,0.0601,286,284.26,11356.28,14.19,0.6671
7790,Gallagher Ellison and Martinez,False,DE,Alvarezfort,Fintech,2008,https://gallagherellisonandmartinez.com,Tax particularly edge former data read adult standard.,18,gallagher-ellison-and-martinez,2023,EUR,2453983,846537,1607446,1433989,173457,14101,159356,24539,49079,110277,270464,1670485,545590,1124895,,2453983,807.63,2730.5,0.001,806,253.48,123352.18,2.19,0.655
7791,Walker-Davis,False,IN,Rogersmouth,EdTech,2016,https://walker-davis.com,Across city join though contain scientist couple large prove.,21,walker-davis,2023,USD,880930,189961,690969,385817,305152,0,305152,8809,17618,287534,36057,520247,244248,275999,73410.83,880930,111.24,234.03,0.0564,14682,5.0,39294.3,0.92,0.7844
7792,Gonzales-Wall,False,FR,South Cherylchester,IoT,2020,https://gonzales-wall.com,Soon information believe leave garden wait main market can buy.,21,gonzales-wall,2023,EUR,251208,98455,152753,28800,123953,14013,109940,2512,5024,104916,13428,236970,110514,126456,,251208,20.0,10.0,0.1022,1046,20.0,30963.89,0.43,0.6081
7793,Wallace-Atkinson,False,TN,Edwardchester,HealthTech,2012,https://wallace-atkinson.com,Mr daughter real like.,16,wallace-atkinson,2023,USD,1193135,530766,662369,444111,218258,15583,202675,11931,23862,178813,57536,848570,341527,507043,99427.92,1193135,31.31,263.05,0.0757,3217,30.9,1000.0,57.54,0.5552
7794,Cruz Martinez and Jackson,False,KE,Alanfurt,Fintech,2014,https://cruzmartinezandjackson.com,Figure work summer chance seem.,16,cruz-martinez-and-jackson,2023,USD,3030465,1252546,1777919,1994139,-216220,0,-216220,30304,60609,-276829,76039,1709912,560847,1149065,,3030465,1499.77,1578.02,0.0581,12626,20.0,139633.11,0.54,0.5867
7795,Gutierrez-Mccormick,False,FR,Lake Don,Energy,2023,https://gutierrez-mccormick.com,Share interesting green resource institution identify.,23,gutierrez-mccormick,2023,EUR,763377,271903,491474,386709,104765,27996,76769,7633,15267,61502,35341,579231,91630,487601,,763377,1479.59,10977.91,0.0886,460,138.01,43428.38,0.81,0.6438
7796,Reeves-Malone,False,US,Davidberg,AI/ML,2009,https://reeves-malone.com,Energy let agreement open where far address election.,20,reeves-malone,2023,USD,1963406,890447,1072959,779177,293782,0,293782,19634,39268,254514,338979,1420439,589422,831017,,1963406,1608.85,7844.94,0.001,496,329.59,50350.61,6.73,0.5465
7797,Thomas Haynes and Horne,False,CA,Port Melissa,Energy,2019,https://thomashaynesandhorne.com,Reflect she east paper yeah cultural they per protect similar research.,15,thomas-haynes-and-horne,2023,USD,1086783,508817,577966,294846,283120,13821,269299,10867,21735,247564,23057,697449,431324,266125,,1086783,20.0,30.06,0.0483,4528,20.0,26838.26,0.86,0.5318
7798,Hoffman-Lopez,False,TN,Morganland,Energy,2022,https://hoffman-lopez.com,Brother poor look outside amount recognize and type discussion.,15,hoffman-lopez,2023,USD,1025146,378950,646196,162043,484153,0,484153,10251,20502,463651,26782,726070,172441,553629,,1025146,275.85,451.95,0.0251,554,154.02,20022.99,1.34,0.6303
7799,Braun LLC,False,AU,Port Danielmouth,SaaS,2020,https://braunllc.com,Parent we agent food increase even note through any.,23,braun-llc,2023,USD,637715,306758,330957,163437,167520,3683,163837,6377,12754,151083,33906,463619,185562,278057,53142.92,637715,10.0,35.27,0.0341,2068,25.69,15167.02,2.24,0.519
7800,Holloway Torres and Haney,False,DE,Hamiltonmouth,Cybersecurity,2020,https://hollowaytorresandhaney.com,Speech baby suffer lose similar imagine.,19,holloway-torres-and-haney,2023,EUR,1056951,521228,535723,660675,-124952,1786,-126738,10569,21139,-147877,56685,611008,533438,77570,,1056951,948.2,1393.25,0.1052,512,172.0,67416.02,0.84,0.5069
7801,Bush Ltd,False,GB,Martinezland,Fintech,2024,https://bushltd.com,Theory store member include answer.,19,bush-ltd,2023,USD,1519843,963408,556435,999895,-443460,2951,-446411,15198,30396,-476807,849576,1713696,355721,1357975,,1519843,206.4,906.47,0.0468,810,156.32,69771.82,12.18,0.3661
7802,Hall Group,False,AU,Port Marvin,Energy,2019,https://hallgroup.com,Popular others wind back individual.,31,hall-group,2023,USD,874267,146987,727280,539699,187581,0,187581,8742,17485,170096,9344,449561,121383,328178,,874267,1428.81,8471.74,0.001,443,164.32,48960.58,0.19,0.8319
7803,Estrada Hughes and Olson,False,CA,North Nathaniel,SaaS,2017,https://estradahughesandolson.com,Crime military car long behavior while truth treat be view.,11,estrada-hughes-and-olson,2023,USD,2432124,1495417,936707,663998,272709,35534,237175,24321,48642,188533,160584,1487740,959548,528192,202677.0,2432124,343.55,1602.89,0.0462,2435,83.21,53983.8,2.97,0.3851
7804,Reed-Jordan,False,KE,West Kennethborough,AgriTech,2016,https://reed-jordan.com,Shoulder marriage stand attention rather subject stand else only point.,17,reed-jordan,2023,USD,611412,163693,447719,292000,155719,4308,151411,6114,12228,139183,24914,371025,59141,311884,,611412,20.0,73.11,0.0962,126,403.86,27127.84,0.92,0.7323
7805,Sherman Walsh and Best,False,IN,Port Marvinmouth,Marketplaces,2009,https://shermanwalshandbest.com,Around art create chance ahead within threat federal head new.,21,sherman-walsh-and-best,2023,USD,2905096,753183,2151913,1411592,740321,0,740321,29050,58101,682220,57066,1527316,76365,1450951,,2905096,254.7,681.53,0.058,12104,20.0,114267.21,0.5,0.7407
7806,Bautista-Gallagher,False,EG,New Jonathanmouth,Energy,2020,https://bautista-gallagher.com,Control suggest rather fall relate mouth.,16,bautista-gallagher,2023,USD,5851367,884041,4967326,1827936,3139390,0,3139390,58513,117027,3022363,888470,3891926,781955,3109971,,5851367,20.0,52.88,0.044,23065,21.14,149610.34,5.94,0.8489
7807,Reeves-Murphy,False,DE,Wellsstad,Marketplaces,2017,https://reeves-murphy.com,Something send wall plant true around.,19,reeves-murphy,2023,EUR,859541,309098,550443,334348,216095,19049,197046,8595,17190,179856,117220,674327,469805,204522,,859541,20.0,70.54,0.1103,3581,20.0,47085.75,2.49,0.6404
7808,Small Bright and Long,False,KE,East Lisaport,EdTech,2015,https://smallbrightandlong.com,World no appear yet money often.,27,small-bright-and-long,2023,USD,322033,163641,158392,16101,142291,0,142291,3220,6440,135851,18816,241542,63882,177660,26836.08,322033,10.0,51.24,0.0064,5367,5.0,1000.0,18.82,0.4919
7809,Rodriguez-Johnson,False,KE,New Ryanville,Energy,2019,https://rodriguez-johnson.com,Another end tell easy face fund act.,17,rodriguez-johnson,2023,USD,848530,211187,637343,524845,112498,20531,91967,8485,16970,74997,17411,556079,171944,384135,,848530,72.48,256.28,0.001,575,122.9,70696.15,0.25,0.7511
7810,Robinson Moore and Lang,False,US,New Shaneport,AgriTech,2020,https://robinsonmooreandlang.com,Lead buy left discover sit.,9,robinson-moore-and-lang,2023,USD,661007,207724,453283,33050,420233,0,420233,6610,13220,407013,29201,470747,235639,235108,,661007,838.45,3159.35,0.0185,704,78.14,32400.16,0.9,0.6857
7811,Hunter Shaffer and Williams,False,GB,Lake Larryview,Mobility,2014,https://huntershafferandwilliams.com,Perhaps democratic anything some environment.,17,hunter-shaffer-and-williams,2023,USD,1825527,569051,1256476,1173839,82637,26711,55926,18255,36510,19416,157940,1237987,725454,512533,,1825527,331.59,352.92,0.001,7606,20.0,88056.03,1.79,0.6883
7812,Collins Martin and Price,False,GB,North Jamesborough,HealthTech,2020,https://collinsmartinandprice.com,Could town sea cup become another while research education sometimes create.,20,collins-martin-and-price,2023,USD,1566942,698365,868577,78347,790230,0,790230,15669,31338,758892,178927,967280,128873,838407,130578.5,1566942,10.0,55.14,0.0777,15165,8.61,1000.0,178.93,0.5543
7813,Ali Meyer and Adams,False,GB,Lake Jennifer,Energy,2011,https://alimeyerandadams.com,Economy approach able watch by him teach ago idea.,20,ali-meyer-and-adams,2023,USD,1227108,320570,906538,629512,277026,0,277026,12271,24542,252484,22971,714415,383100,331315,,1227108,815.22,421.5,0.0336,719,142.1,60500.89,0.38,0.7388
7814,Dillon Group,False,FR,Johnside,AgriTech,2012,https://dillongroup.com,Decade feeling action member force.,24,dillon-group,2023,EUR,158263,91092,67171,131597,-64426,1981,-66407,1582,3165,-69572,7398,172916,54304,118612,,158263,447.78,2405.82,0.001,659,20.0,23981.6,0.31,0.4244
7815,Doyle-Bailey,False,IN,Lake Eugenemouth,EdTech,2021,https://doyle-bailey.com,Line house with agent yard.,29,doyle-bailey,2023,USD,446252,161408,284844,400658,-115814,12252,-128066,4462,8925,-136991,19331,424996,172456,252540,37187.67,446252,10.0,30.02,0.001,705,52.74,43001.3,0.45,0.6383
7816,Bennett-Jones,False,BR,Michaelshire,HealthTech,2018,https://bennett-jones.com,Only assume from picture science expert able option.,16,bennett-jones,2023,USD,1868186,1133901,734285,634915,99370,0,99370,18681,37363,62007,200472,1309814,752457,557357,155682.17,1868186,54.18,338.18,0.0252,1915,81.29,34875.09,5.75,0.393
7817,Lopez Levine and Ross,False,BR,Vegamouth,AI/ML,2018,https://lopezlevineandross.com,Art claim ever career whole.,25,lopez-levine-and-ross,2023,USD,222091,117247,104844,99710,5134,21633,-16499,2220,4441,-20940,27696,177544,82822,94722,,222091,995.41,1068.96,0.1922,925,20.0,1000.0,27.7,0.4721
7818,Jackson PLC,False,IN,Port Christian,Marketplaces,2012,https://jacksonplc.com,Turn hour current light near science stop be maybe help scientist.,24,jackson-plc,2023,USD,96012,18764,77248,54495,22753,5553,17200,960,1920,15280,4342,100279,27379,72900,,96012,20.0,10.0,0.0786,58,135.62,1000.0,4.34,0.8046
7819,Parker LLC,False,FR,Lisaburgh,Marketplaces,2024,https://parkerllc.com,Model budget style herself.,15,parker-llc,2023,EUR,1012693,296766,715927,845746,-129819,0,-129819,10126,20253,-150072,251273,803044,87729,715315,,1012693,482.4,2075.78,0.0312,2448,34.46,84504.15,2.97,0.707
7820,Griffin Phillips and Knight,False,NG,Cassandraview,Marketplaces,2009,https://griffinphillipsandknight.com,Above hotel need such mission white.,25,griffin-phillips-and-knight,2023,USD,1281326,618316,663010,660529,2481,18304,-15823,12813,25626,-41449,51608,776972,430708,346264,,1281326,1045.33,4136.32,0.1311,5338,20.0,82163.65,0.63,0.5174
7821,Schmidt-Cardenas,False,NG,Mosschester,Cybersecurity,2023,https://schmidt-cardenas.com,Present though American hold opportunity wrong I she activity.,20,schmidt-cardenas,2023,USD,431008,149036,281972,202049,79923,0,79923,4310,8620,71303,17644,402306,231858,170448,,431008,55.8,163.52,0.1347,142,251.66,15022.37,1.17,0.6542
7822,Alvarado-Castillo,False,KE,Jeffreyborough,Marketplaces,2011,https://alvarado-castillo.com,Significant firm office wrong national himself hope remain.,15,alvarado-castillo,2023,USD,330493,71971,258522,159451,99071,8390,90681,3304,6609,84072,46880,390099,229729,160370,,330493,20.0,51.37,0.0461,182,151.32,14368.1,3.26,0.7822
7823,Andrews Jordan and Soto,False,ZA,South Jennifer,IoT,2021,https://andrewsjordanandsoto.com,Agency begin attention friend.,20,andrews-jordan-and-soto,2023,USD,1415693,483901,931792,440844,490948,7994,482954,14156,28313,454641,212223,1116372,556627,559745,,1415693,692.26,1065.14,0.0864,496,237.73,41719.14,5.09,0.6582
7824,Gray-Horn,False,GB,Andersonfort,Marketplaces,2015,https://gray-horn.com,Research material whatever prove determine play age effort.,12,gray-horn,2023,USD,2232267,666482,1565785,1228796,336989,9402,327587,22322,44645,282942,74191,1309036,250159,1058877,,2232267,239.02,1284.58,0.1726,9301,20.0,84012.45,0.88,0.7014
7825,Wheeler LLC,False,ZA,Lake Leslieland,AgriTech,2010,https://wheelerllc.com,Camera tend who bit any other explain.,24,wheeler-llc,2023,USD,752892,288421,464471,576375,-111904,0,-111904,7528,15057,-126961,23120,482316,139714,342602,,752892,1170.23,585.12,0.0474,2455,25.55,17495.59,1.32,0.6169
7826,Schroeder Group,False,BR,South Karenview,IoT,2020,https://schroedergroup.com,Nice common image pretty whatever beat.,17,schroeder-group,2023,USD,2317943,1048989,1268954,2084959,-816005,41208,-857213,23179,46358,-903571,24606,1312381,495651,816730,,2317943,20.0,120.66,0.0643,9658,20.0,176277.78,0.14,0.5474
7827,Dominguez-Johnson,False,IN,New Jessicatown,EdTech,2014,https://dominguez-johnson.com,Place alone four any.,27,dominguez-johnson,2023,USD,997168,450716,546452,437934,108518,0,108518,9971,19943,88575,13689,662572,359428,303144,83097.33,997168,10.0,37.02,0.0175,1779,46.69,30932.27,0.44,0.548
7828,Dominguez PLC,False,NG,Jamieland,E-commerce,2015,https://dominguezplc.com,Continue strong fund full adult rock.,18,dominguez-plc,2023,USD,195441,72187,123254,52596,70658,9597,61061,1954,3908,57153,30547,179821,30382,149439,,195441,418.99,1569.86,0.0182,82,196.23,17208.81,1.78,0.6306
7829,Holloway-English,False,GB,Melissatown,Cybersecurity,2017,https://holloway-english.com,Site possible participant financial page pressure produce fine political pull news.,20,holloway-english,2023,USD,385960,170824,215136,146061,69075,21332,47743,3859,7719,40024,3232,243898,66263,177635,,385960,20.0,117.1,0.0127,155,206.67,24266.36,0.13,0.5574
7830,Williams and Sons,False,EG,Davisburgh,HealthTech,2019,https://williamsandsons.com,Bad opportunity magazine test enjoy do policy shake.,22,williams-and-sons,2023,USD,4471543,1058002,3413541,3348583,64958,0,64958,44715,89430,-24472,599626,2954218,1386935,1567283,372628.58,4471543,10.0,45.33,0.0262,7732,48.19,259822.4,2.31,0.7634
7831,Carr PLC,False,BR,East Raven,SaaS,2019,https://carrplc.com,Example through agree wish whose development.,16,carr-plc,2023,USD,817232,331480,485752,540574,-54822,10458,-65280,8172,16344,-81624,17785,559517,158964,400553,68102.67,817232,196.99,1716.47,0.0271,1444,47.15,56894.67,0.31,0.5944
7832,Austin LLC,False,NG,Savageshire,EdTech,2015,https://austinllc.com,Security each party despite outside wide.,13,austin-llc,2023,USD,262061,157674,104387,58189,46198,11792,34406,2620,5241,29165,18021,301793,177449,124344,21838.42,262061,94.22,469.14,0.0369,4367,5.0,21715.86,0.83,0.3983
7833,Brock-Medina,False,DE,Zimmermantown,AgriTech,2014,https://brock-medina.com,Either those draw reflect she president.,23,brock-medina,2023,EUR,168100,60847,107253,27858,79395,8104,71291,1681,3362,67929,9738,273483,42527,230956,,168100,385.51,1118.46,0.1108,58,240.61,21429.96,0.45,0.638
7834,Riley Ltd,False,US,Muellerbury,Cybersecurity,2015,https://rileyltd.com,Later especially reason avoid million number.,21,riley-ltd,2023,USD,2455122,740103,1715019,1526773,188246,0,188246,24551,49102,139144,367874,1636536,279024,1357512,,2455122,20.0,85.55,0.0672,2301,88.91,84686.54,4.34,0.6985
7835,Johnson-Wells,False,FR,Robertmouth,Fintech,2019,https://johnson-wells.com,Choice standard peace need old unit.,20,johnson-wells,2023,EUR,2503814,1517815,985999,480807,505192,0,505192,25038,50076,455116,35092,1460320,448347,1011973,,2503814,1239.92,5156.68,0.001,10432,20.0,43047.11,0.82,0.3938
7836,Gutierrez-Beck,False,BR,Biancaburgh,AI/ML,2023,https://gutierrez-beck.com,Piece program effect wind population inside those enter.,24,gutierrez-beck,2023,USD,524673,172647,352026,70584,281442,0,281442,5246,10493,270949,61579,440058,207835,232223,,524673,167.58,1027.13,0.0254,189,230.27,25904.78,2.38,0.6709
7837,Smith-Cobb,False,TN,Eatonhaven,SaaS,2019,https://smith-cobb.com,Anything environment whole present.,19,smith-cobb,2023,USD,1841311,365986,1475325,1078372,396953,0,396953,18413,36826,360127,47734,1026226,378106,648120,153442.58,1841311,10.0,68.69,0.0216,30688,5.0,110264.37,0.43,0.8012
7838,Martin-Thompson,False,ZA,New Jeffreyfurt,AgriTech,2019,https://martin-thompson.com,Admit mind federal model significant per great serve.,23,martin-thompson,2023,USD,195390,53693,141697,163921,-22224,0,-22224,1953,3907,-26131,38228,138120,93099,45021,,195390,20.0,63.4,0.0604,175,92.91,19981.45,1.91,0.7252
7839,Turner-Bishop,False,EG,New Denisestad,Cybersecurity,2020,https://turner-bishop.com,Hope church future agency likely value stock politics defense see.,14,turner-bishop,2023,USD,1687619,525045,1162574,777707,384867,11656,373211,16876,33752,339459,85623,988546,465396,523150,,1687619,659.68,329.84,0.001,5979,23.52,48977.22,1.75,0.6889
7840,Cisneros-Pearson,False,ZA,Teresaburgh,IoT,2016,https://cisneros-pearson.com,Director expect determine every phone century he summer already.,11,cisneros-pearson,2023,USD,908900,352230,556670,628793,-72123,10870,-82993,9089,18178,-101171,28625,495997,45141,450856,,908900,20.0,75.04,0.0793,861,87.94,38643.69,0.74,0.6125
7841,Sanchez Smith and Smith,False,EG,West Raymondton,E-commerce,2022,https://sanchezsmithandsmith.com,Moment day make body entire family.,24,sanchez-smith-and-smith,2023,USD,447615,189601,258014,299291,-41277,6697,-47974,4476,8952,-56926,14102,353964,46848,307116,,447615,445.1,222.55,0.0378,1865,20.0,27500.99,0.51,0.5764
7842,Jones Shea and Jackson,False,TN,Anthonyton,IoT,2016,https://jonessheaandjackson.com,Reveal money art letter letter moment hospital grow.,16,jones-shea-and-jackson,2023,USD,1120896,153665,967231,556435,410796,0,410796,11208,22417,388379,12289,671692,239806,431886,,1120896,1241.65,8044.18,0.0757,711,131.31,50959.0,0.24,0.8629
7843,Dawson LLC,False,ZA,Ericmouth,Marketplaces,2018,https://dawsonllc.com,Agent successful item eight road little chair.,32,dawson-llc,2023,USD,2048730,795756,1252974,1585933,-332959,0,-332959,20487,40974,-373933,22075,1166264,555228,611036,,2048730,20.0,14.77,0.0349,1322,129.14,142509.28,0.15,0.6116
7844,Wu Inc,False,DE,Olsenland,E-commerce,2015,https://wuinc.com,Science trouble or anything growth three if know whole.,35,wu-inc,2023,EUR,721693,270243,451450,282647,168803,0,168803,7216,14433,154370,11515,543127,270240,272887,,721693,319.27,1477.91,0.0053,330,181.79,37472.78,0.31,0.6255
7845,Santiago Padilla and Cooper,False,TN,Wintersmouth,E-commerce,2023,https://santiagopadillaandcooper.com,Eye official address represent teach what.,22,santiago-padilla-and-cooper,2023,USD,1269153,492497,776656,1024772,-248116,25008,-273124,12691,25383,-298507,29087,790198,262167,528031,,1269153,20.0,82.61,0.0416,781,135.36,51788.49,0.56,0.6119
7846,Todd-Simpson,False,IN,Heatherland,Energy,2020,https://todd-simpson.com,Professional option himself their loss law build listen.,16,todd-simpson,2023,USD,3432755,1194399,2238356,1883283,355073,6281,348792,34327,68655,280137,410977,2275965,1114614,1161351,,3432755,20.0,84.53,0.0595,2275,125.74,128289.66,3.2,0.6521
7847,King-Haynes,False,ZA,Calhounmouth,IoT,2024,https://king-haynes.com,List small bit film course we laugh what early direction unit.,11,king-haynes,2023,USD,86513,19741,66772,4325,62447,0,62447,865,1730,60717,55217,177419,68679,108740,,86513,886.03,3325.75,0.0463,46,156.52,17428.26,3.17,0.7718
7848,Key PLC,False,TN,North Catherine,Fintech,2021,https://keyplc.com,Road thus population hit on recognize box.,22,key-plc,2023,USD,154974,43363,111611,29633,81978,25756,56222,1549,3099,53123,6426,144074,7203,136871,,154974,735.87,745.57,0.0886,440,29.34,1000.0,6.43,0.7202
7849,Farmer Brown and Johnson,False,DE,Gallegosport,AgriTech,2012,https://farmerbrownandjohnson.com,Shoulder production my manager alone.,19,farmer-brown-and-johnson,2023,EUR,352751,85486,267265,17637,249628,5453,244175,3527,7055,237120,16959,230629,105167,125462,,352751,20.0,75.29,0.0658,113,259.53,32950.85,0.51,0.7577
7850,Wood-Welch,False,FR,Sarahchester,HealthTech,2018,https://wood-welch.com,Write military gun foreign expert building support fine.,12,wood-welch,2023,EUR,334549,112758,221791,47901,173890,15587,158303,3345,6690,151613,19796,323870,145207,178663,27879.08,334549,577.54,2664.69,0.001,1120,24.89,2781.78,7.12,0.663
7851,Blevins Ltd,False,IN,Jennamouth,E-commerce,2008,https://blevinsltd.com,A so food door nearly response.,12,blevins-ltd,2023,USD,1342628,270969,1071659,333943,737716,45071,692645,13426,26852,665793,200598,973104,314400,658704,,1342628,357.57,397.99,0.0341,5594,20.0,18541.27,10.82,0.7982
7852,Wright and Sons,False,NG,Port Ashleychester,Cybersecurity,2008,https://wrightandsons.com,Close world present try after son car carry staff ground.,18,wright-and-sons,2023,USD,3022037,617426,2404611,292642,2111969,26499,2085470,30220,60440,2025030,74468,1668138,608752,1059386,,3022037,20.0,79.6,0.001,12591,20.0,8314.94,8.96,0.7957
7853,Morgan Ltd,False,KE,West Matthewfurt,E-commerce,2017,https://morganltd.com,Late deal list far central huge research direction ground central.,22,morgan-ltd,2023,USD,749667,279160,470507,426728,43779,12154,31625,7496,14993,16632,88730,526002,201595,324407,,749667,20.0,10.0,0.0471,3123,20.0,96219.59,0.92,0.6276
7854,Perry-Miller,False,NG,Hallland,Fintech,2018,https://perry-miller.com,Pretty pick fall apply good middle result responsibility color.,20,perry-miller,2023,USD,402023,63074,338949,83265,255684,0,255684,4020,8040,247644,10482,386247,291305,94942,,402023,20.0,69.84,0.0263,1675,20.0,25235.32,0.42,0.8431
7855,Velez-Holmes,False,GB,West Natalie,Energy,2012,https://velez-holmes.com,Gun free those good ok speak option quickly.,21,velez-holmes,2023,USD,1301515,433066,868449,65075,803374,4507,798867,13015,26030,772837,18316,804442,267741,536701,,1301515,1785.31,5871.59,0.0651,1000,108.38,11883.19,1.54,0.6673
7856,Martin-Wright,False,CA,Phillipsside,E-commerce,2020,https://martin-wright.com,Mention could upon stuff just.,19,martin-wright,2023,USD,157089,87604,69485,52530,16955,15401,1554,1570,3141,-1587,3927,138569,68411,70158,,157089,20.0,30.62,0.0261,54,238.8,12618.31,0.31,0.4423
7857,Johnson Ponce and Martinez,False,TN,Jamesview,AgriTech,2022,https://johnsonponceandmartinez.com,Never risk usually somebody president single sure any reveal.,21,johnson-ponce-and-martinez,2023,USD,168342,50832,117510,66194,51316,0,51316,1683,3366,47950,6873,227868,47909,179959,,168342,128.85,383.23,0.04,89,157.35,1000.0,6.87,0.698
7858,Davila Johns and Morris,False,GB,New Scott,Fintech,2015,https://davilajohnsandmorris.com,College find woman miss second receive agreement article me.,15,davila-johns-and-morris,2023,USD,3718967,1445729,2273238,2100175,173063,25649,147414,37189,74379,73035,341227,2370413,1495585,874828,,3718967,175.07,946.66,0.0556,2188,141.62,194732.67,1.75,0.6113
7859,Martinez LLC,False,US,Mayville,Mobility,2016,https://martinezllc.com,Sell kitchen head television war management fast question.,20,martinez-llc,2023,USD,513082,186827,326255,161847,164408,0,164408,5130,10261,154147,2534,355090,39347,315743,,513082,468.97,234.48,0.0568,1251,34.17,18665.33,0.14,0.6359
7860,Smith Mckinney and Lawrence,False,GB,Tateview,EdTech,2019,https://smithmckinneyandlawrence.com,Argue before money discover act professional black ever science.,14,smith-mckinney-and-lawrence,2023,USD,977925,276547,701378,466757,234621,39215,195406,9779,19558,175848,32571,609231,325782,283449,81493.75,977925,132.27,651.97,0.001,1165,69.94,30793.13,1.06,0.7172
7861,Jones-Fleming,False,AU,North Elizabeth,Cybersecurity,2011,https://jones-fleming.com,Them coach student teach particularly she look hope vote sell.,18,jones-fleming,2023,USD,1650560,289505,1361055,717423,643632,9874,633758,16505,33011,600747,44325,937131,349016,588115,,1650560,2503.23,16944.25,0.001,3919,35.09,80940.48,0.55,0.8246
7862,Scott and Sons,False,IN,Carolynstad,HealthTech,2020,https://scottandsons.com,Side race every evidence recent hot major never.,29,scott-and-sons,2023,USD,541519,122735,418784,449252,-30468,0,-30468,5415,10830,-41298,16458,366810,107374,259436,45126.58,541519,10.0,34.77,0.0229,2863,15.76,16397.68,1.0,0.7734
7863,Martin Guerrero and Carr,False,FR,East Paulmouth,AgriTech,2009,https://martinguerreroandcarr.com,Difference rule if choose suddenly customer energy see.,19,martin-guerrero-and-carr,2023,EUR,766530,178540,587990,247461,340529,33334,307195,7665,15330,291865,22122,487809,368693,119116,,766530,20.0,43.64,0.001,3193,20.0,32951.67,0.67,0.7671
7864,Hill Craig and Lee,False,BR,Thomasfort,AgriTech,2014,https://hillcraigandlee.com,Special western perform memory.,14,hill-craig-and-lee,2023,USD,171514,56407,115107,75519,39588,29293,10295,1715,3430,6865,5400,277009,133851,143158,,171514,507.4,1406.59,0.038,89,159.63,1000.0,5.4,0.6711
7865,Velazquez Martin and Sharp,False,DE,Lake Robert,HealthTech,2021,https://velazquezmartinandsharp.com,Father music course purpose or quite officer population.,16,velazquez-martin-and-sharp,2023,EUR,1001544,174788,826756,336405,490351,0,490351,10015,20030,470321,191871,879006,367904,511102,83462.0,1001544,221.57,1338.87,0.071,16692,5.0,61472.46,3.12,0.8255
7866,Williams PLC,False,FR,Samuelside,AgriTech,2018,https://williamsplc.com,Assume defense reduce professor wall forget subject address all.,24,williams-plc,2023,EUR,490318,97878,392440,166482,225958,0,225958,4903,9806,216152,25747,381249,270583,110666,,490318,686.54,1235.73,0.0691,2042,20.0,1000.0,25.75,0.8004
7867,Johnson Ltd,False,IN,Joshuaside,EdTech,2009,https://johnsonltd.com,Record return site appear real forward.,11,johnson-ltd,2023,USD,1543095,722852,820243,823574,-3331,11181,-14512,15430,30861,-45373,106489,1014662,251760,762902,128591.25,1543095,152.2,537.34,0.0061,3937,32.66,88690.98,1.2,0.5316
7868,Lopez Cruz and Howard,False,EG,Margaretport,IoT,2021,https://lopezcruzandhoward.com,Court idea born theory painting two rate.,22,lopez-cruz-and-howard,2023,USD,410123,132342,277781,178204,99577,0,99577,4101,8202,91375,6495,236867,74368,162499,,410123,20.0,150.08,0.001,1708,20.0,18721.59,0.35,0.6773
7869,Jones-Bartlett,False,DE,Alexaland,Marketplaces,2022,https://jones-bartlett.com,Event six bad late rich pressure.,29,jones-bartlett,2023,EUR,494864,63356,431508,24743,406765,0,406765,4948,9897,396868,23307,285701,130138,155563,,494864,20.0,64.06,0.001,793,51.98,28566.75,0.82,0.872
7870,Ross-Gonzales,False,DE,Port Scott,Fintech,2008,https://ross-gonzales.com,Treat store tell price involve common near kitchen production.,18,ross-gonzales,2023,EUR,1526811,461631,1065180,518258,546922,0,546922,15268,30536,516386,33644,940390,623140,317250,,1526811,2065.22,10188.92,0.0894,2383,53.39,37077.32,0.91,0.6977
7871,Griffith-Bradley,False,US,Jamesside,AI/ML,2011,https://griffith-bradley.com,Eight ground really strong race partner foot respond.,25,griffith-bradley,2023,USD,1686241,630291,1055950,720477,335473,0,335473,16862,33724,301749,203930,1179722,406713,773009,,1686241,20.0,50.87,0.0065,2361,59.51,67844.41,3.01,0.6262
7872,Coleman Fowler and Avila,False,EG,Annettechester,AI/ML,2019,https://colemanfowlerandavila.com,Also become enough that fill life back sit practice determine.,27,coleman-fowler-and-avila,2023,USD,1411576,701955,709621,1143830,-434209,7562,-441771,14115,28231,-470002,40995,822462,199445,623017,,1411576,761.02,1712.83,0.0372,500,235.13,101315.47,0.4,0.5027
7873,Harris Brown and Patel,False,GB,Mariaside,HealthTech,2011,https://harrisbrownandpatel.com,Understand woman home wonder point reason sing.,19,harris-brown-and-patel,2023,USD,1634005,672191,961814,1210860,-249046,891,-249937,16340,32680,-282617,48165,1063490,160416,903074,136167.08,1634005,10.0,31.79,0.0306,1449,93.91,94315.15,0.51,0.5886
7874,Stark Hart and Jones,False,FR,East Shawnside,E-commerce,2022,https://starkhartandjones.com,Safe nature machine seem training entire have decision.,14,stark-hart-and-jones,2023,EUR,1680652,555976,1124676,1477230,-352554,5769,-358323,16806,33613,-391936,377229,1346843,524217,822626,,1680652,1104.07,4153.68,0.0441,771,181.65,129406.39,2.92,0.6692
7875,Diaz Group,False,FR,Jenkinsport,AI/ML,2016,https://diazgroup.com,Cell left attack piece human Congress.,22,diaz-group,2023,EUR,917892,540051,377841,746407,-368566,50935,-419501,9178,18357,-437858,49547,591518,221894,369624,,917892,171.52,670.2,0.0067,249,306.9,34690.98,1.43,0.4116
7876,Jones Key and Frost,False,CA,Lake Louishaven,HealthTech,2014,https://joneskeyandfrost.com,Fill color can tell green bag prepare develop.,19,jones-key-and-frost,2023,USD,320574,116906,203668,87294,116374,19870,96504,3205,6411,90093,65391,396904,122111,274793,26714.5,320574,22.49,106.95,0.0848,422,63.17,19813.21,3.3,0.6353
7877,Ferguson Russell and Haney,False,CA,East Devin,Marketplaces,2016,https://fergusonrussellandhaney.com,Sit call soon throw drug service poor music.,16,ferguson-russell-and-haney,2023,USD,2538588,924954,1613634,423010,1190624,22120,1168504,25385,50771,1117733,648529,2059950,353168,1706782,,2538588,20.0,10.0,0.0596,989,213.89,63696.29,10.18,0.6356
7878,Carpenter-Cook,False,ZA,Lake Alan,HealthTech,2021,https://carpenter-cook.com,Power bring voice fish opportunity soldier north key.,18,carpenter-cook,2023,USD,172820,56825,115995,116506,-511,0,-511,1728,3456,-3967,6951,136922,14690,122232,14401.67,172820,849.22,5643.3,0.0597,809,17.78,20426.81,0.34,0.6712
7879,Turner-Brown,False,NG,New John,Mobility,2016,https://turner-brown.com,South each also week where who.,19,turner-brown,2023,USD,4672682,1644504,3028178,2322820,705358,0,705358,46726,93453,611905,278776,2796363,882080,1914283,,4672682,20.0,10.0,0.0223,2855,136.36,195454.35,1.43,0.6481
7880,Davis Taylor and West,False,IN,Amberfort,Marketplaces,2023,https://davistaylorandwest.com,Call final decide teacher watch party its mouth.,19,davis-taylor-and-west,2023,USD,386502,162154,224348,212525,11823,0,11823,3865,7730,4093,16121,343953,17197,326756,,386502,460.76,937.27,0.001,181,177.52,28439.7,0.57,0.5805
7881,Russell Group,False,US,North John,Fintech,2023,https://russellgroup.com,Process off west movement tonight.,9,russell-group,2023,USD,831199,145356,685843,444603,241240,0,241240,8311,16623,224617,171218,778477,258483,519994,,831199,20.0,44.17,0.0729,509,135.85,43991.85,3.89,0.8251
7882,Park Ltd,False,DE,East Linda,Marketplaces,2013,https://parkltd.com,All authority so line Democrat popular.,9,park-ltd,2023,EUR,335293,137671,197622,131205,66417,14306,52111,3352,6705,45406,1993,235471,120692,114779,,335293,657.66,2576.33,0.0303,141,197.71,1000.0,1.99,0.5894
7883,Hill Peck and Soto,False,BR,Lake Frederickchester,Marketplaces,2008,https://hillpeckandsoto.com,Threat five should compare seek bit.,19,hill-peck-and-soto,2023,USD,888804,273886,614918,389429,225489,0,225489,8888,17776,207713,427970,940434,630477,309957,,888804,681.93,658.27,0.0423,3703,20.0,22510.68,19.01,0.6918
7884,White Ellis and Lyons,False,ZA,Port Lesliemouth,AI/ML,2021,https://whiteellisandlyons.com,Exist situation business body reduce none difficult.,25,white-ellis-and-lyons,2023,USD,7535219,4407738,3127481,4148316,-1020835,14533,-1035368,75352,150704,-1186072,392940,4263036,213151,4049885,,7535219,62.86,247.35,0.0302,4432,141.67,332354.47,1.18,0.415
7885,Anderson-Hanson,False,AU,West Jeffreybury,E-commerce,2012,https://anderson-hanson.com,Early wall Democrat end official sit turn report.,25,anderson-hanson,2023,USD,1880950,464885,1416065,949576,466489,32813,433676,18809,37619,396057,115877,1122529,343070,779459,,1880950,2205.42,9323.96,0.0755,1506,104.06,74192.07,1.56,0.7528
7886,Freeman Ross and Maldonado,False,DE,Theresachester,Mobility,2022,https://freemanrossandmaldonado.com,Method career follow someone successful.,19,freeman-ross-and-maldonado,2023,EUR,596765,203968,392797,216735,176062,0,176062,5967,11935,164127,25828,425241,166795,258446,,596765,20.0,27.15,0.0073,268,184.92,21880.42,1.18,0.6582
7887,Brown Mclean and Ibarra,False,EG,Lake Thomas,HealthTech,2021,https://brownmcleanandibarra.com,Easy put their property daughter serious suffer color pretty explain turn.,11,brown-mclean-and-ibarra,2023,USD,1195853,448064,747789,364207,383582,0,383582,11958,23917,359665,338707,1060004,53000,1007004,99654.42,1195853,10.0,53.12,0.0072,2210,45.09,48554.2,6.98,0.6253
7888,Baker Washington and Miller,False,TN,North Rickyfort,Marketplaces,2018,https://bakerwashingtonandmiller.com,Record house collection fill west recognize heart suggest red range.,24,baker-washington-and-miller,2023,USD,114986,32171,82815,42819,39996,5715,34281,1149,2299,31982,6926,108378,38041,70337,,114986,20.0,10.0,0.001,479,20.0,1000.0,6.93,0.7202
7889,Herring-Butler,False,TN,Anthonyland,EdTech,2014,https://herring-butler.com,Ever no market common rest blood.,20,herring-butler,2023,USD,556153,222142,334011,205330,128681,29535,99146,5561,11123,88023,40887,510519,166562,343957,46346.08,556153,10.0,26.65,0.0387,743,62.34,14087.55,2.9,0.6006
7890,Barnes Inc,False,EG,East William,SaaS,2011,https://barnesinc.com,War truth party reach agreement develop main last east.,24,barnes-inc,2023,USD,2447849,560852,1886997,2032468,-145471,31904,-177375,24478,48956,-226331,160358,1401320,529070,872250,203987.42,2447849,477.97,2149.54,0.0459,6484,31.46,164198.83,0.98,0.7709
7891,Clark-Murphy,False,IN,Lake Joshua,SaaS,2009,https://clark-murphy.com,Huge wait past season maintain course reveal last factor seek.,21,clark-murphy,2023,USD,319302,94292,225010,15965,209045,0,209045,3193,6386,202659,31129,291030,148710,142320,26608.5,319302,611.33,1837.47,0.001,5321,5.0,1000.0,31.13,0.7047
7892,Duke Smith and Clark,False,AU,Port Patrickhaven,Marketplaces,2019,https://dukesmithandclark.com,Nice state form degree challenge ground site.,24,duke-smith-and-clark,2023,USD,2161733,690888,1470845,1021978,448867,0,448867,21617,43234,405633,271346,1375397,677391,698006,,2161733,690.47,4739.24,0.191,2315,77.79,73054.85,3.71,0.6804
7893,Cole Case and Powell,False,GB,South Tanyashire,Mobility,2010,https://colecaseandpowell.com,Three simple whole yes cup spend few close benefit.,16,cole-case-and-powell,2023,USD,1232588,387155,845433,775083,70350,15546,54804,12325,24651,30153,27397,664135,363780,300355,,1232588,20.0,83.47,0.0514,5135,20.0,82622.53,0.33,0.6859
7894,Glass PLC,False,US,Christianshire,E-commerce,2018,https://glassplc.com,Check money ahead reality may soldier room.,24,glass-plc,2023,USD,787892,163142,624750,555105,69645,27128,42517,7878,15757,26760,12872,542977,109487,433490,,787892,386.57,1103.56,0.0063,244,268.42,53821.11,0.24,0.7929
7895,Henry-Mendez,False,BR,South Keithland,AI/ML,2009,https://henry-mendez.com,Here face area effect American eat law far goal month.,29,henry-mendez,2023,USD,392246,147328,244918,178672,66246,0,66246,3922,7844,58402,21855,345765,120604,225161,,392246,1005.68,1943.61,0.001,140,232.64,1221.03,17.9,0.6244
7896,Mccormick Dominguez and Cruz,False,US,Port Heather,SaaS,2012,https://mccormickdominguezandcruz.com,Chance approach find hotel true value eye.,21,mccormick-dominguez-and-cruz,2023,USD,4971684,1300789,3670895,3598563,72332,1430,70902,49716,99433,-28531,363887,3007794,1655823,1351971,414307.0,4971684,50.73,276.67,0.0561,3989,103.86,302650.63,1.2,0.7384
7897,Parker-Lewis,False,EG,Abbottland,Marketplaces,2013,https://parker-lewis.com,Chair response key mother many allow shoulder surface lawyer.,12,parker-lewis,2023,USD,803370,256506,546864,574460,-27596,26814,-54410,8033,16067,-70477,38254,631521,287797,343724,,803370,20.0,39.21,0.001,316,211.4,50005.94,0.76,0.6807
7898,Wise Inc,False,ZA,Port Julie,HealthTech,2010,https://wiseinc.com,Appear require choose relate employee phone indeed.,22,wise-inc,2023,USD,1063128,400626,662502,342399,320103,17373,302730,10631,21262,281468,122214,782314,94669,687645,88594.0,1063128,10.0,40.13,0.019,1641,53.96,1000.0,122.21,0.6232
7899,Conner-Carter,False,IN,Lake Daryltown,HealthTech,2018,https://conner-carter.com,Similar never be sound moment decide.,21,conner-carter,2023,USD,790669,137496,653173,472386,180787,13961,166826,7906,15813,151013,10588,493664,109952,383712,65889.08,790669,224.86,500.93,0.0222,1275,51.64,22032.62,0.48,0.8261
7900,Nguyen Alvarado and Yates,False,EG,Arthurton,Marketplaces,2014,https://nguyenalvaradoandyates.com,Physical discussion system thing maintain risk.,20,nguyen-alvarado-and-yates,2023,USD,1173074,504325,668749,583677,85072,0,85072,11730,23461,61611,4416,771701,415815,355886,,1173074,50.56,25.28,0.0873,468,208.87,22995.41,0.19,0.5701
7901,Johnson-Smith,False,FR,Ponceside,Energy,2008,https://johnson-smith.com,According pull beat lot.,20,johnson-smith,2023,EUR,277856,144284,133572,46833,86739,15041,71698,2778,5557,66141,6840,272022,129149,142873,,277856,32.59,19.31,0.0903,150,154.25,1000.0,6.84,0.4807
7902,Williams Strong and Ray,False,KE,New Deborahtown,AgriTech,2015,https://williamsstrongandray.com,Treatment box character term system behavior develop any note thought bring.,21,williams-strong-and-ray,2023,USD,57648,22241,35407,52926,-17519,17796,-35315,576,1152,-36467,4195,160336,58707,101629,,57648,256.95,560.63,0.0691,21,219.91,1000.0,4.2,0.6142
7903,Baker-Harvey,False,KE,New Michaelview,Cybersecurity,2011,https://baker-harvey.com,Tax call speak edge well return suddenly.,13,baker-harvey,2023,USD,471613,117784,353829,97186,256643,1290,255353,4716,9432,245921,69271,385811,76804,309007,,471613,296.07,730.81,0.0243,114,344.47,9624.19,7.2,0.7503
7904,Shaw Miller and Harris,False,AU,West Nicolemouth,EdTech,2020,https://shawmillerandharris.com,Writer anyone fine pull perhaps baby.,17,shaw-miller-and-harris,2023,USD,224805,70709,154096,11240,142856,0,142856,2248,4496,138360,39405,206629,141013,65616,18733.75,224805,376.49,2231.22,0.0108,677,27.65,1000.0,39.4,0.6855
7905,Dyer-Taylor,False,NG,Hermanville,Marketplaces,2010,https://dyer-taylor.com,Total television interesting six foot he inside reveal.,19,dyer-taylor,2023,USD,998053,394224,603829,450678,153151,0,153151,9980,19961,133190,65959,576095,192088,384007,,998053,1282.89,2000.79,0.001,729,114.07,1000.0,65.96,0.605
7906,Thompson Jones and Hampton,False,EG,Port Dawn,HealthTech,2009,https://thompsonjonesandhampton.com,Poor leave fast that bar art far rock across.,25,thompson-jones-and-hampton,2023,USD,3216772,1568574,1648198,1896217,-248019,20285,-268304,32167,64335,-332639,241950,2022402,514590,1507812,268064.33,3216772,913.07,1905.94,0.001,6760,39.65,164851.66,1.47,0.5124
7907,Alvarez-Carter,False,DE,Charlesshire,Fintech,2014,https://alvarez-carter.com,Energy carry throw especially center threat why member really.,23,alvarez-carter,2023,EUR,1036362,374557,661805,119641,542164,6231,535933,10363,20727,515206,186366,876161,461426,414735,,1036362,612.45,2407.92,0.1281,310,278.08,1000.0,186.37,0.6386
7908,Rodriguez Mendoza and Wu,False,TN,Beverlyshire,IoT,2019,https://rodriguezmendozaandwu.com,Model me event subject skill imagine huge.,15,rodriguez-mendoza-and-wu,2023,USD,1190899,375250,815649,738311,77338,33016,44322,11908,23817,20505,62747,855526,544012,311514,,1190899,20.0,10.0,0.001,424,233.8,66671.73,0.94,0.6849
7909,Walter-Alvarado,False,CA,Port Jamie,Cybersecurity,2012,https://walter-alvarado.com,Doctor play amount character network their drive interesting.,16,walter-alvarado,2023,USD,1898811,441310,1457501,1222188,235313,4764,230549,18988,37976,192573,63118,1146273,93457,1052816,,1898811,952.96,4720.02,0.0973,780,202.82,108337.32,0.58,0.7676
7910,Smith-Anderson,False,NG,Jonesside,Energy,2013,https://smith-anderson.com,Beautiful experience debate sound ever drug.,15,smith-anderson,2023,USD,5023904,1721429,3302475,3380882,-78407,14402,-92809,50239,100478,-193287,148446,2850015,485671,2364344,,5023904,20.0,86.47,0.0092,20932,20.0,312391.79,0.48,0.6574
7911,Mueller Howard and Williams,False,ZA,West Amyborough,SaaS,2013,https://muellerhowardandwilliams.com,Appear week various pass maybe concern.,18,mueller-howard-and-williams,2023,USD,2271057,674437,1596620,1393421,203199,23297,179902,22710,45421,134481,146463,1289019,64450,1224569,189254.75,2271057,284.71,1427.44,0.001,7561,25.03,149957.5,0.98,0.703
7912,Burke Group,False,KE,North Clayton,Cybersecurity,2023,https://burkegroup.com,Cultural way we land art quite however.,28,burke-group,2023,USD,8856890,5720829,3136061,4698745,-1562684,0,-1562684,88568,177137,-1739821,615175,5180546,341724,4838822,,8856890,449.81,680.24,0.0779,36903,20.0,405758.35,1.52,0.3541
7913,Sanchez Jenkins and Allen,False,AU,Port Monica,EdTech,2019,https://sanchezjenkinsandallen.com,Sign young president dark economic argue name least travel several.,18,sanchez-jenkins-and-allen,2023,USD,498075,159058,339017,259095,79922,12038,67884,4980,9961,57923,25166,277506,76209,201297,41506.25,498075,380.14,1311.97,0.0654,1687,24.59,22691.02,1.11,0.6807
7914,Irwin and Sons,False,GB,South Dylanfort,Cybersecurity,2019,https://irwinandsons.com,Similar TV wait son easy.,20,irwin-and-sons,2023,USD,4359206,1703032,2656174,3290560,-634386,1417,-635803,43592,87184,-722987,420677,2744445,1788274,956171,,4359206,20.0,106.53,0.0572,6227,58.33,273642.85,1.54,0.6093
7915,Peck PLC,False,KE,Jonesfort,E-commerce,2014,https://peckplc.com,Several relationship voice prepare for.,16,peck-plc,2023,USD,652081,323713,328368,359036,-30668,19514,-50182,6520,13041,-63223,122371,462724,257091,205633,,652081,638.6,1222.31,0.0355,319,170.13,39244.72,3.12,0.5036
7916,Terry Ward and Parks,False,DE,Duartefort,HealthTech,2013,https://terrywardandparks.com,Guy southern personal room.,25,terry-ward-and-parks,2023,EUR,3785289,1330009,2455280,2515212,-59932,12235,-72167,37852,75705,-147872,278632,2345661,1365086,980575,315440.75,3785289,200.18,628.47,0.0265,6131,51.45,184205.57,1.51,0.6486
7917,Madden-Serrano,False,GB,Salasburgh,Marketplaces,2022,https://madden-serrano.com,Remain window almost story theory information really cultural hair.,15,madden-serrano,2023,USD,556893,277123,279770,153121,126649,11676,114973,5568,11137,103836,94737,518076,210494,307582,,556893,1202.43,1595.83,0.0427,351,131.96,23918.08,3.96,0.5024
7918,Davis and Sons,False,DE,New Jenniferchester,Cybersecurity,2014,https://davisandsons.com,Whom late quickly mention fall cell collection.,15,davis-and-sons,2023,EUR,1346823,355570,991253,730136,261117,35330,225787,13468,26936,198851,18870,787527,39376,748151,,1346823,20.0,114.68,0.0016,5611,20.0,48885.53,0.39,0.736
7919,Bell and Sons,False,NG,Williamchester,IoT,2013,https://bellandsons.com,Pm nearly treatment black low area break human learn something.,15,bell-and-sons,2023,USD,1336738,832782,503956,1020920,-516964,21434,-538398,13367,26734,-565132,35315,845546,258698,586848,,1336738,20.0,56.85,0.001,5569,20.0,69791.93,0.51,0.377
7920,Higgins Davis and Lee,False,US,West Tammy,AgriTech,2019,https://higginsdavisandlee.com,Very peace security for suddenly reduce clear clearly.,20,higgins-davis-and-lee,2023,USD,344944,118370,226574,17247,209327,0,209327,3449,6898,202429,16067,285411,138097,147314,,344944,1326.78,887.19,0.1113,293,97.85,16009.86,1.0,0.6568
7921,Wilson Carlson and Small,False,EG,Port Johnmouth,Cybersecurity,2015,https://wilsoncarlsonandsmall.com,Government thousand audience attack interesting read.,24,wilson-carlson-and-small,2023,USD,1258255,196434,1061821,1271728,-209907,0,-209907,12582,25165,-235072,16114,656003,315116,340887,,1258255,1292.35,7822.99,0.0632,869,120.55,93787.4,0.17,0.8439
7922,Barton-Jenkins,False,AU,Millerborough,E-commerce,2015,https://barton-jenkins.com,Call east wish growth result beat family.,21,barton-jenkins,2023,USD,772450,253747,518703,422587,96116,0,96116,7724,15449,80667,41273,559221,234912,324309,,772450,20.0,22.54,0.0348,1635,39.35,54309.57,0.76,0.6715
7923,Lambert Smith and Williams,False,GB,Lake Douglaston,EdTech,2021,https://lambertsmithandwilliams.com,Through marriage read traditional moment research approach.,29,lambert-smith-and-williams,2023,USD,1263961,320902,943059,1274755,-331696,16606,-348302,12639,25279,-373581,63588,849508,220568,628940,105330.08,1263961,224.54,664.6,0.0405,1207,87.22,103562.53,0.61,0.7461
7924,Duncan-Riley,False,TN,East Lauren,Fintech,2024,https://duncan-riley.com,Card authority hair opportunity their paper but.,26,duncan-riley,2023,USD,809302,222914,586388,545086,41302,4855,36447,8093,16186,20261,94126,547247,427265,119982,,809302,20.0,129.28,0.001,2329,28.95,17178.4,5.48,0.7246
7925,Harris LLC,False,CA,Pageberg,SaaS,2023,https://harrisllc.com,Forward civil process available send idea certain end someone.,28,harris-llc,2023,USD,719581,274441,445140,460936,-15796,18272,-34068,7195,14391,-48459,60202,571947,101816,470131,59965.08,719581,130.65,800.55,0.0215,1084,55.28,37596.94,1.6,0.6186
7926,Gonzalez-Roberson,False,TN,Coreyburgh,Fintech,2009,https://gonzalez-roberson.com,Maybe lead attorney respond compare despite wrong.,20,gonzalez-roberson,2023,USD,2023838,837927,1185911,626385,559526,36508,523018,20238,40476,482542,77895,1120161,312214,807947,,2023838,1024.54,7711.84,0.026,3286,51.31,64166.29,1.21,0.586
7927,Hayes-Hampton,False,NG,New Marissaview,Mobility,2009,https://hayes-hampton.com,Myself region plan wife goal agree face.,20,hayes-hampton,2023,USD,4807321,2540335,2266986,1629635,637351,23197,614154,48073,96146,518008,286494,2788564,932251,1856313,,4807321,1827.73,9299.33,0.034,20030,20.0,141808.63,2.02,0.4716
7928,Williams PLC,False,NG,West Christopherside,HealthTech,2020,https://williamsplc.com,Inside can trouble Republican heart admit family hospital place person.,28,williams-plc,2023,USD,1342032,526870,815162,359641,455521,0,455521,13420,26840,428681,23561,839162,363763,475399,111836.0,1342032,165.22,765.91,0.0441,22367,5.0,13410.49,1.76,0.6074
7929,Payne-Park,False,KE,South Markfurt,Mobility,2011,https://payne-park.com,Support wait quite stay line.,10,payne-park,2023,USD,737016,153363,583653,151572,432081,0,432081,7370,14740,417341,50034,546957,156502,390455,,737016,250.92,947.32,0.089,291,210.9,24939.59,2.01,0.7919
7930,Young-Hancock,False,AU,North Jasonberg,AI/ML,2013,https://young-hancock.com,Consumer hospital end coach author under simple what clear water.,22,young-hancock,2023,USD,1866863,478214,1388649,896249,492400,37590,454810,18668,37337,417473,279186,1363679,1066088,297591,,1866863,761.47,3898.99,0.0711,7778,20.0,99831.32,2.8,0.7438
7931,Reynolds Sanders and Le,False,DE,Janeton,Energy,2009,https://reynoldssandersandle.com,Morning nature actually theory sure marriage.,18,reynolds-sanders-and-le,2023,EUR,460398,168904,291494,82634,208860,14264,194596,4603,9207,185389,166785,576442,256956,319486,,460398,201.45,240.1,0.0423,157,243.4,1000.0,166.78,0.6331
7932,Harris-Flores,False,FR,Rachelport,SaaS,2023,https://harris-flores.com,Per worry animal customer between employee owner remember season.,17,harris-flores,2023,EUR,2576107,479310,2096797,987610,1109187,0,1109187,25761,51522,1057665,184115,1571516,78575,1492941,214675.58,2576107,40.72,40.72,0.0433,3705,57.93,75967.76,2.42,0.8139
7933,Mcdaniel Chen and Johnson,False,FR,Dayhaven,HealthTech,2020,https://mcdanielchenandjohnson.com,Bill common fast must institution PM surface.,22,mcdaniel-chen-and-johnson,2023,EUR,355328,117234,238094,272878,-34784,12826,-47610,3553,7106,-54716,6475,319330,141026,178304,29610.67,355328,10.0,25.49,0.001,399,74.17,18727.41,0.35,0.6701
7934,Guerra Swanson and Kaufman,False,FR,Kimberlyberg,E-commerce,2015,https://guerraswansonandkaufman.com,Account difference marriage important since must account direction.,21,guerra-swanson-and-kaufman,2023,EUR,639393,271584,367809,540169,-172360,15006,-187366,6393,12787,-200153,97856,577893,180536,397357,,639393,393.7,499.79,0.001,2664,20.0,47282.43,2.07,0.5752
7935,Henderson-Edwards,False,NG,Joshuachester,Marketplaces,2013,https://henderson-edwards.com,Receive provide fund everybody treatment friend approach building quality than baby.,18,henderson-edwards,2023,USD,3982017,924921,3057096,1487498,1569598,0,1569598,39820,79640,1489958,812188,2858861,1126407,1732454,,3982017,20.0,28.26,0.0399,1020,325.32,123586.78,6.57,0.7677
7936,Griffin Williams and Harris,False,ZA,Port Bridget,Fintech,2023,https://griffinwilliamsandharris.com,Back get likely throughout east maintain.,28,griffin-williams-and-harris,2023,USD,889262,240227,649035,495594,153441,0,153441,8892,17785,135656,245457,888469,470543,417926,,889262,20.0,104.66,0.0512,1011,73.27,21210.07,11.57,0.7299
7937,Owens and Sons,False,BR,New Theresa,Marketplaces,2021,https://owensandsons.com,Painting identify piece reveal.,20,owens-and-sons,2023,USD,812001,401393,410608,90263,320345,0,320345,8120,16240,304105,40637,633861,445509,188352,,812001,54.98,274.62,0.02,2726,24.82,1000.0,40.64,0.5057
7938,Crawford LLC,False,ZA,New Lindsey,AgriTech,2016,https://crawfordllc.com,Call debate wide activity view never house move carry land after.,17,crawford-llc,2023,USD,935274,324997,610277,303875,306402,23065,283337,9352,18705,264632,53177,529307,151265,378042,,935274,1375.07,10314.92,0.0654,299,260.44,15210.74,3.5,0.6525
7939,Cannon PLC,False,AU,East Justinhaven,Energy,2023,https://cannonplc.com,Somebody always leave trade establish loss sort good.,18,cannon-plc,2023,USD,2219055,794657,1424398,147785,1276613,21518,1255095,22190,44381,1210714,297820,1575113,1347619,227494,,2219055,881.37,3175.24,0.0232,4681,39.5,42822.27,6.95,0.6419
7940,Marsh and Sons,False,DE,Port Edward,E-commerce,2022,https://marshandsons.com,Doctor represent them ground build set nation.,15,marsh-and-sons,2023,EUR,1128245,259881,868364,442407,425957,30958,394999,11282,22564,372435,64404,788473,390873,397600,,1128245,20.0,51.66,0.0387,703,133.71,24404.85,2.64,0.7697
7941,Campos-Berg,False,AU,Williammouth,AgriTech,2012,https://campos-berg.com,Worker environment usually trade wall TV either.,16,campos-berg,2023,USD,108039,39535,68504,45627,22877,13014,9863,1080,2160,7703,17800,150315,35737,114578,,108039,1240.27,5616.5,0.0279,114,78.92,27978.34,0.64,0.6341
7942,Small Garner and Lane,False,GB,Hansenhaven,EdTech,2014,https://smallgarnerandlane.com,Soon law clear whole themselves whom.,25,small-garner-and-lane,2023,USD,2713177,1635413,1077764,1719999,-642235,0,-642235,27131,54263,-696498,233484,1673377,497576,1175801,226098.08,2713177,130.7,540.77,0.0167,4422,51.12,181557.58,1.29,0.3972
7943,Miranda Group,False,ZA,Chloeshire,HealthTech,2012,https://mirandagroup.com,Song choice star word opportunity article strategy long young.,20,miranda-group,2023,USD,1403958,193807,1210151,942411,267740,16120,251620,14039,28079,223541,9442,790666,307719,482947,116996.5,1403958,648.0,1662.51,0.0597,3101,37.72,103233.81,0.09,0.862
7944,Hardin Wright and Stout,False,GB,Marissaport,Cybersecurity,2024,https://hardinwrightandstout.com,Role test enjoy blue I order maintain travel.,18,hardin-wright-and-stout,2023,USD,946626,545213,401413,662281,-260868,13695,-274563,9466,18932,-293495,14111,516929,250493,266436,,946626,20.0,37.97,0.0693,1635,48.22,10774.04,1.31,0.424
7945,Clark King and Baker,False,US,Katherinestad,Marketplaces,2011,https://clarkkingandbaker.com,Data bring too notice laugh want air certain everyone manage.,26,clark-king-and-baker,2023,USD,1356844,461791,895053,330021,565032,0,565032,13568,27136,537896,78103,758445,349966,408479,,1356844,20.0,57.94,0.1104,5653,20.0,47303.57,1.65,0.6597
7946,Mendez-Williams,False,AU,Morganland,IoT,2017,https://mendez-williams.com,Girl crime hair pick early particular all style.,28,mendez-williams,2023,USD,616840,130486,486354,426578,59776,43919,15857,6168,12336,3521,71715,482963,227822,255141,,616840,603.93,3830.81,0.0208,157,325.73,24041.16,2.98,0.7885
7947,Dunn Ramsey and Gillespie,False,IN,Westfurt,HealthTech,2019,https://dunnramseyandgillespie.com,Animal both performance level try stay claim stand.,22,dunn-ramsey-and-gillespie,2023,USD,1839639,214551,1625088,1321065,304023,29581,274442,18396,36792,237650,35297,976056,461363,514693,153303.25,1839639,446.04,2814.34,0.0219,5782,26.51,141990.92,0.25,0.8834
7948,Adams Norman and Anderson,False,NG,Edwardston,Marketplaces,2012,https://adamsnormanandanderson.com,Reduce wall among describe Mr thought.,13,adams-norman-and-anderson,2023,USD,2922361,940734,1981627,146118,1835509,0,1835509,29223,58447,1777062,163931,1664533,869004,795529,,2922361,2416.84,8178.96,0.0483,1203,202.32,52966.41,3.09,0.6781
7949,Pope-Jones,False,ZA,Juliemouth,Marketplaces,2013,https://pope-jones.com,Relate left present include look where.,14,pope-jones,2023,USD,1399948,512188,887760,1331100,-443340,12678,-456018,13999,27998,-484016,50454,798848,425657,373191,,1399948,20.0,10.0,0.0099,1459,79.94,107859.69,0.47,0.6341
7950,Hill Inc,False,GB,West Kelly,Cybersecurity,2019,https://hillinc.com,Yeah manage suffer gas step simply executive.,22,hill-inc,2023,USD,1566813,681108,885705,592671,293034,0,293034,15668,31336,261698,153060,1121175,546655,574520,,1566813,1420.55,894.44,0.0595,1157,112.82,41861.0,3.66,0.5653
7951,Vasquez Group,False,TN,Cynthiaport,SaaS,2020,https://vasquezgroup.com,Themselves research order rule budget someone that person.,24,vasquez-group,2023,USD,2173090,1160669,1012421,917865,94556,23207,71349,21730,43461,27888,68171,1343864,343197,1000667,181090.83,2173090,740.46,3653.76,0.0282,3368,53.76,57419.98,1.19,0.4659
7952,Harper Smith and Long,False,GB,Lake Benjaminburgh,IoT,2018,https://harpersmithandlong.com,Have gas themselves entire in their.,24,harper-smith-and-long,2023,USD,479359,235642,243717,141784,101933,0,101933,4793,9587,92346,5565,284031,194552,89479,,479359,801.65,1793.13,0.0426,316,126.32,1000.0,5.56,0.5084
7953,Dunn Group,False,DE,West Gwendolynport,E-commerce,2009,https://dunngroup.com,Catch recently project require stay character person since.,21,dunn-group,2023,EUR,1478717,350896,1127821,487635,640186,662,639524,14787,29574,609950,207766,1068172,53408,1014764,,1478717,897.01,1021.37,0.001,6161,20.0,51219.69,4.06,0.7627
7954,Hahn Keller and Phillips,False,TN,Port Randyberg,EdTech,2023,https://hahnkellerandphillips.com,Approach land sing town scene benefit ahead force cause while.,14,hahn-keller-and-phillips,2023,USD,110573,38071,72502,55496,17006,0,17006,1105,2211,14795,11494,124189,26720,97469,9214.42,110573,10.0,36.37,0.0738,216,42.63,1000.0,11.49,0.6557
7955,Moreno LLC,False,AU,Lake Christine,EdTech,2010,https://morenollc.com,There else outside central open inside situation.,16,moreno-llc,2023,USD,532835,302453,230382,162122,68260,2939,65321,5328,10656,54665,2318,442152,84599,357553,44402.92,532835,107.28,208.0,0.023,1198,37.05,29431.49,0.08,0.4324
7956,Lowery Carr and Sanchez,False,BR,North Rhonda,Fintech,2009,https://lowerycarrandsanchez.com,Food job stop hour break.,15,lowery-carr-and-sanchez,2023,USD,414906,151422,263484,184456,79028,12868,66160,4149,8298,57862,32956,316471,79593,236878,,414906,20.0,67.03,0.0184,134,256.66,4703.36,7.01,0.635
7957,Bailey and Sons,False,IN,Port Jack,Energy,2023,https://baileyandsons.com,Wall matter follow if determine pick attack lot carry.,20,bailey-and-sons,2023,USD,3841300,1667235,2174065,2625422,-451357,318,-451675,38413,76826,-528501,517855,2575398,1017174,1558224,,3841300,20.0,68.84,0.0429,16005,20.0,194749.27,2.66,0.566
7958,Davis Matthews and Conrad,False,IN,Garciamouth,Fintech,2015,https://davismatthewsandconrad.com,Shoulder outside pay evidence task reveal hundred stand hair.,23,davis-matthews-and-conrad,2023,USD,896935,441566,455369,187663,267706,15214,252492,8969,17938,234554,115230,684718,290794,393924,,896935,20.0,82.85,0.087,3737,20.0,1000.0,115.23,0.5077
7959,Kelley-Smith,False,US,Port Ann,Mobility,2018,https://kelley-smith.com,Executive use red with consider weight training.,22,kelley-smith,2023,USD,2396206,889082,1507124,2633192,-1126068,13510,-1139578,23962,47924,-1187502,116539,1406864,284371,1122493,,2396206,20.0,54.97,0.0245,4275,46.7,245054.28,0.48,0.629
7960,Hernandez LLC,False,DE,Stevenmouth,AI/ML,2017,https://hernandezllc.com,Service laugh movement speech ready modern.,19,hernandez-llc,2023,EUR,848658,438640,410018,159011,251007,0,251007,8486,16973,234034,23717,588174,49242,538932,,848658,369.72,1223.71,0.0716,449,157.23,32907.85,0.72,0.4831
7961,Davis Hahn and Horn,False,AU,Cherryville,Fintech,2018,https://davishahnandhorn.com,Box figure oil election east direction behind.,17,davis-hahn-and-horn,2023,USD,119897,30915,88982,111045,-22063,0,-22063,1198,2397,-24460,6948,233986,130341,103645,,119897,20.0,33.92,0.0171,106,93.75,46920.72,0.15,0.7422
7962,Gonzalez and Sons,False,GB,North Miguel,SaaS,2010,https://gonzalezandsons.com,Third whether treatment bring hard.,19,gonzalez-and-sons,2023,USD,624404,270086,354318,462815,-108497,5914,-114411,6244,12488,-126899,20457,420359,126432,293927,52033.67,624404,144.9,973.04,0.0492,2710,19.2,31847.77,0.64,0.5674
7963,Pena LLC,False,DE,Lloydside,Energy,2013,https://penallc.com,Traditional win often wish agency.,18,pena-llc,2023,EUR,189736,44119,145617,56354,89263,0,89263,1897,3794,85469,12165,128777,19069,109708,,189736,565.06,370.69,0.0742,155,101.77,31946.56,0.38,0.7675
7964,Cohen Navarro and Davidson,False,TN,Masonport,Marketplaces,2009,https://cohennavarroanddavidson.com,News party scientist economic major it.,24,cohen-navarro-and-davidson,2023,USD,463479,158794,304685,219656,85029,50528,34501,4634,9269,25232,63253,377140,238045,139095,,463479,20.0,37.18,0.0976,311,123.87,17610.22,3.59,0.6574
7965,Forbes-Brooks,False,NG,Sharonville,AgriTech,2020,https://forbes-brooks.com,Economic book person rather student bed usually.,16,forbes-brooks,2023,USD,430085,239215,190870,130712,60158,0,60158,4300,8601,51557,14254,307614,125136,182478,,430085,20.0,52.01,0.0872,213,167.95,5961.82,2.39,0.4438
7966,Alvarez-Jarvis,False,DE,North Patrick,IoT,2023,https://alvarez-jarvis.com,Action control public before not organization however do physical.,17,alvarez-jarvis,2023,EUR,450969,182191,268778,268471,307,27665,-27358,4509,9019,-36377,3156,408931,98736,310195,,450969,20.0,80.81,0.0634,691,54.37,42658.14,0.07,0.596
7967,Vazquez Prince and Perkins,False,BR,East Robert,E-commerce,2020,https://vazquezprinceandperkins.com,State can moment marriage century central night box civil recent.,22,vazquez-prince-and-perkins,2023,USD,1821469,699553,1121916,1359521,-237605,0,-237605,18214,36429,-274034,141784,1165014,165366,999648,,1821469,20.0,59.43,0.0638,491,308.61,69639.4,2.04,0.6159
7968,Mann-Vang,False,FR,Kevinstad,E-commerce,2016,https://mann-vang.com,Together upon quality anything pressure you weight.,18,mann-vang,2023,EUR,1176788,392337,784451,755546,28905,0,28905,11767,23535,5370,56341,745900,250658,495242,,1176788,20.0,55.31,0.0929,865,113.3,68727.64,0.82,0.6666
7969,Mathis-Washington,False,AU,New Michael,Mobility,2009,https://mathis-washington.com,Laugh series though turn edge yeah show create skin couple.,17,mathis-washington,2023,USD,913469,197995,715474,621520,93954,0,93954,9134,18269,75685,20201,546867,374357,172510,,913469,20.0,78.07,0.1389,906,83.96,63201.99,0.32,0.7832
7970,Wallace Graham and Jones,False,CA,Lake Stevenstad,E-commerce,2016,https://wallacegrahamandjones.com,Let school camera attack development alone nature industry.,22,wallace-graham-and-jones,2023,USD,1060985,180403,880582,196308,684274,0,684274,10609,21219,663055,54068,706975,189822,517153,,1060985,20.0,62.08,0.0363,870,101.62,35600.8,1.52,0.83
7971,Campbell-Robles,False,KE,Robertborough,Fintech,2013,https://campbell-robles.com,Physical manager country office travel.,24,campbell-robles,2023,USD,1177592,444577,733015,707604,25411,10510,14901,11775,23551,-8650,27124,651089,32554,618535,,1177592,604.29,1985.0,0.001,988,99.23,81873.0,0.33,0.6225
7972,Juarez-Bond,False,BR,Brooksmouth,Marketplaces,2010,https://juarez-bond.com,Teach sure international run response study.,21,juarez-bond,2023,USD,456944,173272,283672,27081,256591,0,256591,4569,9138,247453,9779,333555,40889,292666,,456944,20.0,35.23,0.0759,1224,31.1,1000.0,9.78,0.6208
7973,Lewis-Miller,False,CA,Lake Stacy,Fintech,2021,https://lewis-miller.com,Serve picture agent black occur economic size safe officer hear.,14,lewis-miller,2023,USD,827681,67264,760417,157622,602795,16769,586026,8276,16553,569473,42550,630886,146097,484789,,827681,155.85,744.05,0.085,302,227.76,1000.0,42.55,0.9187
7974,Harrington-Drake,False,ZA,West Gina,AgriTech,2010,https://harrington-drake.com,Statement human represent community war actually prove.,25,harrington-drake,2023,USD,29573,14358,15215,15580,-365,0,-365,295,591,-956,20267,133713,54090,79623,,29573,20.0,69.62,0.001,123,20.0,3443.75,5.89,0.5145
7975,Benjamin-Alexander,False,FR,East William,IoT,2018,https://benjamin-alexander.com,Sign whom challenge simple open.,12,benjamin-alexander,2023,EUR,147230,62401,84829,43488,41341,5717,35624,1472,2944,32680,20241,141659,124041,17618,,147230,755.67,2294.65,0.0949,613,20.0,66229.72,0.31,0.5762
7976,Hurst Brock and Wallace,False,CA,Martinezfort,Energy,2016,https://hurstbrockandwallace.com,Reduce college research president since rather certainly cup seven.,16,hurst-brock-and-wallace,2023,USD,1359409,713640,645769,732908,-87139,10569,-97708,13594,27188,-124896,42739,860507,85166,775341,,1359409,97.16,48.58,0.138,1141,99.25,17824.58,2.4,0.475
7977,Thompson Group,False,US,Ryanfort,IoT,2010,https://thompsongroup.com,Idea oil shake coach assume action environmental since eye.,25,thompson-group,2023,USD,488887,205552,283335,123891,159444,7401,152043,4888,9777,142266,96471,346950,87852,259098,,488887,1287.34,1822.46,0.029,2037,20.0,11909.85,8.1,0.5796
7978,Roberts PLC,False,KE,Melissaville,Cybersecurity,2020,https://robertsplc.com,Realize family Democrat lose participant true production study coach.,16,roberts-plc,2023,USD,1212713,270180,942533,628664,313869,0,313869,12127,24254,289615,41359,760368,383965,376403,,1212713,20.0,42.22,0.1144,5052,20.0,55319.87,0.75,0.7772
7979,Brown Miller and Diaz,False,KE,Port Patrick,EdTech,2018,https://brownmilleranddiaz.com,Foot purpose I child.,26,brown-miller-and-diaz,2023,USD,108840,19285,89555,69657,19898,15753,4145,1088,2176,1969,6865,159509,7975,151534,9070.0,108840,10.0,28.57,0.0411,334,27.09,1000.0,6.86,0.8228
7980,Sanchez West and Perez,False,EG,Stevenstad,AI/ML,2023,https://sanchezwestandperez.com,Energy quickly information surface campaign cause trial quickly camera for.,20,sanchez-west-and-perez,2023,USD,1436175,608245,827930,1031607,-203677,0,-203677,14361,28723,-232400,99055,982803,49140,933663,,1436175,589.03,2883.97,0.001,339,352.17,63434.37,1.56,0.5765
7981,Dixon Ltd,False,CA,West Danielside,HealthTech,2009,https://dixonltd.com,Two bill already stand tough social.,22,dixon-ltd,2023,USD,377793,159854,217939,182094,35845,3183,32662,3777,7555,25107,63040,347385,74931,272454,31482.75,377793,201.05,651.37,0.0478,1166,26.99,1000.0,63.04,0.5769
7982,Rush PLC,False,EG,Carolville,SaaS,2012,https://rushplc.com,Middle along four song organization send when.,17,rush-plc,2023,USD,667184,193621,473563,170663,302900,20820,282080,6671,13343,268737,49643,421568,142725,278843,55598.67,667184,345.29,706.61,0.0664,4426,12.56,16205.19,3.06,0.7098
7983,Campbell-Petersen,False,US,Stoutland,AgriTech,2013,https://campbell-petersen.com,Three movement pressure more occur beyond.,19,campbell-petersen,2023,USD,166488,62206,104282,72754,31528,26927,4601,1664,3329,1272,5785,121287,87268,34019,,166488,122.03,438.96,0.0091,39,350.94,1000.0,5.78,0.6264
7984,Roberts and Sons,False,TN,Carolland,HealthTech,2008,https://robertsandsons.com,Yard produce number figure policy public use center.,17,roberts-and-sons,2023,USD,903075,300479,602596,453258,149338,0,149338,9030,18061,131277,9286,526428,74068,452360,75256.25,903075,172.64,1134.8,0.0236,4808,15.65,15200.44,0.61,0.6673
7985,Parker Inc,False,FR,Port Brandibury,IoT,2023,https://parkerinc.com,Health production mind growth dog three side suddenly letter.,22,parker-inc,2023,EUR,119996,33468,86528,87445,-917,9328,-10245,1199,2399,-12644,36631,118888,23853,95035,,119996,768.21,1461.92,0.1158,36,276.97,18319.24,2.0,0.7211
7986,Gibbs Inc,False,FR,East Destinyberg,HealthTech,2010,https://gibbsinc.com,Page she Democrat consumer street conference amount protect behavior business.,19,gibbs-inc,2023,EUR,931911,543400,388511,653463,-264952,0,-264952,9319,18638,-283590,9575,593056,83710,509346,77659.25,931911,755.34,4009.58,0.0533,1947,39.87,44270.41,0.22,0.4169
7987,Hatfield PLC,False,GB,Michaelchester,AgriTech,2010,https://hatfieldplc.com,Single good food million quickly man our rise.,26,hatfield-plc,2023,USD,239787,40690,199097,96058,103039,0,103039,2397,4795,98244,24962,177622,46067,131555,,239787,20.0,126.76,0.077,83,239.29,1000.0,24.96,0.8303
7988,Reyes PLC,False,DE,Gayton,IoT,2015,https://reyesplc.com,Bad wife tree ok company policy.,21,reyes-plc,2023,EUR,975723,402722,573001,193452,379549,47806,331743,9757,19514,312229,9280,511891,246245,265646,,975723,20.0,49.62,0.001,918,88.48,1000.0,9.28,0.5873
7989,Snyder Mcbride and Wood,False,AU,North Karla,Cybersecurity,2021,https://snydermcbrideandwood.com,Laugh story news fire able hot just husband people pay.,24,snyder-mcbride-and-wood,2023,USD,374483,152265,222218,192632,29586,0,29586,3744,7489,22097,130440,393539,118454,275085,,374483,154.13,77.06,0.0341,505,61.77,11292.23,11.55,0.5934
7990,Brown-Trevino,False,KE,Port Michelle,Energy,2022,https://brown-trevino.com,Might raise more control civil least.,27,brown-trevino,2023,USD,904153,220583,683570,587731,95839,25360,70479,9041,18083,52396,41294,548988,194473,354515,,904153,479.29,1278.65,0.0176,255,294.83,73449.78,0.56,0.756
7991,Nelson Johnston and Walter,False,NG,East Kathy,IoT,2022,https://nelsonjohnstonandwalter.com,Adult drive food feeling must.,14,nelson-johnston-and-walter,2023,USD,2760043,503663,2256380,2342068,-85688,0,-85688,27600,55200,-140888,72190,1459013,752801,706212,,2760043,668.73,2621.9,0.0467,1580,145.53,201622.14,0.36,0.8175
7992,Strong PLC,False,TN,North Jenniferville,SaaS,2024,https://strongplc.com,Remain smile air shoulder young likely.,19,strong-plc,2023,USD,1721210,521644,1199566,798849,400717,0,400717,17212,34424,366293,50680,1033197,339809,693388,143434.17,1721210,141.5,824.92,0.001,28686,5.0,87622.04,0.58,0.6969
7993,Clark Roman and Walker,False,EG,Robertstad,EdTech,2010,https://clarkromanandwalker.com,Hot type range camera specific actually everybody student prepare.,25,clark-roman-and-walker,2023,USD,1155209,411536,743673,361804,381869,26147,355722,11552,23104,332618,180081,908586,438998,469588,96267.42,1155209,674.33,4857.83,0.001,1709,56.3,60181.76,2.99,0.6438
7994,Castaneda-Owen,False,GB,Jasminechester,Energy,2023,https://castaneda-owen.com,Budget spring enjoy note realize my why sound recently student.,25,castaneda-owen,2023,USD,1314171,230242,1083929,708820,375109,31460,343649,13141,26283,317366,81377,811468,495608,315860,,1314171,20.0,10.0,0.0042,5475,20.0,74908.34,1.09,0.8248
7995,Richards-Ho,False,EG,Annaton,EdTech,2010,https://richards-ho.com,Case old it fly.,19,richards-ho,2023,USD,811719,415760,395959,627610,-231651,0,-231651,8117,16234,-247885,228574,687525,335452,352073,67643.25,811719,10.0,42.54,0.001,1913,35.35,53769.58,4.25,0.4878
7996,Young-Lee,False,AU,West Kelly,IoT,2013,https://young-lee.com,Republican until two style candidate travel world create task organization increase.,17,young-lee,2023,USD,893300,405577,487723,489914,-2191,36688,-38879,8933,17866,-56745,50742,539233,254621,284612,,893300,401.29,1667.96,0.001,450,165.29,16531.58,3.07,0.546
7997,Carter LLC,False,GB,Danielleshire,Mobility,2020,https://carterllc.com,Capital everybody each prevent voice.,29,carter-llc,2023,USD,4982457,1815745,3166712,4113355,-946643,0,-946643,49824,99649,-1046292,1054173,3552537,340971,3211566,,4982457,572.38,2458.86,0.1099,20760,20.0,344758.93,3.06,0.6356
7998,Ross Soto and Thompson,False,BR,Singhstad,SaaS,2022,https://rosssotoandthompson.com,Different road fish represent fast.,10,ross-soto-and-thompson,2023,USD,911206,187249,723957,308258,415699,24958,390741,9112,18224,372517,16425,609344,414470,194874,75933.83,911206,133.64,1066.19,0.0387,6026,12.6,50122.48,0.33,0.7945
7999,Johnson Prince and Hernandez,False,CA,Jonesstad,Cybersecurity,2024,https://johnsonprinceandhernandez.com,Your now remember how vote theory security understand.,21,johnson-prince-and-hernandez,2023,USD,622697,214651,408046,155270,252776,0,252776,6226,12453,240323,18899,482233,24111,458122,,622697,20.0,76.99,0.0239,2594,20.0,23576.8,0.8,0.6553
8000,Herman-Wright,False,NG,Robinsonville,IoT,2023,https://herman-wright.com,Local as candidate into pass moment door TV.,25,herman-wright,2023,USD,133903,28973,104930,53151,51779,29581,22198,1339,2678,19520,7411,139132,12496,126636,,133903,20.0,14.94,0.0919,85,131.14,23379.9,0.32,0.7836
8001,Leon-Williams,False,BR,Heatherbury,AI/ML,2021,https://leon-williams.com,Many arm fill her reflect.,16,leon-williams,2023,USD,346646,92058,254588,45997,208591,0,208591,3466,6932,201659,13794,263352,76300,187052,,346646,1471.14,3882.21,0.001,228,126.59,1000.0,13.79,0.7344
8002,White Group,False,CA,South Briannafort,EdTech,2014,https://whitegroup.com,Than beyond quite reality situation time.,17,white-group,2023,USD,645579,265462,380117,420890,-40773,6857,-47630,6455,12911,-60541,27895,392219,19610,372609,53798.25,645579,10.0,10.0,0.0501,1127,47.72,53147.16,0.52,0.5888
8003,Benson Inc,False,BR,Johnland,Marketplaces,2017,https://bensoninc.com,Church short but responsibility fine interview.,24,benson-inc,2023,USD,183703,39212,144491,56787,87704,12095,75609,1837,3674,71935,5025,137235,6861,130374,,183703,844.95,1745.22,0.001,765,20.0,1000.0,5.03,0.7865
8004,House Alexander and Mathis,False,DE,West Joanbury,Fintech,2010,https://housealexanderandmathis.com,Kid assume mother trouble bank science already maintain stage.,18,house-alexander-and-mathis,2023,EUR,3237253,856401,2380852,1227629,1153223,0,1153223,32372,64745,1088478,558878,2184362,1043013,1141349,,3237253,908.19,5033.23,0.0895,13488,20.0,133547.64,4.18,0.7355
8005,Shelton-Savage,False,BR,Lake Jeanne,Energy,2018,https://shelton-savage.com,Accept short TV this bank century sea until need.,27,shelton-savage,2023,USD,3238664,891147,2347517,1333221,1014296,0,1014296,32386,64773,949523,127882,1850365,873232,977133,,3238664,1048.26,634.69,0.0127,7611,35.46,118112.22,1.08,0.7248
8006,Ross and Sons,False,IN,South Melissa,EdTech,2008,https://rossandsons.com,Then present always great as increase significant apply family dinner chair.,32,ross-and-sons,2023,USD,307781,106325,201456,145296,56160,41932,14228,3077,6155,8073,2092,218413,144425,73988,25648.42,307781,159.16,936.41,0.0561,276,92.75,26354.19,0.08,0.6545
8007,Flynn and Sons,False,NG,East Nathan,Marketplaces,2018,https://flynnandsons.com,Century staff within operation region.,31,flynn-and-sons,2023,USD,565107,198034,367073,309582,57491,0,57491,5651,11302,46189,25870,398420,170070,228350,,565107,378.05,1594.51,0.069,2354,20.0,17098.65,1.51,0.6496
8008,Mullen LLC,False,GB,South Stuartshire,EdTech,2011,https://mullenllc.com,Us once front truth school style by chair cell audience.,21,mullen-llc,2023,USD,531910,253258,278652,156850,121802,28987,92815,5319,10638,82177,24817,477877,104372,373505,44325.83,531910,10.0,48.29,0.0374,1200,36.92,24685.71,1.01,0.5239
8009,Brown LLC,False,GB,West Juliefurt,SaaS,2013,https://brownllc.com,Ever newspaper baby visit between blood economic.,26,brown-llc,2023,USD,1988895,699568,1289327,1349454,-60127,26056,-86183,19888,39777,-125960,33235,1212086,301295,910791,165741.25,1988895,387.98,1496.23,0.0288,9061,18.29,103542.14,0.32,0.6483
8010,Perez Burke and Mejia,False,FR,Lake Christinaland,IoT,2010,https://perezburkeandmejia.com,Mouth word wait past necessary performance.,22,perez-burke-and-mejia,2023,EUR,203647,68474,135173,86889,48284,17164,31120,2036,4072,27048,10116,132062,38399,93663,,203647,20.0,37.58,0.001,93,181.34,22737.59,0.44,0.6638
8011,Beck Bradley and Underwood,False,CA,Hannahhaven,SaaS,2019,https://beckbradleyandunderwood.com,Cost around something democratic notice.,21,beck-bradley-and-underwood,2023,USD,1896460,635670,1260790,809826,450964,0,450964,18964,37929,413035,103591,1212860,278042,934818,158038.33,1896460,265.61,840.67,0.1079,7249,21.8,84089.88,1.23,0.6648
8012,Thomas Sullivan and Foley,False,EG,Leonburgh,Energy,2016,https://thomassullivanandfoley.com,Dinner store analysis card strong baby usually.,18,thomas-sullivan-and-foley,2023,USD,227815,113606,114209,146763,-32554,0,-32554,2278,4556,-37110,11612,169105,56797,112308,,227815,461.61,1919.51,0.1472,60,314.63,1000.0,11.61,0.5013
8013,Contreras Rodriguez and Campbell,False,IN,Barrettfurt,IoT,2022,https://contrerasrodriguezandcampbell.com,Fall beautiful operation place officer partner minute security.,22,contreras-rodriguez-and-campbell,2023,USD,42812,15475,27337,26659,678,0,678,428,856,-178,16662,189589,115912,73677,,42812,20.0,90.04,0.0387,101,35.24,1000.0,16.66,0.6385
8014,Livingston Garcia and Thompson,False,AU,Wilsonmouth,AgriTech,2023,https://livingstongarciaandthompson.com,Become center right glass already.,24,livingston-garcia-and-thompson,2023,USD,796969,259422,537547,249808,287739,2490,285249,7969,15939,269310,24018,541199,112642,428557,,796969,1186.07,1524.6,0.0464,3320,20.0,12640.02,1.9,0.6745
8015,Brooks-Lozano,False,US,Williamside,Cybersecurity,2009,https://brooks-lozano.com,Difference statement civil space environmental heart region.,24,brooks-lozano,2023,USD,1144402,465239,679163,635344,43819,0,43819,11444,22888,20931,472612,1228651,152347,1076304,,1144402,20.0,54.1,0.001,315,301.83,67805.67,6.97,0.5935
8016,Howard-Wilson,False,US,Clarkside,HealthTech,2021,https://howard-wilson.com,Business building keep clear seat item natural.,24,howard-wilson,2023,USD,1804596,892734,911862,1486061,-574199,0,-574199,18045,36091,-610290,244488,1301240,1026901,274339,150383.0,1804596,461.74,1384.94,0.0827,30076,5.0,116452.7,2.1,0.5053
8017,Mcclain Rodriguez and Mills,False,NG,Avilaside,Mobility,2020,https://mcclainrodriguezandmills.com,He current security admit more total race wear identify deal.,21,mcclain-rodriguez-and-mills,2023,USD,1553094,403683,1149411,466332,683079,0,683079,15530,31061,652018,40141,1002531,208084,794447,,1553094,20.0,47.08,0.0177,335,386.3,26095.74,1.54,0.7401
8018,Rogers-Munoz,False,IN,Lake Stevenport,AgriTech,2021,https://rogers-munoz.com,Indeed eat rock treatment involve discussion doctor with.,22,rogers-munoz,2023,USD,187356,111993,75363,69141,6222,2831,3391,1873,3747,-356,27474,300918,179403,121515,,187356,894.36,3936.77,0.0764,120,129.63,1000.0,27.47,0.4022
8019,Arias LLC,False,EG,Emilyborough,Energy,2017,https://ariasllc.com,Person sign what enough figure news ready gun study individual.,16,arias-llc,2023,USD,684111,325850,358261,561400,-203139,26319,-229458,6841,13682,-243140,28990,414342,36654,377688,,684111,1112.15,4891.52,0.0814,589,96.63,92218.93,0.31,0.5237
8020,Parker-Moran,False,KE,Kathleenton,Mobility,2022,https://parker-moran.com,Home camera fight watch.,16,parker-moran,2023,USD,4055554,1075939,2979615,2730306,249309,27717,221592,40555,81111,140481,135105,2356550,641472,1715078,,4055554,300.35,514.68,0.1022,3015,112.08,253742.07,0.53,0.7347
8021,Johnson Burke and White,False,IN,North Thomaston,Fintech,2021,https://johnsonburkeandwhite.com,Capital process force recently whatever everyone skin save.,20,johnson-burke-and-white,2023,USD,3177918,1257905,1920013,1217694,702319,22550,679769,31779,63558,616211,169062,1875483,624252,1251231,,3177918,20.0,31.16,0.0699,13241,20.0,85691.2,1.97,0.6042
8022,Gibbs Group,False,DE,Blackwellshire,Energy,2019,https://gibbsgroup.com,Week talk church health experience still four onto skill continue exist.,22,gibbs-group,2023,EUR,631852,223939,407913,130063,277850,11371,266479,6318,12637,253842,8533,331992,246549,85443,,631852,1375.38,1156.07,0.0073,255,205.87,1000.0,8.53,0.6456
8023,Thomas-Christian,False,TN,South Stephanie,Cybersecurity,2009,https://thomas-christian.com,Push new east glass send school bring wrong interesting two pick.,16,thomas-christian,2023,USD,375742,129917,245825,150735,95090,7734,87356,3757,7514,79842,42790,387492,19374,368118,,375742,302.04,726.11,0.0268,958,32.67,14677.29,2.92,0.6542
8024,Miller Dunn and Shepard,False,IN,Meyertown,E-commerce,2009,https://millerdunnandshepard.com,Learn Democrat condition open quality hope reduce state allow.,20,miller-dunn-and-shepard,2023,USD,655830,156405,499425,398418,101007,16577,84430,6558,13116,71314,15119,368567,88101,280466,,655830,1629.97,1211.59,0.0466,2732,20.0,38346.68,0.39,0.7615
8025,Wall-Smith,False,US,Robertsbury,Energy,2015,https://wall-smith.com,Red must quite I carry amount maybe claim.,16,wall-smith,2023,USD,9869020,3068943,6800077,1203212,5596865,0,5596865,98690,197380,5399485,556509,5512665,1737534,3775131,,9869020,20.0,84.2,0.0329,41120,20.0,110651.24,5.03,0.689
8026,Atkinson Grant and Bailey,False,CA,Berrychester,E-commerce,2015,https://atkinsongrantandbailey.com,Suddenly push range ability green keep them cost particularly.,18,atkinson-grant-and-bailey,2023,USD,406149,163196,242953,99733,143220,13686,129534,4061,8122,121412,21513,302005,85942,216063,,406149,20.0,122.56,0.0965,1692,20.0,32089.92,0.67,0.5982
8027,Schroeder LLC,False,EG,Shawshire,EdTech,2009,https://schroederllc.com,War consider message apply phone trade future source.,31,schroeder-llc,2023,USD,238578,111020,127558,11928,115630,0,115630,2385,4771,110859,10723,218728,135735,82993,19881.5,238578,10.0,42.35,0.0738,589,33.72,1000.0,10.72,0.5347
8028,Chung Howe and Smith,False,KE,South Peter,Cybersecurity,2020,https://chunghoweandsmith.com,Finish among majority sure some.,27,chung-howe-and-smith,2023,USD,145157,34274,110883,45136,65747,19974,45773,1451,2903,42870,27750,219944,95534,124410,,145157,20.0,12.17,0.001,245,49.32,29801.35,0.93,0.7639
8029,Hartman Ltd,False,IN,East Kennethshire,IoT,2021,https://hartmanltd.com,Head training democratic free choice old plant indicate send.,25,hartman-ltd,2023,USD,1471701,696621,775080,486015,289065,8082,280983,14717,29434,251549,27404,841486,390530,450956,,1471701,471.05,1643.06,0.001,2579,47.55,22074.75,1.24,0.5267
8030,Thompson PLC,False,KE,Anthonystad,HealthTech,2022,https://thompsonplc.com,Such cold for stop federal process week rich food field.,31,thompson-plc,2023,USD,651722,274425,377297,139129,238168,0,238168,6517,13034,225134,42999,435258,196916,238342,54310.17,651722,10.0,31.97,0.0247,685,79.25,24272.9,1.77,0.5789
8031,Park-Reyes,False,EG,Lindseyland,Fintech,2011,https://park-reyes.com,Account upon door safe put doctor.,19,park-reyes,2023,USD,813063,338393,474670,205335,269335,21147,248188,8130,16261,231927,73023,485852,148796,337056,,813063,706.35,2150.54,0.0737,3387,20.0,13632.14,5.36,0.5838
8032,Holmes Lopez and King,False,BR,Rebeccahaven,IoT,2019,https://holmeslopezandking.com,Staff include one leader fill.,16,holmes-lopez-and-king,2023,USD,214240,60729,153511,36241,117270,0,117270,2142,4284,112986,17754,285735,37307,248428,,214240,64.7,383.23,0.0361,892,20.0,4884.26,3.63,0.7165
8033,Harrison LLC,False,GB,North Sharonland,IoT,2020,https://harrisonllc.com,Worry outside poor mean soon network really ago serve wear clearly.,26,harrison-llc,2023,USD,206343,92366,113977,83313,30664,4550,26114,2063,4126,21988,15924,295878,99638,196240,,206343,20.0,60.75,0.0682,334,51.4,40348.99,0.39,0.5524
8034,Johnson-Payne,False,DE,Darrellview,E-commerce,2014,https://johnson-payne.com,Already approach health doctor TV anything sea dark.,20,johnson-payne,2023,EUR,2322099,733384,1588715,1178440,410275,13745,396530,23220,46441,350089,72536,1398845,520366,878479,,2322099,784.9,2133.3,0.0454,9675,20.0,135002.2,0.54,0.6842
8035,Garcia Ltd,False,US,Sarahberg,Cybersecurity,2019,https://garcialtd.com,Far respond community response western until grow.,16,garcia-ltd,2023,USD,842249,429987,412262,230502,181760,33165,148595,8422,16844,131751,735313,1268298,913710,354588,,842249,621.93,3619.43,0.0687,3509,20.0,4226.25,173.99,0.4895
8036,Johns Richardson and Richard,False,KE,South Michael,Mobility,2008,https://johnsrichardsonandrichard.com,Home success in up speak water trade particularly hold.,16,johns-richardson-and-richard,2023,USD,436588,166861,269727,82889,186838,9733,177105,4365,8731,168374,9914,276033,80231,195802,,436588,1186.29,6768.0,0.0136,1819,20.0,1000.0,9.91,0.6178
8037,Acevedo Perez and Medina,False,GB,Foxview,E-commerce,2019,https://acevedoperezandmedina.com,Evidence scientist exist bad home many claim central likely.,16,acevedo-perez-and-medina,2023,USD,1554108,410253,1143855,80623,1063232,0,1063232,15541,31082,1032150,19214,922691,458557,464134,,1554108,20.0,10.0,0.0375,1193,108.49,30907.92,0.62,0.736
8038,Atkins-Jones,False,FR,Port Sarah,HealthTech,2024,https://atkins-jones.com,Fact place piece everyone.,19,atkins-jones,2023,EUR,489118,108913,380205,147795,232410,0,232410,4891,9782,222628,38303,387088,59058,328030,40759.83,489118,41.4,297.65,0.0366,8151,5.0,25935.37,1.48,0.7773
8039,Navarro-Cunningham,False,GB,Karenville,Mobility,2021,https://navarro-cunningham.com,Vote recently leg major Mrs.,26,navarro-cunningham,2023,USD,452649,224389,228260,319250,-90990,0,-90990,4526,9052,-100042,44132,339475,80440,259035,,452649,20.0,64.19,0.0681,550,68.51,6240.84,7.07,0.5043
8040,Smith Inc,False,BR,New Amberland,EdTech,2021,https://smithinc.com,Military who public oil range move commercial.,21,smith-inc,2023,USD,285771,107355,178416,77868,100548,0,100548,2857,5715,94833,4214,252520,89171,163349,23814.25,285771,16.65,45.59,0.0134,1559,15.27,19854.18,0.21,0.6243
8041,Jarvis-Harmon,False,IN,Simsport,EdTech,2010,https://jarvis-harmon.com,Day article government although out certainly turn.,18,jarvis-harmon,2023,USD,398199,153423,244776,180451,64325,47431,16894,3981,7963,8931,15900,372204,34016,338188,33183.25,398199,192.58,664.17,0.0511,306,108.4,13235.33,1.2,0.6147
8042,Rojas-Fernandez,False,CA,South Nicholasshire,IoT,2017,https://rojas-fernandez.com,Bag market check result create than.,17,rojas-fernandez,2023,USD,439523,120333,319190,308985,10205,716,9489,4395,8790,699,11056,359129,240281,118848,,439523,20.0,84.99,0.0745,173,210.7,38488.77,0.29,0.7262
8043,Wells-Ward,False,NG,Jenniferberg,IoT,2018,https://wells-ward.com,Course present interview stand window.,23,wells-ward,2023,USD,957227,572883,384344,352890,31454,2010,29444,9572,19144,10300,41465,541036,92299,448737,,957227,1258.0,629.0,0.0977,642,124.12,24922.93,1.66,0.4015
8044,Ware-Weaver,False,KE,Lake Keithview,Energy,2019,https://ware-weaver.com,Statement finish edge care strategy.,24,ware-weaver,2023,USD,517046,243281,273765,84075,189690,37841,151849,5170,10340,141509,85772,458398,249089,209309,,517046,1261.08,1521.6,0.0841,181,237.93,17023.96,5.04,0.5295
8045,Chandler Barnes and Thomas,False,IN,North Michael,Energy,2021,https://chandlerbarnesandthomas.com,But page democratic federal establish generation range you stuff.,19,chandler-barnes-and-thomas,2023,USD,3845679,1580532,2265147,2081957,183190,0,183190,38456,76913,106277,440068,2557440,830065,1727375,,3845679,692.83,2535.7,0.0566,3303,97.02,173674.75,2.53,0.589
8046,Miller Burke and Fritz,False,DE,New Daniel,AgriTech,2018,https://millerburkeandfritz.com,Network pressure sit woman.,16,miller-burke-and-fritz,2023,EUR,736122,263520,472602,228464,244138,20321,223817,7361,14722,209095,21013,543051,316721,226330,,736122,360.04,1869.17,0.0993,316,194.12,1000.0,21.01,0.642
8047,Mathis-Johnson,False,AU,North Robert,AgriTech,2017,https://mathis-johnson.com,Summer modern yeah reflect store travel wide.,16,mathis-johnson,2023,USD,4422912,2378495,2044417,1741885,302532,0,302532,44229,88458,214074,346263,2601072,1003399,1597673,,4422912,551.8,1662.32,0.0942,4618,79.8,160181.88,2.16,0.4622
8048,Lamb-Mendez,False,ZA,Taylormouth,EdTech,2017,https://lamb-mendez.com,Like common ask baby movie policy.,8,lamb-mendez,2023,USD,198584,93356,105228,73658,31570,0,31570,1985,3971,27599,4542,146581,54099,92482,16548.67,198584,323.9,1321.84,0.0431,174,94.72,1000.0,4.54,0.5299
8049,Lopez-Middleton,False,ZA,Natalieburgh,AgriTech,2010,https://lopez-middleton.com,Administration company when protect anyone remain state sister.,23,lopez-middleton,2023,USD,91510,32699,58811,21109,37702,14017,23685,915,1830,21855,16099,143198,88205,54993,,91510,204.72,504.49,0.0868,36,208.38,1000.0,16.1,0.6427
8050,Osborne Harrison and Watts,False,AU,Wilkinsland,AgriTech,2011,https://osborneharrisonandwatts.com,Leave a family test bed tree up act world.,28,osborne-harrison-and-watts,2023,USD,97305,36094,61211,77592,-16381,0,-16381,973,1946,-18327,78695,181364,41211,140153,,97305,20.0,67.96,0.0205,63,127.5,14251.69,5.52,0.6291
8051,Wilson Rowe and Brown,False,TN,North Garytown,IoT,2015,https://wilsonroweandbrown.com,Move south low lay each hard.,19,wilson-rowe-and-brown,2023,USD,1246567,568203,678364,211028,467336,0,467336,12465,24931,442405,77880,849452,406866,442586,,1246567,20.0,10.0,0.0418,360,288.24,1000.0,77.88,0.5442
8052,Martin PLC,False,AU,Mortonfurt,IoT,2015,https://martinplc.com,Car want third perhaps then could hotel member Mr painting.,17,martin-plc,2023,USD,494845,244292,250553,330784,-80231,0,-80231,4948,9896,-90127,15782,323714,96110,227604,,494845,561.37,280.68,0.1424,2061,20.0,47690.26,0.33,0.5063
8053,Robinson Group,False,ZA,South Rebecca,AgriTech,2016,https://robinsongroup.com,Believe senior economy discover her risk.,19,robinson-group,2023,USD,30983,11229,19754,1549,18205,34673,-16468,309,619,-17087,13110,99084,34204,64880,,30983,20.0,56.06,0.1087,10,236.23,5399.97,2.43,0.6376
8054,Ross-Barber,False,KE,Robertville,Mobility,2017,https://ross-barber.com,Population once police choose physical.,20,ross-barber,2023,USD,1335915,351161,984754,1069209,-84455,7160,-91615,13359,26718,-118333,162201,891555,258066,633489,,1335915,273.68,286.6,0.0592,3496,31.84,55401.44,2.93,0.7371
8055,Mejia Inc,False,DE,Lake Shelby,IoT,2016,https://mejiainc.com,More measure husband full direction rule rate expert.,30,mejia-inc,2023,EUR,472686,284540,188146,311872,-123726,13406,-137132,4726,9453,-146585,12892,288947,139680,149267,,472686,704.42,3241.08,0.031,950,41.46,46786.34,0.28,0.398
8056,Clements Davidson and Briggs,False,TN,South Vincent,AgriTech,2008,https://clementsdavidsonandbriggs.com,Choice him likely character foreign enjoy myself out church.,16,clements-davidson-and-briggs,2023,USD,1092457,477362,615095,984740,-369645,0,-369645,10924,21849,-391494,292528,924130,261712,662418,,1092457,698.03,3899.13,0.0466,4551,20.0,81369.98,3.6,0.563
8057,Castillo-Henson,False,NG,Dylanhaven,Marketplaces,2013,https://castillo-henson.com,Clearly white must whose.,26,castillo-henson,2023,USD,127676,25683,101993,6383,95610,39066,56544,1276,2553,53991,6593,117613,62979,54634,,127676,536.8,2464.71,0.0381,531,20.0,1000.0,6.59,0.7988
8058,Moore-Davis,False,GB,Hernandezberg,EdTech,2009,https://moore-davis.com,Evening this outside exactly few including voice difficult site level.,17,moore-davis,2023,USD,113449,53788,59661,74857,-15196,0,-15196,1134,2268,-17464,4555,241455,110177,131278,9454.08,113449,10.0,30.47,0.0864,131,71.76,8684.21,0.52,0.5259
8059,Bell Shields and Clark,False,KE,West Jacob,E-commerce,2024,https://bellshieldsandclark.com,Yes American store along.,20,bell-shields-and-clark,2023,USD,1547425,532476,1014949,696326,318623,19205,299418,15474,30948,268470,34748,864601,328791,535810,,1547425,20.0,52.29,0.0401,3396,37.97,70946.28,0.49,0.6559
8060,Adams Ltd,False,TN,South Brenda,HealthTech,2023,https://adamsltd.com,Authority green responsibility outside southern necessary.,19,adams-ltd,2023,USD,1715607,846361,869246,1403194,-533948,0,-533948,17156,34312,-568260,843029,1757661,1552148,205513,142967.25,1715607,10.0,50.61,0.0346,2773,51.55,99409.97,8.48,0.5067
8061,Smith Hamilton and Terry,False,ZA,Pricechester,EdTech,2024,https://smithhamiltonandterry.com,Strategy hundred room from total recent.,25,smith-hamilton-and-terry,2023,USD,219436,110034,109402,63519,45883,0,45883,2194,4388,41495,12529,243343,120823,122520,18286.33,219436,287.11,712.38,0.0264,3657,5.0,1000.0,12.53,0.4986
8062,Price Johnson and Sharp,False,KE,Kingshire,AgriTech,2011,https://pricejohnsonandsharp.com,Late citizen admit compare life trade.,21,price-johnson-and-sharp,2023,USD,96237,32912,63325,42841,20484,18681,1803,962,1924,-121,10040,143351,80367,62984,,96237,20.0,10.0,0.1076,85,93.47,30186.69,0.33,0.658
8063,Thompson-Rhodes,False,DE,Hansonburgh,HealthTech,2011,https://thompson-rhodes.com,Again official us nothing eye decide station education land machine.,23,thompson-rhodes,2023,EUR,517795,335103,182692,178089,4603,12485,-7882,5177,10355,-18237,71104,348555,176377,172178,43149.58,517795,153.55,153.55,0.001,755,57.09,1000.0,71.1,0.3528
8064,White-Rhodes,False,US,Harrisshire,IoT,2022,https://white-rhodes.com,Reality task and today eight defense admit.,18,white-rhodes,2023,USD,282626,116141,166485,142523,23962,32991,-9029,2826,5652,-14681,13739,312201,116299,195902,,282626,20.0,102.31,0.0502,130,180.34,1000.0,13.74,0.5891
8065,Porter Patterson and Jackson,False,GB,New Ariel,SaaS,2013,https://porterpattersonandjackson.com,Exist few education daughter occur.,10,porter-patterson-and-jackson,2023,USD,1126667,535829,590838,176887,413951,1683,412268,11266,22533,389735,289825,863231,235289,627942,93888.92,1126667,10.0,19.22,0.0304,1176,79.8,38343.66,7.56,0.5244
8066,Barnes Snow and Martin,False,FR,New Jessicatown,Mobility,2009,https://barnessnowandmartin.com,Today again voice stock poor huge.,23,barnes-snow-and-martin,2023,EUR,1124826,331949,792877,1074474,-281597,0,-281597,11248,22496,-304093,34137,661076,315985,345091,,1124826,508.35,1828.92,0.1013,1466,63.91,94606.61,0.36,0.7049
8067,Miles Baker and Davenport,False,EG,East Alison,E-commerce,2017,https://milesbakeranddavenport.com,Suffer power attention success war cold.,12,miles-baker-and-davenport,2023,USD,459792,204288,255504,288421,-32917,11091,-44008,4597,9195,-53203,88840,396472,32137,364335,,459792,825.9,412.95,0.0896,342,112.02,69298.71,1.28,0.5557
8068,Stephenson Inc,False,NG,Bryanberg,E-commerce,2014,https://stephensoninc.com,Stop road develop good relate represent.,19,stephenson-inc,2023,USD,238625,111874,126751,37048,89703,8901,80802,2386,4772,76030,19564,298504,91824,206680,,238625,713.94,3586.4,0.0798,258,76.85,1000.0,19.56,0.5312
8069,Morrow Gillespie and Bean,False,IN,West Jaredberg,Marketplaces,2021,https://morrowgillespieandbean.com,Wind early company per election then involve visit pick voice.,22,morrow-gillespie-and-bean,2023,USD,85325,39852,45473,67387,-21914,44526,-66440,853,1706,-68146,11413,116635,99789,16846,,85325,20.0,12.17,0.0223,355,20.0,1000.0,11.41,0.5329
8070,Clark-Lee,False,CA,South Marcus,E-commerce,2023,https://clark-lee.com,Dog not book miss require race.,11,clark-lee,2023,USD,2874055,906639,1967416,1431447,535969,0,535969,28740,57481,478488,40996,1629542,517423,1112119,,2874055,1416.4,3104.26,0.0181,11975,20.0,111673.42,0.37,0.6845
8071,Navarro LLC,False,AU,North Oliviaburgh,IoT,2012,https://navarrollc.com,Occur control weight my sort.,16,navarro-llc,2023,USD,122276,62867,59409,45043,14366,348,14018,1222,2445,11573,19373,233475,87893,145582,,122276,20.0,10.0,0.0547,96,105.16,1000.0,19.37,0.4859
8072,Thomas-Morgan,False,AU,West Timothy,HealthTech,2009,https://thomas-morgan.com,Need whether his set.,18,thomas-morgan,2023,USD,1821641,326568,1495073,660996,834077,10025,824052,18216,36432,787620,48673,1052883,622121,430762,151803.42,1821641,189.59,1112.5,0.0255,2932,51.76,29847.29,1.63,0.8207
8073,Martinez-Davis,False,DE,Brianside,SaaS,2009,https://martinez-davis.com,Social available little could free.,17,martinez-davis,2023,EUR,1946102,690472,1255630,97305,1158325,0,1158325,19461,38922,1119403,39482,1062918,455572,607346,162175.17,1946102,672.22,3332.71,0.0394,2128,76.19,42121.91,0.94,0.6452
8074,Morgan-Abbott,False,IN,Tracychester,AgriTech,2021,https://morgan-abbott.com,Experience book follow matter authority certainly reveal job why.,19,morgan-abbott,2023,USD,197726,113145,84581,55710,28871,46316,-17445,1977,3954,-21399,20985,160703,45475,115228,,197726,20.0,41.68,0.1181,823,20.0,1000.0,20.98,0.4278
8075,Vasquez Patton and Moore,False,IN,New Michaelbury,Energy,2010,https://vasquezpattonandmoore.com,Human type type about attack lose.,15,vasquez-patton-and-moore,2023,USD,704154,260297,443857,117482,326375,0,326375,7041,14083,312292,16046,497869,225945,271924,,704154,2030.09,7832.75,0.0067,430,136.31,6533.98,2.46,0.6303
8076,Johnson-Le,False,GB,West Stevenland,Cybersecurity,2015,https://johnson-le.com,No front system stuff stay my.,17,johnson-le,2023,USD,576826,282688,294138,373170,-79032,0,-79032,5768,11536,-90568,58865,502773,260932,241841,,576826,707.98,3550.88,0.0615,2403,20.0,20936.96,2.81,0.5099
8077,Payne Group,False,KE,Port Roseville,SaaS,2008,https://paynegroup.com,Low skill choose especially change ahead hard administration detail table.,20,payne-group,2023,USD,886901,332455,554446,399789,154657,17636,137021,8869,17738,119283,11971,472400,240979,231421,73908.42,886901,10.0,29.1,0.001,5351,13.81,53448.28,0.22,0.6251
8078,Anderson-Dudley,False,GB,East Marystad,Cybersecurity,2019,https://anderson-dudley.com,Media should she organization shoulder.,20,anderson-dudley,2023,USD,387113,211360,175753,36299,139454,0,139454,3871,7742,131712,13545,322743,16137,306606,,387113,1573.92,5671.62,0.0894,146,219.8,9002.67,1.5,0.454
8079,Villarreal-Sutton,False,FR,South Josephview,HealthTech,2011,https://villarreal-sutton.com,Republican especially late nothing real southern room.,20,villarreal-sutton,2023,EUR,269767,125340,144427,251428,-107001,0,-107001,2697,5395,-112396,21312,333469,236344,97125,22480.58,269767,455.69,4113.89,0.0039,472,47.54,39711.47,0.54,0.5354
8080,Kennedy-Stout,False,DE,Kellymouth,Cybersecurity,2022,https://kennedy-stout.com,Statement drug group true age law put size whole.,22,kennedy-stout,2023,EUR,2602483,1593079,1009404,2323715,-1314311,0,-1314311,26024,52049,-1366360,126834,1580993,754463,826530,,2602483,1311.22,655.61,0.0178,1718,126.23,205928.19,0.62,0.3879
8081,Holmes Martinez and Coleman,False,CA,Philipberg,Energy,2019,https://holmesmartinezandcoleman.com,Reality read hundred watch stay call tell while.,23,holmes-martinez-and-coleman,2023,USD,963841,432021,531820,459583,72237,43944,28293,9638,19276,9017,100881,687263,321636,365627,,963841,650.08,5354.76,0.1372,568,141.24,63714.65,1.58,0.5518
8082,Holland Scott and Gordon,False,NG,North Jeffrey,Cybersecurity,2020,https://hollandscottandgordon.com,Religious card traditional cover draw member.,14,holland-scott-and-gordon,2023,USD,1312773,574116,738657,358712,379945,0,379945,13127,26255,353690,766313,1607594,745638,861956,,1312773,95.32,315.69,0.001,5469,20.0,45837.19,16.72,0.5627
8083,Murphy-Martinez,False,DE,Ashleyberg,E-commerce,2018,https://murphy-martinez.com,Concern past hot sing eight employee human although and.,19,murphy-martinez,2023,EUR,297317,108512,188805,298801,-109996,16483,-126479,2973,5946,-132425,691,228072,43082,184990,,297317,522.74,2158.67,0.001,152,162.55,1000.0,0.69,0.635
8084,Kerr-Howell,False,BR,Collinstown,Marketplaces,2023,https://kerr-howell.com,Nature success live allow keep pass break foreign traditional alone.,17,kerr-howell,2023,USD,373078,97804,275274,18653,256621,9294,247327,3730,7461,239866,7923,275533,109287,166246,,373078,20.0,70.39,0.06,410,75.77,1000.0,7.92,0.7378
8085,Ware Coleman and Holt,False,US,North Monica,AI/ML,2021,https://warecolemanandholt.com,Several authority guy today skill receive difference across.,24,ware-coleman-and-holt,2023,USD,274063,95444,178619,182952,-4333,0,-4333,2740,5481,-9814,15071,340654,146127,194527,,274063,383.72,191.86,0.0853,299,76.23,1767.06,8.53,0.6517
8086,Roberts and Sons,False,AU,West Kimberly,Fintech,2014,https://robertsandsons.com,Itself cell ahead leader issue drop window.,23,roberts-and-sons,2023,USD,1760979,614437,1146542,893766,252776,0,252776,17609,35219,217557,25370,975254,371858,603396,,1760979,377.25,1683.5,0.0984,584,250.94,58547.05,0.43,0.6511
8087,Fisher-Woods,False,FR,Jessicaborough,AgriTech,2019,https://fisher-woods.com,Early try against opportunity team house rate firm.,27,fisher-woods,2023,EUR,113313,18794,94519,61576,32943,332,32611,1133,2266,30345,27002,179416,60889,118527,,113313,1708.56,10130.14,0.0157,237,39.82,27147.46,0.99,0.8341
8088,Gutierrez Jacobs and Cunningham,False,NG,Lake Christopher,AgriTech,2014,https://gutierrezjacobsandcunningham.com,Single raise follow benefit line fight focus explain large.,20,gutierrez-jacobs-and-cunningham,2023,USD,300763,154082,146681,171489,-24808,0,-24808,3007,6015,-30823,6777,284827,106403,178424,,300763,20.0,69.35,0.0717,1253,20.0,1000.0,6.78,0.4877
8089,Scott Moses and Wong,False,IN,South Jasonton,Cybersecurity,2018,https://scottmosesandwong.com,Child production effort response at dog find dog bar go.,15,scott-moses-and-wong,2023,USD,1163383,525164,638219,653542,-15323,0,-15323,11633,23267,-38590,5910,606040,125838,480202,,1163383,887.22,2042.16,0.0409,507,191.17,69009.62,0.09,0.5486
8090,Johnson Wagner and Garcia,False,TN,Port Kimberlystad,Energy,2015,https://johnsonwagnerandgarcia.com,Book since magazine child tend month simply seek until court keep.,20,johnson-wagner-and-garcia,2023,USD,1042458,574818,467640,248461,219179,669,218510,10424,20849,197661,103872,779215,347736,431479,,1042458,20.0,65.24,0.1184,465,186.8,19186.51,5.41,0.4486
8091,Weiss-Coleman,False,FR,Port Lisashire,Fintech,2015,https://weiss-coleman.com,A throughout model after police.,26,weiss-coleman,2023,EUR,3130684,1174364,1956320,3265949,-1309629,0,-1309629,31306,62613,-1372242,232909,1837468,817994,1019474,,3130684,573.77,855.98,0.0428,2604,100.15,281992.86,0.83,0.6249
8092,Guzman Group,False,NG,Kimberlyshire,AI/ML,2019,https://guzmangroup.com,Success record easy anyone well section miss spring gas vote.,15,guzman-group,2023,USD,6394307,2631111,3763196,3639293,123903,0,123903,63943,127886,-3983,81816,3471919,1079323,2392596,,6394307,957.64,9576.4,0.001,8309,64.13,296365.57,0.28,0.5885
8093,Green-Butler,False,US,New Michaelfort,EdTech,2017,https://green-butler.com,Development while sort window respond out budget stay receive around.,21,green-butler,2023,USD,290437,104750,185687,242110,-56423,2316,-58739,2904,5808,-64547,17058,254333,152181,102152,24203.08,290437,588.78,1288.4,0.0181,1334,18.13,19205.52,0.89,0.6393
8094,Thomas-Morgan,False,GB,Port Nicholasburgh,EdTech,2021,https://thomas-morgan.com,Class skin remain increase candidate wide.,25,thomas-morgan,2023,USD,2079539,657787,1421752,103976,1317776,19891,1297885,20795,41590,1256295,159202,1277585,610996,666589,173294.92,2079539,339.59,570.96,0.0337,1830,94.65,24389.79,6.53,0.6837
8095,Miller Wu and Hebert,False,GB,Camachomouth,Marketplaces,2012,https://millerwuandhebert.com,Determine while economy kid if person decide base.,13,miller-wu-and-hebert,2023,USD,762189,332133,430056,507124,-77068,7729,-84797,7621,15243,-100040,15289,407060,37217,369843,,762189,195.9,1002.19,0.1321,337,188.34,41970.69,0.36,0.5642
8096,Perez Ltd,False,US,West Robertbury,EdTech,2014,https://perezltd.com,Off quickly rate doctor team near could western understand environmental.,15,perez-ltd,2023,USD,469492,245431,224061,165300,58761,9289,49472,4694,9389,40083,4191,410255,67748,342507,39124.33,469492,795.83,4702.29,0.0257,854,45.76,1000.0,4.19,0.4772
8097,Cortez-Mason,False,IN,Berghaven,Mobility,2017,https://cortez-mason.com,Do although specific myself focus lawyer ok growth kind develop.,17,cortez-mason,2023,USD,1046100,463441,582659,687575,-104916,0,-104916,10461,20922,-125838,73311,743285,201990,541295,,1046100,20.0,65.39,0.1,1177,74.06,23235.73,3.16,0.557
8098,Mitchell Russell and Estrada,False,GB,East Theresafort,AgriTech,2021,https://mitchellrussellandestrada.com,Main western fill grow chair black would program.,17,mitchell-russell-and-estrada,2023,USD,406527,97459,309068,118315,190753,0,190753,4065,8130,182623,5659,318642,90082,228560,,406527,1222.95,2717.18,0.0515,1693,20.0,1000.0,5.66,0.7603
8099,Smith Group,False,DE,Lake Markport,Marketplaces,2011,https://smithgroup.com,Painting bring mention nothing also majority would.,19,smith-group,2023,EUR,428797,222510,206287,175083,31204,13777,17427,4287,8575,8852,40091,388206,177214,210992,,428797,20.0,110.58,0.0537,201,176.94,4047.61,9.9,0.4811
8100,Patterson Ltd,False,US,West Michael,AgriTech,2015,https://pattersonltd.com,Describe top believe difficult identify.,13,patterson-ltd,2023,USD,966365,126227,840138,384397,455741,56602,399139,9663,19327,379812,99716,594486,171587,422899,,966365,674.72,337.36,0.0639,626,128.62,42678.16,2.34,0.8694
8101,Nixon Inc,False,BR,Lake Jane,Mobility,2021,https://nixoninc.com,General few issue fast.,24,nixon-inc,2023,USD,637784,289159,348625,31889,316736,29436,287300,6377,12755,274545,125633,493668,168137,325531,,637784,20.0,114.47,0.0382,300,176.58,34517.36,3.64,0.5466
8102,Clark Ltd,False,NG,Samanthastad,Cybersecurity,2020,https://clarkltd.com,Dark staff space baby room practice say as.,14,clark-ltd,2023,USD,254002,85084,168918,12700,156218,0,156218,2540,5080,151138,31959,167265,83897,83368,,254002,20.0,48.36,0.0609,150,140.66,11318.87,2.82,0.665
8103,Newton Fuller and Kelly,False,AU,Coxborough,AI/ML,2008,https://newtonfullerandkelly.com,Require cell staff that radio information catch course.,11,newton-fuller-and-kelly,2023,USD,803109,452618,350491,422697,-72206,8008,-80214,8031,16062,-96276,91605,523749,94749,429000,,803109,20.0,121.65,0.0275,713,93.84,22196.47,4.13,0.4364
8104,Parker-Martin,False,US,South Michelleport,AI/ML,2018,https://parker-martin.com,Federal like plan last center method miss camera democratic.,29,parker-martin,2023,USD,750899,299882,451017,37544,413473,0,413473,7508,15017,398456,234468,691597,385792,305805,,750899,20.0,40.14,0.0209,328,190.3,35028.37,6.69,0.6006
8105,Miranda-Cox,False,ZA,Woodport,Cybersecurity,2012,https://miranda-cox.com,Month production group question week.,15,miranda-cox,2023,USD,369209,107679,261530,279631,-18101,18809,-36910,3692,7384,-44294,10146,286370,44899,241471,,369209,79.75,167.39,0.031,115,266.02,14069.39,0.72,0.7084
8106,Lee Inc,False,KE,North Samuelmouth,AgriTech,2020,https://leeinc.com,Maybe commercial brother PM yet next toward.,25,lee-inc,2023,USD,425889,137597,288292,108916,179376,5137,174239,4258,8517,165722,17857,392928,33865,359063,,425889,74.82,82.69,0.1034,1276,27.81,2362.13,7.56,0.6769
8107,Bailey-Smith,False,AU,East Douglas,IoT,2009,https://bailey-smith.com,Start by significant church toward factor police you.,23,bailey-smith,2023,USD,2010731,973698,1037033,1312264,-275231,0,-275231,20107,40214,-315445,418183,1503763,662846,840917,,2010731,1083.9,3501.36,0.001,1821,91.99,111430.16,3.75,0.5157
8108,Fisher-Pittman,False,GB,Timothyport,Marketplaces,2010,https://fisher-pittman.com,Voice marriage prevent between suddenly around black.,16,fisher-pittman,2023,USD,1262621,338385,924236,520653,403583,0,403583,12626,25252,378331,40980,762043,361405,400638,,1262621,20.0,75.14,0.1104,5260,20.0,63249.73,0.65,0.732
8109,Key-Morales,False,BR,New Angelahaven,Marketplaces,2023,https://key-morales.com,Expert other research feel truth television enter window world.,19,key-morales,2023,USD,1716291,523788,1192503,1036023,156480,46728,109752,17162,34325,75427,37955,998335,258524,739811,,1716291,20.0,48.55,0.024,7151,20.0,77393.07,0.49,0.6948
8110,Romero-Miller,False,EG,Tonyton,AgriTech,2010,https://romero-miller.com,Billion grow experience back new fine eye painting.,20,romero-miller,2023,USD,137071,47165,89906,105603,-15697,1418,-17115,1370,2741,-19856,2494,147673,64374,83299,,137071,20.0,32.25,0.1499,60,189.79,1000.0,2.49,0.6559
8111,Harper Green and White,False,EG,Port Wendyfort,AgriTech,2014,https://harpergreenandwhite.com,Career film worker citizen scientist their participant.,24,harper-green-and-white,2023,USD,353967,98904,255063,217163,37900,14501,23399,3539,7079,16320,11521,290569,98273,192296,,353967,20.0,87.77,0.001,509,57.93,50536.95,0.23,0.7206
8112,Reyes Miller and Snow,False,US,New Juanmouth,AgriTech,2014,https://reyesmillerandsnow.com,Close election reason how beautiful.,26,reyes-miller-and-snow,2023,USD,248412,78397,170015,46022,123993,10016,113977,2484,4968,109009,10497,297750,171425,126325,,248412,1207.27,603.64,0.0841,564,36.64,60606.58,0.17,0.6844
8113,Johnson-Taylor,False,CA,North Rebecca,SaaS,2012,https://johnson-taylor.com,Most yes board consider pull father near key what shoulder.,16,johnson-taylor,2023,USD,2221505,1196245,1025260,1299453,-274193,0,-274193,22215,44430,-318623,44293,1218653,447135,771518,185125.42,2221505,440.14,602.31,0.1045,5637,32.84,145612.29,0.3,0.4615
8114,Barnett Ltd,False,DE,South Jamesbury,AI/ML,2019,https://barnettltd.com,Early surface put section computer trouble.,23,barnett-ltd,2023,EUR,1015667,478050,537617,916183,-378566,0,-378566,10156,20313,-398879,51758,697344,34867,662477,,1015667,837.73,5581.55,0.111,4231,20.0,71099.75,0.73,0.5293
8115,Li Inc,False,US,East Laurenside,HealthTech,2013,https://liinc.com,Film husband miss himself resource move computer participant mention.,23,li-inc,2023,USD,2168757,578799,1589958,484809,1105149,42647,1062502,21687,43375,1019127,1157116,2276725,252187,2024538,180729.75,2168757,10.0,39.0,0.001,2493,72.48,39350.71,29.41,0.7331
8116,Brown Group,False,NG,Port Renee,IoT,2016,https://browngroup.com,Land across allow team detail whether prove soon purpose.,25,brown-group,2023,USD,2131844,752960,1378884,1153750,225134,0,225134,21318,42636,182498,214600,1305254,482015,823239,,2131844,20.0,182.23,0.0605,807,219.96,78199.51,2.74,0.6468
8117,Hall-Terry,False,TN,Carrollton,Energy,2018,https://hall-terry.com,Cell hold relationship society sell and language offer.,22,hall-terry,2023,USD,337391,68466,268925,28978,239947,31426,208521,3373,6747,201774,37575,352044,136436,215608,,337391,20.0,10.52,0.1735,1405,20.0,31692.54,1.19,0.7971
8118,Wilson Ltd,False,GB,Tiffanychester,Mobility,2018,https://wilsonltd.com,Area both executive focus during kind.,16,wilson-ltd,2023,USD,941203,383804,557399,865950,-308551,0,-308551,9412,18824,-327375,34933,687006,90934,596072,,941203,900.2,2581.76,0.0436,1142,68.64,61145.2,0.57,0.5922
8119,Solomon Lee and Braun,False,ZA,Patrickstad,HealthTech,2014,https://solomonleeandbraun.com,Worry run question paper whom participant dinner.,23,solomon-lee-and-braun,2023,USD,430086,99741,330345,219892,110453,5445,105008,4300,8601,96407,25376,405688,27164,378524,35840.5,430086,219.79,219.79,0.001,7168,5.0,9873.7,2.57,0.7681
8120,Santos Inc,False,DE,North Julianbury,HealthTech,2024,https://santosinc.com,Off husband forward evening actually wear involve treat attention.,28,santos-inc,2023,EUR,4116719,2186249,1930470,1623573,306897,39455,267442,41167,82334,185108,197921,2377965,1025688,1352277,343059.92,4116719,567.17,3122.0,0.0572,7632,44.95,148219.44,1.34,0.4689
8121,Mann Archer and Berry,False,GB,Grayview,IoT,2015,https://mannarcherandberry.com,Security continue government major discussion at painting year instead personal.,20,mann-archer-and-berry,2023,USD,750161,362876,387285,479022,-91737,0,-91737,7501,15003,-106740,43403,423825,124299,299526,,750161,1373.36,3793.67,0.0584,3125,20.0,55988.96,0.78,0.5163
8122,Matthews Carter and Peterson,False,US,Mcdanielburgh,HealthTech,2008,https://matthewscarterandpeterson.com,Case chance technology tell discussion sign live citizen.,20,matthews-carter-and-peterson,2023,USD,1850019,614599,1235420,536881,698539,14387,684152,18500,37000,647152,63577,1046903,248345,798558,154168.25,1850019,10.0,36.36,0.0474,2783,55.38,48253.19,1.32,0.6678
8123,Lopez-Snyder,False,GB,Traciport,E-commerce,2020,https://lopez-snyder.com,Foreign off add century evening deal.,17,lopez-snyder,2023,USD,1376904,586708,790196,753699,36497,19572,16925,13769,27538,-10613,9355,859594,295735,563859,,1376904,2108.51,1683.7,0.001,1743,65.83,53778.32,0.17,0.5739
8124,Lewis and Sons,False,KE,West John,Fintech,2014,https://lewisandsons.com,Similar catch smile rather plant especially wide camera today president.,17,lewis-and-sons,2023,USD,6602964,1505481,5097483,2109599,2987884,0,2987884,66029,132059,2855825,540291,3979729,1936185,2043544,,6602964,384.13,1971.33,0.0304,2682,205.12,144524.6,3.74,0.772
8125,Richardson-Wilson,False,DE,Chambershaven,SaaS,2015,https://richardson-wilson.com,Best son body these staff author discussion receive.,18,richardson-wilson,2023,EUR,1087222,254074,833148,75103,758045,27076,730969,10872,21744,709225,48507,628195,175243,452952,90601.83,1087222,74.29,225.47,0.0197,6326,14.32,15505.34,3.13,0.7663
8126,Green-Brown,False,US,Stanleytown,EdTech,2014,https://green-brown.com,Early business happen might place.,27,green-brown,2023,USD,361156,103142,258014,218670,39344,0,39344,3611,7223,32121,176492,555236,378055,177181,30096.33,361156,10.0,39.64,0.0399,295,101.94,6089.24,28.98,0.7144
8127,Mitchell LLC,False,IN,New Amyport,Energy,2022,https://mitchellllc.com,Suffer visit girl knowledge without party serious teach may.,21,mitchell-llc,2023,USD,2717155,961115,1756040,1106847,649193,1317,647876,27171,54343,593533,43818,1451263,711669,739594,,2717155,1019.52,1557.52,0.0442,671,336.99,73852.55,0.59,0.6463
8128,Williams-Ho,False,EG,South Mathewberg,Fintech,2011,https://williams-ho.com,Southern customer national fear admit number likely we act.,14,williams-ho,2023,USD,946588,187573,759015,157454,601561,1735,599826,9465,18931,580895,130162,743469,54677,688792,,946588,20.0,79.81,0.0857,345,228.04,20601.48,6.32,0.8018
8129,Rogers Brown and White,False,BR,Ramseychester,Energy,2022,https://rogersbrownandwhite.com,Thank really why statement sea fall measure say.,30,rogers-brown-and-white,2023,USD,1765414,627288,1138126,1037614,100512,8155,92357,17654,35308,57049,362038,1367763,397283,970480,,1765414,504.3,1978.88,0.086,7355,20.0,61145.46,5.92,0.6447
8130,Le and Sons,False,CA,Kylestad,SaaS,2022,https://leandsons.com,Crime store first material side oil.,23,le-and-sons,2023,USD,3136445,284743,2851702,1784825,1066877,0,1066877,31364,62728,1004149,99408,1817333,1145266,672067,261370.42,3136445,66.18,271.03,0.0035,2545,102.67,135641.09,0.73,0.9092
8131,Shea Gibson and Moreno,False,TN,Johnfurt,HealthTech,2023,https://sheagibsonandmoreno.com,List upon walk question improve Mr look much certainly enter.,21,shea-gibson-and-moreno,2023,USD,413661,107702,305959,137255,168704,0,168704,4136,8273,160431,8453,373945,190670,183275,34471.75,413661,10.0,43.94,0.0694,6894,5.0,37464.06,0.23,0.7396
8132,Anderson Stevens and Hurst,False,KE,West Christopher,IoT,2019,https://andersonstevensandhurst.com,Even he then field difficult approach body travel everyone little.,21,anderson-stevens-and-hurst,2023,USD,198508,100187,98321,91313,7008,15120,-8112,1985,3970,-12082,2914,208714,112132,96582,,198508,96.12,48.06,0.0041,137,120.14,10961.68,0.27,0.4953
8133,Keith-Paul,False,AU,Bennettside,E-commerce,2015,https://keith-paul.com,Likely about once owner strategy.,21,keith-paul,2023,USD,3527871,1370682,2157189,1398412,758777,0,758777,35278,70557,688220,996887,2781664,923243,1858421,,3527871,20.0,78.73,0.001,1594,184.38,144095.85,6.92,0.6115
8134,Henry Olson and Wood,False,ZA,Kirkside,SaaS,2013,https://henryolsonandwood.com,Fight human school again.,27,henry-olson-and-wood,2023,USD,594995,193379,401616,320880,80736,0,80736,5949,11899,68837,62184,416370,133080,283290,49582.92,594995,10.0,50.07,0.0202,1579,31.4,31949.09,1.95,0.675
8135,Garcia Campbell and Evans,False,IN,Jonathanshire,Marketplaces,2019,https://garciacampbellandevans.com,Each mother us important must arrive challenge peace both record.,23,garcia-campbell-and-evans,2023,USD,1315280,475035,840245,599937,240308,12676,227632,13152,26305,201327,74505,838311,580255,258056,,1315280,667.2,4147.35,0.001,1222,89.65,76256.72,0.98,0.6388
8136,Schwartz-Fisher,False,DE,Haynesport,SaaS,2010,https://schwartz-fisher.com,Bring language identify all agreement stop always today mother.,25,schwartz-fisher,2023,EUR,2850681,950960,1899721,177714,1722007,0,1722007,28506,57013,1664994,110865,1649987,196112,1453875,237556.75,2850681,606.85,2448.17,0.001,3819,62.19,32735.49,3.39,0.6664
8137,Clark and Sons,False,GB,Bonnieborough,EdTech,2016,https://clarkandsons.com,Item live small game ground list brother scene own.,21,clark-and-sons,2023,USD,148894,47447,101447,77824,23623,10049,13574,1488,2977,10597,4097,242630,168915,73715,12407.83,148894,247.47,247.47,0.0716,203,61.07,45523.06,0.09,0.6813
8138,West and Sons,False,EG,Williamton,HealthTech,2015,https://westandsons.com,Collection return brother his popular read executive.,16,west-and-sons,2023,USD,791567,258888,532679,198621,334058,10010,324048,7915,15831,308217,102174,644808,119230,525578,65963.92,791567,310.97,1314.76,0.0637,744,88.64,27501.39,3.72,0.6729
8139,Ramirez Group,False,US,Mackfurt,EdTech,2016,https://ramirezgroup.com,Mean tree better popular black political character.,18,ramirez-group,2023,USD,351326,106170,245156,214272,30884,23658,7226,3513,7026,200,12185,228439,89975,138464,29277.17,351326,1256.94,1909.79,0.0272,298,98.21,58381.05,0.21,0.6978
8140,King-West,False,ZA,Riveraton,HealthTech,2009,https://king-west.com,Program view produce wind write body.,23,king-west,2023,USD,881053,298966,582087,111924,470163,0,470163,8810,17621,452542,94885,603484,193718,409766,73421.08,881053,432.4,1870.17,0.0562,14684,5.0,1000.0,94.88,0.6607
8141,Smith and Sons,False,GB,Wrightmouth,AI/ML,2017,https://smithandsons.com,After read those finish either could time.,19,smith-and-sons,2023,USD,615418,241278,374140,382412,-8272,0,-8272,6154,12308,-20580,149094,484933,145691,339242,,615418,1322.85,7140.56,0.0454,2564,20.0,71420.59,2.09,0.6079
8142,Tucker PLC,False,EG,New Lori,Fintech,2008,https://tuckerplc.com,Human although computer experience young great will realize bring drug.,16,tucker-plc,2023,USD,1187239,449659,737580,281369,456211,0,456211,11872,23744,432467,203633,899840,44992,854848,,1187239,1551.67,4818.29,0.0286,617,160.21,39547.04,5.15,0.6213
8143,Richards Inc,False,FR,New Thomas,Mobility,2013,https://richardsinc.com,Culture career forward establish card blue view.,12,richards-inc,2023,EUR,1329079,585280,743799,241464,502335,0,502335,13290,26581,475754,20241,817187,153511,663676,,1329079,152.54,806.43,0.0989,316,350.12,66151.71,0.31,0.5596
8144,Brady and Sons,False,GB,Port Allison,Marketplaces,2012,https://bradyandsons.com,Condition benefit not character beautiful.,24,brady-and-sons,2023,USD,363497,116716,246781,95114,151667,11144,140523,3634,7269,133254,16790,386142,53416,332726,,363497,1188.75,2933.68,0.001,83,361.41,1000.0,16.79,0.6789
8145,Monroe Group,False,IN,North Mallory,SaaS,2019,https://monroegroup.com,Standard hair explain also that together.,16,monroe-group,2023,USD,689743,217148,472595,480118,-7523,0,-7523,6897,13794,-21317,121304,611176,236989,374187,57478.58,689743,374.8,2700.29,0.0241,815,70.48,36168.6,3.35,0.6852
8146,Meyer PLC,False,US,Mendezton,Mobility,2021,https://meyerplc.com,Nation talk person arrive her perform soon customer.,14,meyer-plc,2023,USD,814424,185239,629185,226450,402735,14041,388694,8144,16288,372406,16598,618813,100626,518187,,814424,20.0,52.12,0.0488,2465,27.53,29351.03,0.57,0.7726
8147,Booker Munoz and Weaver,False,IN,New Karenview,Marketplaces,2022,https://bookermunozandweaver.com,House security whose soldier film instead close bed.,14,booker-munoz-and-weaver,2023,USD,220635,67559,153076,137741,15335,0,15335,2206,4412,10923,1797,131552,50838,80714,,220635,624.78,4310.81,0.001,69,265.72,16468.17,0.11,0.6938
8148,Baker-Smith,False,ZA,Kellytown,Fintech,2023,https://baker-smith.com,Shake avoid worry guy and black research.,22,baker-smith,2023,USD,1648309,424752,1223557,224079,999478,37442,962036,16483,32966,929070,82703,971770,393581,578189,,1648309,20.0,10.0,0.0279,6867,20.0,1000.0,82.7,0.7423
8149,Chan PLC,False,BR,West Jessica,Marketplaces,2023,https://chanplc.com,Become tend court particular method hard team one.,35,chan-plc,2023,USD,725935,269988,455947,36296,419651,0,419651,7259,14518,405133,63023,523114,140438,382676,,725935,20.0,30.67,0.001,3024,20.0,1000.0,63.02,0.6281
8150,Thomas Nunez and Thompson,False,CA,Smithfort,AgriTech,2021,https://thomasnunezandthompson.com,Wrong wonder or wish relationship wear since able trouble civil.,20,thomas-nunez-and-thompson,2023,USD,220215,92326,127889,55939,71950,0,71950,2202,4404,67546,15425,294229,62393,231836,,220215,224.39,1629.41,0.001,80,229.05,1000.0,15.42,0.5807
8151,Martin-Mendez,False,FR,Lake Chad,IoT,2013,https://martin-mendez.com,Parent pick do leg close other environmental before.,27,martin-mendez,2023,EUR,640908,226237,414671,485668,-70997,0,-70997,6409,12818,-83815,20185,538554,245714,292840,,640908,600.79,3758.73,0.1313,1307,40.84,28510.11,0.71,0.647
8152,Cox LLC,False,IN,North Joshua,SaaS,2020,https://coxllc.com,Production pressure yeah case difficult hair my responsibility.,20,cox-llc,2023,USD,582016,236233,345783,318748,27035,0,27035,5820,11640,15395,44109,423086,137504,285582,48501.33,582016,166.38,910.01,0.0653,2602,18.64,4798.76,9.19,0.5941
8153,Walters Day and Andrews,False,CA,Marcusbury,Marketplaces,2015,https://waltersdayandandrews.com,Watch hard loss military participant employee watch event.,19,walters-day-and-andrews,2023,USD,631216,142924,488292,321196,167096,0,167096,6312,12624,154472,17935,391262,169002,222260,,631216,1004.41,4915.54,0.001,410,128.2,36099.87,0.5,0.7736
8154,Walker Group,False,NG,West Connie,Mobility,2012,https://walkergroup.com,Across present feel simple employee official.,17,walker-group,2023,USD,3620768,1314654,2306114,1337416,968698,5492,963206,36207,72415,890791,497027,2415551,626210,1789341,,3620768,1091.05,2407.55,0.001,15086,20.0,114136.74,4.35,0.6369
8155,Jensen-Taylor,False,AU,South Darlene,Marketplaces,2023,https://jensen-taylor.com,Why present skin strong beat.,19,jensen-taylor,2023,USD,1842755,458461,1384294,1101536,282758,21006,261752,18427,36855,224897,874836,1894724,863692,1031032,,1842755,20.0,47.43,0.0599,1599,96.01,81100.58,10.79,0.7512
8156,Hayes PLC,False,BR,East Brittney,HealthTech,2018,https://hayesplc.com,Country under once quite stand.,21,hayes-plc,2023,USD,234647,13954,220693,159433,61260,0,61260,2346,4692,56568,9319,294013,17499,276514,19553.92,234647,279.37,279.37,0.001,477,40.94,5234.84,1.78,0.9405
8157,Garcia-Ryan,False,NG,New Jacob,Fintech,2013,https://garcia-ryan.com,Home worker myself security still much.,34,garcia-ryan,2023,USD,2373007,892018,1480989,1126715,354274,0,354274,23730,47460,306814,300359,1602257,786665,815592,,2373007,20.0,40.48,0.0653,1454,135.98,64725.8,4.64,0.6241
8158,Bell-Vaughn,False,GB,Salinasfort,E-commerce,2009,https://bell-vaughn.com,Thousand person our wife beat involve early star oil.,19,bell-vaughn,2023,USD,2834873,823451,2011422,1069857,941565,0,941565,28348,56697,884868,69198,1573608,960049,613559,,2834873,20.0,68.22,0.0699,2429,97.24,85104.76,0.81,0.7095
8159,Griffin Freeman and Gray,False,AU,Michaelborough,IoT,2018,https://griffinfreemanandgray.com,Night truth vote check sell discover.,23,griffin-freeman-and-gray,2023,USD,1488304,187696,1300608,794324,506284,14565,491719,14883,29766,461953,232045,1111144,84859,1026285,,1488304,2287.9,9588.48,0.0648,470,263.55,70371.5,3.3,0.8739
8160,Gray Lambert and Ferguson,False,TN,Joshuaton,Energy,2017,https://graylambertandferguson.com,Home source parent trade tax woman course international for himself.,21,gray-lambert-and-ferguson,2023,USD,578388,264231,314157,392243,-78086,0,-78086,5783,11567,-89653,38032,346116,68436,277680,,578388,20.0,71.86,0.0199,459,105.0,39943.38,0.95,0.5432
8161,Roberts and Sons,False,ZA,Port Marcusbury,AgriTech,2024,https://robertsandsons.com,Argue skin special however mean ok quality.,14,roberts-and-sons,2023,USD,102030,23316,78714,63515,15199,0,15199,1020,2040,13159,4368,244814,86295,158519,,102030,781.0,3433.07,0.018,365,23.25,1000.0,4.37,0.7715
8162,Marsh PLC,False,ZA,West Albert,Cybersecurity,2012,https://marshplc.com,Prove start full across affect stage court air.,18,marsh-plc,2023,USD,818464,442347,376117,241892,134225,1824,132401,8184,16369,116032,8308,418806,157955,260851,,818464,20.0,33.9,0.063,1557,43.79,1254.96,6.62,0.4595
8163,Chan Group,False,DE,Lake Cassandra,Mobility,2015,https://changroup.com,Opportunity name food remember avoid ready house.,20,chan-group,2023,EUR,674274,432420,241854,33713,208141,11113,197028,6742,13485,183543,73442,454792,180314,274478,,674274,1101.27,3262.49,0.031,653,85.93,22104.17,3.32,0.3587
8164,Walker-Morton,False,BR,Lake Monicatown,EdTech,2022,https://walker-morton.com,Political quality despite difference final traditional paper.,16,walker-morton,2023,USD,462224,107777,354447,217615,136832,22825,114007,4622,9244,104763,46571,456076,309900,146176,38518.67,462224,459.71,2042.88,0.0599,322,119.47,1000.0,46.57,0.7668
8165,Howard Wilson and Diaz,False,KE,Harrisview,Fintech,2013,https://howardwilsonanddiaz.com,Challenge interesting consider player professor among security bed.,16,howard-wilson-and-diaz,2023,USD,1491691,906214,585477,772985,-187508,18752,-206260,14916,29833,-236093,26712,944036,279892,664144,,1491691,395.49,1173.26,0.0691,1133,109.68,49380.2,0.54,0.3925
8166,Hill LLC,False,FR,Williamfort,HealthTech,2010,https://hillllc.com,That however especially finally race least summer soon race.,25,hill-llc,2023,EUR,2322060,714976,1607084,1390411,216673,18939,197734,23220,46441,151293,293970,1492913,74645,1418268,193505.0,2322060,31.03,194.76,0.0355,10626,18.21,78242.61,3.76,0.6921
8167,Ramos-Gomez,False,FR,Taylorchester,SaaS,2011,https://ramos-gomez.com,Wear music only art environment eat south machine statement western.,20,ramos-gomez,2023,EUR,1393386,713381,680005,182704,497301,15650,481651,13933,27867,453784,25784,817534,357802,459732,116115.5,1393386,617.52,3235.13,0.0105,1947,59.63,16214.2,1.59,0.488
8168,Byrd Harris and Spencer,False,NG,Brianside,Mobility,2024,https://byrdharrisandspencer.com,Culture remain piece what least.,21,byrd-harris-and-spencer,2023,USD,5466682,2570178,2896504,3629127,-732623,0,-732623,54666,109333,-841956,1926276,4729393,1477396,3251997,,5466682,456.87,1342.21,0.0324,7948,57.31,294848.0,6.53,0.5298
8169,Mitchell-Patterson,False,US,Sawyershire,EdTech,2019,https://mitchell-patterson.com,Difficult certainly hard within fight.,23,mitchell-patterson,2023,USD,2677975,381030,2296945,2331032,-34087,12107,-46194,26779,53559,-99753,1119514,2629599,975072,1654527,223164.58,2677975,10.0,40.18,0.0098,9452,23.61,188708.44,5.93,0.8577
8170,Simmons Wilson and Mcguire,False,ZA,West Marthachester,AI/ML,2021,https://simmonswilsonandmcguire.com,Them this fund book.,16,simmons-wilson-and-mcguire,2023,USD,394066,125137,268929,129561,139368,9695,129673,3940,7881,121792,85912,459671,128269,331402,,394066,1107.58,7079.87,0.001,675,48.6,19788.66,4.34,0.6824
8171,Wilson Diaz and Franklin,False,AU,Wilsonborough,Cybersecurity,2009,https://wilsondiazandfranklin.com,Training suggest likely house care within off reduce.,19,wilson-diaz-and-franklin,2023,USD,1884070,313384,1570686,792282,778404,0,778404,18840,37681,740723,61416,1025405,655191,370214,,1884070,1271.6,3442.91,0.0764,7850,20.0,40634.08,1.51,0.8337
8172,Ellison Reeves and Cooper,False,BR,East Kristie,Fintech,2022,https://ellisonreevesandcooper.com,There month bank many assume while each sing cup money subject.,27,ellison-reeves-and-cooper,2023,USD,294814,51933,242881,184061,58820,15456,43364,2948,5896,37468,44417,301878,121009,180869,,294814,1428.75,2355.73,0.102,151,161.72,9039.23,4.91,0.8238
8173,Adams-Lee,False,US,South Melissafort,Mobility,2017,https://adams-lee.com,Specific see final fish Mr.,17,adams-lee,2023,USD,2415093,880118,1534975,1666062,-131087,20933,-152020,24150,48301,-200321,76111,1433707,156250,1277457,,2415093,1146.94,4114.07,0.0423,3072,65.5,100888.07,0.75,0.6356
8174,Baldwin Ltd,False,ZA,North Markburgh,SaaS,2015,https://baldwinltd.com,Almost should notice cup player become assume.,15,baldwin-ltd,2023,USD,1308457,338841,969616,660681,308935,37821,271114,13084,26169,244945,8708,764964,413218,351746,109038.08,1308457,292.69,1880.99,0.0399,2645,41.21,55994.69,0.16,0.741
8175,Lucas-Flores,False,KE,Kimberlytown,HealthTech,2019,https://lucas-flores.com,Continue never travel practice state just evidence director.,18,lucas-flores,2023,USD,4148141,1462476,2685665,4401178,-1715513,16720,-1732233,41481,82962,-1815195,112636,2382697,755911,1626786,345678.42,4148141,207.77,1342.78,0.0444,7722,44.76,348565.65,0.32,0.6474
8176,Wiley Inc,False,FR,West Darrellport,IoT,2016,https://wileyinc.com,Tax seem despite finally range suddenly world.,21,wiley-inc,2023,EUR,755705,401322,354383,573580,-219197,0,-219197,7557,15114,-234311,38814,422852,51951,370901,,755705,742.98,4721.2,0.1384,2173,28.98,61009.63,0.64,0.4689
8177,Christian-Turner,False,ZA,Smithland,E-commerce,2013,https://christian-turner.com,Less ball generation order my.,21,christian-turner,2023,USD,1017831,448285,569546,275213,294333,14534,279799,10178,20356,259443,176327,736099,165750,570349,,1017831,480.85,1135.25,0.0364,1071,79.17,32778.51,5.38,0.5596
8178,Hickman-Mclaughlin,False,KE,Millertown,E-commerce,2011,https://hickman-mclaughlin.com,History note guess piece security hair sit reflect success outside single.,24,hickman-mclaughlin,2023,USD,3188758,375608,2813150,2405254,407896,22043,385853,31887,63775,322078,33154,1747081,420745,1326336,,3188758,1197.14,3632.08,0.0407,2111,125.87,215748.42,0.15,0.8822
8179,Pena and Sons,False,EG,Michaelchester,Fintech,2013,https://penaandsons.com,Former south concern civil control result.,16,pena-and-sons,2023,USD,4902051,1925056,2976995,2455900,521095,9105,511990,49020,98041,413949,59930,2560321,136737,2423584,,4902051,20.0,40.4,0.0324,20425,20.0,199203.83,0.3,0.6073
8180,Potter LLC,False,GB,Huntmouth,HealthTech,2023,https://potterllc.com,Item population reduce anyone law into long church company within almost.,20,potter-llc,2023,USD,398925,115724,283201,201992,81209,0,81209,3989,7978,73231,77786,346253,148185,198068,33243.75,398925,154.54,1162.0,0.001,418,79.4,7694.4,10.11,0.7099
8181,Moore-Tran,False,TN,East Amanda,Cybersecurity,2016,https://moore-tran.com,Forward believe change themselves fight whose capital spend.,22,moore-tran,2023,USD,505227,281818,223409,144395,79014,24250,54764,5052,10104,44660,20276,400511,43623,356888,,505227,2179.77,1781.58,0.0197,2105,20.0,8942.92,2.27,0.4422
8182,Williams PLC,False,DE,New Paula,EdTech,2022,https://williamsplc.com,Television nice take though act like above fast reason current.,24,williams-plc,2023,EUR,296686,70954,225732,25730,200002,16308,183694,2966,5933,177761,4231,213644,99655,113989,24723.83,296686,10.0,59.99,0.028,431,57.28,12120.01,0.35,0.7608
8183,Merritt PLC,False,GB,Lewisview,HealthTech,2008,https://merrittplc.com,Blue Mrs tax teach care six itself allow without.,23,merritt-plc,2023,USD,495845,156109,339736,182721,157015,0,157015,4958,9916,147099,21983,408202,180973,227229,41320.42,495845,364.67,1946.55,0.001,6632,6.23,34529.04,0.64,0.6852
8184,Johnson Luna and Johnson,False,CA,South James,AgriTech,2012,https://johnsonlunaandjohnson.com,Game movement activity commercial modern any behavior time natural soldier.,15,johnson-luna-and-johnson,2023,USD,272738,45451,227287,62744,164543,11279,153264,2727,5454,147810,7538,165489,73510,91979,,272738,20.0,43.17,0.1199,133,169.75,1000.0,7.54,0.8334
8185,Rodriguez Parker and Petersen,False,GB,Amandaborough,Fintech,2020,https://rodriguezparkerandpetersen.com,Stock strong discover TV mission water reality seek body.,15,rodriguez-parker-and-petersen,2023,USD,551524,252300,299224,184296,114928,34752,80176,5515,11030,69146,29048,382846,104518,278328,,551524,444.67,1572.75,0.0457,158,290.71,26268.69,1.11,0.5425
8186,Ortiz Ltd,False,GB,North Danielchester,Energy,2018,https://ortizltd.com,Send see always form forget relationship may there training.,15,ortiz-ltd,2023,USD,2771818,1340971,1430847,836448,594399,29513,564886,27718,55436,509450,44264,1515400,364500,1150900,,2771818,2125.15,6806.84,0.0739,2271,101.68,66346.86,0.67,0.5162
8187,Barnes-Morales,False,BR,Port Christophershire,AgriTech,2020,https://barnes-morales.com,Think hope safe like south.,19,barnes-morales,2023,USD,183987,77207,106780,100467,6313,11365,-5052,1839,3679,-8731,24525,119315,14195,105120,,183987,429.81,1664.21,0.001,122,125.4,32095.52,0.76,0.5804
8188,Pennington-Fuentes,False,DE,East Mariaport,EdTech,2008,https://pennington-fuentes.com,Study then executive to add.,10,pennington-fuentes,2023,EUR,89858,31335,58523,31437,27086,0,27086,898,1797,25289,341690,455837,146945,308892,7488.17,89858,514.25,1367.82,0.001,89,83.4,7939.42,43.04,0.6513
8189,Hartman-Klein,False,ZA,North Jamesview,AI/ML,2014,https://hartman-klein.com,Effect scientist help itself until life such animal tend car.,13,hartman-klein,2023,USD,697331,373619,323712,85514,238198,0,238198,6973,13946,224252,12830,371200,185513,185687,,697331,20.0,44.16,0.0249,727,79.91,1000.0,12.83,0.4642
8190,Erickson-Clark,False,DE,Port Colin,AgriTech,2017,https://erickson-clark.com,Data citizen majority nature within foreign green.,17,erickson-clark,2023,EUR,207832,55464,152368,47285,105083,0,105083,2078,4156,100927,16950,250132,95124,155008,,207832,673.68,1171.71,0.0332,865,20.0,18122.28,0.94,0.7331
8191,Woodward-Hansen,False,IN,East Jamesborough,Mobility,2008,https://woodward-hansen.com,Heart blue inside throw reason maintain.,20,woodward-hansen,2023,USD,810633,180436,630197,744142,-113945,0,-113945,8106,16212,-130157,88672,504984,246292,258692,,810633,1197.12,1507.29,0.0598,545,123.78,42073.34,2.11,0.7774
8192,Hernandez LLC,False,IN,North Michaelborough,AI/ML,2024,https://hernandezllc.com,Election yeah nice reason kind week history.,15,hernandez-llc,2023,USD,341224,128347,212877,30934,181943,0,181943,3412,6824,175119,2220,352729,244888,107841,,341224,210.89,1126.04,0.0485,320,88.75,1000.0,2.22,0.6239
8193,King Braun and Andersen,False,EG,Lake Arthur,AI/ML,2018,https://kingbraunandandersen.com,Key wind charge method eat prepare risk more.,31,king-braun-and-andersen,2023,USD,2941284,941735,1999549,2616469,-616920,2446,-619366,29412,58825,-678191,105068,1589096,685628,903468,,2941284,978.53,3917.83,0.0164,1168,209.71,241617.85,0.43,0.6798
8194,Wright Zuniga and Klein,False,US,Port Tracieside,AgriTech,2022,https://wrightzunigaandklein.com,Kind institution law life fast small character mouth.,21,wright-zuniga-and-klein,2023,USD,767196,391192,376004,185141,190863,13379,177484,7671,15343,162141,175306,655423,411976,243447,,767196,1910.57,3287.41,0.0023,357,178.9,2451.56,71.51,0.4901
8195,Kelley-Mcguire,False,US,West Tommymouth,HealthTech,2008,https://kelley-mcguire.com,So candidate rate standard environment.,22,kelley-mcguire,2023,USD,448405,143284,305121,69610,235511,0,235511,4484,8968,226543,26178,433046,21652,411394,37367.08,448405,393.76,1350.81,0.0743,743,50.27,36900.2,0.71,0.6805
8196,Dyer-Martin,False,CA,New Michaelmouth,IoT,2020,https://dyer-martin.com,Production about baby amount most church last water memory.,23,dyer-martin,2023,USD,470791,169819,300972,288097,12875,0,12875,4707,9415,3460,101553,379646,139766,239880,,470791,1430.37,10354.81,0.0768,301,130.15,24874.16,4.08,0.6393
8197,Malone-Anderson,False,AU,Heatherborough,AI/ML,2019,https://malone-anderson.com,Standard forward eight world citizen there occur.,18,malone-anderson,2023,USD,1026691,335201,691490,430460,261030,2911,258119,10266,20533,237586,14194,534587,26729,507858,,1026691,695.95,2866.57,0.0612,535,159.89,16811.96,0.84,0.6735
8198,Mann Ross and Smith,False,FR,Markland,IoT,2018,https://mannrossandsmith.com,Summer cover organization improve over.,21,mann-ross-and-smith,2023,EUR,493288,155236,338052,296680,41372,544,40828,4932,9865,30963,11900,435661,114365,321296,,493288,1036.59,5662.96,0.0383,522,78.7,28129.44,0.42,0.6853
8199,Mitchell Ross and Garcia,False,DE,Lisaton,Marketplaces,2022,https://mitchellrossandgarcia.com,Together simple far job century different east about.,23,mitchell-ross-and-garcia,2023,EUR,103225,18551,84674,5161,79513,0,79513,1032,2064,77449,8832,215516,91636,123880,,103225,734.36,5397.43,0.1049,189,45.29,7311.41,1.21,0.8203
8200,Ray-Garcia,False,EG,East Laura,AgriTech,2013,https://ray-garcia.com,Save reflect official smile result hospital rise.,22,ray-garcia,2023,USD,2759768,941036,1818732,407377,1411355,27446,1383909,27597,55195,1328714,173105,1659396,344891,1314505,,2759768,1337.68,3995.42,0.001,11499,20.0,7664.9,22.58,0.659
8201,Powell-Fields,False,TN,New Barbara,Energy,2014,https://powell-fields.com,Both travel can this which account onto hard computer before look.,19,powell-fields,2023,USD,771959,61173,710786,398883,311903,4786,307117,7719,15439,291678,103676,591167,249816,341351,,771959,288.61,1229.59,0.0178,311,206.51,43248.27,2.4,0.9208
8202,Jones LLC,False,GB,South Mark,IoT,2018,https://jonesllc.com,Dog across explain nothing treat.,23,jones-llc,2023,USD,494982,206392,288590,268982,19608,0,19608,4949,9899,9709,33772,428784,114680,314104,,494982,583.84,3683.85,0.001,2062,20.0,1000.0,33.77,0.583
8203,Wong-Thompson,False,TN,Davidchester,EdTech,2016,https://wong-thompson.com,Garden mind ahead lay lot eight interesting present agency.,16,wong-thompson,2023,USD,322231,108375,213856,74387,139469,0,139469,3222,6444,133025,25485,378313,270218,108095,26852.58,322231,326.44,694.73,0.0701,393,68.23,8193.76,3.11,0.6637
8204,Patel Ltd,False,GB,West Matthewchester,Mobility,2023,https://patelltd.com,Create because responsibility ball option Mrs site practice.,17,patel-ltd,2023,USD,131327,53338,77989,156798,-78809,0,-78809,1313,2626,-81435,639,240422,113229,127193,,131327,117.65,737.33,0.0249,35,306.56,1000.0,0.64,0.5939
8205,Castro and Sons,False,EG,East Christopherstad,E-commerce,2013,https://castroandsons.com,Paper force near opportunity will about.,24,castro-and-sons,2023,USD,2590016,804878,1785138,1563744,221394,0,221394,25900,51800,169594,382712,1766095,445353,1320742,,2590016,1580.54,6570.93,0.0183,10791,20.0,151777.42,2.52,0.6892
8206,Wood-Taylor,False,GB,North Tiffanyview,E-commerce,2012,https://wood-taylor.com,Investment with ago reduce firm.,17,wood-taylor,2023,USD,832842,264665,568177,503081,65096,24286,40810,8328,16656,24154,43635,614550,345792,268758,,832842,20.0,108.46,0.1063,328,211.24,59467.28,0.73,0.6822
8207,Harmon-Mcdonald,False,US,Port Neilfort,Energy,2010,https://harmon-mcdonald.com,Really person attack easy another stop.,18,harmon-mcdonald,2023,USD,13589943,4488147,9101796,3201390,5900406,0,5900406,135899,271798,5628608,849428,7758305,387915,7370390,,13589943,1574.98,2825.28,0.0988,44727,25.32,304608.87,2.79,0.6697
8208,Combs Ltd,False,TN,Sanchezchester,E-commerce,2010,https://combsltd.com,All specific dinner say avoid.,24,combs-ltd,2023,USD,1555999,645715,910284,436318,473966,17308,456658,15559,31119,425539,277222,1137586,345334,792252,,1555999,46.05,142.96,0.0623,1135,114.18,51662.11,5.37,0.585
8209,Freeman-Lambert,False,GB,South Jeremy,IoT,2012,https://freeman-lambert.com,Second tell development response man beyond.,22,freeman-lambert,2023,USD,245489,88704,156785,204472,-47687,0,-47687,2454,4909,-52596,46248,176225,73084,103141,,245489,499.04,1935.03,0.04,302,67.63,27176.73,1.7,0.6387
8210,Stewart Patterson and Cruz,False,US,Johnsonland,Marketplaces,2019,https://stewartpattersonandcruz.com,Case exactly listen practice compare movement again stuff site shoulder.,22,stewart-patterson-and-cruz,2023,USD,736028,341868,394160,427757,-33597,15482,-49079,7360,14720,-63799,27896,449945,200364,249581,,736028,1549.99,775.0,0.1295,512,119.63,27620.57,1.01,0.5355
8211,Gutierrez Campbell and Ayers,False,KE,New Deniseborough,Cybersecurity,2013,https://gutierrezcampbellandayers.com,His single skill watch fire.,25,gutierrez-campbell-and-ayers,2023,USD,901087,514154,386933,622703,-235770,12147,-247917,9010,18021,-265938,138602,739118,313334,425784,,901087,204.51,102.26,0.0322,512,146.51,49686.68,2.79,0.4294
8212,Mckinney Sanchez and Young,False,GB,Port Lisahaven,IoT,2017,https://mckinneysanchezandyoung.com,More door training Republican loss.,23,mckinney-sanchez-and-young,2023,USD,734791,235204,499587,395808,103779,2720,101059,7347,14695,86364,90420,639920,442644,197276,,734791,20.0,61.42,0.0957,574,106.61,18787.19,4.81,0.6799
8213,Brown Miller and Woods,False,FR,Dennisborough,Fintech,2018,https://brownmillerandwoods.com,Design believe decide form matter them carry technology man.,15,brown-miller-and-woods,2023,EUR,734038,202040,531998,140394,391604,23577,368027,7340,14680,353347,49065,469164,29398,439766,,734038,1902.7,8139.3,0.001,469,130.24,16601.84,2.96,0.7248
8214,Smith Hart and Atkinson,False,AU,East Emily,Energy,2014,https://smithhartandatkinson.com,Rise knowledge rise student tend drive group recent friend.,22,smith-hart-and-atkinson,2023,USD,754839,154467,600372,560242,40130,3091,37039,7548,15096,21943,21152,555432,141049,414383,,754839,81.65,428.67,0.0307,840,74.8,62077.39,0.34,0.7954
8215,Hartman-Skinner,False,US,Hamiltonhaven,HealthTech,2018,https://hartman-skinner.com,Including bed series the sea after water why school draw.,20,hartman-skinner,2023,USD,2382722,526398,1856324,1879129,-22805,12786,-35591,23827,47654,-83245,45454,1279515,280837,998678,198560.17,2382722,379.15,2204.43,0.0823,3946,50.31,170689.0,0.27,0.7791
8216,Carter Group,False,CA,Lake Davidtown,Marketplaces,2020,https://cartergroup.com,Beautiful prepare wonder rule minute pass.,27,carter-group,2023,USD,5714424,1763038,3951386,2552481,1398905,0,1398905,57144,114288,1284617,565264,3611383,2456025,1155358,,5714424,303.74,1028.38,0.0401,12191,39.06,224392.8,2.52,0.6915
8217,Leach Wilkins and Finley,False,DE,Christinetown,Energy,2015,https://leachwilkinsandfinley.com,Benefit phone a each save yet ask simply.,23,leach-wilkins-and-finley,2023,EUR,869366,58791,810575,456985,353590,603,352987,8693,17387,335600,77568,683953,331526,352427,,869366,20.0,77.86,0.001,347,208.43,36459.08,2.13,0.9324
8218,Phillips Stanley and Patton,False,EG,Adamborough,Marketplaces,2012,https://phillipsstanleyandpatton.com,Measure prevent choose example free field add fall brother significant.,16,phillips-stanley-and-patton,2023,USD,993515,463593,529922,443170,86752,0,86752,9935,19870,66882,85119,646361,32318,614043,,993515,1418.22,4648.89,0.0319,4139,20.0,1000.0,85.12,0.5334
8219,Murphy Dunn and Brown,False,BR,Smithshire,Energy,2013,https://murphydunnandbrown.com,Understand build buy oil economic.,25,murphy-dunn-and-brown,2023,USD,1861601,496308,1365293,957747,407546,3227,404319,18616,37232,367087,330490,1263847,793283,470564,,1861601,20.0,70.04,0.1035,7756,20.0,107780.93,3.07,0.7334
8220,Higgins Reese and Owens,False,KE,Huffberg,Cybersecurity,2017,https://higginsreeseandowens.com,Rock drop brother tax say response.,23,higgins-reese-and-owens,2023,USD,1734163,674642,1059521,722346,337175,0,337175,17341,34683,302492,59295,1025228,575377,449851,,1734163,704.59,2082.06,0.031,7225,20.0,24877.08,2.38,0.611
8221,Gonzalez-Ferrell,False,BR,Stephanieshire,HealthTech,2009,https://gonzalez-ferrell.com,Street five guess simple air maybe very approach.,14,gonzalez-ferrell,2023,USD,154927,40233,114694,16114,98580,16083,82497,1549,3098,79399,2197,137972,68741,69231,12910.58,154927,10.0,27.65,0.001,2582,5.0,58787.13,0.04,0.7403
8222,Santos Ltd,False,TN,Richardfort,Energy,2010,https://santosltd.com,Billion now another building situation.,24,santos-ltd,2023,USD,1580643,444788,1135855,897563,238292,0,238292,15806,31612,206680,57732,868950,43447,825503,,1580643,466.52,2404.63,0.1604,1121,117.46,90018.46,0.64,0.7186
8223,Allen Hardin and Garcia,False,CA,Gregoryside,Marketplaces,2016,https://allenhardinandgarcia.com,Guy artist course box night player into those make.,22,allen-hardin-and-garcia,2023,USD,2785826,1006868,1778958,1024480,754478,9227,745251,27858,55716,689535,56369,1626554,81327,1545227,,2785826,20.0,29.03,0.0424,8032,28.9,82035.77,0.69,0.6386
8224,Butler Hendricks and Williams,False,KE,East Benjamin,AI/ML,2008,https://butlerhendricksandwilliams.com,Glass notice official company candidate unit power increase.,16,butler-hendricks-and-williams,2023,USD,1986210,1008167,978043,1597321,-619278,0,-619278,19862,39724,-659002,242397,1344471,67223,1277248,,1986210,927.27,4930.18,0.0578,810,204.29,129604.01,1.87,0.4924
8225,Evans Gibson and Ellis,False,BR,Jessicamouth,Marketplaces,2018,https://evansgibsonandellis.com,Ground its write treat feel you bar language.,20,evans-gibson-and-ellis,2023,USD,1163804,213043,950761,553403,397358,0,397358,11638,23276,374082,336445,958603,322095,636508,,1163804,20.0,24.87,0.0889,1032,93.91,41899.13,8.03,0.8169
8226,Tran-Morris,False,FR,Port Vanessa,EdTech,2014,https://tran-morris.com,Story benefit remain require modern owner season such.,23,tran-morris,2023,EUR,1107366,554754,552612,394521,158091,0,158091,11073,22147,135944,19691,656058,307868,348190,92280.5,1107366,278.15,965.25,0.001,755,122.2,15386.02,1.28,0.499
8227,Mendoza and Sons,False,ZA,West Ericstad,Fintech,2015,https://mendozaandsons.com,Everybody hair benefit public one hundred popular time information public.,16,mendoza-and-sons,2023,USD,1640566,1037559,603007,963569,-360562,0,-360562,16405,32811,-393373,102718,1099118,440142,658976,,1640566,1757.6,6791.91,0.0638,649,210.48,84187.56,1.22,0.3676
8228,Camacho-Dean,False,BR,Smithbury,AI/ML,2009,https://camacho-dean.com,Stage technology sometimes Republican theory season life could.,19,camacho-dean,2023,USD,563472,140591,422881,64078,358803,27425,331378,5634,11269,320109,17284,354711,70900,283811,,563472,20.0,10.0,0.0365,700,67.05,44249.85,0.39,0.7505
8229,Green PLC,False,US,Port Jeremiahton,AgriTech,2015,https://greenplc.com,Nearly strategy serious of one.,24,green-plc,2023,USD,389859,167623,222236,109287,112949,17678,95271,3898,7797,87474,55388,290250,188512,101738,,389859,20.0,144.42,0.1089,1624,20.0,10627.76,5.21,0.57
8230,Morgan-Nunez,False,ZA,Port Robinmouth,HealthTech,2010,https://morgan-nunez.com,Must more television social deep nice fish table.,13,morgan-nunez,2023,USD,286408,159613,126795,239802,-113007,0,-113007,2864,5728,-118735,28870,227314,11365,215949,23867.33,286408,375.06,2472.91,0.0508,275,86.52,20872.32,1.38,0.4427
8231,Williams Ltd,False,BR,Buckhaven,Fintech,2013,https://williamsltd.com,Wish then but front.,20,williams-ltd,2023,USD,396340,178498,217842,233715,-15873,12217,-28090,3963,7926,-36016,3820,371151,145647,225504,,396340,20.0,28.16,0.001,1651,20.0,1000.0,3.82,0.5496
8232,Matthews-Richardson,False,GB,Benjaminmouth,Fintech,2013,https://matthews-richardson.com,Central leave whom economic society.,18,matthews-richardson,2023,USD,1642476,704644,937832,910963,26869,0,26869,16424,32849,-5980,89428,1080922,667739,413183,,1642476,863.35,1695.13,0.0827,2412,56.74,90183.36,0.99,0.571
8233,Rivera Mcdonald and Graves,False,AU,East Jessicachester,Fintech,2019,https://riveramcdonaldandgraves.com,I well almost quality parent international.,14,rivera-mcdonald-and-graves,2023,USD,5300147,1622258,3677889,3813250,-135361,19153,-154514,53001,106002,-260516,219078,2997350,457103,2540247,,5300147,957.6,2763.04,0.0808,2894,152.59,320292.2,0.68,0.6939
8234,Gonzales-Washington,False,ZA,Ramirezshire,AgriTech,2024,https://gonzales-washington.com,Actually job success quickly wind week heavy mind.,32,gonzales-washington,2023,USD,942902,506719,436183,386523,49660,32152,17508,9429,18858,-1350,74603,565096,28254,536842,,942902,1701.58,2666.9,0.001,3928,20.0,48318.9,1.54,0.4626
8235,Decker PLC,False,BR,New Amymouth,Fintech,2019,https://deckerplc.com,Grow Democrat we entire along.,20,decker-plc,2023,USD,4825256,1400646,3424610,2187190,1237420,0,1237420,48252,96505,1140915,69176,2591945,641063,1950882,,4825256,296.05,148.02,0.0137,20105,20.0,193980.34,0.36,0.7097
8236,Griffin Hopkins and Ward,False,NG,West Darren,HealthTech,2021,https://griffinhopkinsandward.com,Quite democratic election protect sister break animal new.,17,griffin-hopkins-and-ward,2023,USD,2894034,972773,1921261,1284850,636411,2838,633573,28940,57880,575693,146104,1709583,85479,1624104,241169.5,2894034,10.0,79.24,0.0208,48233,5.0,100369.73,1.46,0.6639
8237,Gutierrez-Wade,False,NG,New Sarahburgh,Energy,2023,https://gutierrez-wade.com,Process book bed two middle partner blood consider.,18,gutierrez-wade,2023,USD,842417,405262,437155,42120,395035,0,395035,8424,16848,378187,50370,668200,333523,334677,,842417,319.82,633.52,0.0298,995,70.5,47729.2,1.06,0.5189
8238,Perez-Herrera,False,TN,Samanthahaven,AgriTech,2008,https://perez-herrera.com,Mother several month near data art late community.,15,perez-herrera,2023,USD,62407,8218,54189,30695,23494,278,23216,624,1248,21968,9596,82845,39238,43607,,62407,751.58,598.27,0.0583,19,266.0,1000.0,9.6,0.8683
8239,Medina Inc,False,FR,East Hayden,IoT,2011,https://medinainc.com,Whose picture price attack those chair.,18,medina-inc,2023,EUR,491967,163649,328318,245427,82891,19451,63440,4919,9839,53601,25878,337887,59887,278000,,491967,383.98,1236.92,0.066,120,340.3,12776.76,2.03,0.6674
8240,Alexander Griffin and Roberts,False,NG,South Jasonshire,E-commerce,2016,https://alexandergriffinandroberts.com,Certainly left despite office.,17,alexander-griffin-and-roberts,2023,USD,250645,92505,158140,233827,-75687,8049,-83736,2506,5012,-88748,6365,245744,12287,233457,,250645,20.0,46.45,0.0944,60,344.69,12521.85,0.51,0.6309
8241,Watson-Wagner,False,NG,Josephland,AI/ML,2009,https://watson-wagner.com,Process animal issue black word positive.,16,watson-wagner,2023,USD,279509,42500,237009,136463,100546,10776,89770,2795,5590,84180,17755,292158,103698,188460,,279509,489.74,1925.03,0.0684,122,190.04,17527.34,1.01,0.8479
8242,Price Park and Gentry,False,TN,Trevinoshire,AgriTech,2017,https://priceparkandgentry.com,Mention explain experience fly nice.,21,price-park-and-gentry,2023,USD,354700,188029,166671,177356,-10685,22910,-33595,3547,7094,-40689,12201,384872,119456,265416,,354700,1913.53,3154.92,0.0989,1477,20.0,40612.13,0.3,0.4699
8243,Roach Johnston and Rose,False,AU,Shannonmouth,HealthTech,2008,https://roachjohnstonandrose.com,Well eat child mean political agency theory.,22,roach-johnston-and-rose,2023,USD,369702,124442,245260,193676,51584,0,51584,3697,7394,44190,15476,211381,101305,110076,30808.5,369702,760.97,2544.34,0.0199,6161,5.0,29261.86,0.53,0.6634
8244,Hernandez Ltd,False,US,Elizabethside,Energy,2013,https://hernandezltd.com,There house either traditional ability exactly.,15,hernandez-ltd,2023,USD,1131631,482573,649058,359401,289657,40765,248892,11316,22632,226260,175529,825347,507820,317527,,1131631,20.0,22.01,0.015,367,256.33,25401.0,6.91,0.5736
8245,Kelly Ltd,False,KE,West Brianville,AI/ML,2023,https://kellyltd.com,Someone customer through line order.,16,kelly-ltd,2023,USD,390959,181141,209818,216965,-7147,4581,-11728,3909,7819,-19547,5193,347906,191853,156053,,390959,447.48,237.3,0.0853,203,160.21,1366.7,3.8,0.5367
8246,White Miller and Gomez,False,EG,Thompsonborough,Marketplaces,2024,https://whitemillerandgomez.com,Government Mr show contain two move some.,19,white-miller-and-gomez,2023,USD,451170,116432,334738,130961,203777,11093,192684,4511,9023,183661,30517,322400,89153,233247,,451170,955.27,5140.48,0.001,243,154.59,2914.01,10.47,0.7419
8247,Pratt-Garcia,False,EG,Cummingsville,EdTech,2018,https://pratt-garcia.com,Away social detail likely fine degree sign five current.,24,pratt-garcia,2023,USD,32984,10350,22634,20829,1805,36352,-34547,329,659,-35206,22886,221438,40592,180846,2748.67,32984,335.53,335.53,0.001,549,5.0,4109.44,5.57,0.6862
8248,Hernandez-Nguyen,False,NG,Kimberlyberg,E-commerce,2020,https://hernandez-nguyen.com,Open time big job perhaps specific factor.,21,hernandez-nguyen,2023,USD,1044715,491789,552926,693218,-140292,0,-140292,10447,20894,-161186,101100,802533,343510,459023,,1044715,20.0,26.56,0.0486,4352,20.0,60681.67,1.67,0.5293
8249,Carter Liu and Mann,False,BR,Markberg,Energy,2017,https://carterliuandmann.com,Him show your among summer old carry itself.,18,carter-liu-and-mann,2023,USD,6476711,2149755,4326956,4697208,-370252,0,-370252,64767,129534,-499786,149487,3527806,1349021,2178785,,6476711,20.0,11.72,0.001,1990,271.21,408747.21,0.37,0.6681
8250,Knight Parker and Brown,False,TN,Mitchellburgh,Cybersecurity,2017,https://knightparkerandbrown.com,Ok week move thank camera yourself policy Congress.,21,knight-parker-and-brown,2023,USD,2376337,396011,1980326,579565,1400761,0,1400761,23763,47526,1353235,246885,1438821,790989,647832,,2376337,20.0,16.54,0.0732,1083,182.71,18781.46,13.15,0.8334
8251,Lopez Inc,False,AU,Lake Tara,Cybersecurity,2011,https://lopezinc.com,Late who personal its article company four character experience.,17,lopez-inc,2023,USD,438121,197146,240975,375302,-134327,0,-134327,4381,8762,-143089,15299,410723,140305,270418,,438121,1200.34,3644.61,0.078,290,125.63,21978.62,0.7,0.55
8252,Anderson Ltd,False,KE,Deantown,Energy,2012,https://andersonltd.com,Recent thousand leave oil occur out.,18,anderson-ltd,2023,USD,2254799,569585,1685214,844851,840363,16088,824275,22547,45095,779180,99963,1332174,66608,1265566,,2254799,20.0,45.63,0.0373,853,220.27,58740.31,1.7,0.7474
8253,Sanchez LLC,False,DE,Brownhaven,AgriTech,2013,https://sanchezllc.com,Least daughter contain age respond left while you.,15,sanchez-llc,2023,EUR,592143,314007,278136,405096,-126960,16411,-143371,5921,11842,-155213,19906,442036,360810,81226,,592143,236.53,1021.4,0.0044,2467,20.0,73614.91,0.27,0.4697
8254,Davis-Williams,False,FR,Richardsfort,IoT,2012,https://davis-williams.com,Training product sit hold candidate under.,25,davis-williams,2023,EUR,1769802,601408,1168394,945345,223049,5676,217373,17698,35396,181977,35150,1117643,64974,1052669,,1769802,666.52,1191.51,0.0575,780,188.92,81497.4,0.43,0.6602
8255,Cortez Norris and Sandoval,False,ZA,Sueborough,Energy,2012,https://corteznorrisandsandoval.com,Particular argue board would try finally yes feel when police.,21,cortez-norris-and-sandoval,2023,USD,2113096,1123759,989337,216488,772849,17507,755342,21130,42261,713081,62847,1253356,339421,913935,,2113096,1008.78,5403.46,0.0356,8804,20.0,1000.0,62.85,0.4682
8256,Jenkins-Medina,False,GB,Davisville,Fintech,2014,https://jenkins-medina.com,Produce house weight scientist quickly herself sort movie rock impact.,15,jenkins-medina,2023,USD,593340,219884,373456,334675,38781,10213,28568,5933,11866,16702,6624,404912,267856,137056,,593340,1889.26,11203.08,0.001,2472,20.0,39892.58,0.17,0.6294
8257,Pope Inc,False,GB,Port Mauriceberg,SaaS,2017,https://popeinc.com,Design cut wonder young good leave machine.,25,pope-inc,2023,USD,1566593,438402,1128191,1074284,53907,26696,27211,15665,31331,-4120,143233,1124270,255851,868419,130549.42,1566593,760.64,2438.74,0.0457,3557,36.7,96085.84,1.49,0.7202
8258,Gilmore-Russell,False,ZA,Port Cynthia,Fintech,2009,https://gilmore-russell.com,Throughout main dark stage goal.,14,gilmore-russell,2023,USD,1165393,544624,620769,58269,562500,0,562500,11653,23307,539193,62647,842424,70980,771444,,1165393,722.98,908.8,0.092,4855,20.0,16573.07,3.78,0.5327
8259,Jones PLC,False,IN,Rhondaberg,HealthTech,2016,https://jonesplc.com,Leave soldier his sound ever inside enjoy effort financial.,16,jones-plc,2023,USD,2420635,1548983,871652,440863,430789,0,430789,24206,48412,382377,39277,1340651,534251,806400,201719.58,2420635,674.02,4106.74,0.0095,40343,5.0,5549.1,7.08,0.3601
8260,Lewis Group,False,NG,West Gabrielle,EdTech,2011,https://lewisgroup.com,Lawyer on or according prove TV hundred far.,25,lewis-group,2023,USD,59944,21497,38447,36663,1784,14233,-12449,599,1198,-13647,459,145432,62919,82513,4995.33,59944,215.22,952.62,0.0063,170,29.32,1000.0,0.46,0.6414
8261,Santiago Garcia and Jones,False,IN,East Stacychester,Cybersecurity,2023,https://santiagogarciaandjones.com,Either writer tonight maintain management allow property speak.,17,santiago-garcia-and-jones,2023,USD,1611766,80588,1531178,454138,1077040,41303,1035737,16117,32235,1003502,214770,1043432,321477,721955,,1611766,20.0,41.63,0.0321,1341,100.11,30348.8,7.08,0.95
8262,Butler White and Mcintosh,False,NG,Daniellebury,IoT,2011,https://butlerwhiteandmcintosh.com,Control old mean war probably young number one common card note.,29,butler-white-and-mcintosh,2023,USD,2179386,1187225,992161,965776,26385,5025,21360,21793,43587,-22227,123090,1322619,403997,918622,,2179386,20.0,10.0,0.0851,1020,178.03,70306.47,1.75,0.4552
8263,Wright Goodman and Zavala,False,FR,West Rogerbury,Mobility,2022,https://wrightgoodmanandzavala.com,Leader market newspaper trial something show third sit billion capital.,23,wright-goodman-and-zavala,2023,EUR,263212,93462,169750,195184,-25434,1236,-26670,2632,5264,-31934,16723,153585,107138,46447,,263212,1218.9,609.45,0.0939,1096,20.0,1000.0,16.72,0.6449
8264,Miller-Rice,False,GB,Markland,Energy,2016,https://miller-rice.com,Black that operation treat short wish.,24,miller-rice,2023,USD,3036322,1090800,1945522,1430542,514980,2065,512915,30363,60726,452189,110703,1646930,392293,1254637,,3036322,623.7,530.49,0.1129,1458,173.46,131713.53,0.84,0.6407
8265,Ford-Cole,False,KE,Sloanstad,Cybersecurity,2024,https://ford-cole.com,He hotel management kitchen manage out nearly.,21,ford-cole,2023,USD,956990,202404,754586,668251,86335,16502,69833,9569,19139,50694,16504,563068,283300,279768,,956990,338.07,1253.15,0.0172,3987,20.0,63576.31,0.26,0.7885
8266,Brown and Sons,False,FR,Lake Stephenside,Marketplaces,2013,https://brownandsons.com,Generation this through exactly newspaper now.,28,brown-and-sons,2023,EUR,1896127,632686,1263441,94806,1168635,11734,1156901,18961,37922,1118979,36054,1147124,112400,1034724,,1896127,20.0,95.05,0.0871,560,282.09,16398.96,2.2,0.6663
8267,Ware-Washington,False,NG,Medinaborough,Cybersecurity,2014,https://ware-washington.com,According conference week garden action politics show public citizen.,24,ware-washington,2023,USD,1240684,471412,769272,333699,435573,0,435573,12406,24813,410760,90290,835764,203614,632150,,1240684,204.65,987.94,0.001,1041,99.27,41410.84,2.18,0.62
8268,Johnson Group,False,FR,Clarkshire,Cybersecurity,2008,https://johnsongroup.com,Sell heart recognize hear from.,27,johnson-group,2023,EUR,3308677,1401539,1907138,2695124,-787986,0,-787986,33086,66173,-854159,139440,1804041,592779,1211262,,3308677,1315.53,5603.53,0.0667,2041,135.07,234063.31,0.6,0.5764
8269,Garcia-Mcfarland,False,US,Andradeport,EdTech,2021,https://garcia-mcfarland.com,Admit crime whole surface already.,19,garcia-mcfarland,2023,USD,1258405,767080,491325,1157227,-665902,0,-665902,12584,25168,-691070,30821,661173,182673,478500,104867.08,1258405,10.0,59.09,0.0216,20973,5.0,117833.73,0.26,0.3904
8270,Brown-Arroyo,False,TN,Vincentfurt,Energy,2008,https://brown-arroyo.com,Night collection claim future deal management you.,20,brown-arroyo,2023,USD,2158472,833226,1325246,107923,1217323,24212,1193111,21584,43169,1149942,217320,1428495,443004,985491,,2158472,1774.64,8610.97,0.0291,819,219.36,28877.73,7.53,0.614
8271,Wilson Group,False,ZA,Kemphaven,Cybersecurity,2013,https://wilsongroup.com,Little unit avoid ahead point low create spring old recognize.,22,wilson-group,2023,USD,411618,50493,361125,20580,340545,0,340545,4116,8232,332313,11286,257179,92684,164495,,411618,783.27,3980.32,0.0729,117,291.33,9615.78,1.17,0.8773
8272,Sheppard PLC,False,ZA,West Bethville,SaaS,2009,https://sheppardplc.com,Although police site once know reflect instead prevent middle upon.,21,sheppard-plc,2023,USD,610201,153637,456564,61580,394984,4139,390845,6102,12204,378641,54752,448460,111294,337166,50850.08,610201,10.0,21.66,0.001,6270,8.11,14898.37,3.68,0.7482
8273,Green-Evans,False,US,South Suzannechester,E-commerce,2014,https://green-evans.com,Throughout four thought themselves tree reach pay natural news.,16,green-evans,2023,USD,778149,310512,467637,287884,179753,0,179753,7781,15562,164191,50043,517487,237142,280345,,778149,20.0,114.22,0.054,898,72.21,30318.78,1.65,0.601
8274,Johnson Chambers and Jenkins,False,ZA,North Lisaburgh,HealthTech,2018,https://johnsonchambersandjenkins.com,Make call lay such tax set anyone risk cold town.,13,johnson-chambers-and-jenkins,2023,USD,990299,336276,654023,207235,446788,0,446788,9902,19805,426983,10846,586588,156127,430461,82524.92,990299,259.61,1006.66,0.0156,16504,5.0,31818.88,0.34,0.6604
8275,Mcdonald James and Price,False,DE,Kevinchester,AI/ML,2020,https://mcdonaldjamesandprice.com,Example area mission cost game under only.,22,mcdonald-james-and-price,2023,EUR,4642987,1541826,3101161,4551439,-1450278,0,-1450278,46429,92859,-1543137,248150,2597954,1802594,795360,,4642987,344.08,1638.8,0.0919,4684,82.6,401309.61,0.62,0.6679
8276,Martin-Price,False,DE,South Natalieville,Fintech,2008,https://martin-price.com,Wrong coach long without religious late others.,12,martin-price,2023,EUR,5503206,2903065,2600141,3517287,-917146,0,-917146,55032,110064,-1027210,160667,2937712,1317596,1620116,,5503206,1327.94,4541.91,0.0394,1535,298.59,309974.4,0.52,0.4725
8277,Wilkins Group,False,CA,Aliton,Marketplaces,2009,https://wilkinsgroup.com,Free always second prove right institution same.,16,wilkins-group,2023,USD,152485,72567,79918,52690,27228,8009,19219,1524,3049,16170,4628,226626,109329,117297,,152485,20.0,51.08,0.0545,134,94.54,1000.0,4.63,0.5241
8278,Dickson Henderson and Schultz,False,CA,Reedville,HealthTech,2016,https://dicksonhendersonandschultz.com,Job recent measure may whether position business middle already maintain.,15,dickson-henderson-and-schultz,2023,USD,591174,251087,340087,365182,-25095,0,-25095,5911,11823,-36918,14677,388972,50134,338838,49264.5,591174,793.99,4108.3,0.0059,901,54.67,1000.0,14.68,0.5753
8279,Hodges Adams and Callahan,False,DE,Jordanfurt,AI/ML,2015,https://hodgesadamsandcallahan.com,Tax out last common perform firm quickly turn world fish.,22,hodges-adams-and-callahan,2023,EUR,1928811,660962,1267849,283985,983864,0,983864,19288,38576,945288,74254,1204613,702317,502296,,1928811,20.0,51.43,0.0408,2159,74.42,32502.62,2.28,0.6573
8280,Pierce-Reyes,False,NG,West Jo,Cybersecurity,2008,https://pierce-reyes.com,As today any green father end.,22,pierce-reyes,2023,USD,510573,139192,371381,390850,-19469,0,-19469,5105,10211,-29680,34529,372473,233048,139425,,510573,837.02,4292.11,0.0181,345,123.04,9326.69,3.7,0.7274
8281,Miller-Page,False,CA,Port Nicolebury,AI/ML,2013,https://miller-page.com,Stand work prepare way last class next back throw.,14,miller-page,2023,USD,2507814,684556,1823258,1006155,817103,32632,784471,25078,50156,734315,365524,1801208,640527,1160681,,2507814,20.0,10.0,0.0211,1292,161.69,91667.27,3.99,0.727
8282,Wright Macdonald and Morrow,False,TN,West Vicki,IoT,2013,https://wrightmacdonaldandmorrow.com,White leg design federal oil.,25,wright-macdonald-and-morrow,2023,USD,1429298,318292,1111006,406526,704480,27741,676739,14292,28585,648154,19612,751278,382545,368733,,1429298,2319.78,8201.05,0.1289,764,155.76,38665.64,0.51,0.7773
8283,Fernandez Barnes and Rice,False,BR,West Joseberg,IoT,2009,https://fernandezbarnesandrice.com,Range charge race by.,20,fernandez-barnes-and-rice,2023,USD,855879,358774,497105,601639,-104534,0,-104534,8558,17117,-121651,32539,543396,83422,459974,,855879,869.59,5366.87,0.0675,3566,20.0,58694.85,0.55,0.5808
8284,Moody-Grimes,False,US,North Vickiton,Mobility,2020,https://moody-grimes.com,Else professor Democrat natural manage garden black resource right person heavy.,22,moody-grimes,2023,USD,385781,112974,272807,90029,182778,24108,158670,3857,7715,150955,9899,396087,82751,313336,,385781,20.0,46.22,0.0342,207,155.24,1000.0,9.9,0.7072
8285,Gamble Briggs and Bird,False,NG,Lake Hannahport,Cybersecurity,2021,https://gamblebriggsandbird.com,Such not your degree including civil ability special mention professor.,16,gamble-briggs-and-bird,2023,USD,524202,74807,449395,410045,39350,0,39350,5242,10484,28866,5202,301342,169367,131975,,524202,739.55,2882.99,0.0919,425,102.62,73322.09,0.07,0.8573
8286,Cooke-Cook,False,GB,Jamieberg,Mobility,2021,https://cooke-cook.com,Everyone surface picture just seek school summer.,13,cooke-cook,2023,USD,887792,191472,696320,283124,413196,0,413196,8877,17755,395441,86588,641760,180345,461415,,887792,608.12,304.06,0.0554,2655,27.86,37913.68,2.28,0.7843
8287,Morales-Maxwell,False,DE,South Claire,EdTech,2013,https://morales-maxwell.com,Man become million against meet then specific or success east.,16,morales-maxwell,2023,EUR,420162,225396,194766,258919,-64153,0,-64153,4201,8403,-72556,23836,253268,95153,158115,35013.5,420162,477.71,1877.74,0.0501,672,52.08,14601.56,1.63,0.4635
8288,Horton Smith and Hull,False,NG,Elizabethland,EdTech,2024,https://hortonsmithandhull.com,Guess hour growth training huge fund.,21,horton-smith-and-hull,2023,USD,169920,41229,128691,67391,61300,24071,37229,1699,3398,33831,8993,164246,31532,132714,14160.0,169920,28.28,45.19,0.0328,332,42.61,15424.82,0.58,0.7574
8289,Townsend and Sons,False,KE,Lucerohaven,Energy,2014,https://townsendandsons.com,Eat full them her safe anyone scene theory bag mouth.,22,townsend-and-sons,2023,USD,3062993,994130,2068863,153149,1915714,0,1915714,30629,61259,1854455,341921,1914994,342551,1572443,,3062993,20.0,71.57,0.047,3748,68.1,24910.47,13.73,0.6754
8290,Dillon-Thompson,False,DE,Natalieland,Mobility,2021,https://dillon-thompson.com,Great thing anyone quality serious lot week.,23,dillon-thompson,2023,EUR,2893628,730695,2162933,1325035,837898,0,837898,28936,57872,780026,104125,1648024,942138,705886,,2893628,20.0,74.42,0.1154,857,281.1,112796.57,0.92,0.7475
8291,Johnson-Lewis,False,ZA,North Erinborough,Fintech,2024,https://johnson-lewis.com,Then explain should buy black upon.,19,johnson-lewis,2023,USD,1394182,584335,809847,69709,740138,8051,732087,13941,27883,704204,47453,787287,81109,706178,,1394182,20.0,30.81,0.0017,1405,82.68,35199.78,1.35,0.5809
8292,Adams Rosales and White,False,CA,South Kimberlymouth,Marketplaces,2011,https://adamsrosalesandwhite.com,Quality few agency future authority recent wife worker wife fall.,18,adams-rosales-and-white,2023,USD,1828892,198925,1629967,532776,1097191,12024,1085167,18288,36577,1048590,65659,1053357,427555,625802,,1828892,1835.54,5335.15,0.1227,1030,147.91,56110.46,1.17,0.8912
8293,Martin-Huang,False,BR,Lake Sarah,AI/ML,2020,https://martin-huang.com,Show believe record think before position thing notice.,23,martin-huang,2023,USD,6120625,1865380,4255245,2539633,1715612,26909,1688703,61206,122412,1566291,846297,4057099,1128632,2928467,,6120625,1395.9,1850.41,0.0168,9426,54.11,230775.39,3.67,0.6952
8294,Lynch-Hernandez,False,GB,North Sarahville,Energy,2022,https://lynch-hernandez.com,Stock seem item tonight everything side will because.,28,lynch-hernandez,2023,USD,15175283,4356257,10819026,16627013,-5807987,26203,-5834190,151752,303505,-6137695,626811,8348958,4737999,3610959,,15175283,20.0,77.02,0.0515,63230,20.0,1360366.95,0.46,0.7129
8295,Carr Hill and Olson,False,FR,Deanfurt,EdTech,2021,https://carrhillandolson.com,By gas yard small may.,26,carr-hill-and-olson,2023,EUR,158219,91930,66289,70134,-3845,0,-3845,1582,3164,-7009,25413,142712,59816,82896,13184.92,158219,369.96,1072.2,0.0064,2636,5.0,1000.0,25.41,0.419
8296,Jones-Alexander,False,NG,Jenniferview,AgriTech,2011,https://jones-alexander.com,Two cost policy structure politics visit.,14,jones-alexander,2023,USD,51034,25439,25595,2551,23044,4748,18296,510,1020,17276,39164,111881,42237,69644,,51034,1084.96,4962.22,0.001,10,411.95,1000.0,39.16,0.5015
8297,Lee Mitchell and Hess,False,US,Harrismouth,Fintech,2014,https://leemitchellandhess.com,These everyone edge assume get against.,24,lee-mitchell-and-hess,2023,USD,3526485,1777441,1749044,3345733,-1596689,26788,-1623477,35264,70529,-1694006,101419,1965475,517283,1448192,,3526485,1068.9,2364.42,0.0401,2224,132.13,293296.84,0.35,0.496
8298,Becker-Chang,False,GB,North Maria,Marketplaces,2024,https://becker-chang.com,Beyond standard listen series beautiful sit sometimes.,22,becker-chang,2023,USD,2076569,1077560,999009,1093382,-94373,18134,-112507,20765,41531,-154038,298349,1485718,393817,1091901,,2076569,20.0,79.51,0.001,8652,20.0,66943.02,4.46,0.4811
8299,Butler Haynes and Thompson,False,AU,South Ryan,HealthTech,2014,https://butlerhaynesandthompson.com,Poor student age suffer get artist benefit.,19,butler-haynes-and-thompson,2023,USD,330751,89220,241531,75322,166209,6144,160065,3307,6615,153450,14420,260557,120568,139989,27562.58,330751,53.86,153.38,0.0387,266,103.37,18355.97,0.79,0.7303
8300,Hinton Taylor and Young,False,DE,West Paulside,Cybersecurity,2012,https://hintontaylorandyoung.com,Statement teach social they process.,22,hinton-taylor-and-young,2023,EUR,841133,379747,461386,546023,-84637,54914,-139551,8411,16822,-156373,21101,555796,327956,227840,,841133,1414.44,5748.73,0.001,241,290.66,41541.55,0.51,0.5485
8301,Carroll-Cochran,False,FR,South Sarachester,Marketplaces,2024,https://carroll-cochran.com,Attorney stage including student about key attention fine outside decision.,20,carroll-cochran,2023,EUR,454329,173736,280593,102144,178449,0,178449,4543,9086,169363,34323,297648,136520,161128,,454329,344.17,1541.77,0.0487,213,177.08,9219.01,3.72,0.6176
8302,Lee and Sons,False,ZA,East Erin,EdTech,2019,https://leeandsons.com,Keep shake since local condition.,28,lee-and-sons,2023,USD,2050103,831422,1218681,587174,631507,39894,591613,20501,41002,550611,25790,1181101,411965,769136,170841.92,2050103,10.0,34.64,0.0521,2123,80.45,29573.11,0.87,0.5944
8303,Stevens Inc,False,GB,South Ryan,Mobility,2010,https://stevensinc.com,Political set other anyone girl laugh body clear security third.,15,stevens-inc,2023,USD,2832032,474269,2357763,824119,1533644,5936,1527708,28320,56640,1471068,77968,1526345,686123,840222,,2832032,20.0,106.45,0.0466,1335,176.66,57931.6,1.35,0.8325
8304,Small LLC,False,NG,Rebeccatown,Mobility,2018,https://smallllc.com,Exactly case its civil more professor today forget.,19,small-llc,2023,USD,569048,134342,434706,111122,323584,24471,299113,5690,11380,287733,39956,359712,242886,116826,,569048,166.24,366.16,0.0363,181,261.89,5156.51,7.75,0.7639
8305,Wagner-Butler,False,ZA,Andersonburgh,Cybersecurity,2008,https://wagner-butler.com,Government start politics administration body detail fund trouble street organization.,22,wagner-butler,2023,USD,2609139,809006,1800133,1164717,635416,18256,617160,26091,52182,564978,50701,1381239,775733,605506,,2609139,412.93,2359.09,0.0122,3562,61.04,86112.41,0.59,0.6899
8306,Evans PLC,False,TN,Jenningsmouth,Mobility,2023,https://evansplc.com,Account culture risk rock road firm.,15,evans-plc,2023,USD,144024,51018,93006,47248,45758,0,45758,1440,2880,42878,12547,248034,103526,144508,,144024,20.0,31.14,0.1561,123,97.03,15092.41,0.83,0.6458
8307,Estrada Group,False,TN,Port Jerry,Fintech,2009,https://estradagroup.com,Ago reduce represent all lead beyond member.,20,estrada-group,2023,USD,3541896,2229767,1312129,972905,339224,0,339224,35418,70837,268387,102993,2064336,103216,1961120,,3541896,20.0,10.0,0.083,1895,155.74,72811.64,1.41,0.3705
8308,Wilson Villarreal and Velasquez,False,TN,Philipview,Marketplaces,2019,https://wilsonvillarrealandvelasquez.com,Project line particular quickly seek movie adult wall.,22,wilson-villarreal-and-velasquez,2023,USD,687363,273090,414273,299122,115151,11107,104044,6873,13747,90297,10153,464472,132964,331508,,687363,20.0,10.0,0.0617,399,143.48,49930.04,0.2,0.6027
8309,Miller PLC,False,KE,Port Johnville,HealthTech,2008,https://millerplc.com,Company poor whose lose carry majority have improve adult me teacher.,18,miller-plc,2023,USD,820548,200225,620323,500005,120318,0,120318,8205,16410,103908,35623,453624,289853,163771,68379.0,820548,419.29,2310.06,0.0093,567,120.42,28732.37,1.24,0.756
8310,Porter PLC,False,BR,East Timothy,AI/ML,2024,https://porterplc.com,Can compare exactly left box sit born resource.,7,porter-plc,2023,USD,6214102,2296606,3917496,1681688,2235808,35317,2200491,62141,124282,2076209,1248557,4436132,2761918,1674214,,6214102,327.08,1046.91,0.122,1615,320.59,147136.98,8.49,0.6304
8311,Schneider Wright and Miller,False,FR,Port Rachel,Marketplaces,2016,https://schneiderwrightandmiller.com,Low with low activity join individual close.,24,schneider-wright-and-miller,2023,EUR,652627,268101,384526,159344,225182,11881,213301,6526,13052,200249,14089,497347,142510,354837,,652627,1073.53,940.1,0.0919,869,62.56,1000.0,14.09,0.5892
8312,Allen Keller and Beltran,False,DE,North John,Fintech,2012,https://allenkellerandbeltran.com,Reality guy growth west care free gas still other.,25,allen-keller-and-beltran,2023,EUR,1410627,646519,764108,330819,433289,10302,422987,14106,28212,394775,31835,754734,176753,577981,,1410627,203.28,310.81,0.001,620,189.42,25537.13,1.25,0.5417
8313,Williamson-Thomas,False,EG,Alecside,IoT,2022,https://williamson-thomas.com,Choice politics at few remember.,21,williamson-thomas,2023,USD,781092,329309,451783,340207,111576,49203,62373,7810,15621,46752,65875,456794,148421,308373,,781092,1010.97,670.54,0.0988,3254,20.0,30787.26,2.14,0.5784
8314,Bullock and Sons,False,TN,North Christophershire,Fintech,2022,https://bullockandsons.com,Force woman business toward thank alone.,19,bullock-and-sons,2023,USD,1491134,601418,889716,324002,565714,12971,552743,14911,29822,522921,13247,891967,237491,654476,,1491134,408.73,204.36,0.112,714,173.88,45572.1,0.29,0.5967
8315,Martinez Inc,False,NG,Jamesberg,Cybersecurity,2011,https://martinezinc.com,Already morning agency sure Republican price capital talk.,11,martinez-inc,2023,USD,586145,200664,385481,334721,50760,3330,47430,5861,11722,35708,23089,340979,17048,323931,,586145,329.5,1817.4,0.001,1226,39.83,22569.8,1.02,0.6577
8316,Rodriguez Johnson and Cummings,False,CA,Fosterburgh,IoT,2021,https://rodriguezjohnsonandcummings.com,Group he have score process medical old product may case.,20,rodriguez-johnson-and-cummings,2023,USD,1933018,248531,1684487,647583,1036904,16101,1020803,19330,38660,982143,43407,1209171,426121,783050,,1933018,281.99,358.81,0.0797,5961,27.02,58533.44,0.74,0.8714
8317,Anderson Ltd,False,KE,Ronaldfort,AI/ML,2015,https://andersonltd.com,If most wish once will raise raise yes.,21,anderson-ltd,2023,USD,369376,187918,181458,163442,18016,32242,-14226,3693,7387,-21613,49113,311577,60004,251573,,369376,1243.91,3303.01,0.0791,1539,20.0,1000.0,49.11,0.4913
8318,Johnson-Hodge,False,NG,Martinezborough,Cybersecurity,2017,https://johnson-hodge.com,Few get show teach would add middle against cut.,13,johnson-hodge,2023,USD,295584,108410,187174,134061,53113,0,53113,2955,5911,47202,44291,371319,133798,237521,,295584,620.19,873.6,0.0464,99,248.8,10702.38,4.14,0.6332
8319,Robertson-Perez,False,CA,New Gabriella,Marketplaces,2023,https://robertson-perez.com,Sing bad so program author kind particularly eye so miss.,23,robertson-perez,2023,USD,902901,563005,339896,45145,294751,0,294751,9029,18058,276693,67401,698805,344501,354304,,902901,20.0,31.16,0.0823,3762,20.0,26669.68,2.53,0.3764
8320,Williams Group,False,GB,West Tara,Cybersecurity,2008,https://williamsgroup.com,Rate decade say military accept once.,24,williams-group,2023,USD,1767663,573501,1194162,632356,561806,0,561806,17676,35353,526453,153087,1158357,378461,779896,,1767663,397.95,2612.78,0.001,2873,51.26,93288.81,1.64,0.6756
8321,Gonzales Group,False,ZA,Port Austinborough,Cybersecurity,2012,https://gonzalesgroup.com,Economy store should like.,20,gonzales-group,2023,USD,1195133,496430,698703,559139,139564,27455,112109,11951,23902,88207,26130,710495,417385,293110,,1195133,20.0,60.8,0.0313,4979,20.0,52802.83,0.49,0.5846
8322,Wu PLC,False,ZA,New Jeremytown,Energy,2020,https://wuplc.com,Less sit half threat push night field audience.,20,wu-plc,2023,USD,487595,142471,345124,180114,165010,0,165010,4875,9751,155259,5239,354325,89324,265001,,487595,20.0,44.68,0.1584,2031,20.0,29928.83,0.18,0.7078
8323,Garcia and Sons,False,CA,West Kelseyhaven,Cybersecurity,2020,https://garciaandsons.com,Computer often air environmental out.,26,garcia-and-sons,2023,USD,2275822,597227,1678595,1097975,580620,0,580620,22758,45516,535104,158751,1402847,1202827,200020,,2275822,20.0,53.93,0.0433,2607,72.74,71591.75,2.22,0.7376
8324,Cox-Moore,False,NG,New Ginamouth,Energy,2013,https://cox-moore.com,Center experience dinner federal again generation seek feel.,19,cox-moore,2023,USD,988061,541784,446277,403744,42533,0,42533,9880,19761,22772,29318,558027,45357,512670,,988061,594.37,3298.65,0.0745,4116,20.0,66140.55,0.44,0.4517
8325,Eaton-Ball,False,KE,Port Ericfort,E-commerce,2011,https://eaton-ball.com,Notice hour get dinner would young write box or.,24,eaton-ball,2023,USD,139981,77455,62526,56735,5791,0,5791,1399,2799,2992,12226,197682,108071,89611,,139981,238.53,918.46,0.121,28,407.76,6241.74,1.96,0.4467
8326,Martinez Inc,False,GB,Port Ryantown,E-commerce,2022,https://martinezinc.com,Water key election view expect pay.,21,martinez-inc,2023,USD,3308558,1091641,2216917,1638252,578665,0,578665,33085,66171,512494,856171,2569362,413701,2155661,,3308558,20.0,113.69,0.001,1261,218.58,137939.43,6.21,0.6701
8327,May Ltd,False,DE,East Marvinstad,AgriTech,2024,https://mayltd.com,Key tend measure much air read computer indicate both wrong.,28,may-ltd,2023,EUR,1476169,518846,957323,1291697,-334374,6540,-340914,14761,29523,-370437,357697,1234707,446502,788205,,1476169,1332.26,6536.76,0.0232,769,159.96,104694.01,3.42,0.6485
8328,Terry Henry and Flores,False,KE,East Jennifertown,IoT,2013,https://terryhenryandflores.com,Education Democrat research administration prepare painting.,24,terry-henry-and-flores,2023,USD,427318,223658,203660,249793,-46133,24463,-70596,4273,8546,-79142,44494,374271,108846,265425,,427318,20.0,10.0,0.091,304,116.9,24741.09,1.8,0.4766
8329,Ruiz Ltd,False,CA,Lovetown,E-commerce,2015,https://ruizltd.com,Maybe growth window arm idea skin value.,25,ruiz-ltd,2023,USD,5362354,2077863,3284491,2339125,945366,0,945366,53623,107247,838119,404666,3170888,1198188,1972700,,5362354,20.0,87.82,0.0916,3156,141.55,189270.87,2.14,0.6125
8330,Farley-Hughes,False,KE,Ruizland,AgriTech,2021,https://farley-hughes.com,Mrs participant suggest instead threat speak according energy character give.,12,farley-hughes,2023,USD,48093,13254,34839,16252,18587,2982,15605,480,961,14644,8340,167598,102039,65559,,48093,352.63,1236.82,0.1319,18,221.97,1000.0,8.34,0.7244
8331,Tanner LLC,False,BR,Danielton,Marketplaces,2008,https://tannerllc.com,Sound present follow glass even early none allow order.,18,tanner-llc,2023,USD,388278,137812,250466,91887,158579,4854,153725,3882,7765,145960,10561,271548,140179,131369,,388278,20.0,18.97,0.0489,1617,20.0,38986.97,0.27,0.6451
8332,Myers LLC,False,AU,Port April,Mobility,2017,https://myersllc.com,Believe source middle know build live suggest figure.,19,myers-llc,2023,USD,3186261,641568,2544693,880815,1663878,43584,1620294,31862,63725,1556569,129963,1833706,1122848,710858,,3186261,20.0,139.35,0.0339,11058,24.01,78460.72,1.66,0.7986
8333,Thompson Walker and Smith,False,GB,Cohenview,IoT,2008,https://thompsonwalkerandsmith.com,Song wind game similar that student black.,26,thompson-walker-and-smith,2023,USD,558913,70797,488116,232479,255637,24190,231447,5589,11178,220269,28072,461647,157499,304148,,558913,604.73,2581.72,0.0861,296,157.08,4368.02,6.43,0.8733
8334,Brown Clark and Hayes,False,EG,Lisafort,AgriTech,2023,https://brownclarkandhayes.com,Chair ago her follow save provide hour.,25,brown-clark-and-hayes,2023,USD,103222,33122,70100,23032,47068,13593,33475,1032,2064,31411,513,203789,37927,165862,,103222,938.59,1662.83,0.0431,79,108.55,17255.35,0.03,0.6791
8335,Roberts-Goodman,False,GB,Lisashire,IoT,2021,https://roberts-goodman.com,Serious include none doctor development house attack project.,19,roberts-goodman,2023,USD,468660,171161,297499,334127,-36628,38594,-75222,4686,9373,-84595,18493,257195,52982,204213,,468660,571.54,1651.5,0.0271,1952,20.0,47683.6,0.39,0.6348
8336,Allison LLC,False,TN,West Robert,IoT,2017,https://allisonllc.com,Ask beyond decide easy today it already become leave.,18,allison-llc,2023,USD,865930,353469,512461,616225,-103764,6710,-110474,8659,17318,-127792,100669,665006,53839,611167,,865930,20.0,73.6,0.0692,560,128.8,32119.14,3.13,0.5918
8337,Cline PLC,False,FR,New Curtisborough,Mobility,2020,https://clineplc.com,Friend authority hour operation including leader edge.,16,cline-plc,2023,EUR,2366172,692898,1673274,902014,771260,0,771260,23661,47323,723937,112482,1458950,284169,1174781,,2366172,411.29,1643.1,0.0724,9859,20.0,80631.37,1.4,0.7072
8338,Miller PLC,False,EG,North Kenneth,SaaS,2008,https://millerplc.com,Letter it actually song board side.,11,miller-plc,2023,USD,1154268,404423,749845,615392,134453,0,134453,11542,23085,111368,14745,769073,38453,730620,96189.0,1154268,511.78,1912.06,0.001,7865,12.23,54065.44,0.27,0.6496
8339,Cruz Inc,False,NG,East Toddchester,IoT,2022,https://cruzinc.com,Door prove player create cultural since rock politics person.,24,cruz-inc,2023,USD,115588,46431,69157,60008,9149,0,9149,1155,2311,6838,9589,167334,46869,120465,,115588,67.03,226.41,0.001,481,20.0,7044.41,1.36,0.5983
8340,Lee Group,False,IN,Tinamouth,Marketplaces,2023,https://leegroup.com,No phone administration example network goal condition itself black.,18,lee-group,2023,USD,668638,209728,458910,154559,304351,0,304351,6686,13372,290979,34293,545785,140340,405445,,668638,130.27,206.97,0.0377,417,133.53,1000.0,34.29,0.6863
8341,Contreras Lewis and Bender,False,IN,Petersfurt,AI/ML,2019,https://contreraslewisandbender.com,Charge arrive build as weight become.,16,contreras-lewis-and-bender,2023,USD,324189,127600,196589,248048,-51459,5029,-56488,3241,6483,-62971,86208,443000,205058,237942,,324189,20.0,91.95,0.1024,190,141.67,29199.18,2.95,0.6064
8342,Buckley-Martin,False,BR,Cameronland,IoT,2017,https://buckley-martin.com,Big against daughter education seem service man in meeting.,21,buckley-martin,2023,USD,2419722,1234664,1185058,663120,521938,0,521938,24197,48394,473544,25011,1381020,546873,834147,,2419722,20.0,48.54,0.0957,1285,156.9,36575.31,0.68,0.4897
8343,Sanchez Lynch and Sanchez,False,TN,West Curtis,AgriTech,2010,https://sanchezlynchandsanchez.com,Specific he their Democrat street little break about like box.,29,sanchez-lynch-and-sanchez,2023,USD,223824,54459,169365,188064,-18699,42176,-60875,2238,4476,-65351,5715,301260,224657,76603,,223824,1218.36,657.7,0.122,932,20.0,3229.62,1.77,0.7567
8344,Morton and Sons,False,NG,West Kristinville,EdTech,2024,https://mortonandsons.com,Job somebody realize paper capital family race.,22,morton-and-sons,2023,USD,173894,28992,144902,61002,83900,13350,70550,1738,3477,67073,2999,140420,85080,55340,14491.17,173894,165.93,729.27,0.0082,415,34.9,21172.87,0.14,0.8333
8345,Myers Group,False,IN,Sarahville,Fintech,2021,https://myersgroup.com,Career total tonight need evidence participant.,16,myers-group,2023,USD,852778,249538,603240,729402,-126162,0,-126162,8527,17055,-143217,13917,532258,236251,296007,,852778,1108.37,1028.42,0.001,517,137.42,62499.39,0.22,0.7074
8346,Green Cook and Kennedy,False,EG,East Brian,EdTech,2017,https://greencookandkennedy.com,Individual ever together letter value language expect through break.,17,green-cook-and-kennedy,2023,USD,1588114,643374,944740,1040501,-95761,59355,-155116,15881,31762,-186878,40980,870342,107316,763026,132342.83,1588114,366.86,1669.84,0.0108,2159,61.28,82742.19,0.5,0.5949
8347,Brown-Boone,False,EG,Princeshire,AI/ML,2018,https://brown-boone.com,Space police make plant ready financial newspaper ability sell.,18,brown-boone,2023,USD,2164689,340449,1824240,416482,1407758,0,1407758,21646,43293,1364465,242523,1395838,484332,911506,,2164689,749.06,833.52,0.001,517,348.86,36030.15,6.73,0.8427
8348,Carr Group,False,DE,Padillastad,Energy,2011,https://carrgroup.com,Power significant south bar then voice operation there.,17,carr-group,2023,EUR,1945279,505753,1439526,969200,470326,0,470326,19452,38905,431421,56699,1119013,337115,781898,,1945279,231.14,703.42,0.094,8105,20.0,72185.79,0.79,0.74
8349,Hartman PLC,False,TN,Smithborough,AgriTech,2008,https://hartmanplc.com,Send modern total listen write budget pattern.,19,hartman-plc,2023,USD,106209,35506,70703,42133,28570,0,28570,1062,2124,26446,23233,200076,84431,115645,,106209,499.1,1610.38,0.043,71,123.64,1000.0,23.23,0.6657
8350,Mcneil-Mendez,False,IN,Christopherberg,AgriTech,2018,https://mcneil-mendez.com,Right anyone defense I specific president Republican list religious.,19,mcneil-mendez,2023,USD,839667,397099,442568,41983,400585,58683,341902,8396,16793,325109,70175,497835,64752,433083,,839667,503.59,251.8,0.1354,311,224.68,1000.0,70.18,0.5271
8351,Michael-Rogers,False,US,Matthewview,IoT,2013,https://michael-rogers.com,Member window boy base subject.,21,michael-rogers,2023,USD,374507,68854,305653,196283,109370,29493,79877,3745,7490,72387,20987,238658,132484,106174,,374507,791.16,2366.31,0.001,218,142.57,23500.91,0.89,0.8161
8352,Odonnell Inc,False,BR,East Danielfurt,Marketplaces,2024,https://odonnellinc.com,Live way employee science but.,17,odonnell-inc,2023,USD,607566,280848,326718,308222,18496,8672,9824,6075,12151,-2327,86356,538621,140281,398340,,607566,20.0,68.59,0.001,392,129.11,37697.78,2.29,0.5377
8353,Lloyd Leon and Moore,False,AU,West Laurenfurt,Energy,2008,https://lloydleonandmoore.com,Interesting dinner two the painting other bad none beat actually.,16,lloyd-leon-and-moore,2023,USD,3348284,970037,2378247,855802,1522445,27284,1495161,33482,66965,1428196,572043,2276344,922209,1354135,,3348284,20.0,20.09,0.0411,13951,20.0,80389.05,7.12,0.7103
8354,Perry Group,False,CA,Humphreybury,HealthTech,2011,https://perrygroup.com,Nearly price world physical idea provide story.,17,perry-group,2023,USD,570516,292968,277548,99259,178289,11264,167025,5705,11410,155615,12046,444000,54755,389245,47543.0,570516,190.19,743.8,0.0231,858,55.4,21752.85,0.55,0.4865
8355,Carter LLC,False,US,Joseside,HealthTech,2020,https://carterllc.com,Mouth stage loss point cold if write.,25,carter-llc,2023,USD,3431270,1930390,1500880,2194211,-693331,18476,-711807,34312,68625,-780432,36747,1908430,719996,1188434,285939.17,3431270,449.72,2835.02,0.0309,6049,47.27,212781.14,0.17,0.4374
8356,Davis Group,False,GB,Lake Joshua,Mobility,2009,https://davisgroup.com,Down guy special image speak occur collection through media.,25,davis-group,2023,USD,5584154,2128161,3455993,3709228,-253235,0,-253235,55841,111683,-364918,288752,3167562,1049006,2118556,,5584154,984.93,3402.28,0.116,10614,43.84,305436.11,0.95,0.6189
8357,Carey-Bryant,False,TN,New Robert,Energy,2017,https://carey-bryant.com,Else group study month know community.,20,carey-bryant,2023,USD,1890444,746722,1143722,1227324,-83602,9466,-93068,18904,37808,-130876,51061,1107382,490916,616466,,1890444,637.89,702.45,0.0567,2368,66.52,84216.29,0.61,0.605
8358,Wood Group,False,NG,Johnsonbury,IoT,2009,https://woodgroup.com,Near among real provide someone value section six decide design guy.,25,wood-group,2023,USD,410464,163500,246964,149527,97437,0,97437,4104,8209,89228,25434,321635,20340,301295,,410464,1115.78,3001.97,0.0783,1710,20.0,39324.0,0.65,0.6017
8359,Fields-Johnston,False,US,Bethanyberg,AI/ML,2013,https://fields-johnston.com,Can fly medical should shoulder join first.,18,fields-johnston,2023,USD,1204597,249403,955194,634461,320733,5838,314895,12045,24091,290804,225624,949504,237992,711512,,1204597,20.0,72.23,0.0657,758,132.4,72114.09,3.13,0.793
8360,Sexton PLC,False,IN,Williamsport,AI/ML,2016,https://sextonplc.com,Clear break Mr participant admit her through couple my student.,14,sexton-plc,2023,USD,1873211,503862,1369349,899320,470029,16529,453500,18732,37464,416036,42731,1176043,514822,661221,,1873211,300.64,1028.81,0.1012,4015,38.87,75391.62,0.57,0.731
8361,Walker Buckley and White,False,CA,South Sharonton,AI/ML,2011,https://walkerbuckleyandwhite.com,Claim guess indicate should to bank decade between single husband.,17,walker-buckley-and-white,2023,USD,1042386,588067,454319,569412,-115093,16678,-131771,10423,20847,-152618,148329,719250,182169,537081,,1042386,1404.18,770.44,0.0859,248,349.9,29766.9,4.98,0.4358
8362,Johnson Group,False,AU,Lake Michaeltown,EdTech,2008,https://johnsongroup.com,Camera magazine meet at where occur.,17,johnson-group,2023,USD,131513,48098,83415,23985,59430,1551,57879,1315,2630,55249,305556,482004,210986,271018,10959.42,131513,306.81,1838.04,0.0449,136,80.05,11478.0,26.62,0.6343
8363,Jones-Carlson,False,NG,North Amy,AI/ML,2014,https://jones-carlson.com,Family amount kid so again.,21,jones-carlson,2023,USD,1385267,589633,795634,467376,328258,11537,316721,13852,27705,289016,98027,973267,421496,551771,,1385267,836.99,418.5,0.0185,1697,68.01,26842.42,3.65,0.5744
8364,Carson-Johnson,False,BR,Port William,SaaS,2018,https://carson-johnson.com,Girl lawyer across base matter whole church.,16,carson-johnson,2023,USD,271969,125469,146500,19017,127483,21575,105908,2719,5439,100469,17536,322111,144587,177524,22664.08,271969,435.98,726.94,0.0538,279,81.11,10322.85,1.7,0.5387
8365,Gibson Tran and Leblanc,False,EG,Roybury,AgriTech,2015,https://gibsontranandleblanc.com,Range tax per like lay major board nor.,17,gibson-tran-and-leblanc,2023,USD,251222,70851,180371,126951,53420,0,53420,2512,5024,48396,119931,391977,127174,264803,,251222,255.52,286.18,0.02,1046,20.0,8584.82,13.97,0.718
8366,Leonard and Sons,False,KE,Hallburgh,IoT,2023,https://leonardandsons.com,Sea outside wind each she few.,27,leonard-and-sons,2023,USD,910232,340769,569463,353480,215983,28600,187383,9102,18204,169179,41029,499661,160896,338765,,910232,1976.38,3185.55,0.0623,339,223.31,24839.65,1.65,0.6256
8367,Sanchez Vega and Yates,False,IN,New Debra,Cybersecurity,2011,https://sanchezvegaandyates.com,Education class activity arrive way.,13,sanchez-vega-and-yates,2023,USD,694968,371515,323453,528700,-205247,0,-205247,6949,13899,-219146,54487,440054,229396,210658,,694968,20.0,64.97,0.0415,2895,20.0,33024.2,1.65,0.4654
8368,Brandt Cross and Collins,False,NG,Smithview,E-commerce,2021,https://brandtcrossandcollins.com,Ground wrong drive claim day environmental small once.,23,brandt-cross-and-collins,2023,USD,169809,77253,92556,71738,20818,12197,8621,1698,3396,5225,10029,110880,52665,58215,,169809,1268.37,3001.98,0.0624,707,20.0,1000.0,10.03,0.5451
8369,Miller Flores and Harper,False,DE,Michaelbury,SaaS,2012,https://millerfloresandharper.com,Sound surface our next throw then security picture possible culture.,21,miller-flores-and-harper,2023,EUR,1364836,490313,874523,538353,336170,0,336170,13648,27296,308874,417965,1227330,684470,542860,113736.33,1364836,888.51,2303.22,0.0241,862,131.86,44676.84,9.36,0.6408
8370,Wilson-Gibbs,False,EG,Caitlinport,E-commerce,2008,https://wilson-gibbs.com,Federal this experience realize want last.,25,wilson-gibbs,2023,USD,483333,194522,288811,103749,185062,0,185062,4833,9666,175396,18962,277539,173143,104396,,483333,62.46,31.23,0.0702,406,98.99,24582.39,0.77,0.5975
8371,Valdez-Nichols,False,US,Martinezstad,SaaS,2014,https://valdez-nichols.com,Size fear discover movie month unit operation program ago approach.,22,valdez-nichols,2023,USD,137942,87925,50017,52483,-2466,0,-2466,1379,2758,-5224,16681,199277,69526,129751,11495.17,137942,148.26,856.26,0.0905,2299,5.0,1000.0,16.68,0.3626
8372,Jones-Gilmore,False,US,Chadport,Marketplaces,2019,https://jones-gilmore.com,Candidate meeting full with actually model third strong.,23,jones-gilmore,2023,USD,5022734,2203549,2819185,3373203,-554018,19391,-573409,50227,100454,-673863,112952,2754408,746169,2008239,,5022734,20.0,135.4,0.1047,1771,236.31,263976.44,0.43,0.5613
8373,Griffith Black and Yu,False,ZA,East Charleston,Energy,2020,https://griffithblackandyu.com,Still off not drop care truth film cut action animal.,21,griffith-black-and-yu,2023,USD,6402302,2253618,4148684,5996408,-1847724,7046,-1854770,64023,128046,-1982816,239325,3536922,893562,2643360,,6402302,20.0,115.14,0.0653,2181,244.6,471255.07,0.51,0.648
8374,Brown Reyes and Lawrence,False,FR,South Michelle,IoT,2019,https://brownreyesandlawrence.com,Fish three network pass professional really.,14,brown-reyes-and-lawrence,2023,EUR,548208,184280,363928,216087,147841,19871,127970,5482,10964,117006,5675,399815,218899,180916,,548208,189.69,94.84,0.001,221,206.25,14344.14,0.4,0.6639
8375,Hernandez Snyder and Mitchell,False,BR,South Sara,EdTech,2008,https://hernandezsnyderandmitchell.com,Imagine college appear marriage like phone cold wrong middle.,25,hernandez-snyder-and-mitchell,2023,USD,221972,96136,125836,101797,24039,8674,15365,2219,4439,10926,20106,135959,72188,63771,18497.67,221972,163.75,674.17,0.0691,499,37.05,49822.44,0.4,0.5669
8376,Jimenez Scott and Tran,False,CA,East Justinhaven,Energy,2017,https://jimenezscottandtran.com,Ten enjoy certainly water film probably TV audience feeling develop.,17,jimenez-scott-and-tran,2023,USD,937601,411716,525885,493964,31921,0,31921,9376,18752,13169,120515,625773,171492,454281,,937601,20.0,21.76,0.0394,3906,20.0,44538.17,2.71,0.5609
8377,Spencer Quinn and Cunningham,False,FR,West Rebeccamouth,AI/ML,2016,https://spencerquinnandcunningham.com,Discussion door lead through entire wife interesting throw let write generation.,24,spencer-quinn-and-cunningham,2023,EUR,914605,415358,499247,424111,75136,0,75136,9146,18292,56844,33848,599473,29973,569500,,914605,1211.46,1045.48,0.0935,3810,20.0,44445.08,0.76,0.5459
8378,Preston Group,False,AU,Lake Andreaview,IoT,2014,https://prestongroup.com,Politics other close it per.,18,preston-group,2023,USD,325304,161070,164234,182060,-17826,0,-17826,3253,6506,-24332,9369,342309,208664,133645,,325304,77.88,38.94,0.001,1355,20.0,52789.6,0.18,0.5049
8379,Bond Thompson and Pitts,False,EG,Joshuafurt,AI/ML,2017,https://bondthompsonandpitts.com,This finally involve season computer.,13,bond-thompson-and-pitts,2023,USD,930772,439600,491172,457069,34103,21843,12260,9307,18615,-6355,13807,516218,296747,219471,,930772,774.02,3744.2,0.1143,305,253.76,34648.23,0.4,0.5277
8380,Thompson Inc,False,TN,Lake Kathrynside,Mobility,2009,https://thompsoninc.com,President Democrat education chair main its seat property.,15,thompson-inc,2023,USD,2324737,818989,1505748,1099953,405795,46146,359649,23247,46494,313155,123948,1288438,603654,684784,,2324737,620.37,1957.93,0.0448,9686,20.0,89288.87,1.39,0.6477
8381,Hall-Donaldson,False,NG,Nathanielburgh,Mobility,2008,https://hall-donaldson.com,Style special difficult land leader ball wrong drug.,23,hall-donaldson,2023,USD,1440522,895683,544839,82982,461857,0,461857,14405,28810,433047,91648,864271,295542,568729,,1440522,1317.59,7417.33,0.001,3675,32.66,14380.9,6.37,0.3782
8382,Gutierrez and Sons,False,BR,Brownshire,Fintech,2024,https://gutierrezandsons.com,President movie tonight have police phone place.,24,gutierrez-and-sons,2023,USD,526860,216694,310166,247402,62764,0,62764,5268,10537,52227,41423,454851,262925,191926,,526860,578.09,1876.43,0.0804,2195,20.0,1766.23,23.45,0.5887
8383,Wood-Potter,False,EG,North Calebburgh,HealthTech,2021,https://wood-potter.com,Effort international box performance suddenly mean affect water.,32,wood-potter,2023,USD,1158379,404272,754107,250105,504002,4562,499440,11583,23167,476273,111393,762002,370728,391274,96531.58,1158379,10.0,48.3,0.0041,3336,28.93,34553.82,3.22,0.651
8384,Clark Arellano and Peters,False,BR,Danielmouth,SaaS,2008,https://clarkarellanoandpeters.com,Edge common military two chance.,9,clark-arellano-and-peters,2023,USD,382929,204533,178396,162720,15676,0,15676,3829,7658,8018,11377,375007,170449,204558,31910.75,382929,333.1,984.62,0.0215,606,52.61,3779.73,3.01,0.4659
8385,Estrada-Jordan,False,FR,East Bryceborough,Marketplaces,2014,https://estrada-jordan.com,Us with either trouble detail.,17,estrada-jordan,2023,EUR,2144807,557287,1587520,107240,1480280,1504,1478776,21448,42896,1435880,127778,1206463,170142,1036321,,2144807,1009.56,2669.67,0.0455,2537,70.45,1000.0,127.78,0.7402
8386,Bennett Group,False,TN,Aarontown,E-commerce,2011,https://bennettgroup.com,Discussion yourself play north would measure stop fly eight inside.,23,bennett-group,2023,USD,594834,134593,460241,439372,20869,32016,-11147,5948,11896,-23043,31403,471591,175186,296405,,594834,20.0,109.09,0.0124,340,145.77,56016.99,0.56,0.7737
8387,Palmer PLC,False,US,Port Alexanderport,EdTech,2016,https://palmerplc.com,National writer rock trade.,22,palmer-plc,2023,USD,384304,217550,166754,210796,-44042,3136,-47178,3843,7686,-54864,7538,219795,66893,152902,32025.33,384304,124.6,327.86,0.0415,5355,5.98,32485.68,0.23,0.4339
8388,Wright-Mejia,False,IN,Lake Melissaberg,AgriTech,2016,https://wright-mejia.com,Cause story last dream hot care only leave.,16,wright-mejia,2023,USD,2454878,465093,1989785,856198,1133587,0,1133587,24548,49097,1084490,97333,1369939,232413,1137526,,2454878,754.18,951.23,0.1395,1206,169.53,59705.23,1.63,0.8105
8389,Mcconnell-Park,False,GB,Meganville,IoT,2009,https://mcconnell-park.com,Charge would information appear various pay idea debate light best.,24,mcconnell-park,2023,USD,647323,141228,506095,456369,49726,3392,46334,6473,12946,33388,15752,473255,23662,449593,,647323,1297.27,2120.35,0.0968,150,359.51,62211.16,0.25,0.7818
8390,Rhodes Group,False,TN,Guyville,Mobility,2016,https://rhodesgroup.com,Begin enjoy major which media move test player its describe.,19,rhodes-group,2023,USD,1004595,299617,704978,495310,209668,8502,201166,10045,20091,181075,40673,646242,366650,279592,,1004595,870.49,1749.12,0.118,250,333.79,12791.98,3.18,0.7018
8391,Jones Inc,False,BR,Courtneyton,E-commerce,2021,https://jonesinc.com,Exist might member audience be eye enter after.,20,jones-inc,2023,USD,1111478,564093,547385,281843,265542,27231,238311,11114,22229,216082,151738,847212,188628,658584,,1111478,1146.72,3090.03,0.001,1726,53.65,33424.24,4.54,0.4925
8392,Davenport-Strickland,False,NG,Banksmouth,Energy,2019,https://davenport-strickland.com,Medical card administration author least a coach face control.,23,davenport-strickland,2023,USD,694262,130587,563675,495648,68027,26244,41783,6942,13885,27898,15744,445700,66266,379434,,694262,1293.73,1904.2,0.088,288,200.72,58491.45,0.27,0.8119
8393,Miller-Coleman,False,GB,Kingside,AgriTech,2009,https://miller-coleman.com,Front half rule responsibility decade.,24,miller-coleman,2023,USD,1316157,371380,944777,746982,197795,15632,182163,13161,26323,155840,161374,883425,404336,479089,,1316157,20.0,58.49,0.1057,1118,98.08,55942.09,2.88,0.7178
8394,Holland-Shaw,False,TN,Charlenemouth,HealthTech,2012,https://holland-shaw.com,Notice prepare land successful likely.,22,holland-shaw,2023,USD,1039368,450634,588734,500427,88307,10201,78106,10393,20787,57319,65411,682635,430739,251896,86614.0,1039368,394.28,1225.9,0.059,1700,50.94,45504.71,1.44,0.5664
8395,Robinson-Skinner,False,FR,New Nathanielshire,E-commerce,2019,https://robinson-skinner.com,Section identify cut successful environment hundred.,18,robinson-skinner,2023,EUR,5241897,2125555,3116342,262094,2854248,0,2854248,52418,104837,2749411,472538,3264363,163218,3101145,,5241897,20.0,90.71,0.001,7578,57.64,20689.59,22.84,0.5945
8396,Rodriguez-Marsh,False,KE,South Alextown,IoT,2021,https://rodriguez-marsh.com,Final meet safe pattern station wife pressure identify play.,20,rodriguez-marsh,2023,USD,406716,245320,161396,176239,-14843,2851,-17694,4067,8134,-25828,45970,330915,139634,191281,,406716,396.58,1366.82,0.0418,262,129.05,1000.0,45.97,0.3968
8397,Mathews Group,False,EG,Port Christinemouth,HealthTech,2018,https://mathewsgroup.com,Anything star space watch night.,23,mathews-group,2023,USD,3651470,1481549,2169921,841186,1328735,26128,1302607,36514,73029,1229578,196686,2030411,1017073,1013338,304289.17,3651470,10.0,39.25,0.0578,5929,51.32,84683.81,2.32,0.5943
8398,Smith Williams and Phillips,False,TN,Lake Robertstad,HealthTech,2013,https://smithwilliamsandphillips.com,Modern little sort season if factor series also.,25,smith-williams-and-phillips,2023,USD,1576916,668663,908253,515087,393166,0,393166,15769,31538,361628,36945,850265,421998,428267,131409.67,1576916,99.11,379.57,0.0563,2523,52.08,27479.74,1.34,0.576
8399,Cook Johnston and King,False,GB,Lake William,Fintech,2008,https://cookjohnstonandking.com,Current edge until something defense important why window project pull.,25,cook-johnston-and-king,2023,USD,174702,51051,123651,65107,58544,29105,29439,1747,3494,25945,22977,250174,40720,209454,,174702,20.0,28.39,0.0621,65,223.32,1437.47,15.98,0.7078
8400,Fisher-Vega,False,CA,Shepardfort,EdTech,2014,https://fisher-vega.com,Painting today that central general too forward but poor.,21,fisher-vega,2023,USD,546868,262755,284113,154498,129615,57959,71656,5468,10937,60719,73107,430776,107074,323702,45572.33,546868,612.93,3858.3,0.001,554,82.18,2546.3,28.71,0.5195
8401,Turner-Smith,False,BR,South Andrewtown,Marketplaces,2017,https://turner-smith.com,Author likely page according away reduce take share.,16,turner-smith,2023,USD,404079,149375,254704,290537,-35833,0,-35833,4040,8081,-43914,108469,488826,237044,251782,,404079,859.43,2536.8,0.017,483,69.59,24848.03,4.37,0.6303
8402,Ryan-Sims,False,EG,New Shelbyfort,SaaS,2016,https://ryan-sims.com,They Mr something structure lose beat add any represent phone protect.,26,ryan-sims,2023,USD,467206,131951,335255,134936,200319,36581,163738,4672,9344,154394,18726,386819,128956,257863,38933.83,467206,10.0,34.38,0.0045,328,118.37,8086.51,2.32,0.7176
8403,Nelson PLC,False,EG,Lake Scottfort,AgriTech,2023,https://nelsonplc.com,Media family play as decade everybody way produce.,22,nelson-plc,2023,USD,160800,46940,113860,70010,43850,0,43850,1608,3216,40634,7926,198624,51098,147526,,160800,688.79,3264.21,0.0907,670,20.0,50606.4,0.16,0.7081
8404,James Graham and Long,False,TN,Port Hunter,AgriTech,2017,https://jamesgrahamandlong.com,Suddenly although impact national these mention answer eight.,20,james-graham-and-long,2023,USD,173687,81834,91853,127493,-35640,0,-35640,1736,3473,-39113,44308,257031,18416,238615,,173687,20.0,63.16,0.1344,237,61.04,34643.4,1.28,0.5288
8405,Gomez Inc,False,BR,Hooperberg,E-commerce,2019,https://gomezinc.com,Fish eat ahead truth never official because.,16,gomez-inc,2023,USD,837406,401938,435468,629172,-193704,0,-193704,8374,16748,-210452,136234,588994,323856,265138,,837406,34.88,84.31,0.012,3489,20.0,58276.51,2.34,0.52
8406,Petersen-Johnson,False,KE,Duncanshire,EdTech,2021,https://petersen-johnson.com,Now finish trip fish glass mention.,14,petersen-johnson,2023,USD,661331,269772,391559,315905,75654,0,75654,6613,13226,62428,7659,402407,195111,207296,55110.92,661331,109.87,451.68,0.0254,11022,5.0,11689.2,0.66,0.5921
8407,Mcpherson Ltd,False,CA,New Courtney,HealthTech,2011,https://mcphersonltd.com,Into institution us month maintain alone wish field.,19,mcpherson-ltd,2023,USD,502175,187594,314581,351606,-37025,0,-37025,5021,10043,-47068,34435,459773,106599,353174,41847.92,502175,348.38,1194.69,0.0122,697,59.97,51927.94,0.66,0.6264
8408,Stanton-Shaw,False,DE,Port Philiphaven,AI/ML,2015,https://stanton-shaw.com,Today executive entire national drive.,14,stanton-shaw,2023,EUR,1336221,472294,863927,615909,248018,24222,223796,13362,26724,197072,89432,942382,176351,766031,,1336221,1419.84,7594.21,0.001,565,196.85,21080.5,4.24,0.6465
8409,Ross Graham and Stevens,False,CA,Merritttown,SaaS,2023,https://rossgrahamandstevens.com,Inside address interest fly spend.,13,ross-graham-and-stevens,2023,USD,807051,287755,519296,383443,135853,0,135853,8070,16141,119712,94663,567912,374021,193891,67254.25,807051,10.0,32.14,0.018,13450,5.0,10195.63,9.28,0.6434
8410,Christensen Ellis and Lopez,False,FR,Vasquezburgh,HealthTech,2017,https://christensenellisandlopez.com,Play exist pattern the however cold spring understand last.,11,christensen-ellis-and-lopez,2023,EUR,1472923,486111,986812,393048,593764,2316,591448,14729,29458,561990,192581,1091968,240711,851257,122743.58,1472923,591.36,1997.64,0.0233,24548,5.0,49945.69,3.86,0.67
8411,Jones Inc,False,CA,Lake Donna,Cybersecurity,2019,https://jonesinc.com,Police change cold parent window information century.,23,jones-inc,2023,USD,1627285,804366,822919,1108072,-285153,20805,-305958,16272,32545,-338503,50724,981558,135395,846163,,1627285,1474.45,8225.03,0.0872,1695,80.0,91148.51,0.56,0.5057
8412,Bennett Mendoza and Gray,False,DE,Brittanybury,Fintech,2013,https://bennettmendozaandgray.com,Minute under might serve home offer until north.,20,bennett-mendoza-and-gray,2023,EUR,691318,203674,487644,239418,248226,48409,199817,6913,13826,185991,53223,423053,203749,219304,,691318,420.22,983.58,0.0213,2880,20.0,1000.0,53.22,0.7054
8413,Hutchinson and Sons,False,ZA,West Breanna,IoT,2009,https://hutchinsonandsons.com,Decide identify choice hope thus whole style.,23,hutchinson-and-sons,2023,USD,1600062,635978,964084,351539,612545,33463,579082,16000,32001,547081,143817,980366,174261,806105,,1600062,205.58,356.53,0.001,1539,86.61,1000.0,143.82,0.6025
8414,Willis LLC,False,US,Tracietown,Cybersecurity,2015,https://willisllc.com,Service clearly ok address go whom.,21,willis-llc,2023,USD,963225,414449,548776,385186,163590,0,163590,9632,19264,144326,52199,698065,421982,276083,,963225,29.5,223.28,0.0793,541,148.1,17547.94,2.97,0.5697
8415,Thompson Group,False,TN,Port Josephfort,HealthTech,2013,https://thompsongroup.com,Force force bed early open student.,20,thompson-group,2023,USD,580665,200285,380380,324073,56307,0,56307,5806,11613,44694,177011,611192,183902,427290,48388.75,580665,71.15,271.97,0.0234,500,96.67,74248.66,2.38,0.6551
8416,Thomas Mcneil and Hernandez,False,FR,South Joelfort,Fintech,2023,https://thomasmcneilandhernandez.com,Sometimes need special finish visit certainly.,23,thomas-mcneil-and-hernandez,2023,EUR,1453253,677920,775333,604656,170677,5037,165640,14532,29065,136575,25616,874780,588810,285970,,1453253,20.0,86.17,0.1205,6055,20.0,58552.57,0.44,0.5335
8417,Meyers Allen and Espinoza,False,DE,Lake Jamesport,Marketplaces,2012,https://meyersallenandespinoza.com,Gas campaign sea admit he that method base.,20,meyers-allen-and-espinoza,2023,EUR,643317,292451,350866,513137,-162271,10809,-173080,6433,12866,-185946,9976,481792,160187,321605,,643317,129.87,498.92,0.0536,2680,20.0,65188.05,0.15,0.5454
8418,Cherry and Sons,False,BR,Port Amanda,Mobility,2023,https://cherryandsons.com,Computer customer key sell dark father.,20,cherry-and-sons,2023,USD,402064,119402,282662,153591,129071,0,129071,4020,8041,121030,68771,307110,158172,148938,,402064,700.77,2651.08,0.1064,1675,20.0,32035.25,2.15,0.703
8419,Lee and Sons,False,GB,South Davidbury,Energy,2016,https://leeandsons.com,Popular environmental per medical police ten catch safe.,30,lee-and-sons,2023,USD,1041212,296503,744709,300726,443983,0,443983,10412,20824,423159,42343,691913,376163,315750,,1041212,354.18,647.05,0.0356,2188,39.64,9413.61,4.5,0.7152
8420,Lambert-Patterson,False,NG,Spencerstad,Marketplaces,2015,https://lambert-patterson.com,His media land skin teach.,20,lambert-patterson,2023,USD,873913,211369,662544,132392,530152,0,530152,8739,17478,512674,59626,542390,225204,317186,,873913,1048.27,1043.61,0.0385,486,149.72,1000.0,59.63,0.7581
8421,Snyder-Mcconnell,False,KE,New Kevin,E-commerce,2018,https://snyder-mcconnell.com,Since store next while us gas west debate movement certain.,14,snyder-mcconnell,2023,USD,354064,184846,169218,225858,-56640,1061,-57701,3540,7081,-64782,21796,396643,175946,220697,,354064,20.0,35.29,0.0325,1475,20.0,43393.74,0.5,0.4779
8422,Douglas Morris and Welch,False,ZA,Lake Hollytown,Marketplaces,2018,https://douglasmorrisandwelch.com,Fear appear cause animal hit deep along offer.,17,douglas-morris-and-welch,2023,USD,854658,279938,574720,764473,-189753,0,-189753,8546,17093,-206846,45857,554356,241338,313018,,854658,1193.81,3686.15,0.015,1309,54.38,89085.45,0.51,0.6725
8423,Smith Group,False,NG,Port Emily,E-commerce,2013,https://smithgroup.com,From reflect effect worker religious garden collection.,19,smith-group,2023,USD,1099809,554937,544872,272922,271950,13758,258192,10998,21996,236196,207414,913470,314650,598820,,1099809,790.13,1395.59,0.0537,4582,20.0,47875.42,4.33,0.4954
8424,Murphy Ltd,False,GB,Michaelburgh,IoT,2017,https://murphyltd.com,Final keep theory meet factor marriage what.,24,murphy-ltd,2023,USD,238050,21074,216976,30234,186742,13208,173534,2380,4761,168773,12149,288247,187515,100732,,238050,20.0,71.02,0.0433,173,114.21,1000.0,12.15,0.9115
8425,Wade Group,False,GB,East Carrietown,Marketplaces,2019,https://wadegroup.com,Recognize power control but black increase.,28,wade-group,2023,USD,1749970,761199,988771,87498,901273,30793,870480,17499,34999,835481,405772,1407548,210440,1197108,,1749970,1901.27,3845.75,0.1558,471,309.23,24918.51,16.28,0.565
8426,Massey Johnson and Harrison,False,GB,Port Josephfurt,Cybersecurity,2018,https://masseyjohnsonandharrison.com,Wall nice behavior at or beat when.,19,massey-johnson-and-harrison,2023,USD,549737,137935,411802,183996,227806,0,227806,5497,10994,216812,16503,319681,167541,152140,,549737,1718.93,6347.62,0.0967,362,126.22,5134.88,3.21,0.7491
8427,Zuniga LLC,False,FR,Hawkinsside,Energy,2011,https://zunigallc.com,Time red short home place then.,25,zuniga-llc,2023,EUR,1776170,592483,1183687,808994,374693,0,374693,17761,35523,339170,30876,1079281,733817,345464,,1776170,392.8,420.61,0.0258,644,229.62,34654.53,0.89,0.6664
8428,Turner Group,False,NG,Port Oscar,E-commerce,2023,https://turnergroup.com,Source own ball similar foot left significant.,17,turner-group,2023,USD,3058783,1240841,1817942,3362284,-1544342,0,-1544342,30587,61175,-1605517,41440,1700176,85008,1615168,,3058783,541.41,270.7,0.0178,1171,217.6,302568.82,0.14,0.5943
8429,Wang Walker and Larson,False,CA,South Michaelberg,IoT,2010,https://wangwalkerandlarson.com,Plan present buy fight develop federal leave now right.,25,wang-walker-and-larson,2023,USD,209057,114033,95024,122597,-27573,7011,-34584,2090,4181,-38765,28634,177182,50972,126210,,209057,883.67,4334.93,0.1194,871,20.0,1000.0,28.63,0.4545
8430,Lynn-Reid,False,EG,Karenfurt,Fintech,2009,https://lynn-reid.com,Race miss mother beyond decade.,20,lynn-reid,2023,USD,363036,117561,245475,83728,161747,10549,151198,3630,7260,143938,9546,376391,79753,296638,,363036,217.28,172.37,0.0365,1512,20.0,16104.65,0.59,0.6762
8431,Cain King and Rich,False,CA,South Ericton,SaaS,2024,https://cainkingandrich.com,Pull stand possible almost only southern usually.,17,cain-king-and-rich,2023,USD,2350883,1302111,1048772,1352685,-303913,37285,-341198,23508,47017,-388215,179352,1476075,502540,973535,195906.92,2350883,150.58,794.3,0.0463,13557,14.45,133021.26,1.35,0.4461
8432,Collins-Rose,False,BR,Port Maureen,SaaS,2019,https://collins-rose.com,Hundred recently computer head her power report through.,24,collins-rose,2023,USD,449679,128593,321086,340038,-18952,0,-18952,4496,8993,-27945,29793,286778,102078,184700,37473.25,449679,666.38,3298.69,0.0664,2101,17.83,16145.22,1.85,0.714
8433,Brown Inc,False,IN,Richardsbury,IoT,2010,https://browninc.com,Game huge might listen key east interest.,21,brown-inc,2023,USD,386138,185438,200700,73206,127494,0,127494,3861,7722,119772,44112,278952,21288,257664,,386138,286.43,143.22,0.1231,138,232.97,54035.18,0.82,0.5198
8434,Robbins Thomas and Richardson,False,IN,Deborahburgh,Mobility,2022,https://robbinsthomasandrichardson.com,Pass power and source nice responsibility power whole soon research.,21,robbins-thomas-and-richardson,2023,USD,631356,310028,321328,31567,289761,1765,287996,6313,12627,275369,52528,400807,84872,315935,,631356,20.0,92.46,0.017,448,117.41,2346.02,22.39,0.5089
8435,Garner Rowe and Ross,False,IN,Lake Shawn,AgriTech,2023,https://garnerroweandross.com,Dark public others girl morning music.,26,garner-rowe-and-ross,2023,USD,394631,139511,255120,186638,68482,3465,65017,3946,7892,57125,11699,345451,98286,247165,,394631,132.68,900.87,0.0479,124,264.38,12590.52,0.93,0.6465
8436,Juarez Anderson and Flores,False,DE,Frenchside,E-commerce,2014,https://juarezandersonandflores.com,Edge analysis win deal.,16,juarez-anderson-and-flores,2023,EUR,367194,160251,206943,104069,102874,0,102874,3671,7343,95531,27493,313597,57449,256148,,367194,1914.82,4123.86,0.0721,331,92.39,29304.28,0.94,0.5636
8437,Garrett-Andrews,False,CA,Jordanside,HealthTech,2017,https://garrett-andrews.com,None your development study can debate small into.,22,garrett-andrews,2023,USD,1062149,304931,757218,913910,-156692,14268,-170960,10621,21242,-192202,43072,722900,258161,464739,88512.42,1062149,10.0,12.03,0.0491,1363,64.92,65375.87,0.66,0.7129
8438,Harrison and Sons,False,EG,Wrightfort,AI/ML,2017,https://harrisonandsons.com,Hour seek reason condition whom cover plant.,12,harrison-and-sons,2023,USD,1755020,417392,1337628,578017,759611,0,759611,17550,35100,724511,33961,1061380,88362,973018,,1755020,1536.4,12596.83,0.0423,1218,120.05,45018.26,0.75,0.7622
8439,Horn-Henry,False,FR,South Sydneyberg,Mobility,2011,https://horn-henry.com,College north large movement throw particular career.,21,horn-henry,2023,EUR,2844815,1207134,1637681,628168,1009513,9543,999970,28448,56896,943074,243672,1696124,425119,1271005,,2844815,374.56,187.28,0.001,1232,192.42,15105.25,16.13,0.5757
8440,Brown-Espinoza,False,CA,Kaylastad,IoT,2017,https://brown-espinoza.com,This future become education expect.,21,brown-espinoza,2023,USD,1115877,324018,791859,566766,225093,6115,218978,11158,22317,196661,87335,795816,213164,582652,,1115877,20.0,30.36,0.0656,549,169.34,40245.51,2.17,0.7096
8441,Smith LLC,False,ZA,Port Toddshire,IoT,2022,https://smithllc.com,Physical wonder chance book town situation decade.,23,smith-llc,2023,USD,1601826,684112,917714,806545,111169,25236,85933,16018,32036,53897,102211,1039053,51952,987101,,1601826,1394.07,7659.57,0.0842,6674,20.0,40009.48,2.55,0.5729
8442,Mcdonald Owens and Durham,False,DE,Williamstad,AgriTech,2017,https://mcdonaldowensanddurham.com,My soon spring prove contain and.,16,mcdonald-owens-and-durham,2023,EUR,371496,59869,311627,115895,195732,8415,187317,3714,7429,179888,21782,346212,78469,267743,,371496,681.06,5210.5,0.1323,861,35.94,2506.18,8.69,0.8388
8443,Schwartz Sanchez and Bailey,False,KE,Port Kevinton,EdTech,2009,https://schwartzsanchezandbailey.com,Oil collection how last than maintain technology.,23,schwartz-sanchez-and-bailey,2023,USD,295249,99676,195573,162282,33291,0,33291,2952,5904,27387,3003,189669,70266,119403,24604.08,295249,293.76,1327.85,0.035,617,39.84,1000.0,3.0,0.6624
8444,Johnson Inc,False,CA,West Christina,EdTech,2023,https://johnsoninc.com,Good budget morning run economic write operation word.,28,johnson-inc,2023,USD,368690,167435,201255,150776,50479,4480,45999,3686,7373,38626,34829,320727,70248,250479,30724.17,368690,65.1,300.41,0.0263,298,102.93,7065.59,4.93,0.5459
8445,Schultz Carpenter and Olson,False,NG,Danielton,AI/ML,2008,https://schultzcarpenterandolson.com,Newspaper teacher yeah agreement chair deal ever institution building.,19,schultz-carpenter-and-olson,2023,USD,1648827,673317,975510,667459,308051,0,308051,16488,32976,275075,297795,1245314,615266,630048,,1648827,20.0,76.63,0.0555,409,335.76,60530.03,4.92,0.5916
8446,Martinez-Myers,False,DE,East Michael,EdTech,2011,https://martinez-myers.com,More style kid type peace either.,14,martinez-myers,2023,EUR,272658,109697,162961,120308,42653,1395,41258,2726,5453,35805,9869,219986,63150,156836,22721.5,272658,231.42,554.01,0.001,278,81.69,37204.1,0.27,0.5977
8447,Price Simpson and Simmons,False,NG,Lake Micheleborough,EdTech,2021,https://pricesimpsonandsimmons.com,Yes civil always scientist activity knowledge.,20,price-simpson-and-simmons,2023,USD,575813,163748,412065,346984,65081,0,65081,5758,11516,53565,24703,366624,138340,228284,47984.42,575813,211.47,211.47,0.0182,596,80.44,19873.39,1.24,0.7156
8448,Jarvis Parker and Sullivan,False,FR,West Annettefort,Fintech,2014,https://jarvisparkerandsullivan.com,Leader against interesting consumer color understand.,22,jarvis-parker-and-sullivan,2023,EUR,724174,247794,476380,127321,349059,0,349059,7241,14483,334576,11947,375886,18794,357092,,724174,924.08,949.88,0.0545,247,243.54,10807.1,1.11,0.6578
8449,Wilson-Nicholson,False,DE,Jacobton,Marketplaces,2024,https://wilson-nicholson.com,Whatever assume feel role industry forward enjoy deep.,28,wilson-nicholson,2023,EUR,132865,65666,67199,79384,-12185,46182,-58367,1328,2657,-61024,11986,176431,84714,91717,,132865,1232.55,2257.85,0.1077,44,248.67,1000.0,11.99,0.5058
8450,Moore Group,False,KE,Lake Michaelfurt,HealthTech,2021,https://mooregroup.com,Process would look scene rule enjoy lose free.,17,moore-group,2023,USD,461881,120718,341163,86570,254593,0,254593,4618,9237,245356,36981,295504,72516,222988,38490.08,461881,255.81,459.23,0.0409,425,90.38,1000.0,36.98,0.7386
8451,Harris Burch and Pitts,False,US,West Deborahfurt,AI/ML,2023,https://harrisburchandpitts.com,Visit do rule do pretty will another together.,26,harris-burch-and-pitts,2023,USD,460745,101767,358978,257788,101190,2753,98437,4607,9214,89223,26568,269065,154624,114441,,460745,20.0,51.07,0.0419,142,269.36,35757.94,0.74,0.7791
8452,Hatfield-Johnson,False,NG,Georgeburgh,AI/ML,2013,https://hatfield-johnson.com,What tend expect wait help.,26,hatfield-johnson,2023,USD,1050176,615268,434908,290249,144659,11466,133193,10501,21003,112190,53591,643981,93736,550245,,1050176,852.48,4597.52,0.0715,4375,20.0,8837.57,6.06,0.4141
8453,Nelson Miller and Waller,False,AU,Rebeccahaven,AI/ML,2010,https://nelsonmillerandwaller.com,Already how operation school energy majority write husband fast add.,15,nelson-miller-and-waller,2023,USD,739663,253669,485994,685703,-199709,0,-199709,7396,14793,-214502,75304,583550,234501,349049,,739663,20.0,89.77,0.0546,837,73.6,41463.28,1.82,0.657
8454,Ochoa Rios and Preston,False,CA,Jamesbury,HealthTech,2023,https://ochoariosandpreston.com,Scientist run while discover those.,15,ochoa-rios-and-preston,2023,USD,258639,84700,173939,129375,44564,2409,42155,2586,5172,36983,42565,188703,33558,155145,21553.25,258639,104.31,321.4,0.0447,828,26.03,1000.0,42.56,0.6725
8455,Bowman-Kennedy,False,NG,Matthewton,Mobility,2014,https://bowman-kennedy.com,Into base huge hope other pass.,19,bowman-kennedy,2023,USD,1108022,266654,841368,738700,102668,0,102668,11080,22160,80508,74409,697366,178073,519293,,1108022,1353.49,1525.62,0.001,383,241.02,67790.53,1.1,0.7593
8456,Brown-Martin,False,US,South Latashabury,AgriTech,2021,https://brown-martin.com,Law stuff father stop court structure agency listen have argue.,19,brown-martin,2023,USD,241433,101457,139976,88569,51407,45570,5837,2414,4828,1009,22765,317696,74872,242824,,241433,20.0,104.2,0.0168,138,145.27,8540.41,2.67,0.5798
8457,Sanchez-Wilson,False,GB,Lake Ashleyton,E-commerce,2010,https://sanchez-wilson.com,Single drug prove program development point police.,24,sanchez-wilson,2023,USD,1648046,328219,1319827,1209623,110204,0,110204,16480,32960,77244,57692,1044677,338533,706144,,1648046,762.37,4185.36,0.001,2697,50.92,78565.66,0.73,0.8008
8458,Nguyen Group,False,CA,East Robert,HealthTech,2011,https://nguyengroup.com,Here finally ability senior church yeah.,29,nguyen-group,2023,USD,444140,78989,365151,61931,303220,6103,297117,4441,8882,288235,5119,426363,78520,347843,37011.67,444140,85.26,889.7,0.0515,769,48.11,1000.0,5.12,0.8222
8459,Wheeler Stewart and Hampton,False,EG,South Nicholestad,Cybersecurity,2017,https://wheelerstewartandhampton.com,Believe start church make American.,18,wheeler-stewart-and-hampton,2023,USD,1545925,511482,1034443,1082119,-47676,18639,-66315,15459,30918,-97233,308813,1281747,615267,666480,,1545925,20.0,89.66,0.001,589,218.49,69656.7,4.43,0.6691
8460,Goodwin-Ashley,False,TN,Sototown,E-commerce,2014,https://goodwin-ashley.com,Family price thing usually price way public instead series certain move.,23,goodwin-ashley,2023,USD,449020,153553,295467,332085,-36618,6173,-42791,4490,8980,-51771,10143,374243,240770,133473,,449020,402.77,1781.26,0.0662,187,199.38,34104.6,0.3,0.658
8461,Stout-Maldonado,False,CA,West Brittanymouth,Cybersecurity,2015,https://stout-maldonado.com,Write north again rich apply also.,14,stout-maldonado,2023,USD,384203,149865,234338,317562,-83224,29687,-112911,3842,7684,-120595,14379,257366,114392,142974,,384203,20.0,54.03,0.0974,282,113.21,19436.99,0.74,0.6099
8462,Haley Lynch and Nelson,False,EG,Evelynberg,AI/ML,2009,https://haleylynchandnelson.com,Short building fill time opportunity end.,19,haley-lynch-and-nelson,2023,USD,1777475,376032,1401443,1521642,-120199,50096,-170295,17774,35549,-205844,39864,1022473,242960,779513,,1777475,794.57,3136.47,0.0983,368,402.37,125780.63,0.32,0.7884
8463,Johnson Murphy and Jones,False,FR,Kimberlyburgh,AI/ML,2011,https://johnsonmurphyandjones.com,Pull deal talk eat number.,24,johnson-murphy-and-jones,2023,EUR,5896505,2643437,3253068,3116664,136404,1588,134816,58965,117930,16886,483576,3542693,1923479,1619214,,5896505,1171.36,3772.58,0.1061,16730,29.37,281790.81,1.72,0.5517
8464,Stephens PLC,False,CA,Russellbury,Energy,2023,https://stephensplc.com,Authority better them there read.,16,stephens-plc,2023,USD,3709579,1035333,2674246,1410860,1263386,0,1263386,37095,74191,1189195,144834,2127208,863340,1263868,,3709579,20.0,10.0,0.0973,1211,255.17,93807.23,1.54,0.7209
8465,Black Ltd,False,DE,West Stephanieberg,AgriTech,2016,https://blackltd.com,Like enough card course whole natural.,19,black-ltd,2023,EUR,99896,21242,78654,4994,73660,5166,68494,998,1997,66497,8632,164697,72338,92359,,99896,20.0,145.28,0.001,49,167.01,1000.0,8.63,0.7874
8466,Hammond-Hill,False,TN,North Joshua,Mobility,2010,https://hammond-hill.com,So including scene better push line her force.,21,hammond-hill,2023,USD,1580472,492836,1087636,1177037,-89401,0,-89401,15804,31609,-121010,34961,887719,340241,547478,,1580472,20.0,95.71,0.015,613,214.75,109972.47,0.32,0.6882
8467,Dunn PLC,False,ZA,New Alexandraburgh,Mobility,2022,https://dunnplc.com,Decade action improve important such population such scientist responsibility serious.,21,dunn-plc,2023,USD,491157,273063,218094,319169,-101075,0,-101075,4911,9823,-110898,55538,486281,128061,358220,,491157,20.0,67.84,0.0017,454,90.15,65584.99,0.85,0.444
8468,Casey Robertson and Kennedy,False,ZA,Wesleyborough,Energy,2013,https://caseyrobertsonandkennedy.com,Necessary area development out day citizen coach argue agency.,21,casey-robertson-and-kennedy,2023,USD,776146,286966,489180,243122,246058,9393,236665,7761,15522,221143,40027,583129,130373,452756,,776146,314.08,1452.48,0.0741,494,130.78,5946.16,6.73,0.6303
8469,Bowers-Patterson,False,KE,Lake Stevenchester,Energy,2010,https://bowers-patterson.com,Lead management health laugh prove exactly.,19,bowers-patterson,2023,USD,1366572,448663,917909,1073899,-155990,3888,-159878,13665,27331,-187209,37967,916648,376083,540565,,1366572,66.77,62.32,0.1066,3804,29.93,130580.62,0.29,0.6717
8470,Mckay and Sons,False,IN,East Eric,EdTech,2014,https://mckayandsons.com,Finally cover me growth actually.,24,mckay-and-sons,2023,USD,2078080,612124,1465956,473581,992375,0,992375,20780,41561,950814,35060,1230268,706947,523321,173173.33,2078080,568.48,3129.17,0.0325,2052,84.39,66080.7,0.53,0.7054
8471,Mendez-Wright,False,TN,Saundersfort,HealthTech,2016,https://mendez-wright.com,Hundred education long share yet investment relationship trip also.,19,mendez-wright,2023,USD,3295305,1476499,1818806,604231,1214575,19807,1194768,32953,65906,1128862,798567,2544237,2095404,448833,274608.75,3295305,10.0,34.3,0.0521,2458,111.7,42587.19,18.75,0.5519
8472,Brown and Sons,False,TN,Yatesfort,Marketplaces,2021,https://brownandsons.com,Half eat rock economy itself oil.,21,brown-and-sons,2023,USD,566453,230792,335661,80528,255133,0,255133,5664,11329,243804,32807,471685,111487,360198,,566453,621.02,310.51,0.0997,502,93.88,1000.0,32.81,0.5926
8473,Petersen Mahoney and Peterson,False,IN,West Jennifer,E-commerce,2009,https://petersenmahoneyandpeterson.com,Total like weight eat single administration rather officer always better.,27,petersen-mahoney-and-peterson,2023,USD,1653458,501253,1152205,518727,633478,8561,624917,16534,33069,591848,68073,1057437,159513,897924,,1653458,20.0,66.39,0.001,3653,37.71,23264.37,2.93,0.6968
8474,Smith-Bruce,False,KE,East Lisahaven,IoT,2008,https://smith-bruce.com,Hear board management plan can.,20,smith-bruce,2023,USD,429814,142173,287641,191760,95881,0,95881,4298,8596,87285,11891,258178,128736,129442,,429814,20.0,92.29,0.0737,1790,20.0,20172.42,0.59,0.6692
8475,Green-Levine,False,ZA,Port Amandashire,SaaS,2011,https://green-levine.com,Structure TV hold political since knowledge.,27,green-levine,2023,USD,524717,278355,246362,327374,-81012,0,-81012,5247,10494,-91506,9897,437669,68587,369082,43726.42,524717,10.0,10.0,0.001,3572,12.24,46503.47,0.21,0.4695
8476,Bennett Brown and Rose,False,US,Lake Kimberlyland,AI/ML,2018,https://bennettbrownandrose.com,Truth black significant college soon out and fish.,18,bennett-brown-and-rose,2023,USD,995209,171741,823468,672055,151413,0,151413,9952,19904,131509,49500,724309,106545,617764,,995209,157.19,699.79,0.0321,2415,34.34,21581.58,2.29,0.8274
8477,Monroe Ltd,False,EG,Molinafort,EdTech,2008,https://monroeltd.com,Fight no hear if smile degree figure state blood.,21,monroe-ltd,2023,USD,217377,75250,142127,10868,131259,21754,109505,2173,4347,105158,9177,165330,8266,157064,18114.75,217377,347.89,2103.65,0.0571,256,70.49,25011.64,0.37,0.6538
8478,Ortiz and Sons,False,NG,Nancyburgh,EdTech,2018,https://ortizandsons.com,Seven final need pressure important.,22,ortiz-and-sons,2023,USD,511459,214752,296707,289351,7356,25085,-17729,5114,10229,-27958,7678,336759,106971,229788,42621.58,511459,553.27,2575.91,0.001,2735,15.58,1000.0,7.68,0.5801
8479,Chapman Inc,False,GB,West Stevenmouth,Fintech,2010,https://chapmaninc.com,Short model this as brother above question future.,17,chapman-inc,2023,USD,1143239,473295,669944,174663,495281,0,495281,11432,22864,472417,37714,746326,577499,168827,,1143239,917.09,2087.29,0.0095,322,295.64,1000.0,37.71,0.586
8480,Melton Cruz and Holmes,False,NG,New Kim,IoT,2021,https://meltoncruzandholmes.com,Situation she true he until.,22,melton-cruz-and-holmes,2023,USD,334210,107584,226626,35658,190968,12564,178404,3342,6684,171720,17536,360868,91975,268893,,334210,2273.18,2717.87,0.0116,173,160.13,4093.21,4.28,0.6781
8481,Hoover Inc,False,BR,Hufffurt,AI/ML,2017,https://hooverinc.com,Kind generation participant letter manage southern once miss true.,18,hoover-inc,2023,USD,1345777,469454,876323,1233166,-356843,0,-356843,13457,26915,-383758,50877,750990,204377,546613,,1345777,908.25,1323.24,0.001,5607,20.0,128618.99,0.4,0.6512
8482,Mcgrath PLC,False,IN,Yuton,HealthTech,2017,https://mcgrathplc.com,Stop choose team know meet certain analysis store hour everybody.,25,mcgrath-plc,2023,USD,677365,250949,426416,464567,-38151,14649,-52800,6773,13547,-66347,115947,524448,270156,254292,56447.08,677365,395.72,2452.6,0.0785,1179,47.85,42557.93,2.72,0.6295
8483,Gonzalez Smith and Vaughan,False,TN,New Daleview,AgriTech,2024,https://gonzalezsmithandvaughan.com,Democrat school simply system cut century table name military sit.,22,gonzalez-smith-and-vaughan,2023,USD,332277,166406,165871,178983,-13112,3817,-16929,3322,6645,-23574,19074,307705,113028,194677,,332277,20.0,97.59,0.0487,87,316.86,1000.0,19.07,0.4992
8484,Zimmerman Group,False,AU,Liubury,AI/ML,2017,https://zimmermangroup.com,Religious perform type religious line someone put notice.,25,zimmerman-group,2023,USD,1271043,195203,1075840,66005,1009835,0,1009835,12710,25420,984415,35247,776574,458730,317844,,1271043,671.15,335.58,0.0397,807,131.09,1000.0,35.25,0.8464
8485,Schwartz-Baker,False,KE,Smithchester,Marketplaces,2022,https://schwartz-baker.com,Partner including rather though player conference control many deep time.,16,schwartz-baker,2023,USD,3405661,807707,2597954,1902123,695831,59469,636362,34056,68113,568249,267535,2056882,102844,1954038,,3405661,884.27,2231.31,0.1168,2791,101.65,162844.06,1.64,0.7628
8486,Anderson Ltd,False,KE,Port Michaelfurt,E-commerce,2022,https://andersonltd.com,Certainly third within evening party bank onto including vote.,21,anderson-ltd,2023,USD,2106308,841604,1264704,1836645,-571941,29846,-601787,21063,42126,-643913,132623,1373108,381969,991139,,2106308,20.0,107.04,0.1739,474,369.98,122227.46,1.09,0.6004
8487,Meyer Gutierrez and Patterson,False,GB,West Markchester,AI/ML,2019,https://meyergutierrezandpatterson.com,Point star white view very.,21,meyer-gutierrez-and-patterson,2023,USD,2221067,844280,1376787,655973,720814,0,720814,22210,44421,676393,82872,1217115,705677,511438,,2221067,160.37,123.05,0.1176,9254,20.0,47278.5,1.75,0.6199
8488,Branch PLC,False,AU,Jesusport,Mobility,2018,https://branchplc.com,Large represent system current few outside street region people throughout.,23,branch-plc,2023,USD,9023539,4175861,4847678,3533222,1314456,32739,1281717,90235,180470,1101247,568661,5083195,955343,4127852,,9023539,166.35,1092.49,0.1945,3490,215.45,317191.78,1.79,0.5372
8489,Oliver Torres and Evans,False,BR,South Rachel,Cybersecurity,2019,https://olivertorresandevans.com,Make somebody at cause sister.,15,oliver-torres-and-evans,2023,USD,832277,431909,400368,219529,180839,0,180839,8322,16645,164194,50631,613846,54398,559448,,832277,335.59,2462.5,0.0877,548,126.54,56042.13,0.9,0.4811
8490,Herrera-Holmes,False,AU,East Julie,AI/ML,2012,https://herrera-holmes.com,Eye put box each near manage do question imagine.,22,herrera-holmes,2023,USD,725929,342621,383308,196344,186964,42034,144930,7259,14518,130412,40493,473428,337324,136104,,725929,850.42,425.21,0.001,482,125.36,30132.84,1.34,0.528
8491,Jordan-Rosales,False,NG,North Madisonmouth,Cybersecurity,2011,https://jordan-rosales.com,Administration author peace knowledge bed government prove.,28,jordan-rosales,2023,USD,697639,265215,432424,181805,250619,14422,236197,6976,13952,222245,13773,385142,143866,241276,,697639,1935.23,10047.85,0.0065,852,68.22,33986.58,0.41,0.6198
8492,Osborne Wood and Adams,False,KE,Hodgesmouth,SaaS,2013,https://osbornewoodandadams.com,Read take attorney feel last energy bag senior discover.,23,osborne-wood-and-adams,2023,USD,2023815,833141,1190674,769409,421265,0,421265,20238,40476,380789,33466,1208437,212231,996206,168651.25,2023815,401.1,2412.81,0.0496,1710,98.61,72123.62,0.46,0.5883
8493,Watson-Collins,False,GB,East Jeanne,Fintech,2022,https://watson-collins.com,Teach important season five thing only explain about air draw.,17,watson-collins,2023,USD,208787,75639,133148,99984,33164,17850,15314,2087,4175,11139,14780,217810,10890,206920,,208787,802.63,2703.12,0.084,81,213.21,14381.05,1.03,0.6377
8494,Taylor Inc,False,ZA,Kellyberg,IoT,2022,https://taylorinc.com,College agency trip share card three probably arrive.,20,taylor-inc,2023,USD,667833,333513,334320,324551,9769,0,9769,6678,13356,-3587,54009,550873,66906,483967,,667833,1702.18,2367.04,0.0441,2782,20.0,29559.06,1.83,0.5006
8495,Estes-Cole,False,ZA,Melissabury,AI/ML,2010,https://estes-cole.com,Gas strategy recent need near score sea professor.,21,estes-cole,2023,USD,462294,165612,296682,46208,250474,27517,222957,4622,9245,213712,16688,379382,18969,360413,,462294,20.0,33.6,0.1221,179,214.74,1000.0,16.69,0.6418
8496,Norman Winters and Vega,False,GB,Barronborough,AgriTech,2024,https://normanwintersandvega.com,Financial factor drop tough without reason fly open million bring.,29,norman-winters-and-vega,2023,USD,3639713,1345825,2293888,940302,1353586,0,1353586,36397,72794,1280792,60742,2079292,938996,1140296,,3639713,20.0,163.64,0.0867,15165,20.0,57198.63,1.06,0.6302
8497,Gibbs Group,False,NG,Stevenborough,EdTech,2022,https://gibbsgroup.com,American what together above eat do grow prove performance.,20,gibbs-group,2023,USD,304334,82344,221990,157190,64800,31709,33091,3043,6086,27005,43204,231522,180698,50824,25361.17,304334,676.82,3905.31,0.001,363,69.7,8896.31,4.86,0.7294
8498,Hays Wolf and Ortiz,False,FR,East Jameschester,Mobility,2008,https://hayswolfandortiz.com,Treatment usually tonight of development high.,16,hays-wolf-and-ortiz,2023,EUR,118521,36504,82017,80810,1207,31037,-29830,1185,2370,-32200,14887,95364,54230,41134,,118521,20.0,10.89,0.0792,493,20.0,1000.0,14.89,0.692
8499,Velasquez-Matthews,False,CA,Allisonshire,IoT,2024,https://velasquez-matthews.com,Television control together special chair per director.,15,velasquez-matthews,2023,USD,390802,162364,228438,139669,88769,0,88769,3908,7816,80953,23386,225854,99757,126097,,390802,20.0,127.21,0.0316,191,169.62,1289.82,18.13,0.5845
8500,Henry Buck and Cook,False,IN,Port Matthew,AgriTech,2018,https://henrybuckandcook.com,Today doctor since beyond herself develop fish.,25,henry-buck-and-cook,2023,USD,213504,54079,159425,79661,79764,0,79764,2135,4270,75494,8886,271526,20370,251156,,213504,20.0,20.48,0.082,833,21.35,1000.0,8.89,0.7467
8501,Miller PLC,False,AU,South Alexis,Fintech,2016,https://millerplc.com,That reality hear serious four director international north.,22,miller-plc,2023,USD,957210,210906,746304,545588,200716,357,200359,9572,19144,181215,61945,616270,240312,375958,,957210,1417.18,5543.52,0.0661,381,209.08,53460.42,1.16,0.7797
8502,Jenkins Glover and Thornton,False,AU,Phillipsstad,EdTech,2021,https://jenkinsgloverandthornton.com,Whose me material receive step beautiful choice office per fast.,20,jenkins-glover-and-thornton,2023,USD,337313,112656,224657,215142,9515,1011,8504,3373,6746,1758,30451,366262,18313,347949,28109.42,337313,10.0,41.24,0.0418,282,99.44,18909.94,1.61,0.666
8503,Gould LLC,False,EG,Amyport,HealthTech,2024,https://gouldllc.com,Action parent huge scientist spend Democrat event.,21,gould-llc,2023,USD,952406,265839,686567,47620,638947,0,638947,9524,19048,619899,20628,511985,144238,367747,79367.17,952406,363.65,1077.72,0.051,4781,16.6,1000.0,20.63,0.7209
8504,Romero Inc,False,TN,Colemanberg,AI/ML,2011,https://romeroinc.com,Partner notice course growth interest begin cup stage let.,18,romero-inc,2023,USD,455004,117845,337159,373906,-36747,32918,-69665,4550,9100,-78765,7236,421885,294775,127110,,455004,119.24,565.05,0.068,128,295.56,51438.49,0.14,0.741
8505,Villarreal Inc,False,FR,Jasminemouth,HealthTech,2014,https://villarrealinc.com,Fall huge church best themselves.,24,villarreal-inc,2023,EUR,173843,80334,93509,21235,72274,8339,63935,1738,3476,60459,2566,238451,35816,202635,14486.92,173843,419.78,419.78,0.0412,271,53.28,12159.61,0.21,0.5379
8506,Holland and Sons,False,BR,East Alexanderstad,SaaS,2014,https://hollandandsons.com,Meeting summer contain machine floor movement nothing beautiful throw.,19,holland-and-sons,2023,USD,2391401,1422414,968987,430500,538487,6172,532315,23914,47828,484487,232642,1466341,554108,912233,199283.42,2391401,277.11,1649.6,0.072,4797,41.54,25317.11,9.19,0.4052
8507,Cameron Group,False,NG,North Jose,AI/ML,2018,https://camerongroup.com,Loss southern fall pass government some although economic food building.,14,cameron-group,2023,USD,7961112,3563412,4397700,1772103,2625597,34803,2590794,79611,159222,2431572,79103,4214519,752823,3461696,,7961112,20.0,76.96,0.0298,10088,65.76,137736.67,0.57,0.5524
8508,Martin Patel and Buckley,False,AU,Crystalchester,Energy,2011,https://martinpatelandbuckley.com,Democrat people news health home yourself day because else.,16,martin-patel-and-buckley,2023,USD,168624,37699,130925,100157,30768,13875,16893,1686,3372,13521,9790,167634,55292,112342,,168624,20.0,21.62,0.0392,140,100.37,8651.3,1.13,0.7764
8509,Moreno Hensley and Hall,False,AU,Victoriaview,Fintech,2015,https://morenohensleyandhall.com,Million record goal name success standard oil.,19,moreno-hensley-and-hall,2023,USD,187350,86557,100793,108987,-8194,0,-8194,1873,3747,-11941,11710,286174,46073,240101,,187350,20.0,61.68,0.0525,97,160.8,22484.93,0.52,0.538
8510,May Inc,False,KE,East Robert,Mobility,2010,https://mayinc.com,Modern hair meeting each war share require response enter whatever.,19,may-inc,2023,USD,249789,126537,123252,160086,-36834,0,-36834,2497,4995,-41829,52102,339628,72549,267079,,249789,129.51,749.76,0.1274,1040,20.0,13289.16,3.92,0.4934
8511,Thompson PLC,False,IN,South Andrewtown,E-commerce,2008,https://thompsonplc.com,Bag important officer risk indeed recent six color board skill.,22,thompson-plc,2023,USD,1609721,316630,1293091,616695,676396,0,676396,16097,32194,644202,27759,999180,414704,584476,,1609721,1523.02,4648.1,0.0159,608,220.51,70276.8,0.39,0.8033
8512,Gutierrez Inc,False,US,North Courtneyport,Cybersecurity,2013,https://gutierrezinc.com,Seem source off some skin small.,27,gutierrez-inc,2023,USD,1553338,522331,1031007,170748,860259,34517,825742,15533,31066,794676,47510,915135,545566,369569,,1553338,20.0,58.85,0.0576,6472,20.0,17014.79,2.79,0.6637
8513,Quinn-Gray,False,FR,New Christina,Mobility,2022,https://quinn-gray.com,Country within audience individual part foreign.,25,quinn-gray,2023,EUR,2005072,594425,1410647,1102903,307744,44715,263029,20050,40101,222928,598700,1712149,562285,1149864,,2005072,897.79,6894.65,0.001,8354,20.0,79856.83,7.5,0.7035
8514,Hall Thompson and Blackburn,False,KE,Jamieland,SaaS,2019,https://hallthompsonandblackburn.com,Just stuff seat none.,21,hall-thompson-and-blackburn,2023,USD,1060303,351554,708749,667426,41323,20496,20827,10603,21206,-379,41658,728719,409533,319186,88358.58,1060303,10.0,47.35,0.061,1117,79.09,51128.36,0.81,0.6684
8515,Kennedy-Soto,False,CA,Soniaside,HealthTech,2021,https://kennedy-soto.com,Hard professor foreign color good part middle contain positive.,19,kennedy-soto,2023,USD,293092,103286,189806,102129,87677,10930,76747,2930,5861,70886,970,325022,195337,129685,24424.33,293092,222.37,318.85,0.001,692,35.26,23554.87,0.04,0.6476
8516,Anderson-Ramirez,False,TN,East Bryanborough,IoT,2014,https://anderson-ramirez.com,You my over put clear car wait individual rock task.,29,anderson-ramirez,2023,USD,271238,96114,175124,166930,8194,0,8194,2712,5424,2770,15777,337807,61362,276445,,271238,1065.45,4033.35,0.001,412,54.82,14223.58,1.11,0.6456
8517,Wilson Ltd,False,DE,Port Amanda,E-commerce,2010,https://wilsonltd.com,Off food hold financial process.,16,wilson-ltd,2023,EUR,923397,198483,724914,355518,369396,0,369396,9233,18467,350929,14064,604547,392186,212361,,923397,1127.52,6886.5,0.0297,445,172.83,26065.55,0.54,0.7851
8518,Roberts LLC,False,BR,North Lisa,Marketplaces,2018,https://robertsllc.com,Unit law some politics bill democratic behavior.,31,roberts-llc,2023,USD,688919,327210,361709,34445,327264,0,327264,6889,13778,313486,99996,509770,220651,289119,,688919,607.82,303.91,0.0917,533,107.65,19655.78,5.09,0.525
8519,Martinez Inc,False,ZA,Port Williamtown,AI/ML,2008,https://martinezinc.com,Yourself play seat fear late line hospital capital subject.,18,martinez-inc,2023,USD,5052485,736356,4316129,3714781,601348,22252,579096,50524,101049,478047,307957,2890033,144501,2745532,,5052485,431.22,1692.82,0.0565,10319,40.8,321641.11,0.96,0.8543
8520,Watson-Henry,False,AU,Wagnerport,Cybersecurity,2022,https://watson-henry.com,Worker before old unit local get prepare check century.,16,watson-henry,2023,USD,1469566,859429,610137,321560,288577,1108,287469,14695,29391,258078,23905,929390,445005,484385,,1469566,20.0,83.84,0.001,4356,28.11,30735.13,0.78,0.4152
8521,Willis Sanchez and Jones,False,ZA,East Courtney,SaaS,2018,https://willissanchezandjones.com,Grow former available hot.,26,willis-sanchez-and-jones,2023,USD,264337,105247,159090,225196,-66106,58948,-125054,2643,5286,-130340,4766,213764,55685,158079,22028.08,264337,357.2,1274.8,0.0425,909,24.23,26409.9,0.18,0.6018
8522,Martinez-Taylor,False,DE,East Kathleen,HealthTech,2020,https://martinez-taylor.com,Herself nation adult thus process pay clear.,23,martinez-taylor,2023,EUR,1190056,169643,1020413,614965,405448,5665,399783,11900,23801,375982,91371,765879,38293,727586,99171.33,1190056,10.0,43.02,0.0077,2803,35.37,53554.51,1.71,0.8574
8523,Richards Group,False,US,Lawrenceland,Cybersecurity,2011,https://richardsgroup.com,Side sea item order.,16,richards-group,2023,USD,1689649,564584,1125065,1012736,112329,0,112329,16896,33792,78537,89670,979363,556322,423041,,1689649,935.95,4358.45,0.0828,1245,113.02,46610.11,1.92,0.6659
8524,Jones Reed and Hudson,False,FR,South Justinside,IoT,2015,https://jonesreedandhudson.com,Hotel plant art food we end alone size goal cold get.,14,jones-reed-and-hudson,2023,EUR,1234743,579398,655345,941784,-286439,0,-286439,12347,24694,-311133,9832,711623,139475,572148,,1234743,20.0,88.69,0.0604,5144,20.0,84992.76,0.12,0.5308
8525,Maldonado Inc,False,AU,New Ryanland,IoT,2010,https://maldonadoinc.com,Candidate quite center degree interesting ok order price image.,10,maldonado-inc,2023,USD,374973,204514,170459,18748,151711,27774,123937,3749,7499,116438,3880,351939,76066,275873,,374973,288.34,1068.02,0.0233,614,50.84,1000.0,3.88,0.4546
8526,Levine-Thompson,False,US,Emilytown,EdTech,2012,https://levine-thompson.com,Ever quite describe fire discover huge dog.,20,levine-thompson,2023,USD,174237,59112,115125,93646,21479,0,21479,1742,3484,17995,9076,198647,91484,107163,14519.75,174237,18.78,53.05,0.0295,162,89.35,41206.42,0.22,0.6607
8527,Moore-Smith,False,KE,Davidville,Mobility,2017,https://moore-smith.com,Maybe serve raise side along.,20,moore-smith,2023,USD,617778,244381,373397,167674,205723,4262,201461,6177,12355,189106,30946,514626,297162,217464,,617778,2058.29,2640.79,0.0678,290,177.28,1000.0,30.95,0.6044
8528,Murillo Knight and Smith,False,GB,Mooreport,Marketplaces,2018,https://murilloknightandsmith.com,Movement life partner indicate simply.,19,murillo-knight-and-smith,2023,USD,1547280,617583,929697,160571,769126,226,768900,15472,30945,737955,47986,890434,304069,586365,,1547280,1180.26,3667.45,0.0886,1060,121.58,1000.0,47.99,0.6009
8529,Rodriguez Jacobs and Jimenez,False,CA,West Kevin,Fintech,2015,https://rodriguezjacobsandjimenez.com,Road green who national direction site loss call than ability.,25,rodriguez-jacobs-and-jimenez,2023,USD,571229,158106,413123,292748,120375,10144,110231,5712,11424,98807,103258,581312,176657,404655,,571229,469.14,999.91,0.0603,1595,29.84,23102.16,4.47,0.7232
8530,Moore Lopez and Carter,False,ZA,Coltonview,Energy,2009,https://moorelopezandcarter.com,Lay sell heavy exist range approach light top green actually.,20,moore-lopez-and-carter,2023,USD,974878,251270,723608,395477,328131,32723,295408,9748,19497,275911,96205,637046,250784,386262,,974878,907.24,5417.27,0.0947,700,116.05,15064.76,6.39,0.7423
8531,Murphy Schultz and Robbins,False,KE,Howardchester,SaaS,2024,https://murphyschultzandrobbins.com,Large police size suggest of attorney particularly best specific son.,14,murphy-schultz-and-robbins,2023,USD,141668,58373,83295,79055,4240,9720,-5480,1416,2833,-8313,8871,127820,30396,97424,11805.67,141668,405.39,1390.97,0.001,111,106.16,1000.0,8.87,0.588
8532,Taylor Taylor and Mccarthy,False,CA,East Cheryl,AI/ML,2011,https://taylortaylorandmccarthy.com,Focus who part business story tax difference keep range.,19,taylor-taylor-and-mccarthy,2023,USD,386778,146181,240597,457187,-216590,41882,-258472,3867,7735,-266207,22592,303978,37084,266894,,386778,353.08,1123.92,0.0789,1611,20.0,42320.16,0.53,0.6221
8533,Dawson Collins and Morton,False,NG,East Yolanda,Cybersecurity,2011,https://dawsoncollinsandmorton.com,Practice employee traditional program include end mother successful term.,22,dawson-collins-and-morton,2023,USD,2616593,499622,2116971,1903951,213020,0,213020,26165,52331,160689,59301,1478784,778006,700778,,2616593,493.59,4342.9,0.001,973,224.02,179277.69,0.33,0.8091
8534,Rodriguez-Hubbard,False,US,Karenview,AgriTech,2018,https://rodriguez-hubbard.com,Month market crime bill alone money husband.,16,rodriguez-hubbard,2023,USD,354495,94255,260240,134543,125697,0,125697,3544,7089,118608,18174,395037,164701,230336,,354495,384.73,1365.24,0.0712,1477,20.0,1000.0,18.17,0.7341
8535,Boyer-Olson,False,US,Paulabury,HealthTech,2017,https://boyer-olson.com,Series drop capital food head benefit meeting ball.,21,boyer-olson,2023,USD,886117,265035,621082,279187,341895,29790,312105,8861,17722,294383,20724,475608,112331,363277,73843.08,886117,504.6,2070.55,0.0223,2701,27.33,69476.06,0.3,0.7009
8536,Watson-Wilkerson,False,DE,Lake Scott,Cybersecurity,2022,https://watson-wilkerson.com,Although machine eat boy service you sure.,25,watson-wilkerson,2023,EUR,622531,326846,295685,379709,-84024,46079,-130103,6225,12450,-142553,22825,402850,88818,314032,,622531,1301.58,2091.86,0.1367,2593,20.0,26535.74,0.86,0.475
8537,Boone-Rodriguez,False,DE,West Sharonmouth,Energy,2010,https://boone-rodriguez.com,Similar condition make participant mind land serious series whether offer.,17,boone-rodriguez,2023,EUR,783151,302143,481008,375048,105960,8643,97317,7831,15663,81654,10968,521672,75257,446415,,783151,643.86,2526.47,0.0969,211,308.75,48021.24,0.23,0.6142
8538,Smith-Rogers,False,CA,Williamsfort,Cybersecurity,2024,https://smith-rogers.com,Ago fire anything surface science card couple become.,21,smith-rogers,2023,USD,7429476,1283436,6146040,5129221,1016819,0,1016819,74294,148589,868230,166597,4013211,1083025,2930186,,7429476,20.0,55.88,0.061,8258,74.97,433195.34,0.38,0.8273
8539,Benton Waller and Allison,False,EG,New Carlberg,EdTech,2020,https://bentonwallerandallison.com,Road remember some politics raise add expect investment few special.,21,benton-waller-and-allison,2023,USD,916201,338170,578031,440567,137464,3367,134097,9162,18324,115773,3250,638472,120316,518156,76350.08,916201,331.41,725.85,0.001,754,101.19,26849.35,0.12,0.6309
8540,Reilly Group,False,AU,Pamelatown,Energy,2012,https://reillygroup.com,Perform trip give group.,27,reilly-group,2023,USD,1324824,607177,717647,625388,92259,0,92259,13248,26496,65763,128484,960475,377740,582735,,1324824,44.4,116.32,0.0732,684,161.38,66876.32,1.92,0.5417
8541,Long Miller and Russell,False,EG,Peterberg,Fintech,2014,https://longmillerandrussell.com,Democrat hour school start site form answer.,22,long-miller-and-russell,2023,USD,784248,261910,522338,182692,339646,0,339646,7842,15684,323962,54935,556713,314444,242269,,784248,1080.69,2428.46,0.001,1322,49.4,17470.48,3.14,0.666
8542,Cain-Smith,False,ZA,Martinland,E-commerce,2024,https://cain-smith.com,Southern indeed represent kid wall gun at not response.,18,cain-smith,2023,USD,1773589,690626,1082963,1134818,-51855,0,-51855,17735,35471,-87326,242612,1313814,170758,1143056,,1773589,231.26,115.63,0.001,1386,106.62,89884.05,2.7,0.6106
8543,James Inc,False,ZA,New Katelyn,IoT,2020,https://jamesinc.com,Size phone imagine will maybe shoulder positive including.,21,james-inc,2023,USD,1097211,345252,751959,310002,441957,0,441957,10972,21944,420013,18437,583096,39941,543155,,1097211,608.51,2890.75,0.0306,4571,20.0,1000.0,18.44,0.6853
8544,Johnson-Wagner,False,KE,Lake Garyshire,EdTech,2014,https://johnson-wagner.com,Job piece charge should plan here garden late role class.,21,johnson-wagner,2023,USD,875986,306754,569232,419258,149974,0,149974,8759,17519,132455,89023,589683,320788,268895,72998.83,875986,330.86,1412.5,0.0217,14599,5.0,14767.27,6.03,0.6498
8545,Newman-Rodriguez,False,CA,Gomezmouth,EdTech,2009,https://newman-rodriguez.com,Approach develop feeling get word store people wide.,22,newman-rodriguez,2023,USD,226469,87225,139244,107190,32054,3459,28595,2264,4529,24066,8983,299066,15692,283374,18872.42,226469,10.0,29.58,0.0135,239,78.88,14619.16,0.61,0.6148
8546,Cabrera-Young,False,ZA,Floresfurt,SaaS,2018,https://cabrera-young.com,Color grow particular strategy.,17,cabrera-young,2023,USD,2626844,1025618,1601226,401298,1199928,0,1199928,26268,52536,1147392,54023,1424952,920644,504308,218903.67,2626844,358.26,1786.51,0.0334,3687,59.36,51278.95,1.05,0.6096
8547,Flores-Sanders,False,NG,Smithbury,E-commerce,2021,https://flores-sanders.com,Radio possible quality after foot yard yes.,21,flores-sanders,2023,USD,231101,74028,157073,93101,63972,23824,40148,2311,4622,35526,32255,214843,128570,86273,,231101,20.0,126.04,0.1319,90,212.01,1000.0,32.26,0.6797
8548,Russell Stein and Smith,False,FR,Thomasmouth,E-commerce,2017,https://russellsteinandsmith.com,Gas military mean support add force necessary service.,28,russell-stein-and-smith,2023,EUR,391938,225894,166044,219833,-53789,7727,-61516,3919,7838,-69354,5198,229692,89931,139761,,391938,416.93,1482.51,0.001,123,263.73,23122.68,0.22,0.4236
8549,Garza PLC,False,EG,South Phillipchester,Marketplaces,2015,https://garzaplc.com,Effort at position listen add citizen.,14,garza-plc,2023,USD,676249,351037,325212,211650,113562,21092,92470,6762,13524,78946,18831,497854,61712,436142,,676249,20.0,38.26,0.0653,294,191.06,1000.0,18.83,0.4809
8550,Smith-Hill,False,FR,New Cindy,Marketplaces,2018,https://smith-hill.com,Candidate security law present big home land participant act.,26,smith-hill,2023,EUR,2751954,1198985,1552969,2344755,-791786,0,-791786,27519,55039,-846825,190117,1644680,474683,1169997,,2751954,639.76,2615.86,0.0575,2054,111.63,180451.64,1.05,0.5643
8551,Smith-Savage,False,TN,West Jon,Energy,2015,https://smith-savage.com,Maintain bag stay the performance box garden artist another.,20,smith-savage,2023,USD,9638982,2628368,7010614,1669772,5340842,7,5340835,96389,192779,5148056,1812053,6649870,3881007,2768863,,9638982,20.0,63.51,0.0525,27210,29.52,132485.41,13.68,0.7273
8552,Williams-Williams,False,KE,Hansonmouth,Mobility,2013,https://williams-williams.com,Allow according popular look name fast girl management organization TV.,17,williams-williams,2023,USD,1110624,271766,838858,499493,339365,11858,327507,11106,22212,305295,64161,753272,191305,561967,,1110624,20.0,38.1,0.0426,864,107.01,69610.65,0.92,0.7553
8553,Pearson Group,False,CA,Gutierrezville,E-commerce,2011,https://pearsongroup.com,Room amount organization agree use rich under money.,15,pearson-group,2023,USD,2380500,269827,2110673,1446148,664525,18527,645998,23805,47610,598388,133110,1382151,388194,993957,,2380500,617.22,1452.67,0.1001,9918,20.0,151637.38,0.88,0.8867
8554,Fletcher-Simpson,False,FR,New Fernandoville,Energy,2017,https://fletcher-simpson.com,Compare per political price whom race structure wall less.,28,fletcher-simpson,2023,EUR,337047,119507,217540,77285,140255,0,140255,3370,6740,133515,85548,266964,174007,92957,,337047,1032.18,3419.01,0.0626,1404,20.0,31851.34,2.69,0.6454
8555,Vazquez-Gibson,False,DE,East Richard,Energy,2009,https://vazquez-gibson.com,Somebody modern happen good soldier.,20,vazquez-gibson,2023,EUR,1460969,348273,1112696,619094,493602,35877,457725,14609,29219,428506,53027,859254,42962,816292,,1460969,139.98,69.99,0.0473,599,203.07,79097.44,0.67,0.7616
8556,Vance Lee and Hernandez,False,BR,Lake Stephanieport,HealthTech,2024,https://vanceleeandhernandez.com,Lose decide movie about job stay method trade.,28,vance-lee-and-hernandez,2023,USD,2052781,734126,1318655,696454,622201,7398,614803,20527,41055,573748,131692,1262180,134603,1127577,171065.08,2052781,156.45,883.39,0.0629,3062,55.85,96690.42,1.36,0.6424
8557,Robertson Hines and Kelly,False,DE,Dyerfurt,Mobility,2023,https://robertsonhinesandkelly.com,Read agency believe fly debate small oil.,18,robertson-hines-and-kelly,2023,EUR,726405,110451,615954,65189,550765,6286,544479,7264,14528,529951,27177,485381,177332,308049,,726405,833.12,1593.92,0.001,1972,30.69,9851.25,2.76,0.8479
8558,Brown-Carlson,False,GB,Lake Ryan,Mobility,2008,https://brown-carlson.com,Report loss station would what food.,20,brown-carlson,2023,USD,291651,87666,203985,246269,-42284,7036,-49320,2916,5833,-55153,1632,345145,182521,162624,,291651,377.28,1838.29,0.0753,400,60.69,6475.03,0.25,0.6994
8559,Tate-Davis,False,GB,Lake Phyllis,AI/ML,2021,https://tate-davis.com,Policy could where because fall quality structure show station.,18,tate-davis,2023,USD,732652,270366,462286,422911,39375,13551,25824,7326,14653,11171,13854,435393,128062,307331,,732652,982.04,1175.18,0.0334,309,197.36,77595.05,0.18,0.631
8560,Munoz-White,False,AU,Mcleanshire,Marketplaces,2020,https://munoz-white.com,Win week onto peace almost difference note.,20,munoz-white,2023,USD,923728,601279,322449,247896,74553,54034,20519,9237,18474,2045,13564,555169,195093,360076,,923728,171.11,390.99,0.0493,339,227.07,17675.6,0.77,0.3491
8561,Mcgee PLC,False,TN,Georgeburgh,SaaS,2018,https://mcgeeplc.com,Service range activity news field land.,16,mcgee-plc,2023,USD,12752253,4491830,8260423,6330484,1929939,0,1929939,127522,255045,1674894,357511,6898504,2245550,4652954,1062687.75,12752253,479.67,2361.78,0.0161,10984,96.74,522012.39,0.68,0.6478
8562,Jones-Nelson,False,DE,Cunninghamshire,AgriTech,2013,https://jones-nelson.com,Play usually government thought guy.,21,jones-nelson,2023,EUR,1502251,721151,781100,1462309,-681209,12938,-694147,15022,30045,-724192,77706,838538,400417,438121,,1502251,365.19,474.8,0.0414,435,287.51,105751.63,0.73,0.52
8563,Bryant King and Salinas,False,NG,Jeremyport,Fintech,2020,https://bryantkingandsalinas.com,Hot religious need interest responsibility class would plan.,16,bryant-king-and-salinas,2023,USD,204186,29720,174466,10209,164257,0,164257,2041,4083,160174,5584,174100,89626,84474,,204186,20.0,53.63,0.1219,850,20.0,12152.12,0.46,0.8544
8564,Baker Knight and Acevedo,False,AU,Abbottfort,AgriTech,2016,https://bakerknightandacevedo.com,Everyone economic suggest realize current sea evidence watch.,32,baker-knight-and-acevedo,2023,USD,405468,158006,247462,20273,227189,17920,209269,4054,8109,201160,19883,257823,125932,131891,,405468,20.0,107.4,0.1163,1689,20.0,1000.0,19.88,0.6103
8565,Cervantes Group,False,FR,North Johnchester,Cybersecurity,2021,https://cervantesgroup.com,First bring beautiful suggest short court poor opportunity admit.,24,cervantes-group,2023,EUR,858003,192513,665490,610806,54684,0,54684,8580,17160,37524,12189,475381,81119,394262,,858003,20.0,65.97,0.0036,3575,20.0,59649.79,0.2,0.7756
8566,Logan-Gallegos,False,FR,North Nicolestad,SaaS,2011,https://logan-gallegos.com,Few start pull page past follow despite.,22,logan-gallegos,2023,EUR,427606,140296,287310,339473,-52163,0,-52163,4276,8552,-60715,10513,244881,61851,183030,35633.83,427606,10.0,10.0,0.0545,367,97.04,58920.35,0.18,0.6719
8567,Wright Ltd,False,KE,Wrightton,Cybersecurity,2022,https://wrightltd.com,Officer yes management magazine attention arm.,19,wright-ltd,2023,USD,653046,253754,399292,164407,234885,0,234885,6530,13060,221825,20599,435932,87729,348203,,653046,777.04,3680.41,0.0741,240,226.15,31495.7,0.65,0.6114
8568,Johnson-Holloway,False,CA,Harrellshire,Marketplaces,2014,https://johnson-holloway.com,Same these us high strong early late.,25,johnson-holloway,2023,USD,1123778,243247,880531,287646,592885,57984,534901,11237,22475,512426,27619,592614,361879,230735,,1123778,569.55,3209.97,0.0835,585,159.92,16778.95,1.65,0.7835
8569,Hawkins LLC,False,CA,West Justin,AI/ML,2017,https://hawkinsllc.com,Whose religious recognize rather hard attention perhaps fly.,26,hawkins-llc,2023,USD,2153532,809644,1343888,557858,786030,0,786030,21535,43070,742960,49167,1160584,367101,793483,,2153532,58.9,331.81,0.1094,8973,20.0,71283.65,0.69,0.624
8570,Gordon Shaffer and Villarreal,False,TN,North Angelamouth,AgriTech,2009,https://gordonshafferandvillarreal.com,Often road rich his buy authority.,16,gordon-shaffer-and-villarreal,2023,USD,549074,114393,434681,247346,187335,4201,183134,5490,10981,172153,17269,312536,78343,234193,,549074,154.51,77.26,0.0211,436,104.81,38498.32,0.45,0.7917
8571,Johnson PLC,False,CA,East Michael,Fintech,2009,https://johnsonplc.com,Into sound if study message authority dog become reason.,25,johnson-plc,2023,USD,3070503,1213657,1856846,554843,1302003,15802,1286201,30705,61410,1224791,157596,1835731,593705,1242026,,3070503,812.44,2085.65,0.001,12793,20.0,29762.1,5.3,0.6047
8572,Garcia Martinez and Oconnell,False,DE,Port Samanthamouth,Marketplaces,2008,https://garciamartinezandoconnell.com,Edge call decade lawyer conference growth movie full meeting like.,16,garcia-martinez-and-oconnell,2023,EUR,1407417,721575,685842,310618,375224,10165,365059,14074,28148,336911,50545,815339,126694,688645,,1407417,214.79,631.35,0.0441,5864,20.0,67680.08,0.75,0.4873
8573,Schneider Moss and Moyer,False,GB,South Darrell,Mobility,2014,https://schneidermossandmoyer.com,Effect arm both church week somebody before final.,10,schneider-moss-and-moyer,2023,USD,634301,148727,485574,257587,227987,0,227987,6343,12686,215301,33172,430803,231870,198933,,634301,1806.0,6871.87,0.001,253,208.11,1000.0,33.17,0.7655
8574,Green Clayton and Miller,False,US,Davisfort,AgriTech,2012,https://greenclaytonandmiller.com,Never condition compare wind quality product.,24,green-clayton-and-miller,2023,USD,42455,18863,23592,24515,-923,4943,-5866,424,849,-6715,2407,209802,64293,145509,,42455,117.67,58.84,0.0617,176,20.0,4728.72,0.51,0.5557
8575,Pineda-Wilson,False,EG,Collinsberg,Energy,2014,https://pineda-wilson.com,Body when class interest senior foot a behavior forget piece.,21,pineda-wilson,2023,USD,1803681,455249,1348432,380995,967437,0,967437,18036,36073,931364,80562,1156914,653493,503421,,1803681,474.07,1002.17,0.001,7515,20.0,47965.11,1.68,0.7476
8576,Davis Williams and Price,False,TN,South Tinaton,HealthTech,2024,https://daviswilliamsandprice.com,It themselves close test.,14,davis-williams-and-price,2023,USD,439433,211740,227693,294860,-67167,0,-67167,4394,8788,-75955,231759,611097,180712,430385,36619.42,439433,484.25,821.33,0.03,846,43.28,13904.52,16.67,0.5182
8577,Patton Ltd,False,FR,Ellisburgh,AgriTech,2016,https://pattonltd.com,Final section agent raise partner decade rather specific that method.,19,patton-ltd,2023,EUR,124154,32978,91176,42788,48388,47991,397,1241,2483,-2086,20786,226103,123737,102366,,124154,964.72,3630.37,0.062,61,168.63,1000.0,20.79,0.7344
8578,Lewis Pitts and Martin,False,BR,South Rebecca,AgriTech,2022,https://lewispittsandmartin.com,Whom seven focus music network now.,23,lewis-pitts-and-martin,2023,USD,537333,235276,302057,261779,40278,12130,28148,5373,10746,17402,14294,429034,244287,184747,,537333,20.0,10.0,0.001,2238,20.0,43830.99,0.33,0.5621
8579,Wolf LLC,False,FR,Lake Jacqueline,AI/ML,2015,https://wolfllc.com,Give become blood board say letter in soon rich much.,15,wolf-llc,2023,EUR,935180,372862,562318,332504,229814,15997,213817,9351,18703,195114,157405,750839,282926,467913,,935180,20.0,88.13,0.0536,3896,20.0,10046.78,15.67,0.6013
8580,Meza Kelley and Mccoy,False,KE,Jayhaven,E-commerce,2014,https://mezakelleyandmccoy.com,Camera hospital carry effect Mrs rule stop.,29,meza-kelley-and-mccoy,2023,USD,758946,343691,415255,391543,23712,0,23712,7589,15178,8534,45130,578648,345296,233352,,758946,745.24,372.62,0.001,249,253.18,39059.79,1.16,0.5471
8581,Silva Inc,False,US,Morganfurt,IoT,2021,https://silvainc.com,Show simple policy century call drop.,16,silva-inc,2023,USD,719535,216547,502988,582276,-79288,4269,-83557,7195,14390,-97947,22155,461530,36263,425267,,719535,20.0,136.53,0.0382,327,183.32,38082.68,0.58,0.699
8582,Cole-Richard,False,KE,Moorechester,SaaS,2021,https://cole-richard.com,Pay group exist top six why.,21,cole-richard,2023,USD,2842786,1338559,1504227,679033,825194,0,825194,28427,56855,768339,109547,1649316,592717,1056599,236898.83,2842786,59.95,287.08,0.0216,2288,103.5,71429.0,1.53,0.5291
8583,Johnson PLC,False,EG,South Eugene,Energy,2016,https://johnsonplc.com,Myself never book management answer right sea painting music suggest.,25,johnson-plc,2023,USD,3242504,1737131,1505373,1947217,-441844,16771,-458615,32425,64850,-523465,176641,1958707,1558609,400098,,3242504,990.69,1851.98,0.0351,2621,103.07,164953.25,1.07,0.4643
8584,Reed Group,False,ZA,Keithtown,Marketplaces,2008,https://reedgroup.com,Art ever item such party structure firm recent expert.,25,reed-group,2023,USD,418798,156089,262709,185233,77476,2799,74677,4187,8375,66302,4092,356001,142701,213300,,418798,30.61,109.52,0.0652,370,94.32,17261.84,0.24,0.6273
8585,Obrien and Sons,False,KE,North Jilltown,HealthTech,2013,https://obrienandsons.com,Fire green election medical deep then letter first sing old.,20,obrien-and-sons,2023,USD,1410701,216294,1194407,375728,818679,0,818679,14107,28214,790465,59381,770750,388514,382236,117558.42,1410701,440.95,1328.12,0.001,5064,23.21,24832.67,2.39,0.8467
8586,Zamora-Hawkins,False,NG,East Heathermouth,AI/ML,2016,https://zamora-hawkins.com,Management inside four through economic expert peace consumer happen woman.,22,zamora-hawkins,2023,USD,2475934,799133,1676801,1134570,542231,0,542231,24759,49518,492713,112013,1546610,251361,1295249,,2475934,20.0,76.33,0.1042,988,208.74,113691.96,0.99,0.6772
8587,Mendez-Clark,False,KE,Floreshaven,AI/ML,2022,https://mendez-clark.com,Which center its describe person history.,16,mendez-clark,2023,USD,375011,91182,283829,185417,98412,17162,81250,3750,7500,73750,10652,282384,120025,162359,,375011,406.45,3294.07,0.0662,855,36.52,18863.55,0.56,0.7569
8588,Cunningham-Petersen,False,AU,Port Sean,AgriTech,2018,https://cunningham-petersen.com,Audience call subject follow blue society from thing movement plant.,19,cunningham-petersen,2023,USD,427670,213215,214455,283495,-69040,0,-69040,4276,8553,-77593,10642,233231,69615,163616,,427670,495.09,4001.45,0.0635,1781,20.0,26918.28,0.4,0.5014
8589,Wise Garcia and Flores,False,AU,Thomasberg,E-commerce,2011,https://wisegarciaandflores.com,Ten plan myself several.,25,wise-garcia-and-flores,2023,USD,134178,36857,97321,95028,2293,0,2293,1341,2683,-390,6142,122859,13371,109488,,134178,37.61,267.89,0.0612,44,252.97,15585.43,0.39,0.7253
8590,Alvarez and Sons,False,ZA,Thomasmouth,EdTech,2018,https://alvarezandsons.com,Election race middle authority child similar.,12,alvarez-and-sons,2023,USD,467871,210463,257408,226099,31309,0,31309,4678,9357,21952,15709,428442,263179,165263,38989.25,467871,10.0,23.62,0.0234,3833,10.17,16943.39,0.93,0.5502
8591,Parks Jacobs and Powers,False,NG,Bradleyland,Cybersecurity,2022,https://parksjacobsandpowers.com,Improve bad successful task field director system.,16,parks-jacobs-and-powers,2023,USD,508160,208570,299590,383837,-84247,16925,-101172,5081,10163,-111335,5426,383448,173452,209996,,508160,297.42,345.83,0.0443,122,345.16,1499.52,3.62,0.5896
8592,Shaffer-Johnson,False,GB,Kathyshire,Mobility,2011,https://shaffer-johnson.com,Yes partner move nor writer easy drive point.,17,shaffer-johnson,2023,USD,1090420,469944,620476,54521,565955,0,565955,10904,21808,544147,190560,849446,130621,718825,,1090420,405.12,3297.85,0.1143,654,138.82,9247.79,20.61,0.569
8593,Conner Allen and Davis,False,EG,North Davidfort,AgriTech,2014,https://connerallenanddavis.com,Education arrive name how message design goal determine economic wall news.,17,conner-allen-and-davis,2023,USD,103147,33911,69236,103149,-33913,0,-33913,1031,2062,-35975,1857,197699,69613,128086,,103147,833.97,1462.26,0.1072,429,20.0,16343.32,0.11,0.6712
8594,Vasquez Cain and Moore,False,US,Jasmineberg,Marketplaces,2021,https://vasquezcainandmoore.com,Measure friend note consumer life both animal several.,19,vasquez-cain-and-moore,2023,USD,430291,228038,202253,365062,-162809,0,-162809,4302,8605,-171414,48175,274974,121733,153241,,430291,868.19,489.07,0.0368,1792,20.0,59324.39,0.81,0.47
8595,Sawyer Barnes and Ray,False,AU,Cookmouth,AI/ML,2011,https://sawyerbarnesandray.com,Build green guy coach movie.,21,sawyer-barnes-and-ray,2023,USD,1210666,561064,649602,1339199,-689597,44276,-733873,12106,24213,-758086,355303,1133946,686446,447500,,1210666,756.02,672.58,0.0414,832,121.16,112217.35,3.17,0.5366
8596,Charles and Sons,False,AU,West Christopherhaven,Fintech,2020,https://charlesandsons.com,Throughout which professional include son.,20,charles-and-sons,2023,USD,1137703,340765,796938,268953,527985,16891,511094,11377,22754,488340,130604,738702,247757,490945,,1137703,1567.22,4272.01,0.0502,688,137.69,1000.0,130.6,0.7005
8597,Davis Munoz and Gonzales,False,IN,Sanchezburgh,Cybersecurity,2009,https://davismunozandgonzales.com,Hard summer second then enter move sometimes condition now hotel.,18,davis-munoz-and-gonzales,2023,USD,337184,154559,182625,154905,27720,303,27417,3371,6743,20674,58884,413099,283506,129593,,337184,20.0,49.9,0.0431,1404,20.0,10156.32,5.8,0.5416
8598,Stephens Love and Nash,False,DE,West Mackenzie,AgriTech,2014,https://stephensloveandnash.com,Whole positive into happen on area.,22,stephens-love-and-nash,2023,EUR,430622,198633,231989,160839,71150,0,71150,4306,8612,62538,24470,273073,56091,216982,,430622,20.0,123.33,0.0905,1794,20.0,39438.62,0.62,0.5387
8599,Miles-Adams,False,KE,Justinside,AI/ML,2024,https://miles-adams.com,Recent design second from well upon.,14,miles-adams,2023,USD,2052226,102611,1949615,686203,1263412,20278,1243134,20522,41044,1202090,10731,1120587,534567,586020,,2052226,1478.27,7388.68,0.0978,1074,159.19,45439.64,0.24,0.95
8600,Alexander Ltd,False,FR,East Brian,AI/ML,2023,https://alexanderltd.com,Attention material test crime art social meet.,24,alexander-ltd,2023,EUR,2151366,1179781,971585,1446969,-475384,9706,-485090,21513,43027,-528117,154569,1298909,405561,893348,,2151366,894.95,2023.24,0.0727,8964,20.0,124564.99,1.24,0.4516
8601,Herrera-Snyder,False,DE,Williamland,AI/ML,2023,https://herrera-snyder.com,War within man theory particular test past itself.,25,herrera-snyder,2023,EUR,693715,79544,614171,310253,303918,19205,284713,6937,13874,270839,53605,445302,66260,379042,,693715,20.0,10.0,0.0866,2890,20.0,18191.47,2.95,0.8853
8602,Moss and Sons,False,EG,Port Adamfurt,Marketplaces,2019,https://mossandsons.com,Less majority weight member move.,24,moss-and-sons,2023,USD,422979,233440,189539,68736,120803,13169,107634,4229,8459,99175,84377,474464,122828,351636,,422979,20.0,10.0,0.1137,1220,28.88,1000.0,84.38,0.4481
8603,Marsh-Contreras,False,NG,Julieside,EdTech,2015,https://marsh-contreras.com,Couple early measure true product environmental blue stage myself current.,17,marsh-contreras,2023,USD,182488,45339,137149,71214,65935,3815,62120,1824,3649,58471,2832,252833,45593,207240,15207.33,182488,10.0,17.25,0.0033,3041,5.0,19117.3,0.15,0.7516
8604,Mckenzie Smith and Bautista,False,DE,Dennisland,Energy,2017,https://mckenziesmithandbautista.com,Film capital building Democrat Mrs field growth side.,21,mckenzie-smith-and-bautista,2023,EUR,278030,137489,140541,130673,9868,1503,8365,2780,5560,2805,8008,264154,125199,138955,,278030,20.0,60.67,0.0086,83,277.3,29515.4,0.27,0.5055
8605,Williamson Inc,False,AU,New Katherine,Mobility,2022,https://williamsoninc.com,Keep long friend role coach brother detail find radio stock.,24,williamson-inc,2023,USD,966651,410463,556188,358011,198177,0,198177,9666,19333,178844,52631,601495,167917,433578,,966651,1471.8,6101.68,0.0292,4027,20.0,47732.01,1.1,0.5754
8606,Blevins-Davis,False,US,Victoriaville,AgriTech,2011,https://blevins-davis.com,Practice give child law little.,22,blevins-davis,2023,USD,500736,55349,445387,301894,143493,18812,124681,5007,10014,114667,28061,462415,122247,340168,,500736,20.0,104.75,0.0858,390,106.89,25284.82,1.11,0.8895
8607,George Inc,False,DE,South Laura,Cybersecurity,2008,https://georgeinc.com,Run indicate should worker free left like recently story building choice.,28,george-inc,2023,EUR,13108549,4168621,8939928,7498966,1440962,0,1440962,131085,262170,1178792,803134,7464101,4571382,2892719,,13108549,20.0,43.25,0.0802,12116,90.16,631076.29,1.27,0.682
8608,Gould Ltd,False,KE,Hoffmanburgh,SaaS,2011,https://gouldltd.com,Mention indicate try argue part strategy know grow really identify.,20,gould-ltd,2023,USD,2812760,936458,1876302,1527694,348608,0,348608,28127,56255,292353,61587,1472346,744299,728047,234396.67,2812760,219.51,243.74,0.0272,13317,17.6,109293.7,0.56,0.6671
8609,White-Church,False,CA,Welchmouth,EdTech,2024,https://white-church.com,Return suddenly major size effort.,23,white-church,2023,USD,441643,107189,334454,118803,215651,0,215651,4416,8832,206819,24724,355590,231472,124118,36803.58,441643,38.72,233.62,0.0262,3687,9.98,3662.44,6.75,0.7573
8610,Estrada Smith and Kennedy,False,BR,Joshuaburgh,Energy,2008,https://estradasmithandkennedy.com,Because performance him may explain us bill.,20,estrada-smith-and-kennedy,2023,USD,2706915,721886,1985029,867845,1117184,0,1117184,27069,54138,1063046,70747,1464111,1125438,338673,,2706915,1681.43,7860.58,0.001,4017,56.15,71939.77,0.98,0.7333
8611,Lewis-Cowan,False,GB,Michellebury,AI/ML,2012,https://lewis-cowan.com,Office them throw deal treat under two worry available when thing.,22,lewis-cowan,2023,USD,1419828,676626,743202,1265619,-522417,926,-523343,14198,28396,-551739,50338,873175,322871,550304,,1419828,20.0,10.0,0.0461,754,156.91,101341.96,0.5,0.5234
8612,Howard PLC,False,TN,West Melissa,HealthTech,2019,https://howardplc.com,Thousand build reduce throughout small the score risk radio rather.,18,howard-plc,2023,USD,1495933,675783,820150,382292,437858,19386,418472,14959,29918,388554,25759,903673,253354,650319,124661.08,1495933,10.0,26.11,0.001,13535,9.21,42031.58,0.61,0.5483
8613,Williams-Meadows,False,IN,Reedborough,HealthTech,2009,https://williams-meadows.com,Above certain though TV suffer attention participant.,19,williams-meadows,2023,USD,2722497,619444,2103053,2448647,-345594,5480,-351074,27224,54449,-405523,169590,1604734,577672,1027062,226874.75,2722497,754.43,2388.64,0.0314,45374,5.0,184741.07,0.92,0.7725
8614,Schwartz-Hernandez,False,IN,Port George,Fintech,2013,https://schwartz-hernandez.com,Card commercial according school no professor tonight member make.,20,schwartz-hernandez,2023,USD,968350,398402,569948,487637,82311,10926,71385,9683,19367,52018,40922,583356,174151,409205,,968350,366.25,1137.96,0.0547,404,199.71,47872.55,0.85,0.5886
8615,Bell Padilla and Brewer,False,DE,South Michael,Fintech,2009,https://bellpadillaandbrewer.com,Deep imagine big remember spend.,25,bell-padilla-and-brewer,2023,EUR,267989,122468,145521,149112,-3591,10119,-13710,2679,5359,-19069,10504,335910,238555,97355,,267989,81.02,518.47,0.0621,297,75.1,1000.0,10.5,0.543
8616,Curtis Castillo and Lee,False,ZA,Robertland,Marketplaces,2019,https://curtiscastilloandlee.com,Clear successful air evidence alone parent behind.,25,curtis-castillo-and-lee,2023,USD,699811,34990,664821,147922,516899,0,516899,6998,13996,502903,34807,417365,57377,359988,,699811,20.0,10.0,0.1046,282,206.79,29519.25,1.18,0.95
8617,Fuller Byrd and Burke,False,EG,New Cherylhaven,Mobility,2012,https://fullerbyrdandburke.com,Modern challenge myself laugh discover pick rise.,27,fuller-byrd-and-burke,2023,USD,5615606,1067811,4547795,3265546,1282249,9811,1272438,56156,112312,1160126,529602,3360660,1562779,1797881,,5615606,701.36,3655.34,0.0078,23398,20.0,263518.73,2.01,0.8098
8618,Waters Inc,False,US,Smithmouth,AgriTech,2016,https://watersinc.com,Spring effort light life business she.,22,waters-inc,2023,USD,35474,4202,31272,8685,22587,33934,-11347,354,709,-12056,7935,139136,46807,92329,,35474,389.07,194.54,0.0431,14,201.94,1000.0,7.94,0.8815
8619,Dominguez Inc,False,FR,New Michael,SaaS,2009,https://dominguezinc.com,Style rather hospital seat executive best.,12,dominguez-inc,2023,EUR,874347,355256,519091,401749,117342,0,117342,8743,17486,99856,19135,466194,250073,216121,72862.25,874347,77.63,208.76,0.1025,2912,25.02,49195.96,0.39,0.5937
8620,Erickson Fry and Smith,False,ZA,South John,Cybersecurity,2023,https://ericksonfryandsmith.com,Material third difference debate red.,29,erickson-fry-and-smith,2023,USD,572514,120670,451844,449467,2377,0,2377,5725,11450,-9073,15991,414899,169436,245463,,572514,550.95,2962.74,0.0918,412,115.75,31332.39,0.51,0.7892
8621,Griffith Hughes and Guerrero,False,ZA,South Amber,IoT,2016,https://griffithhughesandguerrero.com,Foot fine know series room.,24,griffith-hughes-and-guerrero,2023,USD,270346,147516,122830,67160,55670,0,55670,2703,5406,50264,18908,170840,76222,94618,,270346,20.0,126.88,0.0063,1126,20.0,1000.0,18.91,0.4543
8622,Gardner-Lloyd,False,FR,Kristinland,IoT,2014,https://gardner-lloyd.com,Only outside east test across head team after.,30,gardner-lloyd,2023,EUR,2375068,472574,1902494,906376,996118,5673,990445,23750,47501,942944,48177,1345866,682931,662935,,2375068,61.99,277.79,0.0466,1747,113.28,91508.05,0.53,0.801
8623,Garcia Ltd,False,GB,Sotoshire,AgriTech,2019,https://garcialtd.com,For his physical court difference I.,17,garcia-ltd,2023,USD,787046,405081,381965,587944,-205979,12203,-218182,7870,15740,-233922,67938,568410,291439,276971,,787046,434.46,953.13,0.001,499,131.41,63898.43,1.06,0.4853
8624,Carr PLC,False,AU,New Jasonmouth,EdTech,2010,https://carrplc.com,At study accept few always eight particularly.,17,carr-plc,2023,USD,149466,27025,122441,57577,64864,12962,51902,1494,2989,48913,38777,190491,51593,138898,12455.5,149466,852.85,4069.28,0.0543,149,83.42,2882.16,13.45,0.8192
8625,Moreno Bailey and Rollins,False,US,Waltonport,IoT,2023,https://morenobaileyandrollins.com,Serve note game service court your against.,39,moreno-bailey-and-rollins,2023,USD,387611,88435,299176,191945,107231,0,107231,3876,7752,99479,9527,209669,52333,157336,,387611,20.0,89.51,0.001,1615,20.0,15079.63,0.63,0.7718
8626,Stevens Galvan and Lane,False,ZA,East Sarahton,IoT,2017,https://stevensgalvanandlane.com,Well do figure including sign even subject last sport hot.,24,stevens-galvan-and-lane,2023,USD,1372681,249027,1123654,210364,913290,0,913290,13726,27453,885837,235185,1086449,522059,564390,,1372681,183.65,349.36,0.0306,4316,26.5,1251.01,188.0,0.8186
8627,Giles Molina and Vincent,False,FR,Smithville,Marketplaces,2012,https://gilesmolinaandvincent.com,Available score section book important.,17,giles-molina-and-vincent,2023,EUR,200621,97530,103091,100098,2993,3461,-468,2006,4012,-4480,6771,286273,83276,202997,,200621,2031.08,13204.0,0.0161,166,100.4,1000.0,6.77,0.5139
8628,Warner-Love,False,GB,Lake Stevestad,AgriTech,2022,https://warner-love.com,Dream until reason then it low in describe.,27,warner-love,2023,USD,117848,36643,81205,72092,9113,25464,-16351,1178,2356,-18707,3976,90340,34384,55956,,117848,997.19,2113.31,0.0641,177,55.22,1000.0,3.98,0.6891
8629,Cooper Group,False,US,New Williamview,IoT,2023,https://coopergroup.com,Watch must chance value add job future perhaps good.,21,cooper-group,2023,USD,620944,288649,332295,506630,-174335,49901,-224236,6209,12418,-236654,44152,479437,206662,272775,,620944,985.68,527.35,0.0636,351,147.18,1000.0,44.15,0.5351
8630,Calderon Group,False,GB,Dominiqueville,Cybersecurity,2020,https://calderongroup.com,Heavy candidate agreement get hit involve positive make which run southern.,16,calderon-group,2023,USD,486231,295504,190727,138715,52012,0,52012,4862,9724,42288,11024,374407,95368,279039,,486231,318.62,765.96,0.001,2025,20.0,1000.0,11.02,0.3923
8631,Henry LLC,False,IN,Danielsville,IoT,2021,https://henryllc.com,Worker represent risk top knowledge perhaps travel team across kind base.,23,henry-llc,2023,USD,574275,88602,485673,164516,321157,0,321157,5742,11485,309672,13995,358940,101697,257243,,574275,783.82,1656.37,0.1149,415,115.07,6920.94,2.02,0.8457
8632,Gonzalez LLC,False,DE,Thompsonborough,HealthTech,2013,https://gonzalezllc.com,Main which four money parent point type whole phone magazine.,21,gonzalez-llc,2023,EUR,321788,87059,234729,28459,206270,0,206270,3217,6435,199835,28505,284753,131557,153196,26815.67,321788,250.66,779.3,0.0678,190,140.42,8533.84,3.34,0.7295
8633,Burns-Tran,False,CA,Matthewshaven,Fintech,2023,https://burns-tran.com,Message amount left show sit book.,20,burns-tran,2023,USD,1958867,464957,1493910,1873431,-379521,0,-379521,19588,39177,-418698,58734,1118017,604277,513740,,1958867,323.37,161.68,0.0461,4163,39.21,136440.76,0.43,0.7626
8634,Ramirez Group,False,IN,South Melissachester,HealthTech,2013,https://ramirezgroup.com,Part yes now around another.,23,ramirez-group,2023,USD,403666,200172,203494,114861,88633,27601,61032,4036,8073,52959,22441,389669,123328,266341,33638.83,403666,483.91,2339.6,0.0541,6727,5.0,38084.02,0.59,0.5041
8635,Roberts Group,False,IN,South Jason,SaaS,2016,https://robertsgroup.com,Major sure individual sit detail positive view special.,18,roberts-group,2023,USD,1483916,373878,1110038,74195,1035843,0,1035843,14839,29678,1006165,115019,983884,321803,662081,123659.67,1483916,10.0,35.18,0.0636,19753,6.26,1000.0,115.02,0.748
8636,Rodriguez-Smith,False,ZA,Ruizfurt,Marketplaces,2014,https://rodriguez-smith.com,Sister on while seat head.,25,rodriguez-smith,2023,USD,2075902,636540,1439362,1261844,177518,6650,170868,20759,41518,129350,172978,1336920,914493,422427,,2075902,20.0,69.8,0.0299,1997,86.59,103143.72,1.68,0.6934
8637,Clark and Sons,False,GB,Davidborough,Energy,2011,https://clarkandsons.com,Radio east gun although subject.,25,clark-and-sons,2023,USD,18350299,3932896,14417403,13760345,657058,12272,644786,183502,367005,277781,223190,9575246,4964605,4610641,,18350299,20.0,60.99,0.0946,20827,73.42,1113249.07,0.2,0.7857
8638,Guzman LLC,False,FR,South Willieburgh,AI/ML,2009,https://guzmanllc.com,High example role body simply forget represent to ago action.,25,guzman-llc,2023,EUR,1969705,580891,1388814,1324503,64311,10366,53945,19697,39394,14551,43653,1154384,387059,767325,,1969705,1104.46,2984.88,0.0661,8207,20.0,91014.47,0.48,0.7051
8639,Robertson Ltd,False,US,Hernandezton,EdTech,2017,https://robertsonltd.com,Southern own material direction build.,16,robertson-ltd,2023,USD,1140235,315399,824836,324174,500662,0,500662,11402,22804,477858,15348,597158,368410,228748,95019.58,1140235,718.67,3179.14,0.0618,2902,32.74,1000.0,15.35,0.7234
8640,James-Johnston,False,TN,Nicholasstad,AI/ML,2021,https://james-johnston.com,Beyond writer end guess show page west.,20,james-johnston,2023,USD,427192,182932,244260,21359,222901,0,222901,4271,8543,214358,40370,392681,136308,256373,,427192,20.0,41.99,0.0969,208,170.56,5074.39,7.96,0.5718
8641,Simon LLC,False,FR,South Brianna,Cybersecurity,2020,https://simonllc.com,Director protect fish energy game century.,22,simon-llc,2023,EUR,205811,57490,148321,74064,74257,0,74257,2058,4116,70141,6236,266834,139964,126870,,205811,176.43,1182.47,0.026,220,77.84,1000.0,6.24,0.7207
8642,Allen Inc,False,DE,Rangelchester,SaaS,2023,https://alleninc.com,Probably dream participant bag example possible energy church.,18,allen-inc,2023,EUR,522608,218683,303925,406693,-102768,0,-102768,5226,10452,-113220,5410,299846,96696,203150,43550.67,522608,10.0,49.61,0.0229,815,53.38,30250.33,0.18,0.5816
8643,Osborne-Garrett,False,US,North Nathaniel,HealthTech,2020,https://osborne-garrett.com,Course fish east seven rate happy month.,17,osborne-garrett,2023,USD,645973,225946,420027,124454,295573,0,295573,6459,12919,282654,195734,539564,251918,287646,53831.08,645973,126.42,468.42,0.0783,698,77.05,9599.12,20.39,0.6502
8644,Morris-Jones,False,EG,Alyssafort,Cybersecurity,2013,https://morris-jones.com,Evening structure any pick ball debate nation watch federal.,25,morris-jones,2023,USD,1670692,664354,1006338,1240137,-233799,0,-233799,16706,33413,-267212,273065,1185417,925120,260297,,1670692,297.19,1108.93,0.0401,3041,45.77,112881.34,2.42,0.6023
8645,Curtis Fritz and Golden,False,US,Port Peter,HealthTech,2009,https://curtisfritzandgolden.com,Everybody garden inside occur forward manage loss firm.,22,curtis-fritz-and-golden,2023,USD,95769,19149,76620,34739,41881,10762,31119,957,1915,29204,5792,170578,47966,122612,7980.75,95769,10.0,25.19,0.0255,274,29.05,30968.0,0.19,0.8001
8646,Anderson-Cortez,False,US,Julieshire,IoT,2018,https://anderson-cortez.com,Perform role inside perform occur budget back.,20,anderson-cortez,2023,USD,349607,87575,262032,35663,226369,20038,206331,3496,6992,199339,1869,261063,30775,230288,,349607,253.44,1104.44,0.046,427,68.19,21633.23,0.09,0.7495
8647,Mcbride PLC,False,AU,Owensville,EdTech,2020,https://mcbrideplc.com,Red firm six daughter might yet.,26,mcbride-plc,2023,USD,537631,134849,402782,266976,135806,39256,96550,5376,10752,85798,59111,467541,115121,352420,44802.58,537631,415.65,424.43,0.0504,1300,34.45,11788.71,5.01,0.7492
8648,Torres Group,False,AU,Port Jennifer,Energy,2012,https://torresgroup.com,Attack list land forget shake suggest pay early television.,25,torres-group,2023,USD,1220626,273638,946988,263413,683575,0,683575,12206,24412,659163,73645,703558,66781,636777,,1220626,1110.28,555.14,0.0665,345,294.63,10860.01,6.78,0.7758
8649,Nichols Williams and Warren,False,FR,Moraberg,IoT,2019,https://nicholswilliamsandwarren.com,Spend speak response maybe star central condition month.,25,nichols-williams-and-warren,2023,EUR,696445,275499,420946,219425,201521,0,201521,6964,13928,187593,18395,549304,220709,328595,,696445,424.19,1768.97,0.1013,178,324.5,22182.5,0.83,0.6044
8650,Lowe-Kidd,False,DE,East Angela,Energy,2008,https://lowe-kidd.com,Year require some certainly over.,17,lowe-kidd,2023,EUR,567072,145774,421298,153062,268236,23196,245040,5670,11341,233699,194267,536926,223781,313145,,567072,20.0,18.48,0.0274,807,58.55,23543.24,8.25,0.7429
8651,Coffey LLC,False,US,Port Amanda,E-commerce,2022,https://coffeyllc.com,Discover course size information attention Mrs begin trial.,23,coffey-llc,2023,USD,1585772,1068770,517002,1406105,-889103,38610,-927713,15857,31715,-959428,56930,890010,656092,233918,,1585772,931.79,465.9,0.1473,6607,20.0,113325.47,0.5,0.326
8652,Murphy-Joseph,False,EG,Grimesmouth,IoT,2018,https://murphy-joseph.com,Deal at determine way official.,24,murphy-joseph,2023,USD,4725082,1963198,2761884,236254,2525630,13058,2512572,47250,94501,2418071,412523,2859575,967446,1892129,,4725082,1610.53,6535.01,0.0956,2290,171.88,7984.79,51.66,0.5845
8653,Palmer Madden and Randolph,False,US,Andrewville,SaaS,2011,https://palmermaddenandrandolph.com,Thus note room whom light.,22,palmer-madden-and-randolph,2023,USD,1372177,310378,1061799,503972,557827,0,557827,13721,27443,530384,49301,791037,276716,514321,114348.08,1372177,109.76,430.54,0.001,1481,77.16,48591.75,1.01,0.7738
8654,Arnold-Brown,False,EG,Chambersberg,EdTech,2012,https://arnold-brown.com,Cause bad economy TV happen.,12,arnold-brown,2023,USD,255575,56465,199110,12778,186332,0,186332,2555,5111,181221,9819,250287,115124,135163,21297.92,255575,10.0,15.06,0.0418,307,69.27,32381.95,0.3,0.7791
8655,Reyes Inc,False,CA,Morrisland,IoT,2008,https://reyesinc.com,Line type senior middle expert foreign.,13,reyes-inc,2023,USD,213509,115038,98471,103091,-4620,5726,-10346,2135,4270,-14616,7756,263012,115792,147220,,213509,20.0,48.07,0.001,889,20.0,1000.0,7.76,0.4612
8656,Parker-Walters,False,US,Port Ashley,Mobility,2014,https://parker-walters.com,Concern wait human series even firm.,20,parker-walters,2023,USD,543700,336044,207656,332252,-124596,16715,-141311,5437,10874,-152185,84490,548145,70635,477510,,543700,552.73,2274.29,0.0288,246,183.69,38065.45,2.22,0.3819
8657,Ortiz-Buckley,False,KE,Kevinbury,Mobility,2010,https://ortiz-buckley.com,Professional leg pull first hope indicate require hit.,22,ortiz-buckley,2023,USD,919251,432558,486693,478133,8560,24069,-15509,9192,18385,-33894,23283,548490,139174,409316,,919251,909.71,3264.46,0.0428,261,292.68,30982.02,0.75,0.5294
8658,Stewart Fisher and Smith,False,DE,New Alexandra,SaaS,2022,https://stewartfisherandsmith.com,Degree week floor fear debate room.,18,stewart-fisher-and-smith,2023,EUR,1987739,679791,1307948,1155379,152569,8153,144416,19877,39754,104662,81675,1233033,783930,449103,165644.92,1987739,10.0,34.74,0.0155,1092,151.57,111555.79,0.73,0.658
8659,Gibbs Ltd,False,GB,Stewartberg,HealthTech,2010,https://gibbsltd.com,High this safe act by class whom author firm.,31,gibbs-ltd,2023,USD,1511213,412412,1098801,928237,170564,0,170564,15112,30224,140340,402538,1340684,288795,1051889,125934.42,1511213,10.0,55.97,0.0581,1748,72.04,87931.64,4.58,0.7271
8660,Porter and Sons,False,FR,West Jennifer,EdTech,2020,https://porterandsons.com,Key space fund total growth truth picture time fly simple.,18,porter-and-sons,2023,EUR,106182,42932,63250,19158,44092,5842,38250,1061,2123,36127,32321,197162,47548,149614,8848.5,106182,729.68,2119.34,0.0484,100,87.64,1000.0,32.32,0.5957
8661,Garza and Sons,False,KE,Port Gina,SaaS,2024,https://garzaandsons.com,While public whatever learn health evening knowledge American.,16,garza-and-sons,2023,USD,1696800,886375,810425,1058677,-248252,19530,-267782,16968,33936,-301718,65686,1005887,327189,678698,141400.0,1696800,10.0,68.4,0.0209,28280,5.0,111067.61,0.59,0.4776
8662,Adams-Mckinney,False,EG,Port Mark,Fintech,2020,https://adams-mckinney.com,Per nation others later look way.,19,adams-mckinney,2023,USD,250016,82520,167496,138871,28625,0,28625,2500,5000,23625,4787,321426,77315,244111,,250016,20.0,71.11,0.0422,116,179.12,3782.24,1.27,0.6699
8663,Burns-Bradford,False,EG,Jamieton,HealthTech,2013,https://burns-bradford.com,Mouth network gun play of must.,20,burns-bradford,2023,USD,760456,302651,457805,432243,25562,22302,3260,7604,15209,-11949,34392,555551,187214,368337,63371.33,760456,137.53,1042.05,0.0257,891,71.07,19622.61,1.75,0.602
8664,Andrews Brooks and Hicks,False,FR,Cainburgh,SaaS,2016,https://andrewsbrooksandhicks.com,Also offer them need wish risk.,19,andrews-brooks-and-hicks,2023,EUR,2591964,1010767,1581197,2091984,-510787,11764,-522551,25919,51839,-574390,121553,1535527,441467,1094060,215997.0,2591964,10.0,18.05,0.0262,43199,5.0,156646.77,0.78,0.61
8665,Jenkins Hunt and Montoya,False,CA,Harveyton,Cybersecurity,2016,https://jenkinshuntandmontoya.com,Live everyone admit history simple water.,27,jenkins-hunt-and-montoya,2023,USD,2235274,746583,1488691,1505535,-16844,114,-16958,22352,44705,-61663,330398,1632476,587486,1044990,,2235274,644.97,1630.68,0.0352,974,191.2,124126.84,2.66,0.666
8666,Townsend Group,False,ZA,Nicoleland,Energy,2011,https://townsendgroup.com,Form current prepare before success each shake.,15,townsend-group,2023,USD,2142598,717502,1425096,765015,660081,0,660081,21425,42851,617230,124940,1387761,392946,994815,,2142598,20.0,60.09,0.0423,1075,166.01,112893.19,1.11,0.6651
8667,Roberts-Peck,False,EG,Adammouth,Fintech,2013,https://roberts-peck.com,Impact ball similar similar speak nor speak hour admit.,22,roberts-peck,2023,USD,3541713,738249,2803464,2611769,191695,0,191695,35417,70834,120861,575426,2508407,1811265,697142,,3541713,20.0,88.16,0.001,2342,126.0,210992.3,2.73,0.7916
8668,Wolfe LLC,False,NG,Port Jesse,Fintech,2023,https://wolfellc.com,Civil low learn drive local century easy.,24,wolfe-llc,2023,USD,1052106,176512,875594,709423,166171,0,166171,10521,21042,145129,356440,1021033,268382,752651,,1052106,517.71,258.86,0.0338,783,111.94,43218.38,8.25,0.8322
8669,Blackburn Inc,False,US,New Michael,Mobility,2016,https://blackburninc.com,Term through so record close mission thousand.,19,blackburn-inc,2023,USD,308526,106437,202089,167404,34685,0,34685,3085,6170,28515,12159,173058,155752,17306,,308526,224.19,789.63,0.0619,201,127.56,12935.82,0.94,0.655
8670,Tyler Group,False,IN,North Danielle,EdTech,2021,https://tylergroup.com,Call behind success partner visit when per within one.,19,tyler-group,2023,USD,466044,186036,280008,64651,215357,26963,188394,4660,9320,179074,53019,357209,217738,139471,38837.0,466044,603.46,2371.12,0.0771,1196,32.45,1000.0,53.02,0.6008
8671,Carpenter-Smith,False,US,North Alexander,HealthTech,2015,https://carpenter-smith.com,Condition realize Republican another pick service.,20,carpenter-smith,2023,USD,792252,472207,320045,376344,-56299,0,-56299,7922,15845,-72144,23138,523745,112733,411012,66021.0,792252,145.33,145.33,0.0191,1301,50.74,28878.23,0.8,0.404
8672,Duffy Ochoa and Baker,False,AU,North Stephanietown,AgriTech,2017,https://duffyochoaandbaker.com,Everybody cut those notice draw family stuff its clearly.,34,duffy-ochoa-and-baker,2023,USD,737956,189870,548086,252313,295773,14457,281316,7379,14759,266557,18862,484685,387368,97317,,737956,756.77,2893.58,0.0504,800,76.84,60709.95,0.31,0.7427
8673,Barnett-Sharp,False,AU,North Thomasside,HealthTech,2013,https://barnett-sharp.com,Stay sense choose blood large.,20,barnett-sharp,2023,USD,2755594,876325,1879269,317597,1561672,30550,1531122,27555,55111,1476011,229928,1610421,537524,1072897,229632.83,2755594,505.77,736.78,0.0657,4035,56.9,32203.15,7.14,0.682
8674,Fernandez Inc,False,CA,Lake Breannafurt,HealthTech,2010,https://fernandezinc.com,Expert property themselves hand total instead.,20,fernandez-inc,2023,USD,943976,447126,496850,148236,348614,0,348614,9439,18879,329735,23835,620713,233609,387104,78664.67,943976,126.37,355.49,0.0208,1303,60.37,10097.75,2.36,0.5263
8675,Lopez Group,False,BR,Allenmouth,Energy,2008,https://lopezgroup.com,Investment I detail crime their support future cover American.,26,lopez-group,2023,USD,1856668,690826,1165842,719368,446474,0,446474,18566,37133,409341,77924,1122237,417614,704623,,1856668,20.0,67.89,0.0956,7736,20.0,38457.33,2.03,0.6279
8676,Mcintyre-Pierce,False,GB,Scottport,E-commerce,2013,https://mcintyre-pierce.com,Brother down happen fish short friend along lose write real.,21,mcintyre-pierce,2023,USD,850667,288538,562129,426265,135864,9216,126648,8506,17013,109635,40966,486873,216236,270637,,850667,1544.69,6182.52,0.001,236,300.37,30450.88,1.35,0.6608
8677,Lopez Silva and Irwin,False,DE,East Heatherland,IoT,2016,https://lopezsilvaandirwin.com,Between vote cover subject perhaps war.,24,lopez-silva-and-irwin,2023,EUR,676414,315959,360455,352812,7643,9631,-1988,6764,13528,-15516,89031,564218,317285,246933,,676414,269.6,1493.05,0.0619,2818,20.0,83918.8,1.06,0.5329
8678,Phillips Simpson and House,False,AU,North Beverlychester,Fintech,2012,https://phillipssimpsonandhouse.com,Term look claim range green when get teacher.,20,phillips-simpson-and-house,2023,USD,7550052,3426529,4123523,4365332,-241809,0,-241809,75500,151001,-392810,1054355,4912042,2193296,2718746,,7550052,20.0,59.69,0.001,3959,158.91,380246.45,2.77,0.5462
8679,Taylor-Curry,False,ZA,West Joseph,Marketplaces,2008,https://taylor-curry.com,Doctor only run reach another every film person center sure.,22,taylor-curry,2023,USD,701596,286745,414851,226625,188226,0,188226,7015,14031,174195,30790,544787,225026,319761,,701596,1143.45,2151.26,0.0659,584,100.11,35667.86,0.86,0.5913
8680,Donaldson Group,False,KE,Christopherton,AgriTech,2017,https://donaldsongroup.com,From population keep soon.,18,donaldson-group,2023,USD,380623,147951,232672,185087,47585,11656,35929,3806,7612,28317,63116,343744,234962,108782,,380623,1480.18,9713.43,0.0612,374,84.71,16372.86,3.85,0.6113
8681,Hayes-Powell,False,ZA,Brendashire,Mobility,2023,https://hayes-powell.com,Assume set available crime realize recognize audience prove five.,22,hayes-powell,2023,USD,3307282,1488110,1819172,1797034,22138,21825,313,33072,66145,-65832,201790,1874904,259554,1615350,,3307282,45.14,116.91,0.1035,13780,20.0,166723.24,1.21,0.5501
8682,Best-Young,False,GB,Patrickside,Energy,2008,https://best-young.com,Window explain property environment education.,23,best-young,2023,USD,1167764,206843,960921,612711,348210,2542,345668,11677,23355,322313,71040,695722,348289,347433,,1167764,169.1,1267.57,0.104,1320,73.68,58060.8,1.22,0.8229
8683,Garcia Sandoval and Brown,False,DE,Port Lynnfort,Marketplaces,2013,https://garciasandovalandbrown.com,Win identify five wear father fear crime term goal bank include.,24,garcia-sandoval-and-brown,2023,EUR,94707,45063,49644,22442,27202,0,27202,947,1894,25308,3539,202123,50954,151169,,94707,20.0,93.07,0.0019,45,173.36,18805.35,0.19,0.5242
8684,Rogers-Thomas,False,TN,West Michaelmouth,Marketplaces,2019,https://rogers-thomas.com,Large church teach meeting raise adult maybe trial sit.,23,rogers-thomas,2023,USD,836725,191995,644730,209101,435629,0,435629,8367,16734,418895,20200,633401,43911,589490,,836725,185.35,1069.63,0.151,1743,40.0,21197.07,0.95,0.7705
8685,Garza Klein and Brown,False,CA,Lake Brandon,Fintech,2015,https://garzakleinandbrown.com,Interesting ready buy skill say also main.,16,garza-klein-and-brown,2023,USD,2110556,435723,1674833,801967,872866,26341,846525,21105,42211,804314,186542,1378968,288610,1090358,,2110556,20.0,36.12,0.1113,7023,25.04,50832.79,3.67,0.7936
8686,Bailey Ltd,False,GB,Monicashire,Mobility,2021,https://baileyltd.com,Loss until east station attack bed practice house administration around.,23,bailey-ltd,2023,USD,2893618,1195469,1698149,1686766,11383,9220,2163,28936,57872,-55709,85982,1686775,124227,1562548,,2893618,216.78,1231.34,0.001,1472,163.72,151659.35,0.57,0.5869
8687,White-Martinez,False,FR,New Sarahbury,Marketplaces,2022,https://white-martinez.com,Everyone rock available else purpose quickly concern base college.,16,white-martinez,2023,EUR,80860,31256,49604,9031,40573,0,40573,808,1617,38956,4053,112368,29275,83093,,80860,495.45,2531.51,0.1162,336,20.0,3850.8,1.05,0.6135
8688,Kaufman-Lynch,False,KE,Stevenfurt,AgriTech,2008,https://kaufman-lynch.com,Laugh after beautiful civil.,23,kaufman-lynch,2023,USD,153372,52980,100392,48325,52067,0,52067,1533,3067,49000,13737,152351,78455,73896,,153372,976.21,3993.05,0.011,151,84.53,25840.24,0.53,0.6546
8689,Freeman-Gregory,False,BR,Mooreburgh,HealthTech,2016,https://freeman-gregory.com,Stop official real garden others read her address office wish.,18,freeman-gregory,2023,USD,924524,298578,625946,781796,-155850,405,-156255,9245,18490,-174745,98813,624798,168414,456384,77043.67,924524,486.45,2474.23,0.0491,2080,37.04,60645.24,1.63,0.677
8690,Cameron PLC,False,CA,South James,Cybersecurity,2019,https://cameronplc.com,Season represent consider today spring.,25,cameron-plc,2023,USD,760269,183292,576977,252580,324397,44479,279918,7602,15205,264713,13534,592074,413655,178419,,760269,20.92,58.2,0.1616,837,75.61,19043.37,0.71,0.7589
8691,Martinez-Parrish,False,KE,Bankston,AI/ML,2019,https://martinez-parrish.com,Impact save what member fine many risk up voice election.,20,martinez-parrish,2023,USD,95933,36484,59449,23151,36298,10898,25400,959,1918,23482,13237,75940,31898,44042,,95933,905.84,2049.26,0.001,108,73.82,1000.0,13.24,0.6197
8692,Turner Anderson and Perez,False,FR,Hudsonmouth,Energy,2009,https://turnerandersonandperez.com,Investment check difference hope shoulder career should college what.,19,turner-anderson-and-perez,2023,EUR,3164729,431643,2733086,1405822,1327264,11843,1315421,31647,63294,1252127,79313,1783780,1510461,273319,,3164729,1536.27,6069.45,0.0978,958,275.28,133206.19,0.6,0.8636
8693,Mcmahon-Mitchell,False,GB,Amandaville,Fintech,2011,https://mcmahon-mitchell.com,Use contain man become power and.,25,mcmahon-mitchell,2023,USD,720326,354082,366244,480255,-114011,1386,-115397,7203,14406,-129803,11415,569576,291035,278541,,720326,204.42,1073.03,0.001,567,105.83,33265.14,0.34,0.5084
8694,Hopkins-Kennedy,False,KE,Andreaview,Marketplaces,2011,https://hopkins-kennedy.com,Agency kitchen direction man institution allow position leader.,18,hopkins-kennedy,2023,USD,1278723,342772,935951,63936,872015,3146,868869,12787,25574,843295,252279,1067261,382750,684511,,1278723,1180.77,3926.82,0.101,439,242.44,40375.26,6.25,0.7319
8695,Warren Lane and Maynard,False,CA,North Derrickfurt,AI/ML,2010,https://warrenlaneandmaynard.com,Adult response herself two capital owner major idea tend kid.,14,warren-lane-and-maynard,2023,USD,1074979,475195,599784,704244,-104460,0,-104460,10749,21499,-125959,24362,567966,184764,383202,,1074979,884.91,3526.9,0.0834,696,128.59,57491.16,0.42,0.5579
8696,Barker Walker and Nguyen,False,GB,West Christopher,Energy,2020,https://barkerwalkerandnguyen.com,Turn analysis reduce close body price few real time house woman.,24,barker-walker-and-nguyen,2023,USD,1349695,790067,559628,951709,-392081,0,-392081,13496,26993,-419074,109914,954658,326035,628623,,1349695,235.02,685.34,0.001,1194,94.18,57461.85,1.91,0.4146
8697,Shea-Ball,False,AU,Matthewberg,Cybersecurity,2017,https://shea-ball.com,Everyone pass thank war wall condition sea out light.,21,shea-ball,2023,USD,2896309,1772458,1123851,2460903,-1337052,0,-1337052,28963,57926,-1394978,481039,2000080,760906,1239174,,2896309,421.15,210.58,0.0438,12067,20.0,246195.5,1.95,0.388
8698,Mcgee Jackson and Smith,False,ZA,Danielton,IoT,2021,https://mcgeejacksonandsmith.com,During side student stop fast member rise south.,19,mcgee-jackson-and-smith,2023,USD,2419920,1307880,1112040,1041453,70587,11189,59398,24199,48398,11000,77589,1352500,433567,918933,,2419920,601.5,1200.48,0.0982,1800,111.98,104368.56,0.74,0.4595
8699,Webb Perez and Mcdonald,False,IN,Port Patriciaberg,Mobility,2021,https://webbperezandmcdonald.com,Town letter leg budget market resource risk feel letter consumer.,19,webb-perez-and-mcdonald,2023,USD,158775,38328,120447,18997,101450,474,100976,1587,3175,97801,16960,246970,215014,31956,,158775,668.95,3321.78,0.1099,367,36.01,1000.0,16.96,0.7586
8700,Santos Group,False,AU,Martinview,AI/ML,2021,https://santosgroup.com,Cup good sometimes Republican need free well staff design.,22,santos-group,2023,USD,1305826,653340,652486,152848,499638,36175,463463,13058,26116,437347,99885,760307,148298,612009,,1305826,875.57,842.1,0.0027,384,282.77,8342.73,11.97,0.4997
8701,Garza-Boone,False,GB,Port Elizabeth,EdTech,2022,https://garza-boone.com,Memory little ability in finally.,18,garza-boone,2023,USD,1211793,142279,1069514,1035246,34268,0,34268,12117,24235,10033,95578,805295,653490,151805,100982.75,1211793,10.0,79.41,0.0669,1869,54.03,99547.03,0.96,0.8826
8702,Nelson Reed and Kirk,False,TN,New Stephanie,SaaS,2008,https://nelsonreedandkirk.com,Agent wind sing allow land sense similar.,17,nelson-reed-and-kirk,2023,USD,360393,98151,262242,18019,244223,20540,223683,3603,7207,216476,9877,358337,79008,279329,30032.75,360393,295.75,989.11,0.0093,935,32.11,30130.85,0.33,0.7277
8703,Allen Bradley and Martin,False,NG,Drewville,AI/ML,2016,https://allenbradleyandmartin.com,East I toward plant tell.,23,allen-bradley-and-martin,2023,USD,885476,135161,750315,244285,506030,0,506030,8854,17709,488321,50558,618313,236227,382086,,885476,20.0,52.48,0.0166,699,105.49,7874.63,6.42,0.8474
8704,Gilbert Wright and Jackson,False,IN,Joycechester,Mobility,2016,https://gilbertwrightandjackson.com,Join head yet daughter stay example public person you.,19,gilbert-wright-and-jackson,2023,USD,1154532,608593,545939,1039886,-493947,0,-493947,11545,23090,-517037,4301,740476,272592,467884,,1154532,20.0,70.78,0.0298,650,147.97,115625.99,0.04,0.4729
8705,Galvan-Wilson,False,US,Lake Sara,AI/ML,2015,https://galvan-wilson.com,Career hot market model subject already reason character.,12,galvan-wilson,2023,USD,3507701,959896,2547805,620449,1927356,9498,1917858,35077,70154,1847704,127040,1933754,562603,1371151,,3507701,20.0,110.3,0.0403,14615,20.0,28996.53,4.38,0.7263
8706,Smith-Silva,False,EG,West Amandahaven,Marketplaces,2010,https://smith-silva.com,Old rate action use wall manage.,19,smith-silva,2023,USD,277468,75340,202128,136436,65692,19883,45809,2774,5549,40260,6194,210972,18677,192295,,277468,1587.04,6358.4,0.001,333,69.27,1000.0,6.19,0.7285
8707,George-Williams,False,KE,New Kristinland,Fintech,2009,https://george-williams.com,Through college tell suddenly yes hard give word.,24,george-williams,2023,USD,1460096,415397,1044699,748443,296256,0,296256,14600,29201,267055,109539,1030482,246366,784116,,1460096,20.0,13.51,0.1362,6083,20.0,32772.02,3.34,0.7155
8708,Fisher Clark and Young,False,EG,Monicamouth,AgriTech,2012,https://fisherclarkandyoung.com,Start ago media offer financial reveal someone job.,12,fisher-clark-and-young,2023,USD,162471,69965,92506,68326,24180,1397,22783,1624,3249,19534,26503,198863,84373,114490,,162471,36.33,18.16,0.1352,676,20.0,1000.0,26.5,0.5694
8709,Adams-Vaughn,False,FR,Markstad,Energy,2017,https://adams-vaughn.com,Bring court movement join as approach central important herself data.,16,adams-vaughn,2023,EUR,2038324,712858,1325466,996567,328899,3217,325682,20383,40766,284916,13031,1154225,57711,1096514,,2038324,912.56,3623.33,0.1029,2316,73.33,95697.06,0.14,0.6503
8710,Love Inc,False,US,South Lisaberg,SaaS,2020,https://loveinc.com,Assume need herself voice without during.,13,love-inc,2023,USD,770006,388644,381362,520512,-139150,0,-139150,7700,15400,-154550,53932,463735,229769,233966,64167.17,770006,161.59,1034.21,0.0866,471,135.98,29776.86,1.81,0.4953
8711,Hall Ltd,False,KE,North Lauraberg,Cybersecurity,2024,https://hallltd.com,Anyone consider compare huge when their scientist probably physical.,18,hall-ltd,2023,USD,4437825,2402751,2035074,2671702,-636628,32090,-668718,44378,88756,-757474,142484,2387014,119350,2267664,,4437825,863.13,431.56,0.014,10791,34.27,199796.66,0.71,0.4586
8712,Freeman Inc,False,AU,Reneeport,EdTech,2020,https://freemaninc.com,Green tough culture seven party true across least war.,18,freeman-inc,2023,USD,429317,179893,249424,168558,80866,46734,34132,4293,8586,25546,8851,271005,71846,199159,35776.42,429317,137.79,755.48,0.0699,1949,18.35,1000.0,8.85,0.581
8713,Smith Zimmerman and Taylor,False,KE,Michaelburgh,Cybersecurity,2012,https://smithzimmermanandtaylor.com,Alone total both local at level also fire lose.,27,smith-zimmerman-and-taylor,2023,USD,737929,379572,358357,366986,-8629,6317,-14946,7379,14758,-29704,64088,507533,297215,210318,,737929,579.65,2488.62,0.0939,2461,24.98,34165.18,1.88,0.4856
8714,Little Ltd,False,DE,South Edward,E-commerce,2015,https://littleltd.com,Rule film space off.,15,little-ltd,2023,EUR,2173894,732283,1441611,108694,1332917,14136,1318781,21738,43477,1275304,43709,1158413,362299,796114,,2173894,203.18,106.63,0.001,2733,66.28,1000.0,43.71,0.6631
8715,Patel PLC,False,IN,Jonesmouth,AI/ML,2016,https://patelplc.com,Last rather response various quality.,23,patel-plc,2023,USD,195213,110712,84501,55803,28698,0,28698,1952,3904,24794,15516,136026,37184,98842,,195213,666.34,4930.46,0.055,117,138.91,6916.1,2.24,0.4329
8716,Miller Jordan and Duran,False,NG,Annside,Energy,2016,https://millerjordanandduran.com,Between up manage play trial method consider law final talk.,14,miller-jordan-and-duran,2023,USD,3352785,167639,3185146,3104149,80997,0,80997,33527,67055,13942,129708,1895567,509098,1386469,,3352785,798.56,1105.19,0.011,1938,144.12,262167.02,0.49,0.95
8717,Bender-Daniels,False,EG,North Heather,SaaS,2024,https://bender-daniels.com,Oil marriage newspaper deal common perform one family.,21,bender-daniels,2023,USD,531512,233530,297982,142699,155283,32821,122462,5315,10630,111832,127642,536942,149340,387602,44292.67,531512,610.37,1208.97,0.001,624,70.93,26952.11,4.74,0.5606
8718,Harvey-Henderson,False,GB,Charleshaven,Fintech,2015,https://harvey-henderson.com,Decade later key degree PM society.,23,harvey-henderson,2023,USD,3007200,1242809,1764391,963706,800685,3487,797198,30072,60144,737054,128302,1776114,638717,1137397,,3007200,1286.85,3602.21,0.0677,1835,136.55,105922.39,1.21,0.5867
8719,Scott Group,False,KE,Foxmouth,AI/ML,2021,https://scottgroup.com,Brother sport let quickly three prepare tend information painting.,24,scott-group,2023,USD,2661026,1154231,1506795,2245529,-738734,8480,-747214,26610,53220,-800434,83690,1433801,104505,1329296,,2661026,645.81,827.76,0.0705,1467,151.11,171861.03,0.49,0.5662
8720,Gilmore-Stevenson,False,CA,New Jesseside,AgriTech,2021,https://gilmore-stevenson.com,Law down election inside better.,20,gilmore-stevenson,2023,USD,178778,63497,115281,10821,104460,0,104460,1787,3575,100885,7701,273410,103172,170238,,178778,1963.73,11573.58,0.1192,138,107.2,1000.0,7.7,0.6448
8721,Jones Church and Stewart,False,GB,Bellborough,HealthTech,2008,https://joneschurchandstewart.com,Member sense above upon very charge often.,23,jones-church-and-stewart,2023,USD,329258,102890,226368,207943,18425,11045,7380,3292,6585,795,3402,313830,139819,174011,27438.17,329258,535.53,1035.05,0.0266,450,60.87,24265.41,0.14,0.6875
8722,Hoffman Russell and Cox,False,GB,Justinmouth,Fintech,2013,https://hoffmanrussellandcox.com,Poor may concern speech able believe.,19,hoffman-russell-and-cox,2023,USD,761377,277650,483727,254675,229052,0,229052,7613,15227,213825,78761,646286,32314,613972,,761377,1208.58,6920.47,0.0636,319,198.88,50729.51,1.55,0.6353
8723,Allen-Johnson,False,DE,South Michaelfort,Cybersecurity,2023,https://allen-johnson.com,Reality probably election ask left himself marriage painting.,19,allen-johnson,2023,EUR,2495600,871825,1623775,1436586,187189,14573,172616,24956,49912,122704,304782,1712574,1261277,451297,,2495600,20.0,82.67,0.0395,2200,94.5,106926.99,2.85,0.6507
8724,Morgan-Richards,False,BR,Amybury,Cybersecurity,2012,https://morgan-richards.com,Million make cold operation thing still according improve.,25,morgan-richards,2023,USD,3593433,2000029,1593404,179671,1413733,0,1413733,35934,71868,1341865,92815,1971584,723772,1247812,,3593433,204.93,102.46,0.001,4538,65.98,1000.0,92.82,0.4434
8725,Dean-Ford,False,US,West Christinaland,E-commerce,2018,https://dean-ford.com,Focus property read there role success itself benefit risk mission.,27,dean-ford,2023,USD,2868668,1305690,1562978,944683,618295,12884,605411,28686,57373,548038,125561,1574032,435789,1138243,,2868668,94.6,269.27,0.0439,1280,186.69,54277.79,2.31,0.5448
8726,Byrd and Sons,False,US,Lake Steven,EdTech,2014,https://byrdandsons.com,Short moment anyone fish impact water population.,25,byrd-and-sons,2023,USD,367431,160727,206704,257920,-51216,0,-51216,3674,7348,-58564,115169,473256,235760,237496,30619.25,367431,402.15,633.64,0.054,1368,22.37,44225.88,2.6,0.5626
8727,Lewis-Thompson,False,US,West Angela,SaaS,2008,https://lewis-thompson.com,Growth summer remember ago guess century wide line seek sell.,23,lewis-thompson,2023,USD,1117416,543920,573496,659768,-86272,33340,-119612,11174,22348,-141960,134535,892530,484440,408090,93118.0,1117416,692.94,2471.28,0.0514,7467,12.47,16010.24,8.4,0.5132
8728,Wagner-Stewart,False,US,Kevinchester,AI/ML,2024,https://wagner-stewart.com,Radio something son sing force break series together.,27,wagner-stewart,2023,USD,412597,194596,218001,114376,103625,0,103625,4125,8251,95374,3990,356474,219335,137139,,412597,1116.26,5444.7,0.0131,1125,30.55,1000.0,3.99,0.5284
8729,Hill Clark and Hudson,False,TN,Anitafurt,EdTech,2017,https://hillclarkandhudson.com,Maybe security people father important answer its level program program.,24,hill-clark-and-hudson,2023,USD,547245,68205,479040,281726,197314,0,197314,5472,10944,186370,69571,354953,110535,244418,45603.75,547245,244.56,950.15,0.0669,410,111.07,59888.72,1.16,0.8754
8730,Walker-Gardner,False,ZA,New Dustin,Cybersecurity,2020,https://walker-gardner.com,Role high season increase light picture environment might thing growth.,20,walker-gardner,2023,USD,1151268,572685,578583,57563,521020,12512,508508,11512,23025,485483,23206,793902,249817,544085,,1151268,20.0,82.61,0.0069,309,310.37,1000.0,23.21,0.5026
8731,Valencia-Sexton,False,EG,North David,EdTech,2011,https://valencia-sexton.com,Crime exactly race each many example.,20,valencia-sexton,2023,USD,481618,205648,275970,97782,178188,0,178188,4816,9632,168556,33360,411440,254550,156890,40134.83,481618,10.0,60.13,0.0664,763,52.55,28579.24,1.17,0.573
8732,Lynch-Price,False,KE,Carolburgh,SaaS,2008,https://lynch-price.com,Such be health little door.,26,lynch-price,2023,USD,5901560,1597865,4303695,5022016,-718321,0,-718321,59015,118031,-836352,72761,3102343,338485,2763858,491796.67,5901560,10.0,55.96,0.001,4307,114.16,409703.81,0.18,0.7292
8733,Clark and Sons,False,NG,Jeromefort,AI/ML,2010,https://clarkandsons.com,Understand need contain traditional way law our stand level.,20,clark-and-sons,2023,USD,300689,76793,223896,208513,15383,0,15383,3006,6013,9370,1945,193446,93319,100127,,300689,989.11,2255.39,0.001,130,192.31,5261.34,0.37,0.7446
8734,Kidd Johnson and Dodson,False,FR,Liton,AgriTech,2011,https://kiddjohnsonanddodson.com,Nor follow sport policy garden themselves.,18,kidd-johnson-and-dodson,2023,EUR,397147,101217,295930,181234,114696,0,114696,3971,7942,106754,83996,437612,179939,257673,,397147,374.08,1643.48,0.1958,302,109.58,1000.0,84.0,0.7451
8735,Fitzgerald Ltd,False,TN,Gibbston,SaaS,2008,https://fitzgeraldltd.com,Once all live forward free value range clear.,23,fitzgerald-ltd,2023,USD,2087220,632021,1455199,390588,1064611,0,1064611,20872,41744,1022867,249572,1460955,449461,1011494,173935.0,2087220,220.74,1182.18,0.0283,2471,70.37,3751.7,66.52,0.6972
8736,Ward Ortiz and Ortiz,False,KE,Lake Heidi,Fintech,2020,https://wardortizandortiz.com,Water contain hear particularly important.,19,ward-ortiz-and-ortiz,2023,USD,1649759,590070,1059689,1162090,-102401,14427,-116828,16497,32995,-149823,130808,1142512,287196,855316,,1649759,580.07,290.04,0.019,2367,58.08,108847.51,1.2,0.6423
8737,Johnson Herman and Reyes,False,KE,Lake Joshua,Cybersecurity,2012,https://johnsonhermanandreyes.com,Read imagine amount structure four card example issue time.,20,johnson-herman-and-reyes,2023,USD,687541,294908,392633,141386,251247,0,251247,6875,13750,237497,11857,473522,85058,388464,,687541,20.0,98.97,0.0933,531,107.7,1000.0,11.86,0.5711
8738,Coleman PLC,False,DE,Greenestad,HealthTech,2023,https://colemanplc.com,Floor dream although finally interest sense camera travel fight.,20,coleman-plc,2023,EUR,428255,258505,169750,41875,127875,0,127875,4282,8565,119310,35129,380937,19046,361891,35687.92,428255,208.23,1428.92,0.0711,1273,28.03,13276.4,2.65,0.3964
8739,Lyons and Sons,False,DE,Donnaborough,Mobility,2022,https://lyonsandsons.com,Before different mean hold draw impact crime claim.,24,lyons-and-sons,2023,EUR,703821,316662,387159,165778,221381,16252,205129,7038,14076,191053,48770,521810,191367,330443,,703821,20.0,64.73,0.0074,283,207.09,19033.8,2.56,0.5501
8740,Sanchez Fitzgerald and Johnson,False,ZA,Jeremybury,Cybersecurity,2009,https://sanchezfitzgeraldandjohnson.com,Summer sing whose find natural health must.,18,sanchez-fitzgerald-and-johnson,2023,USD,2589923,493829,2096094,699577,1396517,0,1396517,25899,51798,1344719,1155154,2571133,302059,2269074,,2589923,194.17,976.3,0.0387,2590,83.3,87390.45,13.22,0.8093
8741,Reeves-Hess,False,TN,West Alexandramouth,SaaS,2018,https://reeves-hess.com,Language quite building production result particular development.,9,reeves-hess,2023,USD,150511,47316,103195,113309,-10114,48591,-58705,1505,3010,-61715,8602,183151,83013,100138,12542.58,150511,86.01,534.76,0.001,140,89.49,1000.0,8.6,0.6856
8742,Brown-Johnson,False,IN,Laurastad,AI/ML,2010,https://brown-johnson.com,Answer central agree model parent.,26,brown-johnson,2023,USD,2248757,777350,1471407,844213,627194,23446,603748,22487,44975,558773,269408,1416344,451860,964484,,2248757,533.53,645.28,0.0596,9369,20.0,100840.76,2.67,0.6543
8743,Harper PLC,False,NG,Schultztown,Energy,2023,https://harperplc.com,Recently radio sound middle cut big sense partner family respond.,18,harper-plc,2023,USD,2182706,629879,1552827,746912,805915,0,805915,21827,43654,762261,108594,1217818,352202,865616,,2182706,338.8,1361.47,0.0925,4075,44.63,59636.01,1.82,0.7114
8744,Olson Ltd,False,IN,South Patricia,Energy,2015,https://olsonltd.com,Occur southern plan recent small camera Democrat scene board stock piece.,16,olson-ltd,2023,USD,2795951,609873,2186078,1664191,521887,2006,519881,27959,55919,463962,514204,1970549,702959,1267590,,2795951,20.0,140.82,0.001,11649,20.0,93549.6,5.5,0.7819
8745,Mcbride Group,False,US,Michellebury,SaaS,2008,https://mcbridegroup.com,Government child young evening arrive conference.,19,mcbride-group,2023,USD,1682529,768396,914133,211467,702666,22988,679678,16825,33650,646028,10387,1024234,428213,596021,140210.75,1682529,627.44,3345.72,0.0432,2280,61.48,41029.25,0.25,0.5433
8746,Holmes-Kennedy,False,KE,South Kevinhaven,IoT,2024,https://holmes-kennedy.com,City everybody page peace think summer.,17,holmes-kennedy,2023,USD,228788,98091,130697,204915,-74218,6155,-80373,2287,4575,-84948,3950,275944,93549,182395,,228788,453.57,2521.3,0.0187,126,150.89,1000.0,3.95,0.5713
8747,Villanueva-Harris,False,IN,Brockberg,Marketplaces,2015,https://villanueva-harris.com,Guess fire step parent join general.,13,villanueva-harris,2023,USD,608619,156479,452140,676545,-224405,0,-224405,6086,12172,-236577,5229,412234,194128,218106,,608619,20.0,96.99,0.0237,261,194.27,29818.76,0.18,0.7429
8748,Ward Nunez and Carroll,False,DE,Tonyaview,Energy,2011,https://wardnunezandcarroll.com,Thousand indicate billion site can need run big.,13,ward-nunez-and-carroll,2023,EUR,4263830,1758810,2505020,2425280,79740,12421,67319,42638,85276,-17957,24907,2191039,327709,1863330,,4263830,339.62,1624.67,0.001,885,401.34,230351.05,0.11,0.5875
8749,Hart Ltd,False,FR,Dawnchester,Cybersecurity,2015,https://hartltd.com,Return real church president claim.,17,hart-ltd,2023,EUR,22648382,9075179,13573203,16764089,-3190886,0,-3190886,226483,452967,-3643853,425602,11895775,4701458,7194317,,22648382,2282.26,9053.29,0.038,19041,99.12,1416080.12,0.3,0.5993
8750,Morse-Williams,False,EG,Stephentown,Fintech,2011,https://morse-williams.com,Medical seek deep participant lay husband.,11,morse-williams,2023,USD,5209404,1638654,3570750,2084213,1486537,0,1486537,52094,104188,1382349,430303,3169262,1841926,1327336,,5209404,188.45,1137.37,0.001,3833,113.24,182667.45,2.36,0.6854
8751,Singleton LLC,False,NG,Lake Sabrinafurt,Fintech,2018,https://singletonllc.com,Short customer ok political from then four born audience majority.,22,singleton-llc,2023,USD,2301426,550027,1751399,670519,1080880,0,1080880,23014,46028,1034852,98089,1272817,971555,301262,,2301426,1348.78,5993.99,0.0556,963,199.05,54614.61,1.8,0.761
8752,White-Decker,False,FR,West Stephenborough,Marketplaces,2019,https://white-decker.com,Party rich past for law.,19,white-decker,2023,EUR,2572108,548618,2023490,1673170,350320,16719,333601,25721,51442,282159,108613,1410285,234397,1175888,,2572108,382.52,1041.11,0.0054,1042,205.65,143945.4,0.75,0.7867
8753,Mayo Byrd and Hutchinson,False,ZA,Harrischester,AgriTech,2018,https://mayobyrdandhutchinson.com,Cup garden rate others sing them task sell.,11,mayo-byrd-and-hutchinson,2023,USD,606916,266925,339991,460874,-120883,23847,-144730,6069,12138,-156868,13283,399036,113202,285834,,606916,20.0,50.75,0.0883,2528,20.0,1000.0,13.28,0.5602
8754,James Powell and Bennett,False,NG,New Laurenberg,HealthTech,2017,https://jamespowellandbennett.com,Above style probably between full really population measure herself heart.,23,james-powell-and-bennett,2023,USD,167591,80247,87344,68974,18370,12525,5845,1675,3351,2494,17956,227498,63420,164078,13965.92,167591,547.8,2125.61,0.0358,337,41.33,1000.0,17.96,0.5212
8755,Edwards Morales and Wong,False,GB,Kellyburgh,SaaS,2014,https://edwardsmoralesandwong.com,Whether old stay team easy throw.,18,edwards-morales-and-wong,2023,USD,1466617,374084,1092533,125297,967236,0,967236,14666,29332,937904,172589,937945,364075,573870,122218.08,1466617,230.25,622.86,0.02,3211,38.06,1000.0,172.59,0.7449
8756,Hopkins-Powell,False,BR,Brianhaven,AgriTech,2008,https://hopkins-powell.com,Social future serve spend improve stand why class.,17,hopkins-powell,2023,USD,119378,51467,67911,44901,23010,0,23010,1193,2387,20623,12188,225962,81859,144103,,119378,2194.66,6458.04,0.0896,497,20.0,1000.0,12.19,0.5689
8757,Contreras Inc,False,FR,Sharonhaven,E-commerce,2014,https://contrerasinc.com,Social young soldier myself wall better process whether would technology.,14,contreras-inc,2023,EUR,3983260,787210,3196050,1061720,2134330,0,2134330,39832,79665,2054665,202523,2389528,1183499,1206029,,3983260,20.0,35.94,0.0633,16596,20.0,83852.52,2.42,0.8024
8758,Burton Meyer and Walker,False,CA,Lake Teresa,EdTech,2016,https://burtonmeyerandwalker.com,Alone mean walk society vote year morning.,20,burton-meyer-and-walker,2023,USD,161318,25507,135811,104616,31195,33295,-2100,1613,3226,-5326,2523,279222,75378,203844,13443.17,161318,65.61,299.91,0.001,213,62.83,7991.14,0.32,0.8419
8759,Vaughan Sanders and Hutchinson,False,TN,West Tamara,Energy,2008,https://vaughansandersandhutchinson.com,Section anything require view nice wait course.,22,vaughan-sanders-and-hutchinson,2023,USD,5936833,3425847,2510986,2000061,510925,0,510925,59368,118736,392189,411950,3472970,956756,2516214,,5936833,72.28,257.41,0.0431,4922,100.51,187055.89,2.2,0.423
8760,Cruz Mcdonald and Lopez,False,EG,West Shannonside,E-commerce,2020,https://cruzmcdonaldandlopez.com,General foot this safe book notice fear.,26,cruz-mcdonald-and-lopez,2023,USD,2368553,1025599,1342954,118427,1224527,0,1224527,23685,47371,1177156,90077,1360235,541199,819036,,2368553,72.78,80.19,0.001,9868,20.0,25019.71,3.6,0.567
8761,Chang-Olson,False,KE,Prattville,IoT,2016,https://chang-olson.com,State generation pattern hope charge.,18,chang-olson,2023,USD,633874,251334,382540,109229,273311,37558,235753,6338,12677,223076,102703,436180,21809,414371,,633874,809.28,2738.62,0.0165,562,93.86,20042.67,5.12,0.6035
8762,Ellison Inc,False,IN,East Amandabury,IoT,2016,https://ellisoninc.com,Answer yeah student improve film happy thought my know dog security.,18,ellison-inc,2023,USD,4572617,593672,3978945,2761759,1217186,16933,1200253,45726,91452,1108801,402539,2865448,394287,2471161,,4572617,759.48,5068.2,0.1201,1032,369.22,220602.85,1.82,0.8702
8763,Waters Ltd,False,TN,Noahview,Energy,2022,https://watersltd.com,Man street long seat.,15,waters-ltd,2023,USD,3626292,1519533,2106759,2290342,-183583,22562,-206145,36262,72525,-278670,26338,1978743,1440172,538571,,3626292,428.04,680.87,0.003,1300,232.39,224018.8,0.12,0.581
8764,James Inc,False,GB,Watsonton,Cybersecurity,2009,https://jamesinc.com,Age fear president be various.,20,james-inc,2023,USD,3340328,2035352,1304976,2675364,-1370388,4503,-1374891,33403,66806,-1441697,78170,1821709,835805,985904,,3340328,127.75,63.88,0.095,1378,201.89,248723.33,0.31,0.3907
8765,Trevino-Douglas,False,FR,East Beckyview,SaaS,2012,https://trevino-douglas.com,Point floor control point everybody them about case.,19,trevino-douglas,2023,EUR,412403,113504,298899,180725,118174,23561,94613,4124,8248,86365,38122,382471,144580,237891,34366.92,412403,215.23,789.05,0.0485,673,51.06,12209.47,3.12,0.7248
8766,Adams-Walker,False,IN,Coxtown,Marketplaces,2008,https://adams-walker.com,Generation thought pattern laugh effort sister into provide tree.,29,adams-walker,2023,USD,2500192,840688,1659504,1478830,180674,14251,166423,25001,50003,116420,373980,1637520,697499,940021,,2500192,438.57,219.28,0.009,9722,21.43,160207.5,2.33,0.6638
8767,Adams Yates and Herring,False,AU,Nancytown,HealthTech,2010,https://adamsyatesandherring.com,Head stay sign left several.,22,adams-yates-and-herring,2023,USD,2145897,970657,1175240,670074,505166,0,505166,21458,42917,462249,139481,1369907,469633,900274,178824.75,2145897,491.35,491.35,0.0495,35764,5.0,22841.03,6.11,0.5477
8768,Olson Reyes and Phillips,False,ZA,East Mitchelltown,AI/ML,2012,https://olsonreyesandphillips.com,Parent its appear benefit read six role.,20,olson-reyes-and-phillips,2023,USD,1032602,211085,821517,452808,368709,0,368709,10326,20652,348057,42779,562510,95210,467300,,1032602,475.71,1922.51,0.0088,478,179.82,34636.85,1.24,0.7956
8769,Owens-Wolf,False,GB,Port Mary,Marketplaces,2015,https://owens-wolf.com,Another actually clearly model.,26,owens-wolf,2023,USD,3196830,1460227,1736603,472445,1264158,13165,1250993,31968,63936,1187057,120255,1763510,391127,1372383,,3196830,1790.31,6981.49,0.032,1115,238.86,43620.16,2.76,0.5432
8770,Murphy LLC,False,NG,New Kimberlyshire,Mobility,2017,https://murphyllc.com,Friend pick power base suggest today economic loss wall.,22,murphy-llc,2023,USD,2626699,962468,1664231,131334,1532897,29582,1503315,26266,52533,1450782,156592,1558853,77942,1480911,,2626699,20.0,10.0,0.0507,10944,20.0,1000.0,156.59,0.6336
8771,Jordan-Mills,False,US,Williamsfort,HealthTech,2020,https://jordan-mills.com,Tax production line enough drive economy audience.,18,jordan-mills,2023,USD,1215469,246612,968857,812015,156842,2256,154586,12154,24309,130277,245308,1021508,284569,736939,101289.08,1215469,434.02,2531.7,0.026,1368,74.01,67901.54,3.61,0.7971
8772,Pruitt-Friedman,False,GB,Taylormouth,SaaS,2024,https://pruitt-friedman.com,Maintain town police center.,18,pruitt-friedman,2023,USD,953276,266675,686601,322316,364285,29575,334710,9532,19065,315645,39744,587564,326395,261169,79439.67,953276,10.0,50.78,0.001,1351,58.79,24663.12,1.61,0.7203
8773,Clark Curry and Landry,False,CA,South Michael,AI/ML,2010,https://clarkcurryandlandry.com,Bar huge house minute rise half.,21,clark-curry-and-landry,2023,USD,353923,104768,249155,72358,176797,26288,150509,3539,7078,143431,14939,282312,137396,144916,,353923,20.0,51.87,0.0825,1474,20.0,41414.05,0.36,0.704
8774,Johnson Inc,False,EG,Wareton,AgriTech,2018,https://johnsoninc.com,Arrive defense first tax low responsibility agent build wrong yeah.,21,johnson-inc,2023,USD,121841,30547,91294,75839,15455,4148,11307,1218,2436,8871,37829,123855,62821,61034,,121841,525.46,3091.45,0.0814,48,211.51,1000.0,37.83,0.7493
8775,Kim Gordon and Dougherty,False,GB,New Peggychester,Mobility,2015,https://kimgordonanddougherty.com,Under special build notice sit paper current Mrs west single weight.,23,kim-gordon-and-dougherty,2023,USD,1167054,369064,797990,132069,665921,0,665921,11670,23341,642580,9133,736717,205829,530888,,1167054,301.45,1111.88,0.001,384,252.61,1000.0,9.13,0.6838
8776,Cannon-Cox,False,AU,Hernandezland,E-commerce,2014,https://cannon-cox.com,Son hear suffer carry guy outside item pay.,18,cannon-cox,2023,USD,903597,205717,697880,389617,308263,0,308263,9035,18071,290192,489029,1073768,318177,755591,,903597,1409.31,2741.7,0.0416,432,174.29,13849.01,35.31,0.7723
8777,Miller-Weber,False,TN,South Rachel,AgriTech,2013,https://miller-weber.com,Direction outside beat leave soon child the.,20,miller-weber,2023,USD,613090,162810,450280,472554,-22274,0,-22274,6130,12261,-34535,15189,406113,253028,153085,,613090,466.82,868.61,0.0205,857,59.55,56209.32,0.27,0.7344
8778,Cox Jones and Mueller,False,DE,Edwardport,E-commerce,2022,https://coxjonesandmueller.com,Side simple structure ten would rock.,20,cox-jones-and-mueller,2023,EUR,1519193,746127,773066,981045,-207979,7184,-215163,15191,30383,-245546,350816,1262065,192403,1069662,,1519193,20.0,96.95,0.0613,6329,20.0,84987.84,4.13,0.5089
8779,Everett PLC,False,US,Nguyenville,SaaS,2017,https://everettplc.com,Mission true however ask movie ground interview nor certainly.,19,everett-plc,2023,USD,1733520,340758,1392762,776679,616083,0,616083,17335,34670,581413,94017,1016460,651108,365352,144460.0,1733520,526.31,2850.08,0.0652,1191,121.23,64131.27,1.47,0.8034
8780,Jones Richard and Palmer,False,FR,North Joshua,HealthTech,2011,https://jonesrichardandpalmer.com,Six tend work almost image lose cold.,25,jones-richard-and-palmer,2023,EUR,440132,139139,300993,165328,135665,7357,128308,4401,8802,119506,3044,395543,84052,311491,36677.67,440132,10.0,24.72,0.116,1350,27.16,39894.85,0.08,0.6839
8781,Howard Mendez and Moran,False,AU,Simmonsstad,AI/ML,2012,https://howardmendezandmoran.com,Stop own create peace drug determine.,25,howard-mendez-and-moran,2023,USD,445528,96797,348731,320644,28087,0,28087,4455,8910,19177,5273,327341,138987,188354,,445528,172.88,769.93,0.1053,187,197.61,55546.85,0.09,0.7827
8782,Davis Ltd,False,NG,South Cynthiaside,Cybersecurity,2018,https://davisltd.com,Already accept since opportunity right we price gas strong grow.,15,davis-ltd,2023,USD,376553,106474,270079,124999,145080,20552,124528,3765,7531,116997,33639,376702,114632,262070,,376553,20.0,109.62,0.0772,157,199.35,1000.0,33.64,0.7172
8783,Salinas Ramos and Weaver,False,FR,North Peterport,AI/ML,2011,https://salinasramosandweaver.com,Job son let author win attorney.,18,salinas-ramos-and-weaver,2023,EUR,531798,235190,296608,378399,-81791,0,-81791,5317,10635,-92426,25173,445793,144216,301577,,531798,1694.97,2039.28,0.0213,129,342.87,39503.53,0.64,0.5577
8784,Hickman Ltd,False,BR,North Georgeburgh,Energy,2010,https://hickmanltd.com,Simply treatment finish see development clearly require.,22,hickman-ltd,2023,USD,2201021,949273,1251748,124015,1127733,5765,1121968,22010,44020,1077948,69265,1367669,303598,1064071,,2201021,1630.63,7019.74,0.005,9170,20.0,39967.91,1.73,0.5687
8785,Bender Woodward and Schaefer,False,BR,Colemanland,HealthTech,2018,https://benderwoodwardandschaefer.com,Woman sea hair agree true fine might president offer.,16,bender-woodward-and-schaefer,2023,USD,1530636,683372,847264,76531,770733,0,770733,15306,30612,740121,51026,883199,440617,442582,127553.0,1530636,39.84,158.31,0.0103,1847,69.03,1000.0,51.03,0.5535
8786,Thompson Stewart and Hale,False,CA,North William,IoT,2008,https://thompsonstewartandhale.com,Camera film box cost evening make figure road ball.,18,thompson-stewart-and-hale,2023,USD,195786,53886,141900,131487,10413,0,10413,1957,3915,6498,8542,266876,119385,147491,,195786,171.69,1077.55,0.0134,815,20.0,1000.0,8.54,0.7248
8787,Johnson PLC,False,IN,Stevensstad,Marketplaces,2020,https://johnsonplc.com,Later light probably art sing.,16,johnson-plc,2023,USD,300590,66630,233960,170816,63144,0,63144,3005,6011,57133,14524,278185,64817,213368,,300590,2739.85,15300.65,0.1047,1252,20.0,16806.29,0.86,0.7783
8788,Moore Jones and Montgomery,False,FR,West Danielburgh,SaaS,2009,https://moorejonesandmontgomery.com,Outside prepare face stop management central accept tonight laugh.,22,moore-jones-and-montgomery,2023,EUR,579452,195722,383730,400773,-17043,0,-17043,5794,11589,-28632,34653,442810,70686,372124,48287.67,579452,206.05,930.32,0.001,942,51.26,64491.28,0.54,0.6622
8789,Porter Perry and Grant,False,EG,West Sarahbury,IoT,2013,https://porterperryandgrant.com,Main these choice score what power grow although.,22,porter-perry-and-grant,2023,USD,191047,107785,83262,71242,12020,25159,-13139,1910,3820,-16959,12312,193409,60776,132633,,191047,20.0,36.33,0.0167,796,20.0,9077.4,1.36,0.4358
8790,Roy Crawford and Rios,False,DE,West Stephanieburgh,SaaS,2016,https://roycrawfordandrios.com,Girl later worker chance hear yard another organization.,22,roy-crawford-and-rios,2023,EUR,1135571,439880,695691,429545,266146,5268,260878,11355,22711,238167,184017,884544,44227,840317,94630.92,1135571,10.0,62.69,0.0603,1423,66.46,69428.6,2.65,0.6126
8791,Dixon-Joseph,False,TN,Chasefort,Energy,2008,https://dixon-joseph.com,News cost him possible court beautiful general check bring democratic.,18,dixon-joseph,2023,USD,498671,188877,309794,268073,41721,17942,23779,4986,9973,13806,25398,353599,90806,262793,,498671,138.83,141.59,0.001,297,139.6,19896.13,1.28,0.6212
8792,Ortega Ltd,False,US,Hendersonstad,Fintech,2012,https://ortegaltd.com,Above strategy house air wife set other argue.,15,ortega-ltd,2023,USD,3352549,995004,2357545,2846781,-489236,0,-489236,33525,67050,-556286,60162,1890588,878126,1012462,,3352549,1341.22,3416.24,0.001,2271,122.97,246287.01,0.24,0.7032
8793,Marshall and Sons,False,NG,Vegamouth,EdTech,2024,https://marshallandsons.com,Rather describe box fly risk skill guy which reflect happy.,36,marshall-and-sons,2023,USD,1041128,385635,655493,380499,274994,56657,218337,10411,20822,197515,15367,688948,241609,447339,86760.67,1041128,595.7,3381.82,0.0447,850,101.98,25205.84,0.61,0.6296
8794,West Stevens and Cantu,False,GB,New Tammytown,Mobility,2010,https://weststevensandcantu.com,Program different any present music color early open throw.,21,west-stevens-and-cantu,2023,USD,603870,30193,573677,558845,14832,6003,8829,6038,12077,-3248,47798,350756,105414,245342,,603870,453.95,2366.71,0.0973,379,132.5,74801.47,0.64,0.95
8795,Willis Boone and Larson,False,US,Lake Justinhaven,Fintech,2013,https://willisbooneandlarson.com,Garden yeah stuff sign truth science.,28,willis-boone-and-larson,2023,USD,553233,154317,398916,121256,277660,0,277660,5532,11064,266596,46433,384159,156853,227306,,553233,20.0,70.71,0.1435,269,171.38,1000.0,46.43,0.7211
8796,Mckinney-Reese,False,DE,South Kimberlyland,HealthTech,2021,https://mckinney-reese.com,Young training without sign commercial like daughter sign modern change.,17,mckinney-reese,2023,EUR,1342543,730003,612540,663757,-51217,12592,-63809,13425,26850,-90659,16431,730186,438042,292144,111878.58,1342543,357.15,937.82,0.001,13577,8.24,47660.91,0.34,0.4563
8797,Johnson-Reese,False,FR,Dunntown,E-commerce,2010,https://johnson-reese.com,Whom perform return actually determine.,23,johnson-reese,2023,EUR,515763,239315,276448,63132,213316,0,213316,5157,10315,203001,24212,440289,22014,418275,,515763,1208.45,4992.96,0.0052,2149,20.0,43370.95,0.56,0.536
8798,Obrien Frye and Welch,False,GB,Lake Thomas,SaaS,2016,https://obrienfryeandwelch.com,Home industry teach nature child.,19,obrien-frye-and-welch,2023,USD,740699,342453,398246,372908,25338,0,25338,7406,14813,10525,141280,635746,359104,276642,61724.92,740699,10.0,17.92,0.001,700,88.09,49460.52,2.86,0.5377
8799,Parsons Miller and Moody,False,NG,Ryanview,Cybersecurity,2019,https://parsonsmillerandmoody.com,Catch each ground eight home.,22,parsons-miller-and-moody,2023,USD,3773209,2300934,1472275,2288967,-816692,20330,-837022,37732,75464,-912486,182058,2215633,118182,2097451,,3773209,149.33,74.67,0.0602,15721,20.0,202948.2,0.9,0.3902
8800,Beard Torres and Smith,False,US,North Diane,Mobility,2021,https://beardtorresandsmith.com,Fund thing painting attack truth agent page special job.,27,beard-torres-and-smith,2023,USD,1281274,249734,1031540,357331,674209,19800,654409,12812,25625,628784,37352,876807,415820,460987,,1281274,1585.69,3030.46,0.0401,553,192.77,13908.36,2.69,0.8051
8801,Ross Taylor and Hess,False,TN,Connerchester,E-commerce,2015,https://rosstaylorandhess.com,Under prevent she tell enter anything.,23,ross-taylor-and-hess,2023,USD,768862,327879,440983,462403,-21420,0,-21420,7688,15377,-36797,44124,609480,30474,579006,,768862,20.0,126.18,0.0371,3203,20.0,57100.6,0.77,0.5736
8802,Hogan PLC,False,AU,Alvaradoburgh,Cybersecurity,2016,https://hoganplc.com,Can certainly generation drop box popular through ok since fine.,23,hogan-plc,2023,USD,1188127,525880,662247,301159,361088,0,361088,11881,23762,337326,40552,760614,184607,576007,,1188127,20.0,95.87,0.0306,1047,94.52,34278.95,1.18,0.5574
8803,Jenkins-Barton,False,IN,Jessicafurt,Energy,2009,https://jenkins-barton.com,Address language beyond everybody suggest all management decade interview who student.,15,jenkins-barton,2023,USD,1936863,545317,1391546,1062145,329401,0,329401,19368,38737,290664,70873,1093818,468128,625690,,1936863,601.34,1108.95,0.1176,8070,20.0,61665.53,1.15,0.7185
8804,Contreras Hunt and Ward,False,IN,West Nicholasmouth,Marketplaces,2013,https://contrerashuntandward.com,Better radio sense its water phone.,22,contreras-hunt-and-ward,2023,USD,467356,122188,345168,283214,61954,9407,52547,4673,9347,43200,34070,292340,126392,165948,,467356,20.0,10.0,0.1093,110,353.47,39545.93,0.86,0.7386
8805,Rubio LLC,False,GB,West Robertshire,Mobility,2021,https://rubiollc.com,Window whether produce leave quickly peace table must cover.,11,rubio-llc,2023,USD,1389455,339615,1049840,913301,136539,26666,109873,13894,27789,82084,60901,938492,172016,766476,,1389455,20.0,26.2,0.0954,588,196.89,50898.21,1.2,0.7556
8806,Roberts LLC,False,DE,Rogersberg,Marketplaces,2017,https://robertsllc.com,Part power piece hotel majority international she away professional physical hospital.,16,roberts-llc,2023,EUR,823559,378408,445151,123628,321523,0,321523,8235,16471,305052,28919,482626,204473,278153,,823559,20.0,52.73,0.0142,2960,23.18,27301.82,1.06,0.5405
8807,Smith-Newman,False,TN,Lake Richard,SaaS,2011,https://smith-newman.com,Professor teacher majority late go rather do mother actually democratic.,20,smith-newman,2023,USD,224130,112679,111451,87843,23608,18253,5355,2241,4482,873,5880,155428,62866,92562,18677.5,224130,10.0,48.63,0.001,219,85.22,4515.52,1.3,0.4973
8808,Diaz Wilson and Brown,False,KE,East Marioland,Fintech,2018,https://diazwilsonandbrown.com,Such process population suddenly civil safe response arrive.,13,diaz-wilson-and-brown,2023,USD,404942,179424,225518,237264,-11746,0,-11746,4049,8098,-19844,3866,250152,64797,185355,,404942,20.0,42.98,0.066,1687,20.0,25463.34,0.15,0.5569
8809,Miller PLC,False,DE,Tammychester,SaaS,2019,https://millerplc.com,Town ground magazine reality statement song table argue director.,21,miller-plc,2023,EUR,309481,139236,170245,125611,44634,19833,24801,3094,6189,18612,30454,319753,76943,242810,25790.08,309481,480.87,1206.55,0.001,770,33.48,22940.22,1.33,0.5501
8810,Briggs Wilcox and Ho,False,EG,Avilaberg,Cybersecurity,2014,https://briggswilcoxandho.com,Natural during wrong chair past international.,14,briggs-wilcox-and-ho,2023,USD,3562052,1762601,1799451,2059396,-259945,0,-259945,35620,71241,-331186,229255,2073603,256423,1817180,,3562052,998.15,499.08,0.0713,2254,131.68,144763.89,1.58,0.5052
8811,Strong-Jackson,False,ZA,Christopherfort,AgriTech,2023,https://strong-jackson.com,Point close rate adult evening go day.,18,strong-jackson,2023,USD,148873,58879,89994,68086,21908,22361,-453,1488,2977,-3430,12962,136655,23419,113236,,148873,20.0,107.83,0.0208,620,20.0,1000.0,12.96,0.6045
8812,Lee-Sloan,False,GB,Thompsonfurt,AgriTech,2015,https://lee-sloan.com,Story ground happen technology fear staff writer those number low.,17,lee-sloan,2023,USD,85768,36075,49693,46087,3606,0,3606,857,1715,1891,2587,187014,80668,106346,,85768,1101.98,2997.67,0.0708,60,119.1,27401.09,0.09,0.5794
8813,Adams Dyer and Petersen,False,CA,South Yvetteburgh,AI/ML,2021,https://adamsdyerandpetersen.com,Entire investment popular final outside.,26,adams-dyer-and-petersen,2023,USD,466591,106777,359814,235337,124477,3333,121144,4665,9331,111813,17640,383382,119826,263556,,466591,525.84,1306.25,0.0705,1944,20.0,16273.58,1.08,0.7712
8814,Williams-Murray,False,FR,North Gregstad,Mobility,2021,https://williams-murray.com,Success challenge end soon over.,27,williams-murray,2023,EUR,3580824,1952631,1628193,3189059,-1560866,12998,-1573864,35808,71616,-1645480,206308,2086108,1375489,710619,,3580824,20.0,32.67,0.066,4697,63.52,288233.85,0.72,0.4547
8815,Simmons-Day,False,NG,North Michaelton,HealthTech,2013,https://simmons-day.com,She woman campaign source total college security wide father.,11,simmons-day,2023,USD,913560,59014,854546,262086,592460,0,592460,9135,18271,574189,22545,550464,185771,364693,76130.0,913560,10.0,10.0,0.0307,15226,5.0,7842.85,2.87,0.9354
8816,Montes and Sons,False,CA,Jacksonfort,Fintech,2012,https://montesandsons.com,Environmental big write walk economic easy.,18,montes-and-sons,2023,USD,358046,124577,233469,377555,-144086,9284,-153370,3580,7160,-160530,31840,231740,104418,127322,,358046,1072.87,536.43,0.0624,1491,20.0,30125.46,1.06,0.6521
8817,Martin PLC,False,EG,Amyville,Marketplaces,2013,https://martinplc.com,Agree blue bit young win agent party view.,22,martin-plc,2023,USD,1251285,714077,537208,654645,-117437,0,-117437,12512,25025,-142462,7891,656603,278589,378014,,1251285,20.0,25.12,0.0169,1958,53.23,43674.59,0.18,0.4293
8818,Lambert Ltd,False,TN,Port Debrashire,Mobility,2008,https://lambertltd.com,Forget her executive nature great stage but.,23,lambert-ltd,2023,USD,143637,77572,66065,27519,38546,0,38546,1436,2872,35674,959,98813,15694,83119,,143637,20.0,15.99,0.0105,598,20.0,7727.72,0.12,0.4599
8819,Johnson Moyer and Lam,False,NG,Johnsborough,Energy,2021,https://johnsonmoyerandlam.com,And scene word important activity whatever law.,18,johnson-moyer-and-lam,2023,USD,930362,334237,596125,619584,-23459,0,-23459,9303,18607,-42066,48938,602426,155167,447259,,930362,842.13,1749.87,0.0453,3876,20.0,47548.53,1.03,0.6407
8820,Roberts-Moore,False,ZA,East Tricia,Energy,2019,https://roberts-moore.com,Order walk seek just thousand should.,19,roberts-moore,2023,USD,6522089,2263579,4258510,3715809,542701,18158,524543,65220,130441,394102,11105,3469875,1903448,1566427,,6522089,1244.34,7509.18,0.1128,1463,371.45,338712.12,0.03,0.6529
8821,Gomez Shea and Roach,False,ZA,Hernandezland,Energy,2012,https://gomezsheaandroach.com,Current forward plan fight article.,17,gomez-shea-and-roach,2023,USD,5972005,2130954,3841051,3166082,674969,0,674969,59720,119440,555529,138378,3214060,1925502,1288558,,5972005,397.94,1067.16,0.0904,4262,116.75,281133.06,0.49,0.6432
8822,Villanueva Campbell and Peters,False,GB,Port Nicholas,AgriTech,2010,https://villanuevacampbellandpeters.com,Myself American assume five someone economy.,22,villanueva-campbell-and-peters,2023,USD,78713,51066,27647,43549,-15902,0,-15902,787,1574,-17476,39259,234367,66212,168155,,78713,260.61,393.02,0.0438,175,37.3,1000.0,39.26,0.3512
8823,King Group,False,KE,Lesliehaven,Mobility,2021,https://kinggroup.com,Forward reflect discover television look member suddenly.,21,king-group,2023,USD,1913579,1231674,681905,1604629,-922724,0,-922724,19135,38271,-960995,47546,1118620,198341,920279,,1913579,1668.88,10231.67,0.0097,1331,119.79,161960.89,0.29,0.3564
8824,Valdez Holmes and Hughes,False,NG,Racheltown,Mobility,2024,https://valdezholmesandhughes.com,During receive build smile despite huge yes her board carry quickly.,23,valdez-holmes-and-hughes,2023,USD,1516909,575235,941674,689021,252653,7968,244685,15169,30338,214347,59547,892702,376244,516458,,1516909,1340.29,5967.17,0.2195,278,453.5,80130.75,0.74,0.6208
8825,Huff-Walker,False,IN,New Renee,IoT,2017,https://huff-walker.com,Nice fight president century significant couple either.,15,huff-walker,2023,USD,562998,158960,404038,231521,172517,10032,162485,5629,11259,151226,16190,464514,250453,214061,,562998,249.87,144.24,0.1768,115,407.77,41677.06,0.39,0.7177
8826,Sanchez and Sons,False,EG,West Gregory,Mobility,2010,https://sanchezandsons.com,Exactly this bed work center them relate list.,15,sanchez-and-sons,2023,USD,1939157,859346,1079811,1603970,-524159,348,-524507,19391,38783,-563290,57714,1196443,283808,912635,,1939157,213.13,952.18,0.0796,8079,20.0,101793.26,0.57,0.5568
8827,Sherman Goodman and Luna,False,BR,West Daniel,HealthTech,2009,https://shermangoodmanandluna.com,New small have family.,20,sherman-goodman-and-luna,2023,USD,1063427,482768,580659,689412,-108753,0,-108753,10634,21268,-130021,260080,885221,301991,583230,88618.92,1063427,10.0,34.14,0.056,5818,15.23,45660.21,5.7,0.546
8828,Gonzalez-Scott,False,BR,North Melanie,EdTech,2019,https://gonzalez-scott.com,Identify kind material along charge big peace ball.,24,gonzalez-scott,2023,USD,265083,79246,185837,244376,-58539,20784,-79323,2650,5301,-84624,9828,269636,56748,212888,22090.25,265083,98.48,443.56,0.0337,474,46.58,16130.47,0.61,0.7011
8829,Ryan Lara and Hays,False,US,West Darleneton,SaaS,2021,https://ryanlaraandhays.com,Almost enter hand last charge five politics hair type stop study.,26,ryan-lara-and-hays,2023,USD,5225936,935125,4290811,4382580,-91769,0,-91769,52259,104518,-196287,791373,3574357,1198953,2375404,435494.67,5225936,10.0,32.34,0.0015,4800,90.72,339194.41,2.33,0.8211
8830,Lopez PLC,False,FR,Taylorchester,AI/ML,2017,https://lopezplc.com,Writer financial beautiful these anything lawyer relate church both social.,25,lopez-plc,2023,EUR,1094938,545642,549296,839515,-290219,10044,-300263,10949,21898,-322161,196550,766387,128920,637467,,1094938,309.27,1656.35,0.001,317,287.27,79078.66,2.49,0.5017
8831,Watson Inc,False,NG,Nicoleville,IoT,2023,https://watsoninc.com,Seem ahead space though computer car moment guy with.,15,watson-inc,2023,USD,1026800,263315,763485,648073,115412,0,115412,10268,20536,94876,18426,708909,348000,360909,,1026800,20.0,79.65,0.0401,3577,23.92,66399.69,0.28,0.7436
8832,White-Carlson,False,IN,South Malloryfort,HealthTech,2012,https://white-carlson.com,Still happen star whatever Congress middle.,19,white-carlson,2023,USD,733304,242854,490450,398891,91559,0,91559,7333,14666,76893,25839,421304,304515,116789,61108.67,733304,116.07,131.5,0.0436,4355,14.03,74067.49,0.35,0.6688
8833,Crawford Ltd,False,DE,Port Desiree,E-commerce,2016,https://crawfordltd.com,Room play off old as per effect this little bring various.,27,crawford-ltd,2023,EUR,1121145,464827,656318,245697,410621,0,410621,11211,22422,388199,20885,724741,146231,578510,,1121145,480.79,1449.07,0.101,269,346.11,21265.29,0.98,0.5854
8834,Nelson-Herring,False,AU,Port Brittany,EdTech,2017,https://nelson-herring.com,Camera this pass at involve level strategy than network really.,26,nelson-herring,2023,USD,718915,343714,375201,167086,208115,0,208115,7189,14378,193737,11299,516673,123467,393206,59909.58,718915,269.86,665.88,0.0251,1174,50.99,60208.79,0.19,0.5219
8835,Huynh Hartman and Russell,False,US,Murrayshire,AgriTech,2021,https://huynhhartmanandrussell.com,Option identify else next view above during.,21,huynh-hartman-and-russell,2023,USD,704655,325579,379076,465278,-86202,0,-86202,7046,14093,-100295,29395,508938,342302,166636,,704655,309.0,1116.52,0.001,2936,20.0,32707.18,0.9,0.538
8836,Patton-Barrett,False,ZA,Sarahhaven,Energy,2012,https://patton-barrett.com,Bit economy day have whole by tree course.,25,patton-barrett,2023,USD,1429138,596687,832451,817096,15355,0,15355,14291,28582,-13227,43698,790710,441642,349068,,1429138,381.87,1461.59,0.0823,767,155.09,77839.37,0.56,0.5825
8837,Johnson Inc,False,FR,Lake Nicholas,HealthTech,2010,https://johnsoninc.com,Always space machine door discussion stage seem management former color.,22,johnson-inc,2023,EUR,1144010,306634,837376,293313,544063,0,544063,11440,22880,521183,68776,784442,39222,745220,95334.17,1144010,369.63,1039.04,0.0431,19066,5.0,34271.7,2.01,0.732
8838,Mack Young and Willis,False,CA,Arnoldmouth,Marketplaces,2021,https://mackyoungandwillis.com,More poor teach address hot.,17,mack-young-and-willis,2023,USD,1082116,215640,866476,616757,249719,25381,224338,10821,21642,202696,10093,605804,101671,504133,,1082116,852.93,2765.72,0.0096,879,102.53,50590.25,0.2,0.8007
8839,Liu Short and Maxwell,False,IN,Lake Ryan,IoT,2019,https://liushortandmaxwell.com,Join understand reflect history collection.,13,liu-short-and-maxwell,2023,USD,441120,125982,315138,190649,124489,4391,120098,4411,8822,111276,7895,286036,68818,217218,,441120,20.0,83.7,0.0935,229,160.27,20716.17,0.38,0.7144
8840,Palmer Hudson and Morris,False,GB,Lake Melissa,E-commerce,2016,https://palmerhudsonandmorris.com,Effort dream argue direction college.,21,palmer-hudson-and-morris,2023,USD,1120554,284200,836354,414881,421473,38036,383437,11205,22411,361026,804614,1553533,557137,996396,,1120554,414.57,789.7,0.1359,4668,20.0,40140.7,20.04,0.7464
8841,Matthews Kelly and Allen,False,KE,Ashleyview,HealthTech,2008,https://matthewskellyandallen.com,Finish only test design wide here half official.,23,matthews-kelly-and-allen,2023,USD,1148597,520129,628468,140907,487561,32600,454961,11485,22971,431990,114832,705457,111947,593510,95716.42,1148597,10.0,30.9,0.0286,19143,5.0,7887.36,14.56,0.5472
8842,Velazquez Group,False,TN,Jeffreyview,Marketplaces,2016,https://velazquezgroup.com,Far treatment town family follow white organization final stage.,19,velazquez-group,2023,USD,273874,143016,130858,219158,-88300,18386,-106686,2738,5477,-112163,9926,331112,245288,85824,,273874,1335.44,5397.8,0.001,1141,20.0,1000.0,9.93,0.4778
8843,Allen Ltd,False,AU,Barbarabury,AgriTech,2010,https://allenltd.com,Evening bag seem poor option.,17,allen-ltd,2023,USD,148161,22366,125795,99321,26474,0,26474,1481,2963,23511,14461,189274,107783,81491,,148161,1188.57,6265.5,0.0483,47,257.97,11251.53,1.29,0.849
8844,Taylor-Martinez,False,AU,Lambland,Fintech,2011,https://taylor-martinez.com,Available Mrs manage data nor rich attorney Mr behavior their.,15,taylor-martinez,2023,USD,1683231,589311,1093920,765187,328733,6887,321846,16832,33664,288182,703095,1600434,443907,1156527,,1683231,20.0,111.76,0.065,7013,20.0,71543.15,9.83,0.6499
8845,Kramer Clark and Cabrera,False,BR,Collinsville,Cybersecurity,2023,https://kramerclarkandcabrera.com,End performance dark describe trip.,25,kramer-clark-and-cabrera,2023,USD,919813,387933,531880,951485,-419605,0,-419605,9198,18396,-438001,79206,595324,250759,344565,,919813,1018.83,1659.42,0.089,3832,20.0,61543.79,1.29,0.5782
8846,Wu-Smith,False,AU,Brocktown,EdTech,2010,https://wu-smith.com,Write piece maintain others find per movement.,17,wu-smith,2023,USD,746821,251840,494981,408920,86061,23695,62366,7468,14936,47430,18474,583837,188477,395360,62235.08,746821,221.27,1235.65,0.001,656,94.82,41436.0,0.45,0.6628
8847,Rodriguez-Clark,False,NG,East Victoriachester,HealthTech,2022,https://rodriguez-clark.com,Local people citizen black future sound nearly Congress they.,22,rodriguez-clark,2023,USD,5591135,2268193,3322942,4109262,-786320,0,-786320,55911,111822,-898142,139324,3038540,1130420,1908120,465927.92,5591135,10.0,10.0,0.001,3638,128.06,348381.94,0.4,0.5943
8848,Davis Ltd,False,DE,Coxchester,SaaS,2021,https://davisltd.com,Design group thus almost voice enter brother single.,16,davis-ltd,2023,EUR,527484,214539,312945,176307,136638,0,136638,5274,10549,126089,32398,336605,99225,237380,43957.0,527484,258.95,1675.13,0.001,1106,39.73,4115.02,7.87,0.5933
8849,Kim Perez and Hammond,False,DE,Whitestad,AgriTech,2015,https://kimperezandhammond.com,Amount heavy crime Republican section attack necessary political unit bad.,19,kim-perez-and-hammond,2023,EUR,427357,259033,168324,208532,-40208,14052,-54260,4273,8547,-62807,29207,334910,55257,279653,,427357,20.0,65.39,0.001,522,68.17,43999.48,0.66,0.3939
8850,Norris-Weber,False,CA,Kimberlyland,Marketplaces,2017,https://norris-weber.com,Yourself senior he person may price pull process exactly central.,16,norris-weber,2023,USD,313006,19387,293619,79675,213944,21860,192084,3130,6260,185824,5827,212113,73095,139018,,313006,554.49,3523.67,0.1061,1304,20.0,5259.64,1.11,0.9381
8851,Coleman-Bryant,False,NG,Samanthaview,AI/ML,2013,https://coleman-bryant.com,Finish listen them attorney soon free leave quickly bad general short.,28,coleman-bryant,2023,USD,1403153,591954,811199,510536,300663,0,300663,14031,28063,272600,77047,799321,233537,565784,,1403153,2195.42,4342.26,0.089,1208,96.78,54392.21,1.42,0.5781
8852,Robles Mcclure and Jones,False,ZA,Port Charles,Fintech,2024,https://roblesmcclureandjones.com,Offer action boy stage news military.,19,robles-mcclure-and-jones,2023,USD,307622,105300,202322,112413,89909,0,89909,3076,6152,83757,41174,369866,38822,331044,,307622,1117.15,5424.91,0.0447,1281,20.0,10234.05,4.02,0.6577
8853,Goodwin Smith and Miller,False,NG,Jamesborough,AgriTech,2021,https://goodwinsmithandmiller.com,Policy within read leader against protect build.,21,goodwin-smith-and-miller,2023,USD,1021244,188244,833000,654727,178273,2634,175639,10212,20424,155215,88282,633186,130704,502482,,1021244,1498.02,8212.91,0.001,788,107.87,49840.83,1.77,0.8157
8854,Parks Lara and Schultz,False,NG,Williammouth,SaaS,2020,https://parkslaraandschultz.com,Final protect whatever ground hold source.,15,parks-lara-and-schultz,2023,USD,6167414,2792074,3375340,1298745,2076595,0,2076595,61674,123348,1953247,85435,3270777,1308569,1962208,513951.17,6167414,389.88,650.92,0.0109,5219,98.47,87221.8,0.98,0.5473
8855,Kennedy-Estes,False,TN,Delgadoport,AgriTech,2008,https://kennedy-estes.com,Civil travel customer development personal responsibility window age realize practice.,15,kennedy-estes,2023,USD,373960,84080,289880,164058,125822,25326,100496,3739,7479,93017,32069,257764,111808,145956,,373960,20.0,38.81,0.0886,1558,20.0,9800.47,3.27,0.7752
8856,Clark Mckenzie and Walsh,False,CA,North James,Fintech,2011,https://clarkmckenzieandwalsh.com,Reveal citizen structure bad third most song.,16,clark-mckenzie-and-walsh,2023,USD,319401,44476,274925,127744,147181,0,147181,3194,6388,140793,9285,265469,102255,163214,,319401,547.1,1455.79,0.001,157,169.48,32986.41,0.28,0.8608
8857,Harper Richards and Estrada,False,US,Brownville,HealthTech,2010,https://harperrichardsandestrada.com,Traditional he meet bag let join game person.,15,harper-richards-and-estrada,2023,USD,506909,220282,286627,92174,194453,6106,188347,5069,10138,178209,43832,406656,186057,220599,42242.42,506909,123.98,451.07,0.0445,2224,18.99,1000.0,43.83,0.5654
8858,Campbell-Mckinney,False,GB,Cooperfort,E-commerce,2017,https://campbell-mckinney.com,Break sign myself civil argue stage shoulder sort free ever.,22,campbell-mckinney,2023,USD,774484,322674,451810,587400,-135590,11813,-147403,7744,15489,-162892,31615,475119,133351,341768,,774484,626.92,476.74,0.0077,2004,32.2,51999.18,0.61,0.5834
8859,Lester-Smith,False,DE,North Chelseatown,Marketplaces,2016,https://lester-smith.com,Present month difficult actually fine.,21,lester-smith,2023,EUR,312814,118043,194771,154425,40346,0,40346,3128,6256,34090,16444,220337,60614,159723,,312814,20.0,155.45,0.0027,158,164.71,3626.59,4.53,0.6226
8860,Stevenson and Sons,False,FR,Wendyside,Cybersecurity,2013,https://stevensonandsons.com,Each machine sound sort evening career glass building.,21,stevenson-and-sons,2023,EUR,357752,193519,164233,71906,92327,0,92327,3577,7155,85172,27253,377381,181367,196014,,357752,902.0,451.0,0.1328,1490,20.0,3836.56,7.1,0.4591
8861,Small-Jones,False,DE,East Tinafurt,SaaS,2011,https://small-jones.com,Improve establish join year beyond institution.,18,small-jones,2023,EUR,1142103,306290,835813,454491,381322,0,381322,11421,22842,358480,11239,721079,414346,306733,95175.25,1142103,336.87,987.99,0.0776,1494,63.67,44379.73,0.25,0.7318
8862,Osborne Ltd,False,ZA,Port Darrell,Energy,2009,https://osborneltd.com,Produce others today people rule design senior happen.,20,osborne-ltd,2023,USD,151155,79826,71329,7557,63772,0,63772,1511,3023,60749,14773,217247,55267,161980,,151155,579.97,289.98,0.0893,629,20.0,38804.64,0.38,0.4719
8863,Campbell-Miller,False,IN,Port David,IoT,2024,https://campbell-miller.com,Else skin expect poor role enough.,20,campbell-miller,2023,USD,811043,351390,459653,477179,-17526,9369,-26895,8110,16220,-43115,153300,738292,131377,606915,,811043,20.0,83.2,0.001,3379,20.0,18920.13,8.1,0.5667
8864,Robertson-Gibson,False,TN,Hornfort,SaaS,2015,https://robertson-gibson.com,Draw model large carry source sport without paper.,23,robertson-gibson,2023,USD,693637,424073,269564,222948,46616,0,46616,6936,13872,32744,10701,438343,101599,336744,57803.08,693637,10.0,69.0,0.0438,1591,36.32,28738.85,0.37,0.3886
8865,Cook-Mann,False,EG,West Michellemouth,HealthTech,2011,https://cook-mann.com,Camera wide bad religious.,21,cook-mann,2023,USD,249798,113608,136190,234563,-98373,13434,-111807,2497,4995,-116802,15308,198280,56531,141749,20816.5,249798,10.0,41.95,0.0498,819,25.41,18118.77,0.84,0.5452
8866,Moss Ltd,False,ZA,Jasonside,Cybersecurity,2024,https://mossltd.com,Pass form month raise modern accept knowledge happen wonder.,18,moss-ltd,2023,USD,632932,261482,371450,303055,68395,0,68395,6329,12658,55737,25784,427983,162182,265801,,632932,1308.0,4282.59,0.0775,218,241.63,37294.99,0.69,0.5869
8867,Landry Inc,False,TN,West Steveport,SaaS,2009,https://landryinc.com,Republican staff star always decide cause thought.,18,landry-inc,2023,USD,6835115,3861611,2973504,2905956,67548,0,67548,68351,136702,-69154,114549,3539095,3185185,353910,569592.92,6835115,230.77,230.77,0.0259,36890,15.44,223586.6,0.51,0.435
8868,Andrews-Anderson,False,DE,Davisstad,HealthTech,2009,https://andrews-anderson.com,Indeed term suggest big though you never whole.,22,andrews-anderson,2023,EUR,585119,194494,390625,339915,50710,27760,22950,5851,11702,11248,256309,618212,211235,406977,48759.92,585119,536.33,2134.18,0.0533,2247,21.7,38293.31,6.69,0.6676
8869,Soto-Montgomery,False,ZA,Garciaburgh,EdTech,2011,https://soto-montgomery.com,They live eight street list although ahead safe bank human.,26,soto-montgomery,2023,USD,315182,126965,188217,223723,-35506,656,-36162,3151,6303,-42465,41201,204809,46093,158716,26265.17,315182,10.0,37.51,0.0711,275,95.18,23766.27,1.73,0.5972
8870,Krueger LLC,False,KE,South Alanstad,Mobility,2009,https://kruegerllc.com,Short author value plant share artist east son fear newspaper.,20,krueger-llc,2023,USD,7266810,4107908,3158902,3570934,-412032,0,-412032,72668,145336,-557368,466300,4270224,543643,3726581,,7266810,20.0,100.41,0.0604,1999,302.92,279363.94,1.67,0.4347
8871,Patton Green and Williams,False,FR,New Edward,Fintech,2016,https://pattongreenandwilliams.com,City between receive side prepare vote magazine get road live.,16,patton-green-and-williams,2023,EUR,683871,232245,451626,209227,242399,0,242399,6838,13677,228722,14338,485897,24294,461603,,683871,644.11,3099.08,0.0849,322,176.84,33989.53,0.42,0.6604
8872,Johnson-White,False,US,Jackburgh,SaaS,2014,https://johnson-white.com,Allow case raise lot father set class.,17,johnson-white,2023,USD,1159313,471328,687985,433773,254212,0,254212,11593,23186,231026,67223,781758,236968,544790,96609.42,1159313,338.7,1046.18,0.0343,2526,38.24,32598.56,2.06,0.5934
8873,Harding PLC,False,IN,North Glen,Mobility,2011,https://hardingplc.com,Next long these knowledge let.,21,harding-plc,2023,USD,868851,211006,657845,43442,614403,12436,601967,8688,17377,584590,9945,461475,96324,365151,,868851,20.0,33.02,0.0848,3620,20.0,19677.49,0.51,0.7571
8874,Brown Flores and Dickson,False,DE,Andersonmouth,Fintech,2023,https://brownfloresanddickson.com,Store represent window first oil would heavy back.,18,brown-flores-and-dickson,2023,EUR,622254,328733,293521,321167,-27646,8446,-36092,6222,12445,-48537,22482,431448,117533,313915,,622254,2061.84,9583.78,0.0275,345,149.99,77218.01,0.29,0.4717
8875,Thomas and Sons,False,ZA,New Michael,Fintech,2022,https://thomasandsons.com,Popular main clearly authority already want detail guess.,13,thomas-and-sons,2023,USD,1369322,782982,586340,472454,113886,0,113886,13693,27386,86500,19732,767998,691198,76800,,1369322,1000.91,3426.7,0.001,1350,84.51,34634.14,0.57,0.4282
8876,Mason Klein and Park,False,AU,Arnoldshire,Marketplaces,2021,https://masonkleinandpark.com,Similar strong write ready surface risk fill or trip.,27,mason-klein-and-park,2023,USD,608494,317178,291316,418554,-127238,1609,-128847,6084,12169,-141016,29356,477144,54922,422222,,608494,1140.52,5528.86,0.0278,558,90.82,11647.1,2.52,0.4787
8877,Sawyer and Sons,False,US,Garciaview,Cybersecurity,2011,https://sawyerandsons.com,Save degree idea them left young city mention serious.,17,sawyer-and-sons,2023,USD,1882937,585782,1297155,283142,1014013,0,1014013,18829,37658,976355,28810,1137491,573565,563926,,1882937,1544.56,772.28,0.0132,901,174.08,1000.0,28.81,0.6889
8878,Patterson Larsen and Martinez,False,BR,West Cynthia,Energy,2012,https://pattersonlarsenandmartinez.com,Do message visit Mr gun question.,17,patterson-larsen-and-martinez,2023,USD,3037124,661523,2375601,151856,2223745,0,2223745,30371,60742,2163003,12546,1677426,1173316,504110,,3037124,694.03,1654.86,0.0519,2565,98.64,1000.0,12.55,0.7822
8879,Taylor Group,False,AU,Port Wendy,E-commerce,2009,https://taylorgroup.com,Possible subject today live energy.,22,taylor-group,2023,USD,395944,124752,271192,354635,-83443,30719,-114162,3959,7918,-122080,9170,311414,135730,175684,,395944,20.0,81.52,0.0508,1649,20.0,35609.4,0.26,0.6849
8880,Ponce Ross and Doyle,False,ZA,Kennethport,AI/ML,2016,https://poncerossanddoyle.com,Let have sure walk their kitchen operation cold let kitchen.,13,ponce-ross-and-doyle,2023,USD,342820,92109,250711,103421,147290,0,147290,3428,6856,140434,41985,359080,17954,341126,,342820,20.0,10.0,0.0614,139,204.85,6090.79,6.89,0.7313
8881,Hawkins-Smith,False,FR,New Elizabethland,IoT,2017,https://hawkins-smith.com,Black news year call ten building everything sport have summer.,19,hawkins-smith,2023,EUR,1854908,494254,1360654,892862,467792,42188,425604,18549,37098,388506,197614,1235686,767138,468548,,1854908,20.0,27.52,0.0264,1782,86.72,32164.77,6.14,0.7335
8882,Higgins-Dawson,False,BR,Port Michael,Mobility,2024,https://higgins-dawson.com,No continue really knowledge building center ever.,15,higgins-dawson,2023,USD,2145889,519857,1626032,1293333,332699,7840,324859,21458,42917,281942,259371,1393779,780052,613727,,2145889,20.0,74.23,0.0634,8941,20.0,89152.69,2.91,0.7577
8883,Fleming-Larson,False,CA,Gabriellemouth,E-commerce,2008,https://fleming-larson.com,Scene call continue coach allow admit thus care.,20,fleming-larson,2023,USD,872020,340741,531279,659692,-128413,10774,-139187,8720,17440,-156627,47244,611146,37211,573935,,872020,1791.93,5032.18,0.0172,3633,20.0,70606.95,0.67,0.6093
8884,Ford-Garcia,False,BR,Cunninghamshire,Fintech,2010,https://ford-garcia.com,Free would writer traditional such.,16,ford-garcia,2023,USD,645852,359671,286181,355266,-69085,0,-69085,6458,12917,-82002,19475,495583,328493,167090,,645852,1313.95,5951.23,0.0279,221,242.8,30655.52,0.64,0.4431
8885,Montgomery Hawkins and Morrison,False,DE,New Deanna,Mobility,2018,https://montgomeryhawkinsandmorrison.com,Notice think size her green president involve.,20,montgomery-hawkins-and-morrison,2023,EUR,352578,134330,218248,156918,61330,0,61330,3525,7051,54279,31364,304423,112406,192017,,352578,105.62,371.59,0.1354,1469,20.0,28784.18,1.09,0.619
8886,Marshall-Simmons,False,DE,Michelleberg,E-commerce,2024,https://marshall-simmons.com,Coach rule single also computer design security eat increase also few.,25,marshall-simmons,2023,EUR,7755101,2614805,5140296,8340109,-3199813,17118,-3216931,77551,155102,-3372033,37009,4050852,1055337,2995515,,7755101,28.01,142.84,0.0081,7293,88.61,720015.26,0.05,0.6628
8887,Dalton Fitzgerald and Williams,False,GB,Masonton,Cybersecurity,2011,https://daltonfitzgeraldandwilliams.com,Send prevent area usually actually institution each.,30,dalton-fitzgerald-and-williams,2023,USD,1301391,260924,1040467,405965,634502,0,634502,13013,26027,608475,16362,792729,190682,602047,,1301391,20.0,69.85,0.0833,5422,20.0,37617.54,0.43,0.7995
8888,Little Blair and Johnson,False,US,East Emily,Mobility,2013,https://littleblairandjohnson.com,Beyond require much American soon town race must give prepare.,22,little-blair-and-johnson,2023,USD,165571,63666,101905,45250,56655,20387,36268,1655,3311,32957,6170,189857,9492,180365,,165571,20.0,106.88,0.0195,41,332.52,1000.0,6.17,0.6155
8889,Davis Martinez and Johnson,False,NG,South Dana,AI/ML,2022,https://davismartinezandjohnson.com,Dark everything perhaps upon none leg.,20,davis-martinez-and-johnson,2023,USD,1398110,199957,1198153,805358,392795,37946,354849,13981,27962,326887,117265,926909,473295,453614,,1398110,20.0,133.33,0.0764,4438,26.25,75470.32,1.55,0.857
8890,Collins Ltd,False,NG,Lake Robertmouth,Cybersecurity,2008,https://collinsltd.com,Enjoy degree maintain answer simply position even likely.,19,collins-ltd,2023,USD,670789,138737,532052,417480,114572,28184,86388,6707,13415,72973,19092,454133,146395,307738,,670789,1133.44,2645.92,0.0632,415,134.41,34507.69,0.55,0.7932
8891,Scott-Choi,False,EG,Christineside,HealthTech,2022,https://scott-choi.com,Lay speech partner pressure character executive source modern challenge.,15,scott-choi,2023,USD,561721,274095,287626,230149,57477,0,57477,5617,11234,46243,6853,303289,114031,189258,46810.08,561721,387.6,2126.6,0.0089,749,62.47,22054.15,0.31,0.512
8892,Schultz Coleman and Ramirez,False,KE,North Melissahaven,SaaS,2015,https://schultzcolemanandramirez.com,Whole sport outside face less.,28,schultz-coleman-and-ramirez,2023,USD,650884,245293,405591,399264,6327,241,6086,6508,13017,-6931,138945,520829,275034,245795,54240.33,650884,10.0,20.87,0.0328,2307,23.51,13578.87,10.23,0.6231
8893,Johnson-Lee,False,EG,North Debbie,Fintech,2021,https://johnson-lee.com,Mind suddenly local any size.,19,johnson-lee,2023,USD,4979899,2546654,2433245,1881183,552062,2556,549506,49798,99597,449909,895635,3389502,554537,2834965,,4979899,273.13,177.54,0.0538,2394,173.32,127895.81,7.0,0.4886
8894,Long Payne and Hill,False,FR,Sanchezview,Energy,2008,https://longpayneandhill.com,Individual wonder chair protect manage dream anything themselves may.,14,long-payne-and-hill,2023,EUR,6877703,2474241,4403462,1491311,2912151,13879,2898272,68777,137554,2760718,1248011,4794023,525763,4268260,,6877703,359.27,179.64,0.0151,8037,71.31,127799.22,9.77,0.6403
8895,Gibson-Williams,False,NG,Sherriborough,Cybersecurity,2024,https://gibson-williams.com,Available yet consumer effect participant price effect reduce must.,14,gibson-williams,2023,USD,1355855,392071,963784,707170,256614,16005,240609,13558,27117,213492,123469,831380,311906,519474,,1355855,698.2,2824.24,0.001,371,304.25,28968.39,4.26,0.7108
8896,Benson-Elliott,False,FR,Smithburgh,IoT,2023,https://benson-elliott.com,Need worry drive trouble teacher speech true true.,22,benson-elliott,2023,EUR,991034,400902,590132,656907,-66775,1979,-68754,9910,19820,-88574,45293,554752,186051,368701,,991034,542.24,2078.39,0.0364,636,129.84,64260.52,0.7,0.5955
8897,Harris Baker and Nicholson,False,GB,East Tylertown,HealthTech,2014,https://harrisbakerandnicholson.com,Economic present among international middle plan sound bag start change than.,23,harris-baker-and-nicholson,2023,USD,280305,88283,192022,190585,1437,0,1437,2803,5606,-4169,3618,327170,157407,169763,23358.75,280305,470.73,1878.61,0.0611,892,26.16,21462.08,0.17,0.685
8898,Garcia-Knight,False,BR,Christopherton,IoT,2020,https://garcia-knight.com,Past last push pass whatever reason hotel part.,20,garcia-knight,2023,USD,371635,150828,220807,89262,131545,0,131545,3716,7432,124113,76516,392507,288850,103657,,371635,591.3,4050.58,0.001,1548,20.0,1000.0,76.52,0.5942
8899,Johnson and Sons,False,IN,East Kristiland,Mobility,2023,https://johnsonandsons.com,Main big minute someone morning guy.,16,johnson-and-sons,2023,USD,1032115,540278,491837,347971,143866,0,143866,10321,20642,123224,117300,810995,415978,395017,,1032115,189.26,605.23,0.0458,1955,43.98,55939.65,2.1,0.4765
8900,Garcia LLC,False,AU,Changview,Fintech,2014,https://garciallc.com,Sister society agree former stop final find throw.,13,garcia-llc,2023,USD,2672276,802579,1869697,1442447,427250,22948,404302,26722,53445,350857,112958,1481326,146684,1334642,,2672276,2858.9,1429.45,0.0438,11134,20.0,129664.98,0.87,0.6997
8901,Garcia Moody and Bowen,False,EG,Ashleytown,E-commerce,2015,https://garciamoodyandbowen.com,Us close such technology card along skill player choose heavy.,23,garcia-moody-and-bowen,2023,USD,658566,299408,359158,291526,67632,6780,60852,6585,13171,47681,13186,411615,226409,185206,,658566,20.0,65.35,0.0747,522,105.11,14006.79,0.94,0.5454
8902,Wade-Briggs,False,US,Ortizshire,Mobility,2021,https://wade-briggs.com,Together analysis sort accept sound question room industry not.,19,wade-briggs,2023,USD,1949509,555551,1393958,255022,1138936,8362,1130574,19495,38990,1091584,86316,1170985,425330,745655,,1949509,139.63,361.14,0.001,627,258.81,2346.78,36.78,0.715
8903,Moore Mueller and Goodman,False,NG,New Amyburgh,Fintech,2008,https://mooremuellerandgoodman.com,Ok agent near marriage force modern management.,15,moore-mueller-and-goodman,2023,USD,1138657,393174,745483,678801,66682,24206,42476,11386,22773,19703,93674,775963,607772,168191,,1138657,1146.42,6173.63,0.001,320,296.15,49195.23,1.9,0.6547
8904,James Group,False,GB,Edwardsbury,AgriTech,2008,https://jamesgroup.com,Plan gas series ground worry effect.,14,james-group,2023,USD,221320,41314,180006,125837,54169,8782,45387,2213,4426,40961,7351,191180,20508,170672,,221320,782.61,2639.83,0.0011,922,20.0,1000.0,7.35,0.8133
8905,Scott-Smith,False,BR,Rileyton,Cybersecurity,2019,https://scott-smith.com,Term she avoid little move gas operation young.,12,scott-smith,2023,USD,672484,288190,384294,297535,86759,25393,61366,6724,13449,47917,60709,575381,28769,546612,,672484,20.0,62.8,0.0288,473,118.46,1000.0,60.71,0.5715
8906,Jones Young and Sparks,False,AU,Wilkinsfort,E-commerce,2022,https://jonesyoungandsparks.com,Yard right two technology gun discuss thousand.,22,jones-young-and-sparks,2023,USD,426901,182069,244832,223475,21357,1576,19781,4269,8538,11243,12701,234567,108582,125985,,426901,20.0,23.64,0.0473,342,103.72,1000.0,12.7,0.5735
8907,Hunter PLC,False,NG,Lake Juanshire,SaaS,2008,https://hunterplc.com,Guy key design offer many baby answer beautiful.,22,hunter-plc,2023,USD,821367,325222,496145,520570,-24425,0,-24425,8213,16427,-40852,45421,625848,168858,456990,68447.25,821367,10.0,49.46,0.0464,626,109.25,31553.19,1.44,0.604
8908,Patel Price and Becker,False,GB,Garciahaven,Marketplaces,2016,https://patelpriceandbecker.com,Success test camera explain special less stay officer.,11,patel-price-and-becker,2023,USD,364400,114678,249722,215689,34033,0,34033,3644,7288,26745,16444,325342,211040,114302,,364400,20.0,33.48,0.001,1518,20.0,1584.18,10.38,0.6853
8909,Vaughn-Ochoa,False,BR,Mooreport,AgriTech,2014,https://vaughn-ochoa.com,Production program happy near down thought nation issue.,22,vaughn-ochoa,2023,USD,227547,92065,135482,54581,80901,31842,49059,2275,4550,44509,1367,200878,95956,104922,,227547,1687.18,7933.74,0.0676,376,50.34,1925.04,0.71,0.5954
8910,Schmitt Inc,False,AU,East Bethany,HealthTech,2014,https://schmittinc.com,Election house mother would enough care threat peace.,16,schmitt-inc,2023,USD,1504626,382570,1122056,585616,536440,23789,512651,15046,30092,482559,180785,940731,131775,808956,125385.5,1504626,209.98,1264.88,0.0256,25077,5.0,52396.44,3.45,0.7457
8911,Frazier Prince and Oneill,False,TN,West Johnport,HealthTech,2013,https://frazierprinceandoneill.com,Above understand else reduce building including really year difficult never.,24,frazier-prince-and-oneill,2023,USD,532944,259349,273595,297243,-23648,8311,-31959,5329,10658,-42617,14885,289961,136549,153412,44412.0,532944,179.0,1111.22,0.0306,590,75.27,44077.32,0.34,0.5134
8912,Jones-Ward,False,FR,Stephanieton,Energy,2009,https://jones-ward.com,Speak to threat should trial everyone Republican occur onto claim.,30,jones-ward,2023,EUR,962077,302844,659233,627002,32231,0,32231,9620,19241,12990,92277,642880,315724,327156,,962077,21.97,86.87,0.1176,2918,27.47,66849.14,1.38,0.6852
8913,Williams-Taylor,False,AU,Phillipberg,Energy,2020,https://williams-taylor.com,Onto child risk source teach success situation during.,21,williams-taylor,2023,USD,953385,415573,537812,288842,248970,23649,225321,9533,19067,206254,97666,748620,249909,498711,,953385,569.48,284.74,0.1374,561,141.45,25715.12,3.8,0.5641
8914,Howell-Miller,False,NG,Heatherborough,E-commerce,2022,https://howell-miller.com,Serve ten follow meeting about indeed specific.,22,howell-miller,2023,USD,789656,116020,673636,623441,50195,14120,36075,7896,15793,20282,88604,582321,29116,553205,,789656,20.0,48.13,0.0235,3290,20.0,66196.08,1.34,0.8531
8915,Carlson-Hunter,False,IN,North Andrewmouth,Energy,2023,https://carlson-hunter.com,Sing these item energy order person.,19,carlson-hunter,2023,USD,1522429,470144,1052285,480336,571949,0,571949,15224,30448,541501,123014,893002,62766,830236,,1522429,20.0,60.22,0.0966,459,275.83,45724.1,2.69,0.6912
8916,Whitaker-Parker,False,US,West Ronald,Energy,2022,https://whitaker-parker.com,Rather experience indeed another attorney use myself happy inside ago local.,17,whitaker-parker,2023,USD,4056419,469992,3586427,2565872,1020555,4960,1015595,40564,81128,934467,116867,2333922,1244985,1088937,,4056419,20.0,54.28,0.0292,4044,83.57,211281.79,0.55,0.8841
8917,Kim PLC,False,BR,Halestad,Marketplaces,2019,https://kimplc.com,Walk power claim official board detail or soldier including.,21,kim-plc,2023,USD,855499,414414,441085,173477,267608,14870,252738,8554,17109,235629,34935,601460,224592,376868,,855499,561.66,2600.54,0.0663,479,148.58,1000.0,34.94,0.5156
8918,Morris Daniels and Thomas,False,FR,New Geraldview,Energy,2011,https://morrisdanielsandthomas.com,Together military why guy wind whatever.,16,morris-daniels-and-thomas,2023,EUR,3161482,685695,2475787,1828714,647073,11243,635830,31614,63229,572601,51584,1701632,862301,839331,,3161482,323.49,1664.6,0.001,9019,29.21,165936.0,0.31,0.7831
8919,Graham-Christensen,False,DE,Martinbury,IoT,2019,https://graham-christensen.com,Deep magazine avoid why sometimes plan authority account.,21,graham-christensen,2023,EUR,2057754,356352,1701402,606382,1095020,6517,1088503,20577,41155,1047348,976646,2090210,327653,1762557,,2057754,1120.57,5183.14,0.0093,1194,143.52,52726.16,18.52,0.8268
8920,Williams-Blackburn,False,ZA,North Carlosview,Cybersecurity,2012,https://williams-blackburn.com,Structure economy more effect share continue.,28,williams-blackburn,2023,USD,2226611,754151,1472460,1440092,32368,11074,21294,22266,44532,-23238,114457,1252164,539993,712171,,2226611,1036.74,4462.13,0.0684,9277,20.0,136946.65,0.84,0.6613
8921,Gonzalez Pham and Scott,False,FR,Lake Dennis,E-commerce,2009,https://gonzalezphamandscott.com,War several per trade project professor trip unit.,20,gonzalez-pham-and-scott,2023,EUR,1401311,450230,951081,812956,138125,0,138125,14013,28026,110099,24469,791653,281779,509874,,1401311,2009.04,3320.36,0.0946,873,133.69,80567.29,0.3,0.6787
8922,Gomez Watson and Gonzalez,False,ZA,Welchport,Fintech,2021,https://gomezwatsonandgonzalez.com,Program very our officer above site more child behavior.,24,gomez-watson-and-gonzalez,2023,USD,2111459,494093,1617366,330318,1287048,22590,1264458,21114,42229,1222229,29556,1134045,236354,897691,,2111459,1156.85,5009.62,0.0095,1257,139.91,52061.44,0.57,0.766
8923,Smith Nichols and Stephenson,False,IN,Wendymouth,HealthTech,2020,https://smithnicholsandstephenson.com,Author ask security letter college citizen sing live level its.,18,smith-nichols-and-stephenson,2023,USD,1603032,784191,818841,778533,40308,16493,23815,16030,32060,-8245,533417,1455586,72779,1382807,133586.0,1603032,693.95,2093.21,0.0504,6541,20.42,32632.01,16.35,0.5108
8924,Carter-Young,False,FR,Hughesmouth,SaaS,2023,https://carter-young.com,Take similar have identify movement.,22,carter-young,2023,EUR,1417503,196648,1220855,310981,909874,3409,906465,14175,28350,878115,178908,985656,242837,742819,118125.25,1417503,10.0,32.2,0.0226,4100,28.81,64476.97,2.77,0.8613
8925,Scott-Chavez,False,US,Kevinport,EdTech,2014,https://scott-chavez.com,Behind dark however buy look blood.,23,scott-chavez,2023,USD,1211492,92675,1118817,297167,821650,2812,818838,12114,24229,794609,69922,866174,43308,822866,100957.67,1211492,356.87,1425.59,0.0497,1817,55.56,18390.65,3.8,0.9235
8926,Wright James and Curry,False,CA,Bowmanshire,SaaS,2024,https://wrightjamesandcurry.com,Though dream opportunity site eight management team include movement.,25,wright-james-and-curry,2023,USD,894653,458904,435749,237572,198177,40449,157728,8946,17893,139835,300525,901136,211864,689272,74554.42,894653,10.0,32.74,0.0628,2130,35.0,7012.64,42.85,0.4871
8927,Obrien and Sons,False,AU,North Lisa,AgriTech,2013,https://obrienandsons.com,Today effort current something performance message.,15,obrien-and-sons,2023,USD,208623,89908,118715,84825,33890,0,33890,2086,4172,29718,16075,147557,7377,140180,,208623,331.05,2174.77,0.001,246,70.58,1000.0,16.08,0.569
8928,King Chang and Morales,False,IN,Kirkberg,EdTech,2011,https://kingchangandmorales.com,Leave yet budget data girl guess south decision southern thank.,19,king-chang-and-morales,2023,USD,183645,43871,139774,96745,43029,8631,34398,1836,3672,30726,31889,154987,73642,81345,15303.75,183645,267.47,1292.48,0.0344,184,82.9,5468.11,5.83,0.7611
8929,Ford Riley and Shields,False,KE,North Patriciaberg,AI/ML,2015,https://fordrileyandshields.com,Life born mission seven pretty ability room get bar stock consider.,13,ford-riley-and-shields,2023,USD,1599248,613398,985850,157383,828467,0,828467,15992,31984,796483,63848,989223,49461,939762,,1599248,110.8,606.29,0.0169,532,250.18,18576.01,3.44,0.6164
8930,Ward Ltd,False,KE,Barkertown,HealthTech,2017,https://wardltd.com,Edge we fire clear so police college watch race new manage.,24,ward-ltd,2023,USD,1006716,387678,619038,792968,-173930,0,-173930,10067,20134,-194064,28566,672514,149831,522683,83893.0,1006716,440.62,1747.05,0.0367,4900,17.12,112350.27,0.25,0.6149
8931,Jennings Lyons and Wong,False,NG,Jenniferview,AgriTech,2024,https://jenningslyonsandwong.com,Water town several ground gas artist.,22,jennings-lyons-and-wong,2023,USD,352439,175173,177266,17621,159645,0,159645,3524,7048,152597,31665,343169,123107,220062,,352439,20.0,73.89,0.0176,189,155.24,1000.0,31.66,0.503
8932,Johnson-Morris,False,FR,Franklinburgh,EdTech,2008,https://johnson-morris.com,Must black college continue hard cause least dog bit offer.,22,johnson-morris,2023,EUR,64195,14703,49492,23222,26270,16444,9826,641,1283,8543,11518,86816,35929,50887,5349.58,64195,249.33,440.29,0.0169,264,20.23,8196.95,1.41,0.771
8933,Conrad-George,False,US,Jennifershire,AgriTech,2011,https://conrad-george.com,None yet nearly project simple go prove allow.,23,conrad-george,2023,USD,696003,292639,403364,165152,238212,15603,222609,6960,13920,208689,15653,484171,111952,372219,,696003,20.0,125.02,0.0256,2900,20.0,41834.17,0.37,0.5795
8934,Cross-Buchanan,False,ZA,Brittanyberg,Energy,2010,https://cross-buchanan.com,Including direction home sing degree fact free during pretty start.,27,cross-buchanan,2023,USD,742254,257284,484970,458552,26418,29679,-3261,7422,14845,-18106,64299,576263,128005,448258,,742254,1264.52,1636.78,0.0744,2064,29.96,52613.59,1.22,0.6534
8935,Evans Ltd,False,US,Hendersonberg,E-commerce,2015,https://evansltd.com,Attack stock themselves population window so answer move majority.,17,evans-ltd,2023,USD,723266,469428,253838,806818,-552980,44818,-597798,7232,14465,-612263,73468,563410,231278,332132,,723266,20.0,83.41,0.0647,429,140.18,58751.24,1.25,0.351
8936,Zimmerman-Mitchell,False,US,Lake Tony,HealthTech,2011,https://zimmerman-mitchell.com,None language born positive meeting say seek decade follow.,20,zimmerman-mitchell,2023,USD,1129254,321999,807255,820425,-13170,0,-13170,11292,22585,-35755,39037,780852,80594,700258,94104.5,1129254,162.91,496.47,0.0496,2425,38.79,73953.1,0.53,0.7149
8937,Terrell-Ramirez,False,CA,Lake Mary,Fintech,2020,https://terrell-ramirez.com,Social reach attorney budget past find everything front own discover.,15,terrell-ramirez,2023,USD,364801,166602,198199,171366,26833,22571,4262,3648,7296,-3034,5779,196846,86671,110175,,364801,262.73,131.36,0.1329,539,56.35,1000.0,5.78,0.5433
8938,Vasquez Bullock and Ward,False,EG,Raventon,Cybersecurity,2019,https://vasquezbullockandward.com,Stuff set dark administration poor.,29,vasquez-bullock-and-ward,2023,USD,502930,193407,309523,361519,-51996,30497,-82493,5029,10058,-92551,9695,309360,15468,293892,,502930,20.0,42.66,0.0071,2095,20.0,14081.32,0.69,0.6154
8939,Wilson-Sweeney,False,AU,Ayerschester,Cybersecurity,2020,https://wilson-sweeney.com,Usually important rest always later reason arm commercial.,17,wilson-sweeney,2023,USD,1941532,552011,1389521,1315130,74391,27601,46790,19415,38830,7960,166214,1263110,81742,1181368,,1941532,473.61,869.98,0.1318,626,258.32,107389.08,1.55,0.7157
8940,Murray-Mitchell,False,ZA,Diazmouth,AgriTech,2020,https://murray-mitchell.com,Significant ever choice short someone interview camera sell such cell such.,29,murray-mitchell,2023,USD,125607,42051,83556,7076,76480,0,76480,1256,2512,73968,6986,198410,42763,155647,,125607,20.0,81.0,0.001,30,340.69,32028.05,0.22,0.6652
8941,Gonzalez Inc,False,ZA,Webbbury,EdTech,2015,https://gonzalezinc.com,Picture tough heart activity take buy such trade.,28,gonzalez-inc,2023,USD,348731,106329,242402,227112,15290,10621,4669,3487,6974,-2305,22632,272686,97928,174758,29060.92,348731,10.0,37.62,0.0166,350,82.98,5740.75,3.94,0.6951
8942,Price Group,False,BR,Andrewsmouth,IoT,2018,https://pricegroup.com,Employee man skin become admit wife thank good.,24,price-group,2023,USD,790830,255362,535468,520922,14546,15059,-513,7908,15816,-16329,159916,730223,36511,693712,,790830,1662.37,5707.21,0.0329,254,259.31,32287.35,4.95,0.6771
8943,Zamora Wood and Hall,False,DE,Sharonport,AgriTech,2010,https://zamorawoodandhall.com,War early fund everybody single baby.,18,zamora-wood-and-hall,2023,EUR,148818,12660,136158,90313,45845,35575,10270,1488,2976,7294,16530,194080,47295,146785,,148818,20.0,10.0,0.0424,131,94.31,1000.0,16.53,0.9149
8944,Miller Ltd,False,FR,Miguelborough,SaaS,2018,https://millerltd.com,Officer by sign floor property voice.,19,miller-ltd,2023,EUR,1980191,1044488,935703,776761,158942,9809,149133,19801,39603,109530,199244,1354257,695183,659074,165015.92,1980191,184.94,1059.56,0.0558,5119,32.23,64299.93,3.1,0.4725
8945,Rush Little and Fitzgerald,False,US,Osborneberg,Fintech,2016,https://rushlittleandfitzgerald.com,Capital spring president anyone huge.,18,rush-little-and-fitzgerald,2023,USD,985241,315521,669720,377369,292351,34962,257389,9852,19704,237685,78113,693565,238062,455503,,985241,20.0,64.39,0.0222,4105,20.0,27524.17,2.84,0.6798
8946,Briggs-Hernandez,False,EG,Lake Josephshire,Energy,2016,https://briggs-hernandez.com,Fast without myself lay threat management entire rate TV treat.,19,briggs-hernandez,2023,USD,1623358,369703,1253655,1087069,166586,42454,124132,16233,32467,91665,162590,1023150,457837,565313,,1623358,824.51,1624.54,0.0886,6763,20.0,100172.13,1.62,0.7723
8947,Oliver Inc,False,AU,Lake David,HealthTech,2023,https://oliverinc.com,Strategy natural east seven sure north good give hit.,23,oliver-inc,2023,USD,623876,306031,317845,157639,160206,21129,139077,6238,12477,126600,4804,325536,16276,309260,51989.67,623876,10.0,88.34,0.0761,2180,23.84,1000.0,4.8,0.5095
8948,Carlson-Berry,False,NG,East Jacobside,IoT,2021,https://carlson-berry.com,Ready drop car certain assume new focus story help.,24,carlson-berry,2023,USD,361093,67715,293378,197506,95872,52501,43371,3610,7221,36150,21723,289618,121939,167679,,361093,20.0,89.15,0.1305,1456,20.66,1962.35,11.07,0.8125
8949,Campbell Edwards and Macias,False,FR,Bellfurt,E-commerce,2023,https://campbelledwardsandmacias.com,Law mean person fast note image free represent wait.,23,campbell-edwards-and-macias,2023,EUR,1291377,740410,550967,669381,-118414,0,-118414,12913,25827,-144241,119004,928015,459265,468750,,1291377,453.06,226.53,0.0128,517,208.14,34643.02,3.44,0.4267
8950,Rangel Cook and Schwartz,False,DE,West Charlesshire,AI/ML,2018,https://rangelcookandschwartz.com,Buy church feeling sing should wait spend need during.,24,rangel-cook-and-schwartz,2023,EUR,1052321,366356,685965,447641,238324,18019,220305,10523,21046,199259,94422,668133,304253,363880,,1052321,20.0,10.0,0.0469,4384,20.0,29536.14,3.2,0.6519
8951,Johnson LLC,False,CA,Joshuafurt,Cybersecurity,2011,https://johnsonllc.com,Face major trouble into own join region.,17,johnson-llc,2023,USD,2414853,348780,2066073,255914,1810159,0,1810159,24148,48297,1761862,198572,1471793,400231,1071562,,2414853,121.63,380.8,0.1325,10061,20.0,9306.83,21.34,0.8556
8952,Bond and Sons,False,GB,Benjaminstad,AI/ML,2010,https://bondandsons.com,Hour indeed office bad public tend federal likely democratic remember.,14,bond-and-sons,2023,USD,3796173,1459960,2336213,189808,2146405,25555,2120850,37961,75923,2044927,46352,2131110,732283,1398827,,3796173,497.98,988.47,0.001,15817,20.0,9468.16,4.9,0.6154
8953,Bush Rowe and Rose,False,EG,Lake Vanessaberg,Mobility,2018,https://bushroweandrose.com,Result event student create drug include their open stock.,16,bush-rowe-and-rose,2023,USD,771897,326329,445568,159768,285800,0,285800,7718,15437,270363,21181,498369,200914,297455,,771897,1388.24,3291.07,0.0197,3216,20.0,9738.8,2.17,0.5772
8954,Perez-Walker,False,AU,Mcclureland,Fintech,2012,https://perez-walker.com,Time record them alone agreement vote run responsibility yard meeting.,24,perez-walker,2023,USD,1793779,530006,1263773,944466,319307,31146,288161,17937,35875,252286,340710,1261368,446124,815244,,1793779,20.0,10.0,0.0539,1157,129.19,86171.94,3.95,0.7045
8955,Holmes Torres and Freeman,False,DE,Lopezfurt,IoT,2019,https://holmestorresandfreeman.com,Adult near full learn never however baby mouth race base.,20,holmes-torres-and-freeman,2023,EUR,287617,116029,171588,46293,125295,44230,81065,2876,5752,75313,19950,309685,173263,136422,,287617,1492.13,11681.07,0.0683,91,261.75,1000.0,19.95,0.5966
8956,Juarez-Huynh,False,AU,Lake Douglas,IoT,2023,https://juarez-huynh.com,Data serious yes million prove spend modern listen subject allow.,22,juarez-huynh,2023,USD,427655,110892,316763,208052,108711,0,108711,4276,8553,100158,8985,338789,79316,259473,,427655,20.0,70.55,0.0595,105,336.77,40869.84,0.22,0.7407
8957,Welch Dean and Cisneros,False,NG,South Sheena,Fintech,2018,https://welchdeanandcisneros.com,Should have like father media early dream.,15,welch-dean-and-cisneros,2023,USD,1597921,588358,1009563,528844,480719,0,480719,15979,31958,448761,98722,992661,266508,726153,,1597921,356.46,708.0,0.0708,1226,108.58,27978.16,3.53,0.6318
8958,Sawyer-Frank,False,CA,New Michael,AgriTech,2012,https://sawyer-frank.com,Again arm reason Congress likely.,18,sawyer-frank,2023,USD,411013,150476,260537,212347,48190,19094,29096,4110,8220,20876,10418,235834,66034,169800,,411013,1488.5,8431.92,0.1078,1712,20.0,1000.0,10.42,0.6339
8959,Baker PLC,False,TN,North Thomasburgh,Marketplaces,2009,https://bakerplc.com,New fact trip city range design.,19,baker-plc,2023,USD,703220,261261,441959,454329,-12370,6780,-19150,7032,14064,-33214,41906,450270,96630,353640,,703220,294.94,855.85,0.0656,2930,20.0,49002.06,0.86,0.6285
8960,Braun LLC,False,AU,Martinezfort,Marketplaces,2022,https://braunllc.com,Your couple important rise positive.,16,braun-llc,2023,USD,376814,198489,178325,28571,149754,0,149754,3768,7536,142218,3438,342078,184308,157770,,376814,20.0,79.93,0.0215,563,55.69,1000.0,3.44,0.4732
8961,Hunt Cunningham and Ward,False,GB,North Alan,EdTech,2020,https://huntcunninghamandward.com,Security laugh piece data affect idea always.,20,hunt-cunningham-and-ward,2023,USD,182205,20201,162004,186260,-24256,0,-24256,1822,3644,-27900,7413,226236,60504,165732,15183.75,182205,10.0,13.76,0.001,297,51.09,31152.21,0.24,0.8891
8962,Johnson Brown and Diaz,False,US,Novakfort,HealthTech,2017,https://johnsonbrownanddiaz.com,Money happy show first create environmental range yard lead.,23,johnson-brown-and-diaz,2023,USD,212107,29229,182878,142817,40061,0,40061,2121,4242,35819,5491,189856,56482,133374,17675.58,212107,63.58,366.14,0.0245,198,88.94,1000.0,5.49,0.8622
8963,Vazquez-Parker,False,AU,Elliotthaven,AgriTech,2021,https://vazquez-parker.com,Past moment production score.,25,vazquez-parker,2023,USD,162510,55832,106678,68687,37991,0,37991,1625,3250,34741,3959,275537,94470,181067,,162510,1043.2,1565.84,0.065,127,105.83,1000.0,3.96,0.6564
8964,Davies Anderson and Barrett,False,AU,Wrightport,Cybersecurity,2019,https://daviesandersonandbarrett.com,History learn head much policy dark firm response us.,25,davies-anderson-and-barrett,2023,USD,5926651,2245655,3680996,593691,3087305,0,3087305,59266,118533,2968772,523612,3669668,402232,3267436,,5926651,20.0,55.29,0.0884,24694,20.0,100480.57,5.21,0.6211
8965,Lewis-Chavez,False,AU,Sharonview,AgriTech,2021,https://lewis-chavez.com,State conference TV decide arm economy in most give.,16,lewis-chavez,2023,USD,773118,347190,425928,317082,108846,0,108846,7731,15462,93384,6828,403028,74472,328556,,773118,1754.03,6735.93,0.1058,3121,20.64,10501.07,0.65,0.5509
8966,Thompson PLC,False,AU,East Jamesview,Mobility,2022,https://thompsonplc.com,Fast per its write whom focus professional stay.,22,thompson-plc,2023,USD,215172,44416,170756,76527,94229,8109,86120,2151,4303,81817,16869,244327,46152,198175,,215172,519.87,2488.44,0.0761,101,176.53,1000.0,16.87,0.7936
8967,Smith-Lopez,False,GB,South Heidi,SaaS,2019,https://smith-lopez.com,Important theory prevent end gun.,20,smith-lopez,2023,USD,541575,275038,266537,27078,239459,0,239459,5415,10831,228628,30962,433463,116978,316485,45131.25,541575,10.0,44.21,0.0106,1416,31.87,1000.0,30.96,0.4922
8968,Sellers LLC,False,FR,East Mitchelltown,Mobility,2011,https://sellersllc.com,How partner baby behavior drive above attention store.,12,sellers-llc,2023,EUR,1037530,590797,446733,229085,217648,36979,180669,10375,20750,159919,15049,558206,333656,224550,,1037530,764.28,2098.06,0.001,436,198.22,1000.0,15.05,0.4306
8969,Moore Hernandez and Walker,False,US,North Ricardomouth,Mobility,2014,https://moorehernandezandwalker.com,Military class space science debate have focus.,22,moore-hernandez-and-walker,2023,USD,354033,184317,169716,169377,339,18380,-18041,3540,7080,-25121,72332,282197,43373,238824,,354033,851.14,1557.72,0.0309,1475,20.0,32315.28,2.24,0.4794
8970,Turner Barry and Poole,False,US,Stephanieside,AI/ML,2022,https://turnerbarryandpoole.com,Apply manager little early away worker job.,29,turner-barry-and-poole,2023,USD,1898862,717412,1181450,94943,1086507,0,1086507,18988,37977,1048530,116455,1086513,287552,798961,,1898862,20.0,65.22,0.001,5172,30.59,1000.0,116.46,0.6222
8971,Salinas Ltd,False,FR,Turnerville,E-commerce,2020,https://salinasltd.com,Board response dream game affect design.,22,salinas-ltd,2023,EUR,220423,51939,168484,173176,-4692,3303,-7995,2204,4408,-12403,26420,192220,68500,123720,,220423,502.26,1613.51,0.001,236,77.68,44568.32,0.59,0.7644
8972,Terry Thompson and Ward,False,AU,Smithmouth,AgriTech,2023,https://terrythompsonandward.com,Maybe city free building message name develop perhaps.,14,terry-thompson-and-ward,2023,USD,716943,76360,640583,283634,356949,12752,344197,7169,14338,329859,97714,462646,332747,129899,,716943,1180.41,3951.28,0.0426,603,99.04,33327.02,2.93,0.8935
8973,Robinson Group,False,NG,Molinaville,Marketplaces,2015,https://robinsongroup.com,Else property former avoid stop call bad also.,17,robinson-group,2023,USD,209011,68930,140081,112281,27800,9077,18723,2090,4180,14543,5324,169181,57973,111208,,209011,666.62,645.13,0.0324,119,145.88,7874.12,0.68,0.6702
8974,Sanchez LLC,False,EG,Lake Debra,Marketplaces,2009,https://sanchezllc.com,Single media help recent age reach agreement.,27,sanchez-llc,2023,USD,788985,290807,498178,582834,-84656,35164,-119820,7889,15779,-135599,26401,494055,39803,454252,,788985,784.54,587.74,0.0789,3287,20.0,75022.31,0.35,0.6314
8975,Thompson-Brown,False,DE,West Faith,Fintech,2023,https://thompson-brown.com,Chance guy family soon result season soldier world middle fill.,20,thompson-brown,2023,EUR,80820,39165,41655,37180,4475,0,4475,808,1616,2859,10899,204797,39498,165299,,80820,143.08,130.6,0.0729,336,20.0,16652.62,0.65,0.5154
8976,Johnson-Yates,False,CA,East Margaret,AgriTech,2015,https://johnson-yates.com,Economic reason somebody brother art serious sell wife material.,20,johnson-yates,2023,USD,155694,58304,97390,120075,-22685,3428,-26113,1556,3113,-29226,6592,197652,111053,86599,,155694,20.0,35.38,0.0553,76,170.54,20334.0,0.32,0.6255
8977,Ware Washington and Garner,False,NG,Dustinport,SaaS,2013,https://warewashingtonandgarner.com,Though deep create customer course fear future class successful especially.,13,ware-washington-and-garner,2023,USD,153302,29984,123318,78212,45106,31320,13786,1533,3066,10720,37488,206838,91838,115000,12775.17,153302,10.0,10.0,0.0627,2555,5.0,14741.83,2.54,0.8044
8978,Walker Kennedy and White,False,EG,Allisonfurt,AgriTech,2010,https://walkerkennedyandwhite.com,Respond price light visit get policy people whole fast company.,20,walker-kennedy-and-white,2023,USD,230304,107323,122981,40661,82320,0,82320,2303,4606,77714,5496,217276,42546,174730,,230304,1598.87,7549.11,0.0802,959,20.0,1000.0,5.5,0.534
8979,Price-Hernandez,False,IN,New Saraberg,AI/ML,2018,https://price-hernandez.com,Bag pretty Democrat physical TV participant.,16,price-hernandez,2023,USD,417910,69123,348787,288786,60001,52764,7237,4179,8358,-1121,47722,326798,209786,117012,,417910,342.9,171.45,0.0061,706,49.27,13040.62,3.66,0.8346
8980,Smith-Herrera,False,ZA,North Jeffrey,Mobility,2013,https://smith-herrera.com,Whom ago beautiful role during century often wife stage then.,23,smith-herrera,2023,USD,290064,117037,173027,43492,129535,0,129535,2900,5801,123734,6838,174739,82494,92245,,290064,711.05,4359.81,0.0902,290,83.2,22687.47,0.3,0.5965
8981,Rice Inc,False,TN,Lynnbury,SaaS,2013,https://riceinc.com,Including accept receive season life upon life face world.,18,rice-inc,2023,USD,906333,340112,566221,549888,16333,0,16333,9063,18126,-1793,76236,670130,202107,468023,75527.75,906333,849.47,2327.86,0.0575,15105,5.0,66713.43,1.14,0.6247
8982,Miller Davis and Hensley,False,KE,South Craig,HealthTech,2018,https://millerdavisandhensley.com,Writer far can bit across.,18,miller-davis-and-hensley,2023,USD,1373189,682009,691180,68659,622521,3361,619160,13731,27463,591697,357121,1235225,604838,630387,114432.42,1373189,647.55,647.55,0.001,22886,5.0,7106.66,50.25,0.5033
8983,Palmer Joseph and White,False,IN,Lake Jonathan,Energy,2024,https://palmerjosephandwhite.com,Off civil blood rich we bill.,17,palmer-joseph-and-white,2023,USD,5419771,1060055,4359716,1362565,2997151,5129,2992022,54197,108395,2883627,795193,3536178,864897,2671281,,5419771,178.58,661.08,0.0806,1228,367.69,124969.57,6.36,0.8044
8984,Matthews-Miller,False,TN,Sandovalfurt,HealthTech,2022,https://matthews-miller.com,Couple let former computer tend entire cause effect.,17,matthews-miller,2023,USD,5286392,1247160,4039232,2227142,1812090,16726,1795364,52863,105727,1689637,738673,3382706,1232989,2149717,440532.67,5286392,547.32,1568.7,0.0621,7012,62.82,152449.34,4.85,0.7641
8985,Martinez Osborn and Barber,False,GB,Moonport,AI/ML,2024,https://martinezosbornandbarber.com,Life analysis nation suggest if daughter today majority next arrive.,25,martinez-osborn-and-barber,2023,USD,721741,313661,408080,500428,-92348,0,-92348,7217,14434,-106782,13384,464922,352202,112720,,721741,20.0,33.75,0.1148,3007,20.0,17331.52,0.77,0.5654
8986,Hayes-Williams,False,IN,Meyerton,SaaS,2022,https://hayes-williams.com,Including remember drive likely financial issue poor about simply off.,17,hayes-williams,2023,USD,720856,157741,563115,747071,-183956,0,-183956,7208,14417,-198373,381797,818044,40902,777142,60071.33,720856,178.82,273.79,0.0281,3000,20.02,62172.33,6.14,0.7812
8987,Stark PLC,False,TN,New Melissa,Energy,2016,https://starkplc.com,Authority most share song check.,23,stark-plc,2023,USD,1114636,534537,580099,548848,31251,12160,19091,11146,22292,-3201,117225,818109,40905,777204,,1114636,514.23,1075.36,0.0257,331,280.45,58468.23,2.0,0.5204
8988,Paul Hall and Shaw,False,GB,West Christyland,SaaS,2022,https://paulhallandshaw.com,Yeah daughter kid again yes protect simple.,22,paul-hall-and-shaw,2023,USD,258604,48945,209659,83543,126116,0,126116,2586,5172,120944,22160,208671,39050,169621,21550.33,258604,399.5,1609.3,0.001,207,103.8,1000.0,22.16,0.8107
8989,Anderson-Henry,False,BR,West Emilyton,Energy,2014,https://anderson-henry.com,Prepare and risk will possible husband plant.,16,anderson-henry,2023,USD,1066183,289308,776875,522665,254210,0,254210,10661,21323,232887,45589,685297,190628,494669,,1066183,1356.79,1117.06,0.074,1214,73.15,42290.35,1.08,0.7287
8990,Benitez Group,False,GB,North Jacqueline,Mobility,2010,https://benitezgroup.com,Similar enough soldier investment onto house cost.,23,benitez-group,2023,USD,3637088,1110902,2526186,1617671,908515,11424,897091,36370,72741,824350,445575,2355528,220075,2135453,,3637088,2327.91,2377.67,0.0284,3572,84.84,126667.05,3.52,0.6946
8991,White Jensen and Morris,False,ZA,Lake Brandonton,EdTech,2018,https://whitejensenandmorris.com,Idea purpose dog human either baby Democrat democratic once.,25,white-jensen-and-morris,2023,USD,182429,57827,124602,76617,47985,23807,24178,1824,3648,20530,3561,105024,53906,51118,15202.42,182429,10.0,33.69,0.001,3040,5.0,2037.46,1.75,0.683
8992,Davis Ltd,False,DE,Michaelburgh,Cybersecurity,2020,https://davisltd.com,Section executive note partner likely.,24,davis-ltd,2023,EUR,1653667,538691,1114976,943279,171697,0,171697,16536,33073,138624,11014,859183,180391,678792,,1653667,20.0,10.0,0.0433,714,192.84,93728.49,0.12,0.6742
8993,Lee Alexander and Cole,False,EG,Rebeccaburgh,Energy,2012,https://leealexanderandcole.com,Soon get meeting power reason might much miss decade bit.,22,lee-alexander-and-cole,2023,USD,1758504,648349,1110155,1528589,-418434,0,-418434,17585,35170,-453604,39933,1034701,92098,942603,,1758504,20.0,23.81,0.001,7327,20.0,111125.44,0.36,0.6313
8994,Lee Joseph and Robinson,False,CA,New Veronica,IoT,2012,https://leejosephandrobinson.com,Partner develop service discussion crime leave one provide develop.,16,lee-joseph-and-robinson,2023,USD,286924,92370,194554,14346,180208,7459,172749,2869,5738,167011,22032,296043,54198,241845,,286924,1121.59,4946.43,0.0987,148,160.72,1000.0,22.03,0.6781
8995,Vega Gray and Williams,False,DE,Brittanyview,AI/ML,2021,https://vegagrayandwilliams.com,Message store huge approach try attorney.,21,vega-gray-and-williams,2023,EUR,2801013,599972,2201041,1636276,564765,0,564765,28010,56020,508745,283351,1851918,827980,1023938,,2801013,20.0,131.06,0.0608,1737,134.33,161858.36,1.75,0.7858
8996,Williams Taylor and Elliott,False,ZA,Angelahaven,AI/ML,2023,https://williamstaylorandelliott.com,Rest notice trial history article per if long land.,15,williams-taylor-and-elliott,2023,USD,206304,58997,147307,102069,45238,27583,17655,2063,4126,13529,8846,176937,70025,106912,,206304,433.09,795.98,0.0248,49,347.74,2954.12,2.99,0.714
8997,Alexander Mccoy and Harris,False,KE,Lake Dennisview,SaaS,2021,https://alexandermccoyandharris.com,Above politics no test describe source ever.,13,alexander-mccoy-and-harris,2023,USD,1214559,280433,934126,804610,129516,18852,110664,12145,24291,86373,8346,766828,530636,236192,101213.25,1214559,148.29,165.52,0.0477,906,111.66,80917.78,0.1,0.7691
8998,Galloway Collins and Gordon,False,BR,Maldonadoport,Cybersecurity,2008,https://gallowaycollinsandgordon.com,White quite everything available ten floor decide walk far history.,22,galloway-collins-and-gordon,2023,USD,4252981,1089174,3163807,1594721,1569086,27195,1541891,42529,85059,1456832,1045543,3250833,862362,2388471,,4252981,501.78,1366.12,0.0846,2472,143.34,176129.16,5.94,0.7439
8999,Martinez-Richardson,False,AU,Port Chadport,AgriTech,2024,https://martinez-richardson.com,Up party voice else just positive describe.,29,martinez-richardson,2023,USD,320917,137591,183326,128360,54966,0,54966,3209,6418,48548,11834,287135,111656,175479,,320917,20.0,126.97,0.0805,141,188.87,8694.51,1.36,0.5713
9000,Sandoval Inc,False,NG,Port Johnborough,Energy,2015,https://sandovalinc.com,Loss little attack husband local necessary stay court PM.,19,sandoval-inc,2023,USD,979276,378373,600903,475136,125767,0,125767,9792,19585,106182,52050,676790,33839,642951,,979276,20.0,75.45,0.1114,4080,20.0,74536.86,0.7,0.6136
9001,Aguilar Bowers and Cortez,False,GB,Bakertown,SaaS,2018,https://aguilarbowersandcortez.com,Almost baby provide across leg who western rich important.,26,aguilar-bowers-and-cortez,2023,USD,697706,142983,554723,162982,391741,0,391741,6977,13954,377787,33613,416137,139576,276561,58142.17,697706,579.17,2302.41,0.0436,613,94.73,37054.34,0.91,0.7951
9002,Diaz-Wiggins,False,AU,Port Roberta,E-commerce,2015,https://diaz-wiggins.com,Moment join guy see work.,19,diaz-wiggins,2023,USD,547446,376444,171002,276916,-105914,4561,-110475,5474,10948,-121423,33000,385314,167547,217767,,547446,917.98,4320.04,0.0153,265,171.9,14554.74,2.27,0.3124
9003,Guzman Group,False,IN,Randallland,SaaS,2019,https://guzmangroup.com,Social consider wind decide leg stock gas cut tax where.,28,guzman-group,2023,USD,2789862,614804,2175058,1390522,784536,12070,772466,27898,55797,716669,118424,1706587,689137,1017450,232488.5,2789862,87.24,645.07,0.001,8652,26.87,129514.54,0.91,0.7796
9004,Kim and Sons,False,AU,Lake Michael,SaaS,2024,https://kimandsons.com,Magazine will need hospital.,12,kim-and-sons,2023,USD,528127,89515,438612,283168,155444,5790,149654,5281,10562,139092,39554,388227,153309,234918,44010.58,528127,587.51,587.51,0.0352,8802,5.0,29740.45,1.33,0.8305
9005,Gomez-Peters,False,KE,Wattsland,HealthTech,2023,https://gomez-peters.com,Month current near turn board movie.,15,gomez-peters,2023,USD,900048,381765,518283,253039,265244,0,265244,9000,18000,247244,14389,646542,32327,614215,75004.0,900048,526.91,1449.77,0.0132,1490,50.33,1000.0,14.39,0.5758
9006,Dunn-Malone,False,DE,West Amy,IoT,2021,https://dunn-malone.com,Message executive still cup all station worker.,25,dunn-malone,2023,EUR,259576,146481,113095,101183,11912,32467,-20555,2595,5191,-25746,5605,322247,120663,201584,,259576,20.0,57.89,0.0904,290,74.52,4203.29,1.33,0.4357
9007,Paul Schroeder and Allen,False,ZA,Cathychester,Fintech,2018,https://paulschroederandallen.com,About must artist than eight process tax nice.,16,paul-schroeder-and-allen,2023,USD,564524,368703,195821,128700,67121,33746,33375,5645,11290,22085,61893,396814,73435,323379,,564524,523.79,1391.29,0.0059,127,368.84,1000.0,61.89,0.3469
9008,Spencer-Ross,False,KE,North Stephentown,Mobility,2021,https://spencer-ross.com,Environment be establish she result position indeed relationship pick.,26,spencer-ross,2023,USD,9031340,4925177,4106163,1152321,2953842,5156,2948686,90313,180626,2768060,1940590,6525895,2103237,4422658,,9031340,995.64,4490.26,0.0597,20744,36.28,95758.78,20.27,0.4547
9009,Mcclure Contreras and Smith,False,IN,New Joanna,SaaS,2018,https://mcclurecontrerasandsmith.com,Church together give skin nothing.,14,mcclure-contreras-and-smith,2023,USD,871269,335480,535789,451695,84094,43672,40422,8712,17425,22997,178633,684432,118723,565709,72605.75,871269,85.07,538.18,0.001,777,93.39,5577.97,32.02,0.615
9010,Arnold PLC,False,DE,Kevinmouth,Marketplaces,2018,https://arnoldplc.com,Phone so expect unit choose.,20,arnold-plc,2023,EUR,4730189,236509,4493680,254723,4238957,0,4238957,47301,94603,4144354,51045,2498266,1935984,562282,,4730189,20.0,68.14,0.0491,1360,289.64,26693.39,1.91,0.95
9011,Cabrera-Brady,False,TN,Joshuaberg,Mobility,2009,https://cabrera-brady.com,Position beat free full hard perhaps popular.,20,cabrera-brady,2023,USD,1095287,143352,951935,441154,510781,18227,492554,10952,21905,470649,14738,722067,266935,455132,,1095287,1174.37,5561.78,0.0621,4520,20.19,46429.88,0.32,0.8691
9012,Wade Burns and Adkins,False,ZA,Fernandezport,Mobility,2024,https://wadeburnsandadkins.com,Lawyer agree participant north style how character.,15,wade-burns-and-adkins,2023,USD,766759,395133,371626,816520,-444894,0,-444894,7667,15335,-460229,60307,598546,231351,367195,,766759,639.69,4090.66,0.1603,3194,20.0,94674.03,0.64,0.4847
9013,Stokes Group,False,KE,East Danny,Mobility,2023,https://stokesgroup.com,Far position kitchen rule since explain trip vote.,21,stokes-group,2023,USD,531062,212741,318321,295581,22740,0,22740,5310,10621,12119,10882,278085,113000,165085,,531062,1519.28,10772.53,0.0576,365,121.22,44585.43,0.24,0.5994
9014,Anderson LLC,False,ZA,Lynntown,E-commerce,2019,https://andersonllc.com,Central recent record attorney how friend show only property paper control.,25,anderson-llc,2023,USD,334957,110646,224311,67845,156466,0,156466,3349,6699,149767,56959,294709,119771,174938,,334957,872.81,1633.09,0.0742,175,158.72,1000.0,56.96,0.6697
9015,Conway-Santos,False,IN,Fieldsberg,HealthTech,2021,https://conway-santos.com,Approach better day man door true.,19,conway-santos,2023,USD,651640,176774,474866,288139,186727,0,186727,6516,13032,173695,2112,370379,18518,351861,54303.33,651640,10.0,47.78,0.0181,1613,33.65,57341.66,0.04,0.7287
9016,Frost Dominguez and Bates,False,FR,North Rachelfort,IoT,2008,https://frostdominguezandbates.com,Know wrong could two clearly room situation defense generation.,18,frost-dominguez-and-bates,2023,EUR,359900,90553,269347,97239,172108,0,172108,3599,7198,164910,33495,303839,45045,258794,,359900,20.0,77.32,0.1011,1499,20.0,11916.64,2.81,0.7484
9017,Jones-Schaefer,False,DE,Lake Russell,AI/ML,2016,https://jones-schaefer.com,Institution sense single couple high particular born improve catch.,19,jones-schaefer,2023,EUR,4326824,2006025,2320799,2083106,237693,51494,186199,43268,86536,99663,61951,2347298,117577,2229721,,4326824,2503.37,1251.68,0.0816,6606,54.58,122979.19,0.5,0.5364
9018,Bolton Anderson and Allen,False,GB,Jacquelinestad,HealthTech,2023,https://boltonandersonandallen.com,Reduce style recent fall pretty.,24,bolton-anderson-and-allen,2023,USD,2565408,983414,1581994,539061,1042933,16821,1026112,25654,51308,974804,61286,1344418,710115,634303,213784.0,2565408,410.47,1658.81,0.001,20054,10.66,56401.36,1.09,0.6167
9019,Blair-Lee,False,DE,East Elizabeth,Energy,2012,https://blair-lee.com,Stock prepare full especially size present sure budget space.,20,blair-lee,2023,EUR,401218,178115,223103,93390,129713,4843,124870,4012,8024,116846,47771,320018,31494,288524,,401218,685.91,691.71,0.0575,662,50.49,1000.0,47.77,0.5561
9020,Cox-Johnson,False,EG,Kennedyville,Cybersecurity,2014,https://cox-johnson.com,Quickly certain third make manage color throw prove well.,17,cox-johnson,2023,USD,1469753,271108,1198645,269120,929525,0,929525,14697,29395,900130,46492,786601,251832,534769,,1469753,1340.3,2294.04,0.001,3033,40.38,1000.0,46.49,0.8155
9021,Palmer LLC,False,GB,Hallview,SaaS,2013,https://palmerllc.com,Nature apply lose less hundred consider.,22,palmer-llc,2023,USD,481284,163515,317769,107407,210362,0,210362,4812,9625,200737,122246,390574,225010,165564,40107.0,481284,10.0,42.96,0.0314,814,49.24,6141.15,19.91,0.6603
9022,Hobbs Group,False,GB,East Michael,Marketplaces,2012,https://hobbsgroup.com,Respond old result could why medical pay far smile throughout wide.,18,hobbs-group,2023,USD,292451,125120,167331,162618,4713,0,4713,2924,5849,-1136,37312,346604,165662,180942,,292451,145.3,72.65,0.0703,812,30.01,41478.31,0.9,0.5722
9023,Hunter-Thornton,False,EG,North Caseymouth,Fintech,2011,https://hunter-thornton.com,Reality worry life compare conference hotel.,19,hunter-thornton,2023,USD,24643263,9678268,14964995,16327965,-1362970,0,-1362970,246432,492865,-1855835,1433213,13792063,8140929,5651134,,24643263,524.07,917.99,0.0578,102680,20.0,1363900.52,1.05,0.6073
9024,Kidd Vasquez and Clay,False,AU,North Davidton,Fintech,2022,https://kiddvasquezandclay.com,Benefit paper fill specific oil as.,12,kidd-vasquez-and-clay,2023,USD,713057,206648,506409,374713,131696,16973,114723,7130,14261,100462,37220,401473,143575,257898,,713057,20.0,104.52,0.0961,315,188.1,2751.05,13.53,0.7102
9025,Mcdaniel Soto and Wolf,False,CA,New William,Marketplaces,2023,https://mcdanielsotoandwolf.com,Many cause view without cultural.,16,mcdaniel-soto-and-wolf,2023,USD,942512,415805,526707,551426,-24719,31229,-55948,9425,18850,-74798,22910,504727,229691,275036,,942512,1057.99,529.0,0.1111,489,160.37,44453.75,0.52,0.5588
9026,Price-Cochran,False,TN,Harrismouth,IoT,2011,https://price-cochran.com,Seat morning form might international.,16,price-cochran,2023,USD,2878348,1199802,1678546,2002835,-324289,4764,-329053,28783,57566,-386619,72568,1607902,560684,1047218,,2878348,57.1,105.92,0.0156,3406,70.42,155885.9,0.47,0.5832
9027,Griffin-Brown,False,EG,Rojasland,Fintech,2021,https://griffin-brown.com,Owner paper rise also recognize skill.,20,griffin-brown,2023,USD,6935138,3653585,3281553,2314900,966653,12805,953848,69351,138702,815146,413140,4023235,1491199,2532036,,6935138,916.62,6167.05,0.105,3959,145.96,170476.47,2.42,0.4732
9028,Morales Hardin and Brady,False,GB,Linview,SaaS,2017,https://moraleshardinandbrady.com,Choice capital describe behavior.,16,morales-hardin-and-brady,2023,USD,962252,308057,654195,788687,-134492,0,-134492,9622,19245,-153737,24793,661635,128054,533581,80187.67,962252,435.7,3223.64,0.001,706,113.42,68738.3,0.36,0.6799
9029,Johnson-Johnson,False,GB,North Christopher,IoT,2019,https://johnson-johnson.com,Near small ball song at west gun price method voice.,19,johnson-johnson,2023,USD,522584,143608,378976,89254,289722,0,289722,5225,10451,279271,9499,417236,38125,379111,,522584,20.0,97.77,0.0867,261,166.39,1000.0,9.5,0.7252
9030,Porter-Sherman,False,FR,Walkermouth,AgriTech,2016,https://porter-sherman.com,Indicate media general history suddenly ready.,19,porter-sherman,2023,EUR,265657,130187,135470,154930,-19460,0,-19460,2656,5313,-24773,35498,361576,24572,337004,,265657,1827.22,4692.85,0.0569,54,409.5,16988.14,2.09,0.5099
9031,Brown-Miller,False,NG,Mccannburgh,Energy,2015,https://brown-miller.com,Space six growth stop program first.,20,brown-miller,2023,USD,2016274,787289,1228985,1262259,-33274,0,-33274,20162,40325,-73599,23310,1204174,490175,713999,,2016274,542.99,1778.59,0.001,1147,146.37,94465.02,0.25,0.6095
9032,Koch-Jensen,False,US,Port Jennifermouth,E-commerce,2013,https://koch-jensen.com,Eat always a late quality laugh.,22,koch-jensen,2023,USD,4581291,1860883,2720408,2810473,-90065,0,-90065,45812,91625,-181690,138355,2523166,980985,1542181,,4581291,20.0,31.26,0.0127,1541,247.61,225552.24,0.61,0.5938
9033,Cortez-Pena,False,FR,South Johnnyport,Energy,2008,https://cortez-pena.com,Impact contain box performance central half.,21,cortez-pena,2023,EUR,2737667,901870,1835797,1266203,569594,26928,542666,27376,54753,487913,189188,1636973,162607,1474366,,2737667,20.0,52.99,0.1654,6422,35.52,85376.22,2.22,0.6706
9034,Moran Vega and Martinez,False,DE,Williamsontown,IoT,2013,https://moranvegaandmartinez.com,Southern couple bill court represent approach set.,19,moran-vega-and-martinez,2023,EUR,599914,168231,431683,315483,116200,4466,111734,5999,11998,99736,147125,500016,25000,475016,,599914,888.19,1973.07,0.0128,599,83.4,15038.5,9.78,0.7196
9035,Malone Group,False,GB,Parkshaven,SaaS,2013,https://malonegroup.com,Building but trade begin between newspaper imagine nothing force.,25,malone-group,2023,USD,731139,317241,413898,36556,377342,19654,357688,7311,14622,343066,22305,407086,218383,188703,60928.25,731139,37.45,88.63,0.001,859,70.86,1000.0,22.3,0.5661
9036,Jenkins Hunter and Jones,False,ZA,Peggybury,Energy,2008,https://jenkinshunterandjones.com,Use understand so probably direction yard either.,19,jenkins-hunter-and-jones,2023,USD,1397620,246648,1150972,726014,424958,21034,403924,13976,27952,375972,176087,981400,207270,774130,,1397620,149.19,74.6,0.001,5823,20.0,73444.89,2.4,0.8235
9037,Howell Pacheco and Joseph,False,FR,Vazquezbury,AgriTech,2013,https://howellpachecoandjoseph.com,Call position be prepare which soon threat.,18,howell-pacheco-and-joseph,2023,EUR,150234,58576,91658,18485,73173,0,73173,1502,3004,70169,10536,219354,65377,153977,,150234,134.14,618.75,0.001,402,31.14,1000.0,10.54,0.6101
9038,Cortez Arnold and Rogers,False,BR,Port Michael,Energy,2016,https://cortezarnoldandrogers.com,Affect end surface task administration.,23,cortez-arnold-and-rogers,2023,USD,4762087,1293956,3468131,2117981,1350150,21373,1328777,47620,95241,1233536,305244,2744231,1071028,1673203,,4762087,2011.48,4180.55,0.065,2576,154.02,187770.53,1.63,0.7283
9039,Thompson Miller and Moore,False,EG,New Ashley,Fintech,2009,https://thompsonmillerandmoore.com,Pm less news future education evidence develop.,23,thompson-miller-and-moore,2023,USD,1732350,395137,1337213,964858,372355,27064,345291,17323,34647,310644,222837,1207011,60350,1146661,,1732350,20.0,45.76,0.0468,741,194.73,87805.07,2.54,0.7719
9040,Wright-Reed,False,TN,East Judith,AI/ML,2008,https://wright-reed.com,Right so then bag help find turn they nearly.,14,wright-reed,2023,USD,3389392,1440796,1948596,1107223,841373,1192,840181,33893,67787,772394,849688,2715133,1583663,1131470,,3389392,20.0,60.95,0.0598,9679,29.18,102679.82,8.28,0.5749
9041,Coleman PLC,False,FR,Jessemouth,Mobility,2022,https://colemanplc.com,Spend condition cause value.,30,coleman-plc,2023,EUR,460139,184257,275882,236661,39221,0,39221,4601,9202,30019,19824,332909,16645,316264,,460139,838.04,2397.52,0.1378,225,169.71,17264.71,1.15,0.5996
9042,Estrada Inc,False,AU,Lake John,SaaS,2014,https://estradainc.com,Movie believe pressure back prevent.,19,estrada-inc,2023,USD,1819023,398127,1420896,90951,1329945,13938,1316007,18190,36380,1279627,93187,1067558,599116,468442,151585.25,1819023,96.99,362.44,0.0625,1880,80.63,1000.0,93.19,0.7811
9043,Wagner PLC,False,AU,Wrightmouth,Fintech,2020,https://wagnerplc.com,Along they fast wide often.,27,wagner-plc,2023,USD,2830086,955452,1874634,2694227,-819593,7815,-827408,28300,56601,-884009,38537,1523534,871277,652257,,2830086,20.0,10.0,0.0758,1508,156.3,195466.94,0.2,0.6624
9044,Lara-Smith,False,DE,New Jeffreyton,Mobility,2009,https://lara-smith.com,Song front think how eat three character morning argue beat.,18,lara-smith,2023,EUR,357390,103662,253728,98840,154888,14865,140023,3573,7147,132876,13876,272105,13605,258500,,357390,2209.15,3280.18,0.0577,208,142.65,1000.0,13.88,0.7099
9045,Reid King and Barker,False,CA,South Tommychester,Marketplaces,2008,https://reidkingandbarker.com,Continue strong these role I.,17,reid-king-and-barker,2023,USD,271422,74737,196685,43455,153230,0,153230,2714,5428,147802,37747,207492,120203,87289,,271422,1855.1,8464.24,0.0015,152,148.44,1000.0,37.75,0.7246
9046,Rivers Jarvis and Haas,False,US,Kristinastad,AgriTech,2014,https://riversjarvisandhaas.com,Actually last unit sense fact large morning.,16,rivers-jarvis-and-haas,2023,USD,1515096,374369,1140727,669708,471019,27622,443397,15150,30301,413096,30395,852703,336155,516548,,1515096,20.0,94.96,0.0959,568,222.07,65109.51,0.47,0.7529
9047,Davis PLC,False,DE,Lake Laura,HealthTech,2021,https://davisplc.com,Car yeah drug official at price rock rich sense growth hear.,22,davis-plc,2023,EUR,838639,291198,547441,191194,356247,19797,336450,8386,16772,319678,6050,452731,102601,350130,69886.58,838639,282.79,1186.85,0.001,1292,54.08,8283.44,0.73,0.6528
9048,Clements-Lee,False,EG,East Emily,HealthTech,2016,https://clements-lee.com,Begin answer health spring ask sound office main eight.,16,clements-lee,2023,USD,5728042,2276506,3451536,4290982,-839446,0,-839446,57280,114560,-954006,189009,3105069,276119,2828950,477336.83,5728042,456.5,695.78,0.0143,9992,47.77,345412.96,0.55,0.6026
9049,White Tyler and Johnson,False,IN,New Johntown,Energy,2015,https://whitetylerandjohnson.com,Politics maintain same relate similar because newspaper low lay.,24,white-tyler-and-johnson,2023,USD,1605770,446863,1158907,331109,827798,0,827798,16057,32115,795683,53652,980216,261364,718852,,1605770,208.43,576.37,0.001,4034,33.17,22033.21,2.44,0.7217
9050,Lewis-Holloway,False,FR,New Kristin,Mobility,2013,https://lewis-holloway.com,Television trip Republican we do.,22,lewis-holloway,2023,EUR,145498,73886,71612,60006,11606,9795,1811,1454,2909,-1098,14803,208340,71854,136486,,145498,1619.56,6506.04,0.0679,35,342.05,16479.96,0.9,0.4922
9051,Price-Jones,False,KE,Evanmouth,AgriTech,2022,https://price-jones.com,Month happen determine not citizen individual provide boy.,23,price-jones,2023,USD,315975,138204,177771,164863,12908,1669,11239,3159,6319,4920,13249,208861,137676,71185,,315975,1642.72,12459.89,0.1347,109,240.02,6290.9,2.11,0.5626
9052,Chandler LLC,False,TN,North Lindaview,EdTech,2008,https://chandlerllc.com,Whole price five home front herself manage president do identify.,23,chandler-llc,2023,USD,346770,87222,259548,201833,57715,0,57715,3467,6935,50780,20893,299776,103354,196422,28897.5,346770,339.14,1451.74,0.0533,2835,10.19,39488.41,0.53,0.7485
9053,Davis Ltd,False,NG,Fostermouth,EdTech,2009,https://davisltd.com,Strong stop crime along fall eye candidate whatever really.,22,davis-ltd,2023,USD,837867,495249,342618,41893,300725,24633,276092,8378,16757,259335,41974,543774,156860,386914,69822.25,837867,113.42,578.82,0.0479,4708,14.83,1000.0,41.97,0.4089
9054,Harrington Reese and Barnett,False,ZA,Jakeland,Energy,2018,https://harringtonreeseandbarnett.com,Foot morning goal which range specific side soldier religious region.,17,harrington-reese-and-barnett,2023,USD,1888405,792325,1096080,751076,345004,0,345004,18884,37768,307236,25587,1031090,152045,879045,,1888405,20.0,66.77,0.0999,800,196.66,87916.48,0.29,0.5804
9055,Henderson-Simon,False,IN,Chelseaburgh,SaaS,2013,https://henderson-simon.com,Democrat meet want site benefit clearly where court agency.,19,henderson-simon,2023,USD,1996282,991098,1005184,871517,133667,0,133667,19962,39925,93742,222429,1343891,517104,826787,166356.83,1996282,18.33,77.91,0.001,3500,47.53,74724.75,2.98,0.5035
9056,Bryant Scott and Hamilton,False,CA,Lyonsfurt,IoT,2018,https://bryantscottandhamilton.com,Government yet whether station goal ever hand try move drive.,18,bryant-scott-and-hamilton,2023,USD,844308,419325,424983,81139,343844,16872,326972,8443,16886,310086,40983,467450,167315,300135,,844308,20.0,59.8,0.0472,278,252.94,1000.0,40.98,0.5034
9057,Hopkins-Gay,False,FR,Angelicachester,Cybersecurity,2015,https://hopkins-gay.com,Necessary watch however single happy where.,12,hopkins-gay,2023,EUR,2227207,432428,1794779,140550,1654229,0,1654229,22272,44544,1609685,119016,1425514,624729,800785,,2227207,20.0,36.0,0.0043,1195,155.21,20113.38,5.92,0.8058
9058,Graves Wells and Clark,False,ZA,South Dannystad,IoT,2015,https://graveswellsandclark.com,Sort drug lawyer upon example director become southern often from.,17,graves-wells-and-clark,2023,USD,907081,218794,688287,360737,327550,1219,326331,9070,18141,308190,51415,587390,223848,363542,,907081,20.0,188.9,0.0237,3779,20.0,30055.56,1.71,0.7588
9059,Obrien Cowan and Nash,False,GB,Sandramouth,Mobility,2013,https://obriencowanandnash.com,Right area statement us voice administration indicate.,22,obrien-cowan-and-nash,2023,USD,572255,245312,326943,435608,-108665,0,-108665,5722,11445,-120110,94382,428779,206126,222653,,572255,706.86,2418.55,0.0447,2384,20.0,14952.76,6.31,0.5713
9060,Garcia and Sons,False,AU,Riveramouth,Mobility,2013,https://garciaandsons.com,Ground security direction give life.,23,garcia-and-sons,2023,USD,2634009,844523,1789486,1630392,159094,33531,125563,26340,52680,72883,718353,2049543,802886,1246657,,2634009,1674.8,2726.88,0.1133,649,338.16,116748.84,6.15,0.6794
9061,Lucas-Johnston,False,NG,North Victoriaton,Fintech,2013,https://lucas-johnston.com,Catch recently final force woman person minute.,23,lucas-johnston,2023,USD,472822,122034,350788,181481,169307,9385,159922,4728,9456,150466,20176,359261,102519,256742,,472822,434.27,1513.31,0.0268,358,110.05,21851.36,0.92,0.7419
9062,Valentine Vaughn and Lane,False,KE,Lake Joann,Fintech,2020,https://valentinevaughnandlane.com,Service born you rule item week let must beat her have.,20,valentine-vaughn-and-lane,2023,USD,1513170,735968,777202,288094,489108,30117,458991,15131,30263,428728,142973,937212,338149,599063,,1513170,1571.76,2810.16,0.1016,1372,91.87,47813.44,2.99,0.5136
9063,Parker and Sons,False,DE,Adrianaborough,E-commerce,2009,https://parkerandsons.com,Candidate relationship support event model since side.,19,parker-and-sons,2023,EUR,1368196,684040,684156,625723,58433,13500,44933,13681,27363,17570,22564,764565,201176,563389,,1368196,20.0,129.41,0.0535,909,125.37,52212.58,0.43,0.5
9064,Hernandez PLC,False,IN,New Lisaport,IoT,2021,https://hernandezplc.com,Question doctor record very talk man.,18,hernandez-plc,2023,USD,1019902,309720,710182,256049,454133,0,454133,10199,20398,433735,49607,708511,316526,391985,,1019902,1059.04,3190.54,0.0317,881,96.42,10726.06,4.62,0.6963
9065,Kelley Ltd,False,US,Port Gary,HealthTech,2021,https://kelleyltd.com,Lot start almost between.,20,kelley-ltd,2023,USD,258052,108495,149557,162165,-12608,0,-12608,2580,5161,-17769,28504,291474,126466,165008,21504.33,258052,651.49,3536.81,0.0199,400,53.74,35990.61,0.79,0.5796
9066,Goodman Inc,False,ZA,Martinezshire,Energy,2022,https://goodmaninc.com,Education experience price space this begin network character son.,21,goodman-inc,2023,USD,5578658,2312066,3266592,2724883,541709,17690,524019,55786,111573,412446,252127,3087765,1368849,1718916,,5578658,650.54,3299.81,0.001,6144,75.66,222946.1,1.13,0.5856
9067,Taylor Ochoa and Hatfield,False,TN,Baxterside,Marketplaces,2018,https://taylorochoaandhatfield.com,So design resource yourself key.,20,taylor-ochoa-and-hatfield,2023,USD,411406,175020,236386,279793,-43407,1670,-45077,4114,8228,-53305,56648,354785,155967,198818,,411406,20.0,71.71,0.001,188,182.13,22144.81,2.56,0.5746
9068,Ferguson-Rodriguez,False,GB,Port Sallyfurt,Mobility,2013,https://ferguson-rodriguez.com,Probably parent medical significant read world feel region.,21,ferguson-rodriguez,2023,USD,1553371,846130,707241,1206899,-499658,27467,-527125,15533,31067,-558192,542281,1373301,445593,927708,,1553371,438.87,736.95,0.0411,495,261.35,135872.85,3.99,0.4553
9069,Perez Espinoza and Nguyen,False,NG,South Kristybury,Marketplaces,2017,https://perezespinozaandnguyen.com,Rich woman hold truth front well eye thing.,19,perez-espinoza-and-nguyen,2023,USD,1579884,552912,1026972,1334299,-307327,0,-307327,15798,31597,-338924,118535,1091177,695610,395567,,1579884,1226.35,2098.4,0.0507,6582,20.0,142835.56,0.83,0.65
9070,Mcguire and Sons,False,CA,Billyburgh,EdTech,2023,https://mcguireandsons.com,Mind mind class hand fine.,25,mcguire-and-sons,2023,USD,413186,225406,187780,107635,80145,3364,76781,4131,8263,68518,6469,289244,111091,178153,34432.17,413186,10.0,43.2,0.0553,855,40.24,18220.2,0.36,0.4545
9071,Evans Ltd,False,IN,Bridgetberg,IoT,2019,https://evansltd.com,Everybody simple set inside enough property east camera loss move.,19,evans-ltd,2023,USD,1284859,658984,625875,576060,49815,0,49815,12848,25697,24118,29760,747840,142049,605791,,1284859,2176.24,11005.25,0.0889,5353,20.0,56043.67,0.53,0.4871
9072,Frazier Ltd,False,US,East Justinmouth,Mobility,2008,https://frazierltd.com,Recent instead future who wife.,17,frazier-ltd,2023,USD,995311,194949,800362,242458,557904,226,557678,9953,19906,537772,120636,713158,306969,406189,,995311,20.0,53.59,0.01,4147,20.0,36770.48,3.28,0.8041
9073,Brock Group,False,NG,Fergusontown,AI/ML,2021,https://brockgroup.com,Him form instead place hard possible business.,13,brock-group,2023,USD,771996,318059,453937,570026,-116089,18221,-134310,7719,15439,-149749,66588,532132,356145,175987,,771996,20.0,45.98,0.0685,517,124.25,26385.01,2.52,0.588
9074,Barnett-Bautista,False,IN,Walkerland,SaaS,2021,https://barnett-bautista.com,With degree clearly light newspaper assume tell mention large.,33,barnett-bautista,2023,USD,9584494,2164315,7420179,7326595,93584,4339,89245,95844,191689,-102444,228023,5219196,934342,4284854,798707.83,9584494,10.0,24.92,0.0435,10775,74.12,638654.53,0.36,0.7742
9075,Martinez Inc,False,ZA,Port Brianna,Mobility,2019,https://martinezinc.com,Capital skill particularly teach practice way line participant choose.,15,martinez-inc,2023,USD,2952552,1136789,1815763,1182528,633235,499,632736,29525,59051,573685,220167,1890203,826986,1063217,,2952552,816.36,2892.03,0.0278,2471,99.55,97863.91,2.25,0.615
9076,Schwartz Group,False,AU,Singhtown,Energy,2008,https://schwartzgroup.com,Lay song themselves continue reach authority store offer level soldier.,24,schwartz-group,2023,USD,3502719,1109373,2393346,1417653,975693,46307,929386,35027,70054,859332,42219,1843711,1014004,829707,,3502719,1620.0,1902.3,0.0463,7821,37.32,115725.44,0.36,0.6833
9077,Espinoza Hoover and Baker,False,GB,Leblancbury,SaaS,2008,https://espinozahooverandbaker.com,Travel far political yet modern thank language wall.,23,espinoza-hoover-and-baker,2023,USD,450953,158637,292316,226350,65966,4166,61800,4509,9019,52781,24296,397292,19864,377428,37579.42,450953,212.38,561.13,0.0211,484,77.5,34391.7,0.71,0.6482
9078,Baker-Thomas,False,BR,Port Natashaburgh,Cybersecurity,2011,https://baker-thomas.com,Last decade morning since argue business.,18,baker-thomas,2023,USD,831106,282802,548304,669556,-121252,11809,-133061,8311,16622,-149683,168871,678171,384055,294116,,831106,819.0,519.85,0.061,284,243.29,54425.18,3.1,0.6597
9079,Case Patel and Page,False,KE,Port Lindsey,HealthTech,2009,https://casepatelandpage.com,Rise same debate fish trade father social either.,23,case-patel-and-page,2023,USD,633360,127165,506195,290799,215396,782,214614,6333,12667,201947,12751,489105,165335,323770,52780.0,633360,269.31,1411.43,0.0324,778,67.82,7193.76,1.77,0.7992
9080,Turner-Myers,False,GB,Kelseymouth,HealthTech,2010,https://turner-myers.com,Any professor poor act store stage whole wind although.,24,turner-myers,2023,USD,236781,78044,158737,276854,-118117,0,-118117,2367,4735,-122852,128655,362128,42827,319301,19731.75,236781,316.58,1117.0,0.0018,407,48.42,33924.48,3.79,0.6704
9081,Mendoza-Hunt,False,CA,Norrisfort,AgriTech,2015,https://mendoza-hunt.com,Reveal read kitchen collection turn recently.,20,mendoza-hunt,2023,USD,388252,136697,251555,250746,809,5507,-4698,3882,7765,-12463,26695,398629,228529,170100,,388252,20.0,157.66,0.001,198,162.92,1000.0,26.7,0.6479
9082,Ortiz LLC,False,KE,West Kyleland,SaaS,2016,https://ortizllc.com,During provide same statement job.,20,ortiz-llc,2023,USD,152459,87907,64552,75275,-10723,4268,-14991,1524,3049,-18040,4906,263941,71074,192867,12704.92,152459,201.18,804.06,0.0548,2540,5.0,1000.0,4.91,0.4234
9083,Brown LLC,False,IN,Alexisshire,AI/ML,2009,https://brownllc.com,Glass sometimes believe run decide else church among ago campaign.,12,brown-llc,2023,USD,745721,210832,534889,37286,497603,0,497603,7457,14914,482689,95836,557448,116238,441210,,745721,2236.43,6791.7,0.0534,891,69.7,1000.0,95.84,0.7173
9084,Murray-Jones,False,KE,Jennifertown,EdTech,2013,https://murray-jones.com,Than discuss feeling others institution benefit high green about ability hotel.,24,murray-jones,2023,USD,208895,124441,84454,123872,-39418,0,-39418,2088,4177,-43595,14378,148116,88065,60051,17407.92,208895,10.0,35.32,0.0419,137,126.74,9628.59,1.49,0.4043
9085,Holmes Schneider and Miller,False,GB,Jasonmouth,E-commerce,2014,https://holmesschneiderandmiller.com,Lay community response sign ok heavy full act.,18,holmes-schneider-and-miller,2023,USD,613831,212430,401401,240697,160704,32362,128342,6138,12276,116066,38136,368448,166521,201927,,613831,20.0,10.0,0.0328,1605,31.86,16533.04,2.31,0.6539
9086,Schultz Ltd,False,DE,North Elizabeth,EdTech,2013,https://schultzltd.com,Draw case degree old town ok.,23,schultz-ltd,2023,EUR,729662,137712,591950,269739,322211,34563,287648,7296,14593,273055,20554,412222,192941,219281,60805.17,729662,617.36,2470.6,0.0129,538,112.89,19976.94,1.03,0.8113
9087,Thompson-Chambers,False,US,Brentfort,HealthTech,2015,https://thompson-chambers.com,Maybe open since suggest important each director.,17,thompson-chambers,2023,USD,307579,88801,218778,139687,79091,1271,77820,3075,6151,71669,13144,207566,132013,75553,25631.58,307579,596.11,2781.41,0.0359,260,98.38,1000.0,13.14,0.7113
9088,Hill-Cook,False,CA,Port Jameshaven,Fintech,2009,https://hill-cook.com,Road figure adult size six of address prove certainly feeling.,13,hill-cook,2023,USD,1277990,578799,699191,685780,13411,10586,2825,12779,25559,-22734,109981,788000,143193,644807,,1277990,1696.39,4803.65,0.0855,1473,72.26,55900.23,1.97,0.5471
9089,Rogers Group,False,GB,New Danielport,E-commerce,2018,https://rogersgroup.com,New difficult painting green book vote then keep.,23,rogers-group,2023,USD,3571310,838534,2732776,2996473,-263697,20807,-284504,35713,71426,-355930,167649,2047403,557628,1489775,,3571310,20.0,92.38,0.001,7590,39.21,254630.88,0.66,0.7652
9090,Jones Nichols and Brown,False,CA,Dannyfort,SaaS,2011,https://jonesnicholsandbrown.com,Family agency old player along responsibility soon reflect theory process.,18,jones-nichols-and-brown,2023,USD,1018210,677492,340718,650303,-309585,0,-309585,10182,20364,-329949,68129,733151,152376,580775,84850.83,1018210,10.0,10.0,0.064,1592,53.29,25840.68,2.64,0.3346
9091,Hernandez Rose and Flores,False,KE,Port Sheilaville,Cybersecurity,2015,https://hernandezroseandflores.com,Effect above experience skin us.,27,hernandez-rose-and-flores,2023,USD,1029926,250538,779388,683245,96143,0,96143,10299,20598,75545,147184,794236,221625,572611,,1029926,20.0,36.45,0.1061,319,268.8,50703.44,2.9,0.7567
9092,Thomas Inc,False,CA,Leeville,AgriTech,2018,https://thomasinc.com,If certainly run view many risk available western decide.,21,thomas-inc,2023,USD,175793,44714,131079,132471,-1392,0,-1392,1757,3515,-4907,17975,300072,77245,222827,,175793,1166.06,1988.32,0.1008,323,45.29,24417.17,0.74,0.7456
9093,Weaver and Sons,False,AU,Duncanland,Cybersecurity,2009,https://weaverandsons.com,Ground more value music end system image kid appear last.,20,weaver-and-sons,2023,USD,485920,301340,184580,312681,-128101,2922,-131023,4859,9718,-140741,56233,346914,242249,104665,,485920,161.91,80.96,0.061,373,108.34,20048.36,2.8,0.3799
9094,Golden Inc,False,DE,South Yolandachester,Energy,2024,https://goldeninc.com,City the contain either write evening.,22,golden-inc,2023,EUR,5085745,1556293,3529452,2762412,767040,22102,744938,50857,101714,643224,380536,3008034,1271173,1736861,,5085745,65.55,372.15,0.0664,2126,199.31,215306.53,1.77,0.694
9095,Bailey Andersen and Watson,False,NG,Port Isaac,AI/ML,2017,https://baileyandersenandwatson.com,Marriage from compare Mrs participant direction leave since treat modern.,17,bailey-andersen-and-watson,2023,USD,714333,268404,445929,215678,230251,0,230251,7143,14286,215965,9951,505605,177894,327711,,714333,412.45,1274.2,0.001,2976,20.0,15410.49,0.65,0.6243
9096,Hickman PLC,False,ZA,Jonton,EdTech,2014,https://hickmanplc.com,Third ground town history eight to determine product resource situation.,26,hickman-plc,2023,USD,1345189,785660,559529,884026,-324497,6865,-331362,13451,26903,-358265,147796,909928,241236,668692,112099.08,1345189,360.51,360.51,0.0267,2352,47.66,55800.49,2.65,0.4159
9097,Gilbert Ltd,False,AU,Gonzalezmouth,EdTech,2014,https://gilbertltd.com,Firm teach other character likely student official.,19,gilbert-ltd,2023,USD,294301,133436,160865,104347,56518,0,56518,2943,5886,50632,5630,314908,89484,225424,24525.08,294301,377.87,377.87,0.0183,1199,20.44,41535.74,0.14,0.5466
9098,Anderson-Russo,False,GB,New Troy,AgriTech,2015,https://anderson-russo.com,Green add teach wall issue people per none free.,26,anderson-russo,2023,USD,232478,100265,132213,89281,42932,30216,12716,2324,4649,8067,17996,138208,63425,74783,,232478,296.07,1450.72,0.001,367,52.73,8734.24,2.06,0.5687
9099,Sutton-Wood,False,TN,Lake Melissa,HealthTech,2021,https://sutton-wood.com,Argue agency decade message pattern civil once popular.,12,sutton-wood,2023,USD,1266942,213269,1053673,299883,753790,0,753790,12669,25338,728452,16718,716532,417643,298889,105578.5,1266942,186.76,628.76,0.0209,1592,66.3,5009.9,3.34,0.8317
9100,Vasquez Ltd,False,GB,Hardychester,SaaS,2008,https://vasquezltd.com,Seem anyone subject difference skin too movie authority.,23,vasquez-ltd,2023,USD,486360,48529,437831,44363,393468,26549,366919,4863,9727,357192,37763,334712,115022,219690,40530.0,486360,187.71,1329.23,0.0555,7250,5.59,1340.01,28.18,0.9002
9101,Guerra-Alvarado,False,CA,East Amy,IoT,2015,https://guerra-alvarado.com,Play role on professional friend force again affect dinner management.,20,guerra-alvarado,2023,USD,798281,252144,546137,268567,277570,0,277570,7982,15965,261605,36918,473378,189466,283912,,798281,1034.52,734.82,0.0792,536,123.89,1000.0,36.92,0.6841
9102,Hoover Group,False,FR,Sanchezville,HealthTech,2016,https://hoovergroup.com,Experience some believe really.,25,hoover-group,2023,EUR,276290,79818,196472,72592,123880,33494,90386,2762,5525,84861,2085,233494,109850,123644,23024.17,276290,10.0,79.21,0.0173,566,40.61,34467.13,0.06,0.7111
9103,Reed Ltd,False,AU,West Ralph,AgriTech,2010,https://reedltd.com,Type marriage church pattern maybe fire power late decision.,13,reed-ltd,2023,USD,127457,51255,76202,83579,-7377,27836,-35213,1274,2549,-37762,8483,121906,26625,95281,,127457,1473.01,3617.27,0.0987,62,171.03,1000.0,8.48,0.5979
9104,Cobb Ltd,False,GB,Port Debra,IoT,2009,https://cobbltd.com,This face read case appear.,24,cobb-ltd,2023,USD,2251999,962270,1289729,726971,562758,17785,544973,22519,45039,499934,51464,1318913,474939,843974,,2251999,1567.44,2741.52,0.0746,1903,98.57,60667.85,0.85,0.5727
9105,Hayes-Burgess,False,EG,Browntown,E-commerce,2020,https://hayes-burgess.com,People return major at eat end attack opportunity.,28,hayes-burgess,2023,USD,559216,263472,295744,334770,-39026,16752,-55778,5592,11184,-66962,12820,345081,234690,110391,,559216,1188.53,3198.14,0.1103,2330,20.0,81190.2,0.16,0.5289
9106,Long-Thomas,False,CA,Christopherfurt,IoT,2012,https://long-thomas.com,Commercial single physical instead leg their plant measure score.,23,long-thomas,2023,USD,563491,229542,333949,383013,-49064,0,-49064,5634,11269,-60333,50653,443005,200838,242167,,563491,989.55,2709.45,0.0281,262,178.64,34353.65,1.47,0.5926
9107,Parker Kennedy and Preston,False,US,Port Fredshire,Fintech,2012,https://parkerkennedyandpreston.com,Adult again view build artist.,26,parker-kennedy-and-preston,2023,USD,478808,99322,379486,192335,187151,745,186406,4788,9576,176830,19808,377294,286856,90438,,478808,20.0,10.0,0.0083,202,196.98,34678.98,0.57,0.7926
9108,Vargas Group,False,DE,Morenomouth,Mobility,2020,https://vargasgroup.com,Dream meet computer similar phone size.,23,vargas-group,2023,EUR,1570978,1059666,511312,1149776,-638464,14653,-653117,15709,31419,-684536,81461,903393,342910,560483,,1570978,20.0,112.89,0.0287,5687,23.02,81299.98,1.0,0.3255
9109,Rasmussen Ltd,False,DE,Santanaborough,Fintech,2023,https://rasmussenltd.com,Building it have allow value first show talk.,15,rasmussen-ltd,2023,EUR,467576,184584,282992,105223,177769,0,177769,4675,9351,168418,56437,368945,198497,170448,,467576,847.06,1700.13,0.0528,287,135.74,1000.0,56.44,0.6052
9110,Walker-Jackson,False,EG,East Wendyberg,AgriTech,2019,https://walker-jackson.com,Each blue else top line different difference win reduce.,26,walker-jackson,2023,USD,339443,94467,244976,31478,213498,15634,197864,3394,6788,191076,13550,336354,121549,214805,,339443,578.33,1948.43,0.0653,133,212.01,25672.69,0.53,0.7217
9111,Hudson LLC,False,IN,Lake Stevenborough,HealthTech,2010,https://hudsonllc.com,Beautiful husband answer cover chair suggest piece.,16,hudson-llc,2023,USD,288218,156903,131315,237000,-105685,49663,-155348,2882,5764,-161112,11452,181324,38128,143196,24018.17,288218,539.41,2409.79,0.0463,4803,5.0,28135.99,0.41,0.4556
9112,Miller and Sons,False,US,New Heather,Energy,2013,https://millerandsons.com,Compare unit current service green.,20,miller-and-sons,2023,USD,2080773,1002165,1078608,538789,539819,13531,526288,20807,41615,484673,833886,1903158,797500,1105658,,2080773,2330.64,9111.63,0.0694,8669,20.0,14517.21,57.44,0.5184
9113,Miller and Sons,False,KE,Jenniferton,AgriTech,2010,https://millerandsons.com,Perform rather program Republican career at either place defense any.,18,miller-and-sons,2023,USD,192441,65690,126751,55489,71262,2068,69194,1924,3848,65346,4153,249100,126868,122232,,192441,1402.22,3396.41,0.0854,125,127.56,1000.0,4.15,0.6586
9114,Elliott Group,False,KE,New Lisamouth,EdTech,2022,https://elliottgroup.com,Young best way former.,23,elliott-group,2023,USD,178962,60085,118877,63756,55121,2240,52881,1789,3579,49302,14391,128375,19102,109273,14913.5,178962,302.15,1799.61,0.001,141,105.26,2427.72,5.93,0.6643
9115,Brown-Norris,False,CA,New Garyhaven,IoT,2011,https://brown-norris.com,Us office he any wish first air night reveal left.,19,brown-norris,2023,USD,168530,18902,149628,62949,86679,18806,67873,1685,3370,64503,16339,278760,96437,182323,,168530,1588.36,6984.32,0.1276,702,20.0,1000.0,16.34,0.8878
9116,Wong Hood and Nicholson,False,KE,South Natalie,HealthTech,2013,https://wonghoodandnicholson.com,Main teacher hand far education list character year visit.,28,wong-hood-and-nicholson,2023,USD,413436,153250,260186,219927,40259,16471,23788,4134,8268,15520,38217,311695,68680,243015,34453.0,413436,388.84,2079.9,0.0176,634,54.32,8484.69,4.5,0.6293
9117,Watson Gonzalez and Burnett,False,TN,Angelaborough,Mobility,2010,https://watsongonzalezandburnett.com,Operation work claim message place.,20,watson-gonzalez-and-burnett,2023,USD,1046468,203039,843429,369504,473925,26017,447908,10464,20929,426979,65323,611245,30562,580683,,1046468,934.61,4806.63,0.001,1110,78.51,23079.91,2.83,0.806
9118,Moore-Maynard,False,ZA,New Mackenzie,EdTech,2011,https://moore-maynard.com,How partner behavior consumer cold nice role.,26,moore-maynard,2023,USD,570011,153098,416913,598268,-181355,14575,-195930,5700,11400,-207330,20314,379404,96978,282426,47500.92,570011,572.98,3910.14,0.0246,593,80.02,70125.87,0.29,0.7314
9119,Mcgee LLC,False,EG,South Bryanland,E-commerce,2015,https://mcgeellc.com,Stop early Congress sure out example yet different.,16,mcgee-llc,2023,USD,607440,240243,367197,30372,336825,0,336825,6074,12148,324677,16999,370875,132857,238018,,607440,20.0,38.02,0.0491,331,152.69,1000.0,17.0,0.6045
9120,Robinson LLC,False,ZA,South Diane,Energy,2012,https://robinsonllc.com,Truth grow to culture wall or ask impact government grow.,16,robinson-llc,2023,USD,1236846,712251,524595,1021395,-496800,0,-496800,12368,24736,-521536,73215,881369,210907,670462,,1236846,20.0,26.12,0.0225,1877,54.89,84942.34,0.86,0.4241
9121,Cole-Cooper,False,TN,Jenniferview,AgriTech,2023,https://cole-cooper.com,Get month fill leg gun their.,20,cole-cooper,2023,USD,165647,66205,99442,114216,-14774,9382,-24156,1656,3312,-27468,932,141920,34145,107775,,165647,53.71,163.3,0.0639,690,20.0,1000.0,0.93,0.6003
9122,Garcia-Thomas,False,CA,Gonzalesberg,HealthTech,2024,https://garcia-thomas.com,Agent operation kid conference approach beautiful fine agency debate explain.,21,garcia-thomas,2023,USD,578442,224604,353838,255124,98714,4173,94541,5784,11568,82973,122444,489992,297748,192244,48203.5,578442,453.06,2127.54,0.001,379,126.89,27042.28,4.53,0.6117
9123,Smith and Sons,False,BR,Fisherfurt,Energy,2016,https://smithandsons.com,Left read many reflect its.,22,smith-and-sons,2023,USD,3661214,969916,2691298,2723370,-32072,0,-32072,36612,73224,-105296,90707,2106599,1071515,1035084,,3661214,20.0,47.66,0.0206,15255,20.0,237616.96,0.38,0.7351
9124,Jones Herman and White,False,TN,Lake Danielshire,Fintech,2012,https://joneshermanandwhite.com,Line section it yet movie mind.,13,jones-herman-and-white,2023,USD,801396,294837,506559,423262,83297,14340,68957,8013,16027,52930,60805,641475,176364,465111,,801396,20.0,39.47,0.0542,3339,20.0,31046.44,1.96,0.6321
9125,Roberts-Franklin,False,ZA,Port Sarah,SaaS,2021,https://roberts-franklin.com,Suggest between science source appear world.,21,roberts-franklin,2023,USD,284338,67650,216688,103280,113408,0,113408,2843,5686,107722,10593,305470,109691,195779,23694.83,284338,250.49,250.49,0.0468,373,63.43,24870.33,0.43,0.7621
9126,Gilbert Ltd,False,FR,Lake Bridget,Mobility,2015,https://gilbertltd.com,Life yard contain source in hear strategy.,23,gilbert-ltd,2023,EUR,8154656,3450741,4703915,3055286,1648629,35162,1613467,81546,163093,1450374,261139,4388719,219435,4169284,,8154656,271.0,812.21,0.0476,2987,227.49,257297.33,1.01,0.5768
9127,Villa-Robinson,False,US,North Jenniferfurt,SaaS,2013,https://villa-robinson.com,Population successful floor would while remain two itself who.,20,villa-robinson,2023,USD,522069,282239,239830,145238,94592,0,94592,5220,10441,84151,12883,278486,90778,187708,43505.75,522069,410.64,1623.35,0.0343,512,84.86,33335.49,0.39,0.4594
9128,Morrow Wood and Harrison,False,BR,Kaitlynport,Cybersecurity,2016,https://morrowwoodandharrison.com,Together couple defense onto notice him participant either environmental executive.,22,morrow-wood-and-harrison,2023,USD,1656410,501702,1154708,213760,940948,9677,931271,16564,33128,898143,34306,987391,462650,524741,,1656410,20.0,64.75,0.001,6901,20.0,15089.73,2.27,0.6971
9129,Perez-Leon,False,CA,Lindaview,HealthTech,2016,https://perez-leon.com,Bar candidate sit serve race Mrs.,18,perez-leon,2023,USD,261982,66215,195767,260084,-64317,0,-64317,2619,5239,-69556,16236,149381,83000,66381,21831.83,261982,149.8,651.25,0.0671,424,51.4,8553.48,1.9,0.7473
9130,Ortega-Miranda,False,US,Patriciafurt,EdTech,2013,https://ortega-miranda.com,Movement charge clearly audience positive past mean leader.,24,ortega-miranda,2023,USD,528206,138056,390150,493204,-103054,5843,-108897,5282,10564,-119461,23304,309481,97217,212264,44017.17,528206,10.0,38.02,0.047,371,118.61,48940.51,0.48,0.7386
9131,Strickland Underwood and Bennett,False,ZA,Richardshire,Fintech,2010,https://stricklandunderwoodandbennett.com,Score western red owner among.,19,strickland-underwood-and-bennett,2023,USD,3152435,864136,2288299,2602382,-314083,0,-314083,31524,63048,-377131,233203,1889810,450820,1438990,,3152435,1121.19,4741.76,0.1016,7703,34.1,197724.49,1.18,0.7259
9132,Holloway Group,False,CA,Warnerburgh,Cybersecurity,2015,https://hollowaygroup.com,Economy relate able now high play.,20,holloway-group,2023,USD,1047458,454298,593160,228404,364756,11087,353669,10474,20949,332720,11628,630467,400893,229574,,1047458,20.0,97.71,0.0529,527,165.58,31112.61,0.37,0.5663
9133,Moody Cox and Ayala,False,CA,West Alicia,E-commerce,2008,https://moodycoxandayala.com,Before at no single teach art hundred this feel hot.,19,moody-cox-and-ayala,2023,USD,2950381,795684,2154697,147519,2007178,0,2007178,29503,59007,1948171,8224,1616764,836881,779883,,2950381,860.95,450.65,0.0205,767,320.35,37557.15,0.22,0.7303
9134,Allen-Banks,False,CA,Lake Meganview,Fintech,2016,https://allen-banks.com,Security big less wall appear blood.,19,allen-banks,2023,USD,4605349,1430771,3174578,510311,2664267,0,2664267,46053,92106,2572161,84798,2496504,943694,1552810,,4605349,20.0,66.87,0.068,1742,220.2,68178.73,1.24,0.6893
9135,Robinson-King,False,DE,East Joel,Cybersecurity,2012,https://robinson-king.com,Alone establish need practice keep enjoy night southern heavy approach.,21,robinson-king,2023,EUR,4782711,2264937,2517774,1815702,702072,2322,699750,47827,95654,604096,238206,2812136,2104012,708124,,4782711,224.03,574.67,0.001,2256,176.62,173341.96,1.37,0.5264
9136,Potts-Schneider,False,FR,Leroyfurt,IoT,2011,https://potts-schneider.com,Unit method close interview federal reflect major.,25,potts-schneider,2023,EUR,165647,59771,105876,85074,20802,13594,7208,1656,3312,3896,12194,220869,87951,132918,,165647,20.0,66.99,0.1173,690,20.0,1000.0,12.19,0.6392
9137,Reynolds-Clark,False,IN,Rickyport,EdTech,2009,https://reynolds-clark.com,Require image interview half as instead.,24,reynolds-clark,2023,USD,329629,142275,187354,218034,-30680,4214,-34894,3296,6592,-41486,131025,341211,169695,171516,27469.08,329629,397.86,621.68,0.0419,1623,16.92,31914.32,4.11,0.5684
9138,Medina Group,False,NG,West Matthewside,Mobility,2023,https://medinagroup.com,Official instead local process firm Democrat upon second.,17,medina-group,2023,USD,1440136,537329,902807,517789,385018,12375,372643,14401,28802,343841,404461,1290385,267372,1023013,,1440136,409.04,1148.44,0.0975,630,190.38,38720.21,10.45,0.6269
9139,Henderson-Howard,False,KE,Lake Staceyberg,Mobility,2012,https://henderson-howard.com,In manage dog thus none difficult key little.,23,henderson-howard,2023,USD,1224831,325801,899030,564209,334821,12523,322298,12248,24496,297802,26384,824909,252423,572486,,1224831,20.0,167.26,0.0462,5103,20.0,19739.16,1.34,0.734
9140,Martin Inc,False,IN,East Shawnview,Mobility,2012,https://martininc.com,Movie story executive apply product large ask case.,23,martin-inc,2023,USD,1444868,296731,1148137,814727,333410,3943,329467,14448,28897,300570,432699,1339190,765196,573994,,1444868,626.03,2503.03,0.0755,542,221.88,55253.34,7.83,0.7946
9141,Woodard PLC,False,CA,Heathhaven,Cybersecurity,2016,https://woodardplc.com,Serious improve particularly believe ago.,21,woodard-plc,2023,USD,409656,136167,273489,36598,236891,0,236891,4096,8193,228698,24873,341243,23485,317758,,409656,20.0,27.17,0.0618,303,112.32,14067.1,1.77,0.6676
9142,Watkins Group,False,GB,West Ericahaven,HealthTech,2010,https://watkinsgroup.com,Enjoy admit cut there statement event understand design watch to much.,13,watkins-group,2023,USD,156195,74951,81244,113917,-32673,0,-32673,1561,3123,-35796,2365,212544,49077,163467,13016.25,156195,337.68,1666.17,0.0297,232,56.1,13946.83,0.17,0.5201
9143,Johnson-Anderson,False,NG,South Thomas,AI/ML,2015,https://johnson-anderson.com,Civil agreement animal sort position weight prevent possible agreement.,24,johnson-anderson,2023,USD,1138547,430943,707604,565505,142099,9063,133036,11385,22770,110266,20149,694229,70812,623417,,1138547,281.75,1095.75,0.1315,4743,20.0,24423.92,0.82,0.6215
9144,Lopez PLC,False,ZA,Lake Crystalstad,AgriTech,2018,https://lopezplc.com,Sense table evening concern.,23,lopez-plc,2023,USD,843439,173837,669602,526763,142839,8964,133875,8434,16868,117007,14063,450168,143206,306962,,843439,1253.47,843.23,0.0179,346,203.05,53219.78,0.26,0.7939
9145,Ellis PLC,False,ZA,South Andre,AI/ML,2011,https://ellisplc.com,Raise machine spend four stock along attorney.,22,ellis-plc,2023,USD,663582,188311,475271,377926,97345,16705,80640,6635,13271,67369,125481,491888,119834,372054,,663582,20.0,63.31,0.0693,595,92.87,20884.68,6.01,0.7162
9146,Crawford-Henry,False,KE,Harpermouth,HealthTech,2008,https://crawford-henry.com,Back until use owner apply and design he truth commercial.,28,crawford-henry,2023,USD,1318759,496230,822529,65937,756592,17078,739514,13187,26375,713139,123105,892035,365205,526830,109896.58,1318759,809.13,5078.68,0.035,1368,80.32,1000.0,123.1,0.6237
9147,Hicks Ltd,False,IN,East Lauramouth,AI/ML,2023,https://hicksltd.com,Democratic health student lawyer him leg social all between under.,20,hicks-ltd,2023,USD,113648,53230,60418,30422,29996,0,29996,1136,2272,27724,8796,105755,5287,100468,,113648,563.37,2906.42,0.0163,473,20.0,27846.67,0.32,0.5316
9148,Beck Lee and Melendez,False,EG,Lake Brian,SaaS,2021,https://beckleeandmelendez.com,Despite summer minute if will source throw staff word.,17,beck-lee-and-melendez,2023,USD,2080959,180657,1900302,1577857,322445,12188,310257,20809,41619,268638,133163,1302936,166422,1136514,173413.25,2080959,10.0,11.33,0.0478,1885,91.97,143815.03,0.93,0.9132
9149,Michael and Sons,False,EG,Wardland,Marketplaces,2020,https://michaelandsons.com,According fund on language whom.,17,michael-and-sons,2023,USD,344260,97587,246673,142418,104255,21873,82382,3442,6885,75497,6130,192895,81997,110898,,344260,1055.7,1811.09,0.1485,142,201.4,1000.0,6.13,0.7165
9150,Rodriguez-Jenkins,False,KE,Vasqueztown,EdTech,2014,https://rodriguez-jenkins.com,Mouth media cut wish couple step.,27,rodriguez-jenkins,2023,USD,875202,267664,607538,238323,369215,27784,341431,8752,17504,323927,11992,499428,24971,474457,72933.5,875202,78.85,131.28,0.001,580,125.65,18572.63,0.65,0.6942
9151,Zamora-Taylor,False,DE,Port Latoya,HealthTech,2021,https://zamora-taylor.com,Deep might plan fish sing upon purpose law return wall.,21,zamora-taylor,2023,EUR,1037075,257899,779176,354058,425118,0,425118,10370,20741,404377,49317,748710,584870,163840,86422.92,1037075,10.0,23.26,0.0181,17284,5.0,57089.8,0.86,0.7513
9152,Guerra Group,False,CA,East Jonathan,Fintech,2019,https://guerragroup.com,Character development nice information sit focus but trouble chair black.,26,guerra-group,2023,USD,1995231,662782,1332449,664972,667477,8110,659367,19952,39904,619463,29612,1138569,648514,490055,,1995231,20.0,103.86,0.0413,2833,58.69,43808.07,0.68,0.6678
9153,Roman-Harris,False,KE,Thompsonborough,SaaS,2013,https://roman-harris.com,Eye board after write growth guess.,21,roman-harris,2023,USD,922094,316685,605409,400316,205093,0,205093,9220,18441,186652,20668,651320,203362,447958,76841.17,922094,10.0,45.29,0.0577,951,80.73,43167.75,0.48,0.6566
9154,Wilson Lynn and Mckenzie,False,CA,Gainesshire,Mobility,2017,https://wilsonlynnandmckenzie.com,Catch few majority few whom air like car offer receive.,28,wilson-lynn-and-mckenzie,2023,USD,3508215,1128212,2380003,3345148,-965145,16790,-981935,35082,70164,-1052099,84499,1852885,659981,1192904,,3508215,20.0,34.97,0.0896,1313,222.5,272647.7,0.31,0.6784
9155,Wang-Miles,False,TN,New David,AgriTech,2009,https://wang-miles.com,Election scientist agree as fill operation above.,17,wang-miles,2023,USD,207888,74803,133085,133307,-222,26074,-26296,2078,4157,-30453,7482,289428,126702,162726,,207888,927.14,4489.44,0.0909,866,20.0,1000.0,7.48,0.6402
9156,Morris Group,False,NG,Heathfort,E-commerce,2024,https://morrisgroup.com,Expect other tough drop nation recognize four.,16,morris-group,2023,USD,1095826,410804,685022,158218,526804,0,526804,10958,21916,504888,38530,650004,205675,444329,,1095826,20.0,15.16,0.0821,2568,35.56,1000.0,38.53,0.6251
9157,Murphy-Carrillo,False,AU,Christensenberg,E-commerce,2024,https://murphy-carrillo.com,Receive indeed bit seven center environmental keep.,15,murphy-carrillo,2023,USD,239827,113892,125935,203579,-77644,55637,-133281,2398,4796,-138077,10342,255852,41263,214589,,239827,20.0,56.16,0.029,430,46.43,22666.16,0.46,0.5251
9158,Ferrell-Mendez,False,NG,Timothytown,EdTech,2013,https://ferrell-mendez.com,Performance debate operation traditional commercial control.,18,ferrell-mendez,2023,USD,279318,107108,172210,193171,-20961,0,-20961,2793,5586,-26547,9636,224034,11201,212833,23276.5,279318,10.0,27.1,0.001,516,45.09,30030.37,0.32,0.6165
9159,Lowe-Flowers,False,AU,Leeburgh,E-commerce,2021,https://lowe-flowers.com,Small spring dark affect laugh loss ability bill brother.,19,lowe-flowers,2023,USD,318529,125002,193527,132651,60876,4347,56529,3185,6370,50159,9174,264097,123748,140349,,318529,766.3,1116.09,0.0166,1327,20.0,18928.35,0.48,0.6076
9160,Lopez Lewis and Williams,False,ZA,North Rhonda,Mobility,2012,https://lopezlewisandwilliams.com,Man hospital decision explain none type candidate with current.,11,lopez-lewis-and-williams,2023,USD,351959,198464,153495,111256,42239,26359,15880,3519,7039,8841,1436,202730,19524,183206,,351959,697.48,348.74,0.0039,1466,20.0,2667.6,0.54,0.4361
9161,Henry Ferguson and Sutton,False,TN,West Barbara,HealthTech,2008,https://henryfergusonandsutton.com,Girl lead country best store high.,18,henry-ferguson-and-sutton,2023,USD,595364,164138,431226,245575,185651,0,185651,5953,11907,173744,15683,388289,281700,106589,49613.67,595364,547.75,1293.03,0.001,3242,15.3,39957.26,0.39,0.7243
9162,Barnes Lara and Taylor,False,ZA,Timchester,AI/ML,2016,https://barneslaraandtaylor.com,South store daughter star simple design.,19,barnes-lara-and-taylor,2023,USD,577429,74055,503374,87168,416206,0,416206,5774,11548,404658,1898,306375,91616,214759,,577429,20.0,45.33,0.001,314,152.9,1000.0,1.9,0.8718
9163,Cortez Inc,False,TN,Petersonstad,Mobility,2012,https://cortezinc.com,Cold despite doctor lot case hand room.,24,cortez-inc,2023,USD,1169829,559149,610680,382628,228052,0,228052,11698,23396,204656,93141,683795,378578,305217,,1169829,20.0,100.55,0.1084,4874,20.0,39227.96,2.37,0.522
9164,Scott-Palmer,False,BR,Port Rachelhaven,IoT,2013,https://scott-palmer.com,Amount kid beautiful term scientist collection.,25,scott-palmer,2023,USD,2638458,637814,2000644,1676538,324106,42205,281901,26384,52769,229132,149209,1485107,296500,1188607,,2638458,20.0,105.67,0.067,10993,20.0,147144.95,1.01,0.7583
9165,Wilson LLC,False,CA,New Sean,AgriTech,2014,https://wilsonllc.com,Tonight ball about billion goal onto according type best.,22,wilson-llc,2023,USD,582660,158921,423739,439284,-15545,26708,-42253,5826,11653,-53906,20186,466719,55596,411123,,582660,163.56,642.36,0.0328,550,88.17,69715.49,0.29,0.7272
9166,Peterson Smith and Espinoza,False,AU,Ramirezburgh,Marketplaces,2018,https://petersonsmithandespinoza.com,Us despite happen beautiful series sure measure full.,16,peterson-smith-and-espinoza,2023,USD,892977,352990,539987,749239,-209252,0,-209252,8929,17859,-227111,51937,695177,130798,564379,,892977,3035.99,9089.43,0.0425,470,158.25,86698.42,0.6,0.6047
9167,Lewis-Barry,False,ZA,Barberside,E-commerce,2010,https://lewis-barry.com,Break always form war white share bring series manager.,25,lewis-barry,2023,USD,1128051,367769,760282,694175,66107,0,66107,11280,22561,43546,42914,792521,194937,597584,,1128051,1423.28,5196.59,0.0508,1144,82.15,70755.73,0.61,0.674
9168,Goodman Castillo and Butler,False,AU,Port Markberg,IoT,2020,https://goodmancastilloandbutler.com,Out eat season box within.,25,goodman-castillo-and-butler,2023,USD,192032,113924,78108,71427,6681,2957,3724,1920,3840,-116,15133,185142,59844,125298,,192032,20.0,84.35,0.1105,64,248.96,6302.68,2.4,0.4067
9169,Thompson LLC,False,GB,Meganborough,AI/ML,2013,https://thompsonllc.com,Course thank type which service stand popular idea join by.,19,thompson-llc,2023,USD,720520,232675,487845,165612,322233,45063,277170,7205,14410,262760,38173,468348,206518,261830,,720520,244.02,638.6,0.0892,3002,20.0,3466.49,11.01,0.6771
9170,Peterson LLC,False,GB,West Juliafurt,HealthTech,2019,https://petersonllc.com,Gas trial will box age point nothing and general.,19,peterson-llc,2023,USD,1513961,185207,1328754,624637,704117,4649,699468,15139,30279,669189,24704,937380,292642,644738,126163.42,1513961,10.0,30.48,0.0114,2794,45.14,77510.88,0.32,0.8777
9171,Jenkins-Church,False,US,East Christopher,Fintech,2013,https://jenkins-church.com,Significant trial people fill.,23,jenkins-church,2023,USD,2970964,1405373,1565591,1674580,-108989,22476,-131465,29709,59419,-190884,91444,1738267,827257,911010,,2970964,1167.69,3637.78,0.1179,1355,182.59,148028.31,0.62,0.527
9172,Rodriguez-Hess,False,CA,East Victoria,Cybersecurity,2020,https://rodriguez-hess.com,Learn ability minute agent pay worker resource challenge.,12,rodriguez-hess,2023,USD,642104,392941,249163,90004,159159,0,159159,6421,12842,146317,44297,365462,174846,190616,,642104,20.0,19.15,0.0768,528,101.23,8869.35,4.99,0.388
9173,Jones Blackwell and Smith,False,GB,Browntown,AgriTech,2022,https://jonesblackwellandsmith.com,We office popular may similar rest land test economic good.,31,jones-blackwell-and-smith,2023,USD,1058050,442105,615945,71414,544531,1655,542876,10580,21161,521715,26776,675065,239118,435947,,1058050,20.0,10.0,0.0353,4408,20.0,1000.0,26.78,0.5822
9174,Johnson Lowe and Donovan,False,GB,Garnershire,AI/ML,2021,https://johnsonloweanddonovan.com,Data across others guess air within your trouble structure visit note.,19,johnson-lowe-and-donovan,2023,USD,2143000,441546,1701454,1512787,188667,4192,184475,21430,42860,141615,184784,1318686,621667,697019,,2143000,593.63,927.47,0.0855,8929,20.0,154612.81,1.2,0.794
9175,Reeves Inc,False,DE,East Anthonyfurt,IoT,2016,https://reevesinc.com,Name want mean realize.,22,reeves-inc,2023,EUR,798762,262794,535968,350108,185860,0,185860,7987,15975,169885,40861,611143,164742,446401,,798762,1253.37,3576.75,0.0764,982,67.77,16930.81,2.41,0.671
9176,Bass Cortez and Rollins,False,GB,New Thomasmouth,Marketplaces,2008,https://basscortezandrollins.com,Item would policy let.,26,bass-cortez-and-rollins,2023,USD,1011321,440604,570717,571535,-818,1715,-2533,10113,20226,-22759,37286,629279,306807,322472,,1011321,165.44,148.61,0.0399,4213,20.0,15593.11,2.39,0.5643
9177,Gonzalez-Lawson,False,FR,Port Cassidyport,HealthTech,2013,https://gonzalez-lawson.com,Voice institution between from audience article test.,18,gonzalez-lawson,2023,EUR,1249484,511915,737569,400797,336772,0,336772,12494,24989,311783,123285,833689,252337,581352,104123.67,1249484,10.0,23.44,0.0489,8676,12.0,41031.39,3.0,0.5903
9178,Duncan PLC,False,DE,Tommyhaven,AgriTech,2010,https://duncanplc.com,National security body myself still seat.,22,duncan-plc,2023,EUR,123791,36181,87610,81859,5751,28443,-22692,1237,2475,-25167,7600,257986,12899,245087,,123791,20.0,78.35,0.0102,70,145.54,1000.0,7.6,0.7077
9179,Huang Gardner and Christian,False,IN,Juarezton,IoT,2013,https://huanggardnerandchristian.com,Camera the three easy skin ever.,20,huang-gardner-and-christian,2023,USD,1363504,106312,1257192,718521,538671,0,538671,13635,27270,511401,154160,922923,195206,727717,,1363504,23.92,28.8,0.0699,924,122.95,45893.99,3.36,0.922
9180,Campbell Jensen and Mcdaniel,False,KE,Bellborough,SaaS,2008,https://campbelljensenandmcdaniel.com,Campaign professional such computer nice with analysis.,29,campbell-jensen-and-mcdaniel,2023,USD,4992722,2013656,2979066,3262983,-283917,0,-283917,49927,99854,-383771,693016,3257079,437710,2819369,416060.17,4992722,505.47,1476.16,0.0331,39103,10.64,250150.8,2.77,0.5967
9181,Thompson Inc,False,KE,New Bruce,Cybersecurity,2021,https://thompsoninc.com,Sea myself best because range alone business lay leg.,17,thompson-inc,2023,USD,3462446,672903,2789543,678341,2111202,2448,2108754,34624,69248,2039506,1630861,3420447,898278,2522169,,3462446,1428.06,8651.83,0.0724,2057,140.23,42147.46,38.69,0.8057
9182,Scott Vance and Walters,False,TN,North Tyler,HealthTech,2022,https://scottvanceandwalters.com,Plant ground large way teacher.,17,scott-vance-and-walters,2023,USD,1318259,405089,913170,65912,847258,15883,831375,13182,26365,805010,311679,1109599,277539,832060,109854.92,1318259,593.87,3007.58,0.001,1213,90.56,1000.0,311.68,0.6927
9183,Jackson Baldwin and Brown,False,US,Denniston,HealthTech,2021,https://jacksonbaldwinandbrown.com,Consumer up mouth wind difficult car science.,16,jackson-baldwin-and-brown,2023,USD,7374512,2703273,4671239,4889837,-218598,0,-218598,73745,147490,-366088,1017294,4901498,1381210,3520288,614542.67,7374512,790.51,3349.23,0.001,6598,93.14,410089.49,2.48,0.6334
9184,Lowe Porter and Vincent,False,TN,Port Anthony,SaaS,2016,https://loweporterandvincent.com,Son speech although ever can decision up mother standard yeah.,24,lowe-porter-and-vincent,2023,USD,265199,126206,138993,48719,90274,0,90274,2651,5303,84971,6473,194240,110042,84198,22099.92,265199,79.38,532.26,0.0207,303,72.73,1000.0,6.47,0.5241
9185,Clark-Barton,False,CA,Lake Angelaside,SaaS,2019,https://clark-barton.com,Technology describe best kid already religious.,28,clark-barton,2023,USD,1078748,113444,965304,630971,334333,30017,304316,10787,21574,282742,79628,780588,276615,503973,89895.67,1078748,199.7,917.95,0.0545,1717,52.34,67897.04,1.17,0.8948
9186,Sanders Ltd,False,TN,New Andrewstad,EdTech,2013,https://sandersltd.com,Again social hour dinner everything somebody reflect energy local half.,22,sanders-ltd,2023,USD,425308,37898,387410,21265,366145,24302,341843,4253,8506,333337,23424,293251,139881,153370,35442.33,425308,97.32,346.78,0.0274,606,58.48,1000.0,23.42,0.9109
9187,Chen Hudson and Freeman,False,FR,East Frank,Mobility,2017,https://chenhudsonandfreeman.com,Sea board too growth fact our American interview wrong.,14,chen-hudson-and-freeman,2023,EUR,569567,233025,336542,196360,140182,21072,119110,5695,11391,107719,95009,436520,54767,381753,,569567,20.0,80.91,0.0139,657,72.15,2520.71,37.69,0.5909
9188,Thomas Boone and Goodman,False,BR,Danielborough,SaaS,2008,https://thomasbooneandgoodman.com,Manager fill keep rich thing read land available glass.,16,thomas-boone-and-goodman,2023,USD,941829,403356,538473,157940,380533,15238,365295,9418,18836,346459,74112,652748,139137,513611,78485.75,941829,170.13,848.12,0.0161,1228,63.87,32799.31,2.26,0.5717
9189,Mills Li and Garcia,False,ZA,Port Kimberlyville,EdTech,2010,https://millsliandgarcia.com,Future window friend draw room environmental fast evidence.,34,mills-li-and-garcia,2023,USD,792788,430650,362138,360193,1945,1280,665,7927,15855,-15190,59828,623827,160366,463461,66065.67,792788,172.65,670.58,0.0575,1836,35.97,3066.03,19.51,0.4568
9190,Barnes Clayton and Smith,False,US,Millerton,Cybersecurity,2010,https://barnesclaytonandsmith.com,While economic another know thought good strong.,18,barnes-clayton-and-smith,2023,USD,732990,372113,360877,637893,-277016,0,-277016,7329,14659,-291675,6886,512880,182991,329889,,732990,20.0,97.08,0.001,3054,20.0,46970.46,0.15,0.4923
9191,Thompson Porter and Guerrero,False,KE,Lake David,EdTech,2015,https://thompsonporterandguerrero.com,Their series myself structure discover reflect party difficult list even.,13,thompson-porter-and-guerrero,2023,USD,538254,285866,252388,85029,167359,8393,158966,5382,10765,148201,25332,462383,320150,142233,44854.5,538254,176.21,666.02,0.0683,710,63.16,1000.0,25.33,0.4689
9192,Brady-Shields,False,CA,South Maureen,EdTech,2013,https://brady-shields.com,Surface question technology life cover get oil.,17,brady-shields,2023,USD,352225,104310,247915,142915,105000,2035,102965,3522,7044,95921,19454,308532,114999,193533,29352.08,352225,783.27,3998.18,0.0806,290,101.03,18676.44,1.04,0.7039
9193,Harding-Walton,False,GB,South Judithborough,HealthTech,2017,https://harding-walton.com,Bag find either suffer close technology meet value mind reason.,17,harding-walton,2023,USD,1602202,698422,903780,1291837,-388057,42207,-430264,16022,32044,-462308,65815,1039912,336384,703528,133516.83,1602202,10.0,51.47,0.0363,3005,44.43,110464.83,0.6,0.5641
9194,Andrews-Elliott,False,EG,North James,Fintech,2010,https://andrews-elliott.com,Study loss such watch face know.,21,andrews-elliott,2023,USD,750778,348719,402059,156446,245613,0,245613,7507,15015,230598,86033,550904,157298,393606,,750778,682.38,3552.62,0.106,3128,20.0,17916.37,4.8,0.5355
9195,Conner Bush and Villanueva,False,KE,Hernandezborough,EdTech,2020,https://connerbushandvillanueva.com,Walk author worker peace try employee author fight for doctor.,18,conner-bush-and-villanueva,2023,USD,465361,120353,345008,93606,251402,10758,240644,4653,9307,231337,12461,395275,161767,233508,38780.08,465361,408.92,1224.03,0.0805,1176,32.96,18486.5,0.67,0.7414
9196,Johnston-Shaw,False,US,New Karenshire,Cybersecurity,2009,https://johnston-shaw.com,Author available material there direction.,25,johnston-shaw,2023,USD,512833,213487,299346,191724,107622,0,107622,5128,10256,97366,88824,397533,61274,336259,,512833,1173.81,1225.23,0.1295,244,174.85,7903.81,11.24,0.5837
9197,Edwards-Jones,False,TN,Rothborough,SaaS,2024,https://edwards-jones.com,Sister owner police manager who success.,26,edwards-jones,2023,USD,8026860,3225796,4801064,3580921,1220143,40078,1180065,80268,160537,1019528,91733,4266228,2507436,1758792,668905.0,8026860,112.46,268.84,0.001,133781,5.0,320822.75,0.29,0.5981
9198,Jackson-Keith,False,GB,West Lindamouth,Mobility,2023,https://jackson-keith.com,Key seat huge since mother.,16,jackson-keith,2023,USD,980331,276861,703470,558657,144813,0,144813,9803,19606,125207,65758,718861,222830,496031,,980331,20.0,62.01,0.1544,4084,20.0,40067.54,1.64,0.7176
9199,Navarro Inc,False,BR,Dixonland,SaaS,2018,https://navarroinc.com,Morning tax avoid question eye win long.,20,navarro-inc,2023,USD,755646,208967,546679,347133,199546,20800,178746,7556,15112,163634,126377,643946,192064,451882,62970.5,755646,304.69,957.03,0.0728,1757,35.82,15126.7,8.35,0.7235
9200,Smith LLC,False,TN,Lake Rachael,AgriTech,2020,https://smithllc.com,Part former result late concern thousand.,12,smith-llc,2023,USD,462674,132373,330301,281265,49036,8995,40041,4626,9253,30788,8657,249759,131855,117904,,462674,20.0,25.27,0.001,384,100.37,42191.06,0.21,0.7139
9201,Walker Inc,False,FR,East Jaredport,Marketplaces,2021,https://walkerinc.com,One cover whatever forget with attorney describe need air space.,21,walker-inc,2023,EUR,594424,249802,344622,312807,31815,0,31815,5944,11888,19927,10940,393960,144346,249614,,594424,354.8,1725.63,0.0601,606,81.63,6183.12,1.77,0.5798
9202,Tyler-Houston,False,US,New Samanthatown,Mobility,2021,https://tyler-houston.com,Themselves wear TV stock song keep.,22,tyler-houston,2023,USD,378942,122294,256648,220473,36175,21856,14319,3789,7578,6741,3202,243586,43403,200183,,378942,558.72,1543.35,0.0824,1578,20.0,3563.43,0.9,0.6773
9203,Walker Pierce and Davis,False,GB,Harrismouth,Energy,2017,https://walkerpierceanddavis.com,Ever world life computer rock reach bank.,22,walker-pierce-and-davis,2023,USD,1560261,261308,1298953,609568,689385,41492,647893,15602,31205,616688,56102,1007479,457756,549723,,1560261,97.69,221.49,0.0675,6501,20.0,57207.0,0.98,0.8325
9204,Reyes-Rodriguez,False,DE,Matthewfort,Cybersecurity,2024,https://reyes-rodriguez.com,Cold tonight maintain four require senior meet against however school.,18,reyes-rodriguez,2023,EUR,1330154,358722,971432,1019302,-47870,0,-47870,13301,26603,-74473,64702,894604,425630,468974,,1330154,514.17,990.64,0.0642,403,274.9,66662.78,0.97,0.7303
9205,Powers Russo and Sampson,False,ZA,Fowlerside,E-commerce,2008,https://powersrussoandsampson.com,Staff cell thing road marriage start such concern actually.,15,powers-russo-and-sampson,2023,USD,1114589,620301,494288,55729,438559,0,438559,11145,22291,416268,11982,640164,385900,254264,,1114589,308.42,1066.92,0.0814,532,174.46,1000.0,11.98,0.4435
9206,Anderson Hernandez and Khan,False,US,Lake Michaelfort,IoT,2018,https://andersonhernandezandkhan.com,Reality perform key firm full reach the attorney.,18,anderson-hernandez-and-khan,2023,USD,926720,377853,548867,47829,501038,0,501038,9267,18534,482504,41943,595335,265538,329797,,926720,492.28,347.99,0.001,225,342.33,30066.81,1.39,0.5923
9207,Hudson-Pugh,False,DE,Daisymouth,Mobility,2013,https://hudson-pugh.com,Leader never attention strong show who almost.,25,hudson-pugh,2023,EUR,1812657,690369,1122288,451307,670981,34261,636720,18126,36253,600467,150402,1219830,422287,797543,,1812657,1051.65,3863.18,0.078,7552,20.0,11225.15,13.4,0.6191
9208,Anderson-Chaney,False,DE,Romerofurt,AgriTech,2021,https://anderson-chaney.com,Understand huge knowledge bad dark find each worker.,20,anderson-chaney,2023,EUR,1641414,218974,1422440,1168365,254075,0,254075,16414,32828,221247,33548,1009056,690190,318866,,1641414,1322.92,3348.4,0.001,1685,81.14,77265.47,0.43,0.8666
9209,Tyler Inc,False,FR,South Jamesbury,Mobility,2021,https://tylerinc.com,Remember return seat power fund sell summer who instead.,24,tyler-inc,2023,EUR,376104,107214,268890,265144,3746,8744,-4998,3761,7522,-12520,30508,379718,341746,37972,,376104,338.92,713.55,0.1209,509,61.47,25833.31,1.18,0.7149
9210,Hines West and Davis,False,BR,Margaretton,HealthTech,2015,https://hineswestanddavis.com,Sell husband history everything day and room herself help research.,28,hines-west-and-davis,2023,USD,874292,437348,436944,448546,-11602,24190,-35792,8742,17485,-53277,98706,652197,324803,327394,72857.67,874292,10.0,10.0,0.0495,1720,42.34,46812.72,2.11,0.4998
9211,Smith Curtis and Johnston,False,BR,Johnsonburgh,Fintech,2014,https://smithcurtisandjohnston.com,Walk card least statement try.,22,smith-curtis-and-johnston,2023,USD,373037,39832,333205,24950,308255,19635,288620,3730,7460,281160,3962,283835,88655,195180,,373037,20.0,75.17,0.0306,226,137.11,1000.0,3.96,0.8932
9212,Anthony-Bishop,False,DE,Lake Williamhaven,Energy,2011,https://anthony-bishop.com,Include doctor paper may but list machine nation when.,25,anthony-bishop,2023,EUR,264195,76363,187832,120919,66913,0,66913,2641,5283,61630,3096,325292,166517,158775,,264195,1217.01,1443.46,0.1187,183,119.8,1000.0,3.1,0.711
9213,Carlson-James,False,US,Jamesville,Marketplaces,2016,https://carlson-james.com,Often star break listen part sure feeling south wide.,17,carlson-james,2023,USD,2781491,1288485,1493006,952446,540560,0,540560,27814,55629,484931,109424,1535703,696592,839111,,2781491,257.44,824.46,0.0055,1998,115.99,97403.33,1.12,0.5368
9214,Fuentes-Ewing,False,IN,Port John,Cybersecurity,2010,https://fuentes-ewing.com,Visit image improve medical policy.,15,fuentes-ewing,2023,USD,1056857,418934,637923,161891,476032,0,476032,10568,21137,454895,70653,763340,385896,377444,,1056857,1431.75,4826.71,0.0152,260,337.53,11875.7,5.95,0.6036
9215,Washington Rivas and Sanford,False,TN,West Christine,AgriTech,2012,https://washingtonrivasandsanford.com,Tax president full yourself bad production available hot program able.,20,washington-rivas-and-sanford,2023,USD,88048,27352,60696,50968,9728,0,9728,880,1760,7968,28556,171645,93469,78176,,88048,464.46,1346.68,0.0863,80,91.15,4971.86,5.74,0.6894
9216,Carroll Dunlap and Powell,False,DE,North Kathryn,Cybersecurity,2011,https://carrolldunlapandpowell.com,Skill help around remain onto.,12,carroll-dunlap-and-powell,2023,EUR,144069,62968,81101,35740,45361,10481,34880,1440,2881,31999,4222,275118,117563,157555,,144069,20.0,41.52,0.1036,600,20.0,12055.3,0.35,0.5629
9217,Weeks PLC,False,TN,Port Bonnieview,E-commerce,2016,https://weeksplc.com,Religious study language picture wife magazine hit forward Mrs trouble.,19,weeks-plc,2023,USD,967339,360865,606474,71841,534633,0,534633,9673,19346,515287,43168,723813,88914,634899,,967339,201.63,1132.38,0.0607,877,91.82,6965.17,6.2,0.627
9218,Moore and Sons,False,IN,Jenniferhaven,Fintech,2014,https://mooreandsons.com,Radio play soon person wide thank than.,17,moore-and-sons,2023,USD,876705,339734,536971,543487,-6516,8980,-15496,8767,17534,-33030,59407,638896,31944,606952,,876705,1236.02,4022.99,0.001,262,278.79,31523.34,1.88,0.6125
9219,Yang and Sons,False,EG,East Robertburgh,HealthTech,2022,https://yangandsons.com,Sea expert those property professor available office possible artist something.,24,yang-and-sons,2023,USD,1640006,742700,897306,332659,564647,0,564647,16400,32800,531847,17554,889821,513826,375995,136667.17,1640006,10.0,34.54,0.0312,3086,44.28,5344.38,3.28,0.5471
9220,Moses PLC,False,EG,New Alejandraland,Marketplaces,2020,https://mosesplc.com,Including behind sure million there generation cut these probably.,14,moses-plc,2023,USD,884008,72424,811584,142169,669415,13546,655869,8840,17680,638189,51130,509278,223274,286004,,884008,500.2,2470.95,0.0335,1356,54.31,12320.31,4.15,0.9181
9221,Reed Sandoval and Lopez,False,NG,Allenport,E-commerce,2023,https://reedsandovalandlopez.com,Away trial however pick difference involve soldier question admit focus.,19,reed-sandoval-and-lopez,2023,USD,535553,207938,327615,153331,174284,0,174284,5355,10711,163573,43954,348088,30180,317908,,535553,767.43,3487.02,0.001,883,50.51,10141.02,4.33,0.6117
9222,White Washington and Zimmerman,False,TN,Lake Madelineside,SaaS,2021,https://whitewashingtonandzimmerman.com,Data question scene just be picture almost forward feeling.,26,white-washington-and-zimmerman,2023,USD,352404,83024,269380,167575,101805,9739,92066,3524,7048,85018,29450,234531,69264,165267,29367.0,352404,114.17,180.18,0.0431,497,59.05,25840.22,1.14,0.7644
9223,Wright PLC,False,ZA,Bellfort,EdTech,2016,https://wrightplc.com,Price color executive not positive responsibility debate stop wait.,12,wright-plc,2023,USD,85449,31555,53894,58510,-4616,5993,-10609,854,1708,-12317,5012,101644,52790,48854,7120.75,85449,268.82,1042.44,0.0503,51,138.2,1000.0,5.01,0.6307
9224,Perkins-Walter,False,KE,North Jane,AgriTech,2013,https://perkins-walter.com,Tv month trade stay.,26,perkins-walter,2023,USD,202719,104445,98274,79714,18560,0,18560,2027,4054,14506,8190,304786,140414,164372,,202719,1117.16,5482.19,0.0269,113,149.44,18222.66,0.45,0.4848
9225,Foster and Sons,False,KE,East Alicia,SaaS,2016,https://fosterandsons.com,Report Mr state strategy tonight instead.,20,foster-and-sons,2023,USD,5058963,866017,4192946,636106,3556840,0,3556840,50589,101179,3455661,154889,2876004,143800,2732204,421580.25,5058963,435.57,1822.01,0.001,7249,58.15,50018.46,3.1,0.8288
9226,Jenkins Moody and Castillo,False,TN,Cheryltown,Fintech,2023,https://jenkinsmoodyandcastillo.com,Happy great dark especially give region then pattern drive.,22,jenkins-moody-and-castillo,2023,USD,2067488,734930,1332558,1369395,-36837,0,-36837,20674,41349,-78186,1399361,2479738,1756760,722978,,2067488,43.77,21.88,0.1133,1110,155.19,110097.03,12.71,0.6445
9227,Chavez Kline and Moore,False,CA,East Timothyview,E-commerce,2011,https://chavezklineandmoore.com,Tax statement enjoy determine issue.,17,chavez-kline-and-moore,2023,USD,1618436,546033,1072403,80921,991482,0,991482,16184,32368,959114,32404,954732,182682,772050,,1618436,20.0,18.08,0.0322,1716,78.58,1000.0,32.4,0.6626
9228,Walker Burnett and Ochoa,False,NG,West Nicholasburgh,AI/ML,2022,https://walkerburnettandochoa.com,Network raise name window value heart bar.,17,walker-burnett-and-ochoa,2023,USD,2605953,726424,1879529,2218595,-339066,26131,-365197,26059,52119,-417316,114973,1603323,80166,1523157,,2605953,325.71,1815.04,0.001,1890,114.89,181853.8,0.63,0.7212
9229,Frost Pope and King,False,US,Deannahaven,Fintech,2023,https://frostpopeandking.com,Issue measure human than reality executive scientist.,18,frost-pope-and-king,2023,USD,740644,318482,422162,655067,-232905,3944,-236849,7406,14812,-251661,112165,660066,92490,567576,,740644,953.01,1193.09,0.0196,3086,20.0,73567.65,1.52,0.57
9230,Mcbride-Griffith,False,KE,Jordanbury,IoT,2014,https://mcbride-griffith.com,Road place send alone parent president certainly night.,25,mcbride-griffith,2023,USD,710045,298186,411859,299842,112017,8385,103632,7100,14200,89432,9358,511708,281594,230114,,710045,361.83,598.28,0.0408,592,99.95,17444.82,0.54,0.58
9231,Blake LLC,False,GB,Michelechester,AgriTech,2013,https://blakellc.com,Front street blue course mission civil seat call.,10,blake-llc,2023,USD,55716,13722,41994,33397,8597,51233,-42636,557,1114,-43750,4993,178687,38731,139956,,55716,904.54,4873.82,0.001,33,137.35,1000.0,4.99,0.7537
9232,Hopkins Adams and Lee,False,US,West Eric,HealthTech,2017,https://hopkinsadamsandlee.com,Sometimes general mother front address purpose.,25,hopkins-adams-and-lee,2023,USD,1250877,273096,977781,583179,394602,0,394602,12508,25017,369585,180001,976118,467644,508474,104239.75,1250877,366.27,366.27,0.0442,2048,50.89,51626.55,3.49,0.7817
9233,Moss Group,False,NG,Sotostad,EdTech,2022,https://mossgroup.com,Bank own social play keep despite enough shake success piece.,17,moss-group,2023,USD,607690,320562,287128,327176,-40048,0,-40048,6076,12153,-52201,54652,413369,326739,86630,50640.83,607690,10.0,30.47,0.044,830,61.0,7106.39,7.69,0.4725
9234,Robinson Salinas and Savage,False,IN,New Bruceside,AgriTech,2016,https://robinsonsalinasandsavage.com,Must benefit put there others drug marriage how onto continue.,21,robinson-salinas-and-savage,2023,USD,126727,57099,69628,48214,21414,7696,13718,1267,2534,11184,49775,129071,40925,88146,,126727,1808.37,4476.73,0.0655,381,27.71,12115.04,4.11,0.5494
9235,Herrera PLC,False,FR,North Kathleenmouth,Mobility,2013,https://herreraplc.com,Might food whose thank protect candidate.,26,herrera-plc,2023,EUR,851711,85917,765794,751788,14006,0,14006,8517,17034,-3028,17144,510331,212847,297484,,851711,1158.49,5727.97,0.0222,783,90.57,95892.23,0.18,0.8991
9236,Norton-Ramos,False,DE,Gutierrezmouth,AgriTech,2019,https://norton-ramos.com,Yard wife bill evening side better the project activity citizen.,28,norton-ramos,2023,EUR,246582,143220,103362,134002,-30640,0,-30640,2465,4931,-35571,7163,312052,109281,202771,,246582,20.0,73.38,0.0553,1027,20.0,31850.08,0.22,0.4192
9237,Thomas Larson and Hurley,False,TN,Cummingsburgh,E-commerce,2014,https://thomaslarsonandhurley.com,Become source beyond sometimes maintain.,23,thomas-larson-and-hurley,2023,USD,877867,356013,521854,286065,235789,0,235789,8778,17557,218232,25399,513776,163111,350665,,877867,863.04,431.52,0.0331,3657,20.0,41627.31,0.61,0.5945
9238,Lindsey-Harris,False,NG,New Seanview,Energy,2016,https://lindsey-harris.com,Theory soon money thus only kitchen think.,18,lindsey-harris,2023,USD,3012369,1320920,1691449,1253051,438398,28112,410286,30123,60247,350039,277581,1964957,343562,1621395,,3012369,954.57,3156.18,0.001,6604,38.01,75244.69,3.69,0.5615
9239,Hopkins-Reed,False,EG,Michaelstad,IoT,2008,https://hopkins-reed.com,Beautiful thought somebody least account provide which cause.,18,hopkins-reed,2023,USD,420760,173712,247048,61081,185967,0,185967,4207,8415,177552,8437,399472,226128,173344,,420760,463.16,231.58,0.0264,113,308.09,22408.64,0.38,0.5871
9240,Martinez Burns and Harrison,False,GB,Smithfort,E-commerce,2017,https://martinezburnsandharrison.com,Employee low later fight shoulder approach many effort war.,23,martinez-burns-and-harrison,2023,USD,1114766,316302,798464,341485,456979,194,456785,11147,22295,434490,101819,818562,335100,483462,,1114766,1139.96,569.98,0.109,465,199.65,6759.58,15.06,0.7163
9241,Briggs Hanna and Owens,False,AU,Fosterhaven,AI/ML,2019,https://briggshannaandowens.com,Board do number alone pressure especially stage dream whatever.,22,briggs-hanna-and-owens,2023,USD,745118,316029,429089,37255,391834,0,391834,7451,14902,376932,47456,601538,154215,447323,,745118,20.0,47.34,0.0512,320,193.58,17964.95,2.64,0.5759
9242,Robinson Ltd,False,ZA,Colemanton,EdTech,2020,https://robinsonltd.com,College decide far together national morning.,21,robinson-ltd,2023,USD,268079,73140,194939,110070,84869,21562,63307,2680,5361,57946,13891,310051,194901,115150,22339.92,268079,10.0,69.43,0.0115,1453,15.37,1000.0,13.89,0.7272
9243,Hall LLC,False,AU,Port Amber,HealthTech,2021,https://hallllc.com,Region second others music money daughter instead effect.,21,hall-llc,2023,USD,476522,23826,452696,320713,131983,0,131983,4765,9530,122453,19471,326664,164739,161925,39710.17,476522,13.18,13.18,0.0137,388,102.32,1000.0,19.47,0.95
9244,Parks and Sons,False,NG,Port Julie,IoT,2009,https://parksandsons.com,Main entire market explain else whatever all husband.,12,parks-and-sons,2023,USD,110265,45394,64871,43169,21702,0,21702,1102,2205,19497,10715,241644,89700,151944,,110265,687.67,343.84,0.0393,158,57.94,1000.0,10.72,0.5883
9245,Jones-Noble,False,IN,East Johnbury,Cybersecurity,2022,https://jones-noble.com,Most but summer TV adult record.,26,jones-noble,2023,USD,3382329,1515589,1866740,2345808,-479068,0,-479068,33823,67646,-546714,21579,1774616,736295,1038321,,3382329,497.91,987.81,0.0076,1458,193.3,184524.4,0.12,0.5519
9246,Adams-Harris,False,GB,East Anna,EdTech,2024,https://adams-harris.com,Think next author health military section step while her.,15,adams-harris,2023,USD,368407,39827,328580,58937,269643,0,269643,3684,7368,262275,4393,354398,60664,293734,30700.58,368407,117.96,462.61,0.0447,2621,11.71,1000.0,4.39,0.8919
9247,Maldonado Ltd,False,TN,Ashleystad,Cybersecurity,2016,https://maldonadoltd.com,With tax early down assume ask cultural.,18,maldonado-ltd,2023,USD,1604485,730640,873845,872950,895,951,-56,16044,32089,-32145,53358,980475,463603,516872,,1604485,20.0,144.42,0.0981,561,238.0,47955.96,1.11,0.5446
9248,Gonzales Group,False,FR,Port Andrewshire,Marketplaces,2008,https://gonzalesgroup.com,Environment pay sit mind kitchen set degree rather stand second.,25,gonzales-group,2023,EUR,249385,70390,178995,117693,61302,0,61302,2493,4987,56315,29218,316006,92364,223642,,249385,538.12,1365.66,0.0502,211,98.28,5060.83,5.77,0.7177
9249,Scott Ltd,False,US,Port Michael,IoT,2018,https://scottltd.com,Put agree statement trip issue mouth staff.,23,scott-ltd,2023,USD,435905,174001,261904,21795,240109,9834,230275,4359,8718,221557,121698,501071,300669,200402,,435905,676.98,4456.82,0.1072,183,198.28,35619.3,3.42,0.6008
9250,Gill-Mcgee,False,DE,Michellestad,AI/ML,2018,https://gill-mcgee.com,Member both thus civil green.,18,gill-mcgee,2023,EUR,1580867,375729,1205138,898217,306921,32030,274891,15808,31617,243274,74999,1024926,204235,820691,,1580867,515.84,1294.95,0.0775,727,181.02,38994.36,1.92,0.7623
9251,Harrison Case and Smith,False,BR,Lake Eileentown,E-commerce,2023,https://harrisoncaseandsmith.com,Size development effort movie air use.,20,harrison-case-and-smith,2023,USD,2096068,800203,1295865,746971,548894,7297,541597,20960,41921,499676,68109,1305731,444969,860762,,2096068,20.0,55.62,0.1149,768,227.18,27347.24,2.49,0.6182
9252,Roberts Nichols and Perez,False,ZA,Sheltonberg,AgriTech,2013,https://robertsnicholsandperez.com,Amount growth cold computer western stuff really.,18,roberts-nichols-and-perez,2023,USD,1253778,563328,690450,471435,219015,0,219015,12537,25075,193940,243439,1002789,390667,612122,,1253778,72.91,150.95,0.075,525,198.74,22069.0,11.03,0.5507
9253,Baldwin Osborn and Villegas,False,FR,Charleston,Energy,2016,https://baldwinosbornandvillegas.com,Life treatment concern effect color so.,22,baldwin-osborn-and-villegas,2023,EUR,317105,102224,214881,121959,92922,0,92922,3171,6342,86580,11422,209533,74609,134924,,317105,20.0,26.81,0.0778,120,220.2,9530.37,1.2,0.6776
9254,Hatfield and Sons,False,DE,Erikatown,E-commerce,2008,https://hatfieldandsons.com,Rule future west head threat thought choose.,17,hatfield-and-sons,2023,EUR,1194652,275641,919011,1201750,-282739,14423,-297162,11946,23893,-321055,198872,920074,333659,586415,,1194652,656.02,1350.02,0.0542,499,199.24,101409.47,1.96,0.7693
9255,Perkins Ltd,False,AU,Cobbville,SaaS,2015,https://perkinsltd.com,Themselves recent music side general man.,27,perkins-ltd,2023,USD,1045846,232085,813761,819524,-5763,0,-5763,10458,20916,-26679,32055,726636,199295,527341,87153.83,1045846,969.34,5925.36,0.001,1992,43.75,73151.96,0.44,0.7781
9256,Lowe and Sons,False,EG,West John,AI/ML,2010,https://loweandsons.com,Something material business religious husband.,16,lowe-and-sons,2023,USD,766176,292171,474005,314882,159123,0,159123,7661,15323,143800,128153,598636,87541,511095,,766176,1237.95,4648.93,0.0538,528,120.81,1000.0,128.15,0.6187
9257,Walsh-Callahan,False,IN,Port Olivia,Marketplaces,2021,https://walsh-callahan.com,Use others room with should style note.,13,walsh-callahan,2023,USD,1536123,369080,1167043,1104488,62555,11410,51145,15361,30722,20423,45796,950356,628880,321476,,1536123,20.0,107.28,0.1295,440,290.29,75655.8,0.61,0.7597
9258,Garza Silva and Chavez,False,US,Hamptonland,AgriTech,2023,https://garzasilvaandchavez.com,Family arm the dog.,19,garza-silva-and-chavez,2023,USD,611418,319649,291769,374294,-82525,13457,-95982,6114,12228,-108210,163972,521627,109957,411670,,611418,409.85,700.29,0.0474,354,143.72,26093.74,6.28,0.4772
9259,Harris and Sons,False,BR,Peterbury,Marketplaces,2021,https://harrisandsons.com,Technology know type blue when policy ahead cold.,22,harris-and-sons,2023,USD,1407852,544964,862888,629135,233753,0,233753,14078,28157,205596,9605,795942,162822,633120,,1407852,1744.65,872.32,0.0308,5866,20.0,39977.87,0.24,0.6129
9260,Neal PLC,False,ZA,Davidfort,Fintech,2017,https://nealplc.com,Support her former common conference street toward.,21,neal-plc,2023,USD,2059993,1044590,1015403,2064296,-1048893,28277,-1077170,20599,41199,-1118369,16898,1073565,583433,490132,,2059993,20.0,33.09,0.001,787,217.86,154752.08,0.11,0.4929
9261,Barnett Sanders and Aguirre,False,DE,South Mariemouth,Mobility,2024,https://barnettsandersandaguirre.com,Hard arrive arm against thing close play enter operation of.,14,barnett-sanders-and-aguirre,2023,EUR,773958,286448,487510,130857,356653,23456,333197,7739,15479,317718,61477,487978,238168,249810,,773958,20.0,86.04,0.001,3224,20.0,4317.83,14.24,0.6299
9262,Flores Vega and Hernandez,False,NG,North Douglas,AgriTech,2016,https://floresvegaandhernandez.com,Federal him next single ahead.,13,flores-vega-and-hernandez,2023,USD,288335,110653,177682,189109,-11427,51046,-62473,2883,5766,-68239,30215,319552,47215,272337,,288335,20.0,10.0,0.0953,117,204.78,5084.73,5.94,0.6162
9263,King Ltd,False,DE,Gomezchester,Mobility,2009,https://kingltd.com,May build gun image customer take grow.,12,king-ltd,2023,EUR,203168,90377,112791,109441,3350,0,3350,2031,4063,-713,4568,157882,40685,117197,,203168,361.62,966.11,0.1081,156,107.89,17116.27,0.27,0.5552
9264,Lee Ltd,False,TN,Janicetown,Cybersecurity,2020,https://leeltd.com,Tv section mission do subject training feel add school determine.,25,lee-ltd,2023,USD,1946065,887749,1058316,509050,549266,12651,536615,19460,38921,497694,156582,1232350,256229,976121,,1946065,20.0,29.63,0.0457,942,172.15,38256.5,4.09,0.5438
9265,Smith-Bowman,False,FR,Sandramouth,AI/ML,2022,https://smith-bowman.com,Last set fill together officer bad.,25,smith-bowman,2023,EUR,1807250,434790,1372460,521326,851134,35484,815650,18072,36145,779505,59956,964735,538280,426455,,1807250,20.0,43.52,0.0231,7530,20.0,33006.68,1.82,0.7594
9266,Martinez Rodriguez and Gardner,False,BR,Bradshawton,E-commerce,2021,https://martinezrodriguezandgardner.com,Across all economic resource hold skill high seven all respond.,19,martinez-rodriguez-and-gardner,2023,USD,1275972,275715,1000257,485817,514440,0,514440,12759,25519,488921,47009,724050,358493,365557,,1275972,332.6,1206.3,0.0782,367,289.52,56048.62,0.84,0.7839
9267,Lynch Group,False,IN,Cookberg,Energy,2022,https://lynchgroup.com,Respond state type baby assume energy bag.,15,lynch-group,2023,USD,1014332,217880,796452,710590,85862,15510,70352,10143,20286,50066,53334,657710,217046,440664,,1014332,394.27,197.14,0.0403,600,140.82,37010.88,1.44,0.7852
9268,Armstrong LLC,False,GB,Leemouth,Marketplaces,2020,https://armstrongllc.com,Car hard arrive interest investment professional care daughter.,26,armstrong-llc,2023,USD,1212936,407055,805881,474398,331483,19910,311573,12129,24258,287315,40416,808762,40438,768324,,1212936,1387.79,4239.52,0.056,655,154.24,21041.11,1.92,0.6644
9269,Hunter Miller and Kennedy,False,AU,Lake Andrewburgh,EdTech,2020,https://huntermillerandkennedy.com,Information recognize room kind ever impact.,22,hunter-miller-and-kennedy,2023,USD,243010,86034,156976,188894,-31918,0,-31918,2430,4860,-36778,4645,246661,53646,193015,20250.83,243010,221.02,842.33,0.0245,360,56.16,1000.0,4.64,0.646
9270,Ramirez PLC,False,NG,Davidside,Fintech,2019,https://ramirezplc.com,Each unit blood positive life.,17,ramirez-plc,2023,USD,1437519,380369,1057150,787200,269950,0,269950,14375,28750,241200,257606,1096526,562743,533783,,1437519,278.58,1587.25,0.001,650,184.07,35271.97,7.3,0.7354
9271,Sutton Patrick and Hunter,False,BR,Angelaborough,AgriTech,2010,https://suttonpatrickandhunter.com,Director individual level rich six quality someone less draw.,19,sutton-patrick-and-hunter,2023,USD,524172,137212,386960,140842,246118,0,246118,5241,10483,235635,5817,415417,129406,286011,,524172,1217.05,4894.37,0.0378,459,95.16,1000.0,5.82,0.7382
9272,Moreno PLC,False,NG,Goodmanberg,E-commerce,2024,https://morenoplc.com,Run seat must thought our hard personal.,13,moreno-plc,2023,USD,690539,218500,472039,166375,305664,0,305664,6905,13810,291854,7147,548556,38838,509718,,690539,20.0,74.09,0.1071,579,99.25,43093.76,0.17,0.6836
9273,Morton Group,False,ZA,New Sandraville,IoT,2009,https://mortongroup.com,They current receive couple institution own.,20,morton-group,2023,USD,1177576,674202,503374,928187,-424813,0,-424813,11775,23551,-448364,58875,786694,273366,513328,,1177576,20.0,26.85,0.0678,4906,20.0,77517.59,0.76,0.4275
9274,Riddle Ltd,False,US,West Kevinfort,HealthTech,2022,https://riddleltd.com,Energy region their three young investment.,8,riddle-ltd,2023,USD,795613,377171,418442,306565,111877,7395,104482,7956,15912,88570,68450,471432,100484,370948,66301.08,795613,176.63,962.17,0.0473,783,84.57,20538.56,3.33,0.5259
9275,Lawson Group,False,EG,Dodsonburgh,Cybersecurity,2013,https://lawsongroup.com,Provide line decade reflect fire serve son meet whole authority.,20,lawson-group,2023,USD,3039603,1023725,2015878,3507513,-1491635,0,-1491635,30396,60792,-1552427,285832,1868183,636638,1231545,,3039603,441.85,1368.15,0.0012,1188,213.21,295323.1,0.97,0.6632
9276,Ross Golden and Lozano,False,KE,Jacobfort,Fintech,2008,https://rossgoldenandlozano.com,Trouble seven admit start make green.,25,ross-golden-and-lozano,2023,USD,687242,147992,539250,256672,282578,19941,262637,6872,13744,248893,186156,610155,61675,548480,,687242,1631.46,4397.78,0.0166,341,167.73,22774.9,8.17,0.7847
9277,Browning-Pitts,False,AU,South Rebeccaburgh,AI/ML,2017,https://browning-pitts.com,Positive budget address statement amount experience feel.,14,browning-pitts,2023,USD,1894460,264634,1629826,544962,1084864,0,1084864,18944,37889,1046975,15204,1148723,78908,1069815,,1894460,20.0,10.0,0.0575,643,245.44,54921.93,0.28,0.8603
9278,Johnston-Curtis,False,CA,Jennaton,SaaS,2022,https://johnston-curtis.com,Fire show night sure fish weight senior.,22,johnston-curtis,2023,USD,963993,321373,642620,626544,16076,24342,-8266,9639,19279,-27545,25997,528353,231613,296740,80332.75,963993,505.85,3123.28,0.0783,1052,76.32,88652.75,0.29,0.6666
9279,Miller-Hansen,False,BR,West Lorichester,AI/ML,2020,https://miller-hansen.com,Accept very rock choice always though we hit.,24,miller-hansen,2023,USD,1181011,558659,622352,548899,73453,0,73453,11810,23620,49833,88898,848405,676834,171571,,1181011,20.0,113.43,0.0402,4920,20.0,82725.43,1.07,0.527
9280,Olsen Montes and Lee,False,US,North Jennifer,AgriTech,2015,https://olsenmontesandlee.com,Year lot develop save hit.,22,olsen-montes-and-lee,2023,USD,334846,115876,218970,295329,-76359,4390,-80749,3348,6696,-87445,27353,316097,225264,90833,,334846,1257.22,2036.87,0.0206,242,115.09,10457.56,2.62,0.6539
9281,Underwood LLC,False,CA,Port Susan,Energy,2021,https://underwoodllc.com,Well tree fire which several early expect oil material good.,14,underwood-llc,2023,USD,1533516,301370,1232146,697809,534337,17743,516594,15335,30670,485924,19415,792070,582131,209939,,1533516,1224.0,6550.96,0.0277,6389,20.0,73989.67,0.26,0.8035
9282,Mcconnell King and Barrett,False,US,Laurafurt,E-commerce,2009,https://mcconnellkingandbarrett.com,Decide take land guy guess catch.,26,mcconnell-king-and-barrett,2023,USD,629327,301657,327670,412641,-84971,12242,-97213,6293,12586,-109799,28798,480847,233183,247664,,629327,759.25,1263.89,0.0691,2622,20.0,1000.0,28.8,0.5207
9283,Carroll Contreras and Vega,False,DE,Olsonview,Cybersecurity,2015,https://carrollcontrerasandvega.com,Candidate Democrat beat exist career color.,19,carroll-contreras-and-vega,2023,EUR,813980,114014,699966,377925,322041,0,322041,8139,16279,305762,17888,539086,259624,279462,,813980,155.62,522.01,0.0502,3087,21.97,31263.78,0.57,0.8599
9284,Blevins-Strong,False,EG,New Aaronport,AgriTech,2021,https://blevins-strong.com,Such admit central just cell Congress role movie.,19,blevins-strong,2023,USD,358570,195400,163170,203279,-40109,42036,-82145,3585,7171,-89316,2397,260219,172462,87757,,358570,1376.77,2007.29,0.1557,1494,20.0,26836.98,0.09,0.4551
9285,Gray Martin and Montgomery,False,KE,Port John,AI/ML,2015,https://graymartinandmontgomery.com,There management specific listen strategy consumer.,19,gray-martin-and-montgomery,2023,USD,983739,465342,518397,855761,-337364,0,-337364,9837,19674,-357038,63444,591822,95702,496120,,983739,509.15,1940.49,0.0176,2820,29.06,49954.43,1.27,0.527
9286,Hart-Thomas,False,DE,South Timothymouth,SaaS,2020,https://hart-thomas.com,Sea college firm fill some term into international financial.,19,hart-thomas,2023,EUR,3300037,1475103,1824934,1339525,485409,523,484886,33000,66000,418886,90263,1752907,135741,1617166,275003.08,3300037,206.2,799.2,0.0211,2920,94.17,124621.59,0.72,0.553
9287,Hansen PLC,False,EG,Newmanburgh,Marketplaces,2022,https://hansenplc.com,Total dream fine animal everybody chance tough.,15,hansen-plc,2023,USD,2752629,1067360,1685269,1693418,-8149,41848,-49997,27526,55052,-105049,189668,1699090,747953,951137,,2752629,102.37,97.21,0.0364,10855,21.13,127777.08,1.48,0.6122
9288,Weber-Brooks,False,BR,Mayton,EdTech,2008,https://weber-brooks.com,Better fill responsibility gas degree whatever civil.,19,weber-brooks,2023,USD,251810,141784,110026,94724,15302,0,15302,2518,5036,10266,17928,247832,97180,150652,20984.17,251810,81.89,308.24,0.0135,4196,5.0,20520.21,0.87,0.4369
9289,Castillo Group,False,TN,Sabrinafort,Mobility,2011,https://castillogroup.com,Commercial or born fire forget together bring mind bill.,19,castillo-group,2023,USD,1341643,478540,863103,708604,154499,11279,143220,13416,26832,116388,128318,885346,446975,438371,,1341643,1237.2,4534.28,0.096,5590,20.0,61914.39,2.07,0.6433
9290,Hunt-Guzman,False,NG,Lake Fernandochester,HealthTech,2013,https://hunt-guzman.com,Seven go language production development perform space event manager effect.,20,hunt-guzman,2023,USD,578266,144830,433436,45773,387663,2262,385401,5782,11565,373836,21964,486469,152616,333853,48188.83,578266,336.82,1580.96,0.0275,5051,9.54,1000.0,21.96,0.7495
9291,Lowe Bailey and Welch,False,ZA,New Barbaraview,HealthTech,2021,https://lowebaileyandwelch.com,Marriage agency real ahead production choose.,25,lowe-bailey-and-welch,2023,USD,586742,286071,300671,214008,86663,0,86663,5867,11734,74929,54747,451398,143335,308063,48895.17,586742,10.0,56.16,0.076,1034,47.27,26837.76,2.04,0.5124
9292,Berry Carey and Jensen,False,TN,Martinberg,Mobility,2016,https://berrycareyandjensen.com,Common break arrive crime son feeling speech prepare a indicate ability.,25,berry-carey-and-jensen,2023,USD,457105,246353,210752,78857,131895,6436,125459,4571,9142,116317,47897,421930,173895,248035,,457105,471.74,2067.15,0.0427,185,205.33,9802.65,4.89,0.4611
9293,Barker-Greene,False,AU,Lake Jennifer,Fintech,2008,https://barker-greene.com,Allow role maintain major throughout both better always recognize himself.,15,barker-greene,2023,USD,444770,229515,215255,296015,-80760,0,-80760,4447,8895,-89655,17723,377292,126948,250344,,444770,1591.17,4179.05,0.0599,248,149.22,1000.0,17.72,0.484
9294,Rojas Group,False,AU,West Davidstad,AI/ML,2022,https://rojasgroup.com,Recently most president challenge dog PM weight.,23,rojas-group,2023,USD,164276,62224,102052,83346,18706,12878,5828,1642,3285,2543,95100,280854,90863,189991,,164276,20.0,85.92,0.036,158,86.55,28549.57,3.33,0.6212
9295,Anderson-Fleming,False,NG,New Aaron,Marketplaces,2024,https://anderson-fleming.com,Team Democrat new song follow success race real see read page.,22,anderson-fleming,2023,USD,279216,104181,175035,84187,90848,1848,89000,2792,5584,83416,8840,257654,29745,227909,,279216,1451.77,2770.45,0.0307,362,64.26,1000.0,8.84,0.6269
9296,Allen Barker and Brown,False,TN,Leefort,E-commerce,2014,https://allenbarkerandbrown.com,Trade by then ask discover nature task.,23,allen-barker-and-brown,2023,USD,364177,36638,327539,78640,248899,30146,218753,3641,7283,211470,11645,311986,104858,207128,,364177,20.0,138.19,0.1043,1517,20.0,41557.36,0.28,0.8994
9297,Olson-Bailey,False,NG,New Adam,E-commerce,2009,https://olson-bailey.com,Parent animal seven win different decide black.,18,olson-bailey,2023,USD,456123,110999,345124,255055,90069,9618,80451,4561,9122,71329,15602,260894,41393,219501,,456123,718.81,2125.05,0.0891,1900,20.0,1000.0,15.6,0.7566
9298,Calderon-Zimmerman,False,TN,Shanemouth,Mobility,2014,https://calderon-zimmerman.com,Majority employee board management each difference tree.,17,calderon-zimmerman,2023,USD,178658,72289,106369,21429,84940,14894,70046,1786,3573,66473,1910,142030,123574,18456,,178658,1745.17,7762.03,0.1337,139,106.37,1000.0,1.91,0.5954
9299,Hurley-Flowers,False,KE,Lake Martha,Energy,2014,https://hurley-flowers.com,Yet myself series country wear machine from development number sort throw.,26,hurley-flowers,2023,USD,640179,110479,529700,32008,497692,3101,494591,6401,12803,481788,127646,597536,268751,328785,,640179,20.0,86.64,0.1146,2274,23.45,1000.0,127.65,0.8274
9300,Harris Archer and Harris,False,IN,Campbellmouth,Marketplaces,2013,https://harrisarcherandharris.com,History alone smile firm eat ball forward left walk better across.,24,harris-archer-and-harris,2023,USD,220502,61943,158559,123103,35456,0,35456,2205,4410,31046,21472,133527,32150,101377,,220502,1283.49,641.74,0.1152,90,203.32,29346.19,0.73,0.7191
9301,Merritt PLC,False,ZA,Powersland,AI/ML,2024,https://merrittplc.com,Player case think new anything.,18,merritt-plc,2023,USD,1018380,347989,670391,323222,347169,35031,312138,10183,20367,291771,116212,632749,290236,342513,,1018380,1337.82,3267.09,0.0462,593,142.91,14992.12,7.75,0.6583
9302,Robinson Smith and Marshall,False,AU,Port Markville,Mobility,2020,https://robinsonsmithandmarshall.com,Board range scene free purpose.,17,robinson-smith-and-marshall,2023,USD,893939,438251,455688,385663,70025,12891,57134,8939,17878,39256,78271,606858,112267,494591,,893939,715.56,3281.75,0.0602,859,86.69,34124.69,2.29,0.5098
9303,Davidson-May,False,US,Blackwelltown,Cybersecurity,2018,https://davidson-may.com,Conference book prepare true.,16,davidson-may,2023,USD,2037537,687315,1350222,1324814,25408,0,25408,20375,40750,-15342,76113,1271861,471729,800132,,2037537,20.0,43.47,0.0579,8489,20.0,131118.68,0.58,0.6627
9304,Larson Lowe and Hughes,False,AU,New Tonya,Marketplaces,2018,https://larsonloweandhughes.com,Fire way level activity piece investment everything police.,24,larson-lowe-and-hughes,2023,USD,804860,278040,526820,212086,314734,22423,292311,8048,16097,276214,120696,628706,31435,597271,,804860,1249.27,5589.02,0.0573,397,168.74,22865.1,5.28,0.6545
9305,Phillips Inc,False,US,South Diamond,Marketplaces,2017,https://phillipsinc.com,Part happy long four ago accept exist see and player.,20,phillips-inc,2023,USD,334043,108655,225388,54637,170751,1184,169567,3340,6680,162887,11508,356002,94299,261703,,334043,20.0,14.37,0.0378,124,223.69,21257.37,0.54,0.6747
9306,Chapman Eaton and Williams,False,KE,Walkerfort,HealthTech,2012,https://chapmaneatonandwilliams.com,Someone style I weight.,16,chapman-eaton-and-williams,2023,USD,147554,45921,101633,113069,-11436,43728,-55164,1475,2951,-58115,5989,233743,58459,175284,12296.17,147554,114.1,358.42,0.0242,2459,5.0,12949.93,0.46,0.6888
9307,Garrett-Walker,False,FR,Burkeside,Cybersecurity,2022,https://garrett-walker.com,Interview trip man true one admit of set language action.,22,garrett-walker,2023,EUR,961904,277204,684700,188719,495981,444,495537,9619,19238,476299,26922,623785,154024,469761,,961904,699.27,748.4,0.0386,895,89.5,23157.78,1.16,0.7118
9308,Jones Ramos and Wallace,False,US,Cruzchester,AgriTech,2021,https://jonesramosandwallace.com,International expect these could mouth.,14,jones-ramos-and-wallace,2023,USD,125237,55306,69931,20495,49436,20097,29339,1252,2504,26835,5147,258223,120121,138102,,125237,540.74,1870.49,0.001,94,110.75,1000.0,5.15,0.5584
9309,Perkins-Peterson,False,AU,Port Michellemouth,Cybersecurity,2010,https://perkins-peterson.com,Around few call her wait.,26,perkins-peterson,2023,USD,810748,536818,273930,879420,-605490,18847,-624337,8107,16214,-640551,108198,532794,342004,190790,,810748,1178.96,1785.72,0.001,804,83.94,89606.17,1.21,0.3379
9310,Andersen-Cook,False,NG,North Mary,Energy,2022,https://andersen-cook.com,Stay none we administration meeting cost travel appear back.,16,andersen-cook,2023,USD,586261,182335,403926,399617,4309,16483,-12174,5862,11725,-23899,8206,389014,49687,339327,,586261,564.23,3846.41,0.1069,883,55.27,76744.38,0.11,0.689
9311,Myers Murphy and Delgado,False,US,Blaketon,Energy,2020,https://myersmurphyanddelgado.com,Middle try particularly memory save doctor spend three movement.,17,myers-murphy-and-delgado,2023,USD,2987545,1744981,1242564,613370,629194,0,629194,29875,59750,569444,18954,1615240,1117058,498182,,2987545,651.54,3192.07,0.121,2136,116.53,67939.93,0.28,0.4159
9312,Kelly PLC,False,DE,Shawfurt,HealthTech,2009,https://kellyplc.com,Yet system right expert particular never.,21,kelly-plc,2023,EUR,1089582,396979,692603,692263,340,16571,-16231,10895,21791,-38022,15160,606605,335952,270653,90798.5,1089582,10.0,47.43,0.0023,9517,9.54,61811.16,0.25,0.6357
9313,Taylor-Berger,False,AU,Lake Karen,Fintech,2020,https://taylor-berger.com,With list accept role way each beat media.,19,taylor-berger,2023,USD,948224,352947,595277,331049,264228,0,264228,9482,18964,245264,23886,579114,173287,405827,,948224,46.89,68.55,0.1153,3950,20.0,14634.37,1.63,0.6278
9314,Andersen LLC,False,AU,North Michael,HealthTech,2008,https://andersenllc.com,Idea line grow car president simply with thousand bed study.,18,andersen-llc,2023,USD,2535232,666261,1868971,752926,1116045,16774,1099271,25352,50704,1048567,89940,1434129,322405,1111724,211269.33,2535232,10.0,25.9,0.055,4745,44.52,84395.74,1.07,0.7372
9315,Davila and Sons,False,EG,Sanchezbury,EdTech,2013,https://davilaandsons.com,Total anything past successful list hair.,18,davila-and-sons,2023,USD,537508,208227,329281,163292,165989,28414,137575,5375,10750,126825,237731,624885,183446,441439,44792.33,537508,529.38,4018.01,0.0227,1241,36.07,1000.0,237.73,0.6126
9316,Martin-Sanders,False,AU,Port Mariah,AI/ML,2010,https://martin-sanders.com,Large security how capital.,16,martin-sanders,2023,USD,971773,131516,840257,735952,104305,16717,87588,9717,19435,68153,32824,712772,137566,575206,,971773,116.57,372.2,0.0717,379,213.42,49211.39,0.67,0.8647
9317,Caldwell LLC,False,BR,Daveburgh,IoT,2013,https://caldwellllc.com,Produce later interest include since debate fish probably risk him.,29,caldwell-llc,2023,USD,302722,80288,222434,170242,52192,4972,47220,3027,6054,41166,91819,409829,209088,200741,,302722,20.0,30.11,0.001,709,35.56,5136.84,17.87,0.7348
9318,Hanna-Acevedo,False,EG,East Maria,Fintech,2012,https://hanna-acevedo.com,Physical house month rich soldier box decision he old manage.,30,hanna-acevedo,2023,USD,362121,93039,269082,421399,-152317,41736,-194053,3621,7242,-201295,21388,244158,70071,174087,,362121,603.32,429.48,0.1829,382,78.85,52765.11,0.41,0.7431
9319,Campbell and Sons,False,TN,New Lisaborough,Cybersecurity,2018,https://campbellandsons.com,Wind pull memory free do yes time address option.,15,campbell-and-sons,2023,USD,353242,172704,180538,192771,-12233,0,-12233,3532,7064,-19297,10826,291597,35623,255974,,353242,866.42,433.21,0.1195,450,65.31,36295.99,0.3,0.5111
9320,Schwartz-Velazquez,False,AU,Perryfort,EdTech,2015,https://schwartz-velazquez.com,Model offer kitchen Congress so short.,23,schwartz-velazquez,2023,USD,396731,172180,224551,217688,6863,32917,-26054,3967,7934,-33988,46170,399571,39507,360064,33060.92,396731,112.19,561.89,0.057,471,70.16,33567.82,1.38,0.566
9321,Charles Johnson and Smith,False,EG,Stewarttown,Fintech,2022,https://charlesjohnsonandsmith.com,Continue ever miss somebody not car there vote action thank.,24,charles-johnson-and-smith,2023,USD,2068699,1126675,942024,463079,478945,5500,473445,20686,41373,432072,25330,1161480,387811,773669,,2068699,20.0,10.0,0.001,907,190.0,35692.08,0.71,0.4554
9322,Calhoun Huynh and Mercado,False,ZA,Ramirezburgh,SaaS,2021,https://calhounhuynhandmercado.com,Of foreign road any rise really.,24,calhoun-huynh-and-mercado,2023,USD,255119,95995,159124,45399,113725,11434,102291,2551,5102,97189,45763,312306,189307,122999,21259.92,255119,10.0,57.5,0.0607,316,67.26,1000.0,45.76,0.6237
9323,Brown-Jones,False,IN,New Richardmouth,IoT,2016,https://brown-jones.com,Garden low present north magazine capital law land.,26,brown-jones,2023,USD,334627,130247,204380,189850,14530,5847,8683,3346,6692,1991,5464,300815,179667,121148,,334627,2056.56,3825.36,0.1474,106,262.28,6997.27,0.78,0.6108
9324,Newman Group,False,GB,South Scott,Energy,2017,https://newmangroup.com,Yes leave age father himself perhaps.,18,newman-group,2023,USD,3317918,1059120,2258798,991039,1267759,14642,1253117,33179,66358,1186759,291708,2109121,449590,1659531,,3317918,1862.91,5491.05,0.0946,13824,20.0,97740.38,2.98,0.6808
9325,Hensley-Simmons,False,GB,East Christineport,SaaS,2014,https://hensley-simmons.com,Hospital stop detail big.,13,hensley-simmons,2023,USD,434859,175128,259731,21742,237989,6870,231119,4348,8697,222422,46969,266183,94990,171193,36238.25,434859,128.53,582.88,0.0124,7247,5.0,5439.13,8.64,0.5973
9326,Coleman Nguyen and Pena,False,ZA,Kellychester,Cybersecurity,2015,https://colemannguyenandpena.com,Charge time answer watch wide station security wife air Mrs later.,20,coleman-nguyen-and-pena,2023,USD,1015887,471980,543907,714883,-170976,22422,-193398,10158,20317,-213715,109464,790489,279175,511314,,1015887,1482.25,4755.33,0.0219,547,154.69,59850.12,1.83,0.5354
9327,Merritt Ltd,False,FR,West Maria,Marketplaces,2015,https://merrittltd.com,Box direction material chair none would site common.,24,merritt-ltd,2023,EUR,392696,130568,262128,293101,-30973,15373,-46346,3926,7853,-54199,20668,361438,27784,333654,,392696,20.0,37.25,0.0863,336,97.28,6136.43,3.37,0.6675
9328,Reyes PLC,False,CA,Villanuevaside,AgriTech,2008,https://reyesplc.com,Last teach which sport serve poor.,18,reyes-plc,2023,USD,329168,108003,221165,119289,101876,0,101876,3291,6583,95293,37025,216203,31321,184882,,329168,344.7,1357.63,0.0082,112,242.91,1000.0,37.02,0.6719
9329,Hernandez-Davis,False,FR,Markburgh,AgriTech,2019,https://hernandez-davis.com,Give both which professional brother office serve.,24,hernandez-davis,2023,EUR,203389,69771,133618,110984,22634,23515,-881,2033,4067,-4948,20966,189146,102233,86913,,203389,20.0,71.17,0.001,847,20.0,4629.62,4.53,0.657
9330,Carlson and Sons,False,AU,South Stevenburgh,IoT,2021,https://carlsonandsons.com,Near evening threat player goal real report.,25,carlson-and-sons,2023,USD,756871,222798,534073,337865,196208,14918,181290,7568,15137,166153,572273,1000689,476762,523927,,756871,763.18,2994.36,0.1009,209,301.25,48931.41,11.7,0.7056
9331,Payne Aguilar and Clark,False,EG,New Patricia,SaaS,2020,https://payneaguilarandclark.com,Prove letter daughter apply think southern south still fight.,16,payne-aguilar-and-clark,2023,USD,145890,60380,85510,56127,29383,0,29383,1458,2917,26466,17698,205092,108168,96924,12157.5,145890,1039.3,5385.32,0.001,219,55.33,4234.72,4.18,0.5861
9332,Allen Blake and Logan,False,KE,Nicoleview,HealthTech,2010,https://allenblakeandlogan.com,Serve age moment Congress forget.,18,allen-blake-and-logan,2023,USD,2435087,848393,1586694,953842,632852,3753,629099,24350,48701,580398,93100,1440459,901716,538743,202923.92,2435087,256.84,1141.51,0.078,40584,5.0,92983.82,1.0,0.6516
9333,Davis-Jones,False,KE,Hallchester,E-commerce,2022,https://davis-jones.com,Add grow carry body director bring major standard.,16,davis-jones,2023,USD,2392718,860160,1532558,1778819,-246261,28934,-275195,23927,47854,-323049,76314,1351520,465394,886126,,2392718,868.43,434.22,0.034,1035,192.49,209112.3,0.36,0.6405
9334,Williams and Sons,False,DE,New James,SaaS,2019,https://williamsandsons.com,Take field positive no position.,23,williams-and-sons,2023,EUR,2259658,563936,1695722,1588576,107146,0,107146,22596,45193,61953,59914,1387526,325740,1061786,188304.83,2259658,274.63,1251.92,0.0284,4177,45.08,134905.27,0.44,0.7504
9335,Gonzales Ltd,False,IN,Port Robert,IoT,2024,https://gonzalesltd.com,Thus anything ever message exist eat clearly memory.,17,gonzales-ltd,2023,USD,436584,240110,196474,101342,95132,35107,60025,4365,8731,51294,9853,234111,92186,141925,,436584,59.19,262.03,0.0338,385,94.44,1000.0,9.85,0.45
9336,Jones Rangel and Osborne,False,GB,North Jessicashire,AgriTech,2015,https://jonesrangelandosborne.com,Major computer too its each statement spend talk.,19,jones-rangel-and-osborne,2023,USD,1022390,277100,745290,728980,16310,0,16310,10223,20447,-4137,366630,968115,122337,845778,,1022390,355.16,177.58,0.001,4259,20.0,64758.79,5.66,0.729
9337,Hayden PLC,False,NG,Tylerburgh,AI/ML,2016,https://haydenplc.com,Mention control red new call Mrs first eight help issue.,21,hayden-plc,2023,USD,2013385,371249,1642136,100669,1541467,10417,1531050,20133,40267,1490783,162887,1353103,511969,841134,,2013385,20.0,114.97,0.0406,1317,127.36,1000.0,162.89,0.8156
9338,Walker and Sons,False,BR,Lake Dannyhaven,EdTech,2009,https://walkerandsons.com,Movement gas finally around.,27,walker-and-sons,2023,USD,194538,47737,146801,66759,80042,20918,59124,1945,3890,55234,11359,288339,155241,133098,16211.5,194538,136.37,606.57,0.001,213,75.92,1000.0,11.36,0.7546
9339,Gamble-White,False,ZA,North Rubentown,HealthTech,2010,https://gamble-white.com,Memory see economic fly Mrs politics focus even lead plant.,13,gamble-white,2023,USD,683828,185505,498323,269863,228460,0,228460,6838,13676,214784,237755,627872,55486,572386,56985.67,683828,28.48,94.38,0.0631,936,60.87,1000.0,237.76,0.7287
9340,Graham Bolton and Villanueva,False,EG,Bankshaven,Cybersecurity,2011,https://grahamboltonandvillanueva.com,Wife account song only issue recent.,22,graham-bolton-and-villanueva,2023,USD,1868033,883836,984197,1136313,-152116,15816,-167932,18680,37360,-205292,78231,1012406,455925,556481,,1868033,318.27,770.65,0.1709,1979,78.65,148293.62,0.53,0.5269
9341,Day-Morgan,False,TN,Port Robertborough,Mobility,2024,https://day-morgan.com,Student attorney born cold fly time.,16,day-morgan,2023,USD,1022562,451397,571165,616994,-45829,33191,-79020,10225,20451,-99471,132523,659018,142974,516044,,1022562,20.0,69.4,0.063,629,135.37,59699.89,2.22,0.5586
9342,Taylor Mann and Rice,False,US,Ramirezmouth,Energy,2020,https://taylormannandrice.com,Watch window firm impact player chair how service.,20,taylor-mann-and-rice,2023,USD,1050641,192862,857779,863167,-5388,0,-5388,10506,21012,-26400,39321,671177,353814,317363,,1050641,1035.27,526.63,0.0456,4377,20.0,66419.26,0.59,0.8164
9343,Jimenez Townsend and Mcintosh,False,BR,Lake Jodi,AgriTech,2015,https://jimeneztownsendandmcintosh.com,Marriage every recognize into public.,20,jimenez-townsend-and-mcintosh,2023,USD,124522,11512,113010,72103,40907,40607,300,1245,2490,-2190,29297,249797,12489,237308,,124522,20.0,10.0,0.0523,45,229.6,15633.37,1.87,0.9076
9344,Wright Raymond and Fleming,False,BR,North Kenneth,Fintech,2018,https://wrightraymondandfleming.com,Space partner fund nice prevent three sense direction change.,19,wright-raymond-and-fleming,2023,USD,619809,193364,426445,212579,213866,0,213866,6198,12396,201470,10539,472783,106870,365913,,619809,538.9,2489.27,0.001,426,120.97,10765.14,0.98,0.688
9345,Dixon Elliott and Ruiz,False,BR,North Bryanmouth,AI/ML,2009,https://dixonelliottandruiz.com,Current region yet painting four level network him.,17,dixon-elliott-and-ruiz,2023,USD,1734395,643141,1091254,1132109,-40855,0,-40855,17343,34687,-75542,580078,1501273,339646,1161627,,1734395,20.0,59.92,0.096,1823,79.28,88173.21,6.58,0.6292
9346,Serrano Inc,False,FR,West Alexander,Energy,2016,https://serranoinc.com,Manage itself tell already where.,13,serrano-inc,2023,EUR,538311,188250,350061,183942,166119,15432,150687,5383,10766,139921,103338,433474,74712,358762,,538311,20.0,30.23,0.0419,2242,20.0,8208.03,12.59,0.6503
9347,Andrade Livingston and Smith,False,AU,Port Haley,IoT,2012,https://andradelivingstonandsmith.com,Too lay tree apply support relate.,18,andrade-livingston-and-smith,2023,USD,762958,287877,475081,302624,172457,0,172457,7629,15259,157198,54845,603892,77736,526156,,762958,891.73,4014.36,0.0167,1463,43.45,7122.66,7.7,0.6227
9348,Lopez Rivas and Cole,False,BR,South Elizabethshire,AI/ML,2010,https://lopezrivasandcole.com,System mind simple trial figure rest federal maybe.,20,lopez-rivas-and-cole,2023,USD,1352683,520085,832598,839148,-6550,0,-6550,13526,27053,-33603,102973,832794,296984,535810,,1352683,1158.64,4843.9,0.0134,569,197.98,72969.12,1.41,0.6155
9349,Ryan Inc,False,CA,New Anthonyfort,SaaS,2014,https://ryaninc.com,Gun way window wind set forget control benefit guy point.,20,ryan-inc,2023,USD,1027553,107114,920439,601051,319388,0,319388,10275,20551,298837,98190,675783,128726,547057,85629.42,1027553,212.45,1698.29,0.0957,17125,5.0,50036.22,1.96,0.8958
9350,Mcneil PLC,False,EG,Brewerland,SaaS,2011,https://mcneilplc.com,Majority color personal why produce organization stop.,17,mcneil-plc,2023,USD,834044,355213,478831,527371,-48540,0,-48540,8340,16680,-65220,96050,652803,360272,292531,69503.67,834044,10.0,62.82,0.001,2557,27.18,30196.7,3.18,0.5741
9351,Brown-Adams,False,EG,North Rodneybury,SaaS,2012,https://brown-adams.com,General two degree yourself fund strategy program choose fine.,23,brown-adams,2023,USD,2815359,640710,2174649,566568,1608081,11962,1596119,28153,56307,1539812,239173,1783060,692315,1090745,234613.25,2815359,933.39,4929.14,0.0398,4612,50.87,47174.71,5.07,0.7724
9352,Walker-Moran,False,TN,Mcintyreville,Marketplaces,2017,https://walker-moran.com,Else anyone hard increase important.,12,walker-moran,2023,USD,108111,31714,76397,95143,-18746,26899,-45645,1081,2162,-47807,9154,123913,30469,93444,,108111,20.0,90.73,0.001,109,82.39,1000.0,9.15,0.7067
9353,Weiss-Taylor,False,US,Ericmouth,Mobility,2009,https://weiss-taylor.com,Free newspaper card guess state ask determine pass yourself.,12,weiss-taylor,2023,USD,1282866,64143,1218723,323446,895277,18504,876773,12828,25657,851116,483581,1162436,373427,789009,,1282866,2178.45,1089.22,0.0032,640,167.03,5711.38,84.67,0.95
9354,Heath Howard and Wilson,False,DE,Mccoyland,SaaS,2024,https://heathhowardandwilson.com,Statement conference forward day letter head book common system.,18,heath-howard-and-wilson,2023,EUR,2552026,1041645,1510381,294556,1215825,0,1215825,25520,51040,1164785,34568,1341564,265419,1076145,212668.83,2552026,85.01,114.52,0.0367,3688,57.66,30485.75,1.13,0.5918
9355,Davis Ltd,False,BR,New Robert,AI/ML,2009,https://davisltd.com,Source dark factor second east.,19,davis-ltd,2023,USD,1195456,638628,556828,505968,50860,0,50860,11954,23909,26951,44484,800931,312817,488114,,1195456,1048.83,1715.01,0.0851,1966,50.65,69235.3,0.64,0.4658
9356,Hall-Daniel,False,NG,Bennettview,Marketplaces,2010,https://hall-daniel.com,Do take Congress goal teach fund bag perform sit ahead push.,13,hall-daniel,2023,USD,906541,55630,850911,55652,795259,36188,759071,9065,18130,740941,11034,630302,229854,400448,,906541,382.15,528.56,0.039,630,119.88,1000.0,11.03,0.9386
9357,Pierce White and Mora,False,EG,New Melissaland,HealthTech,2020,https://piercewhiteandmora.com,Sing Mr politics ability appear sing.,19,pierce-white-and-mora,2023,USD,605634,102477,503157,406843,96314,38827,57487,6056,12112,45375,31498,409288,32783,376505,50469.5,605634,10.0,44.45,0.0385,682,73.93,46995.66,0.67,0.8308
9358,Smith-Cochran,False,GB,North Jasonborough,AI/ML,2013,https://smith-cochran.com,Growth international fear between more especially about specific impact.,18,smith-cochran,2023,USD,314553,120147,194406,93185,101221,18672,82549,3145,6291,76258,8540,331232,186785,144447,,314553,20.0,21.75,0.0996,147,178.01,4980.45,1.71,0.618
9359,Wood Hayes and Gomez,False,KE,North Michaelland,Energy,2013,https://woodhayesandgomez.com,Get bag military attention eat source into military surface stock.,23,wood-hayes-and-gomez,2023,USD,10042760,3761398,6281362,8212621,-1931259,8458,-1939717,100427,200855,-2140572,1886168,6960008,348000,6612008,,10042760,20.0,14.98,0.0581,4039,207.18,684701.16,2.75,0.6255
9360,Roberts Ltd,False,BR,South Robert,AgriTech,2017,https://robertsltd.com,Within present six its data test ball up.,13,roberts-ltd,2023,USD,336054,111484,224570,206086,18484,37878,-19394,3360,6721,-26115,8383,365678,59256,306422,,336054,979.9,8051.95,0.0917,243,115.08,24898.92,0.34,0.6683
9361,Smith LLC,False,NG,Whitetown,E-commerce,2008,https://smithllc.com,Require fine responsibility benefit skill six crime pick.,18,smith-llc,2023,USD,272909,95998,176911,142336,34575,0,34575,2729,5458,29117,114538,307411,58436,248975,,272909,403.06,201.53,0.0794,1137,20.0,1000.0,114.54,0.6482
9362,Alvarez Group,False,BR,Kirkfurt,SaaS,2022,https://alvarezgroup.com,She let on cultural head agree.,18,alvarez-group,2023,USD,205061,87300,117761,37582,80179,0,80179,2050,4101,76078,18862,212707,92254,120453,17088.42,205061,374.65,1518.55,0.0011,3417,5.0,1000.0,18.86,0.5743
9363,Wolfe Henderson and Walker,False,GB,South Nancy,AI/ML,2024,https://wolfehendersonandwalker.com,Movement color TV admit day.,20,wolfe-henderson-and-walker,2023,USD,556817,209735,347082,45633,301449,9100,292349,5568,11136,281213,101687,526779,396957,129822,,556817,308.08,1339.88,0.0113,325,142.49,1000.0,101.69,0.6233
9364,Mckenzie-Rios,False,BR,Rodriguezhaven,IoT,2018,https://mckenzie-rios.com,Consumer serve Republican act range return allow doctor picture work.,23,mckenzie-rios,2023,USD,192701,60314,132387,97873,34514,218,34296,1927,3854,30442,1354,290199,123017,167182,,192701,20.0,124.43,0.1096,129,124.23,4762.57,0.28,0.687
9365,Juarez Gibson and Acosta,False,KE,Lake Taylor,HealthTech,2022,https://juarezgibsonandacosta.com,Huge course ten rich against sport.,19,juarez-gibson-and-acosta,2023,USD,3361028,551336,2809692,168051,2641641,0,2641641,33610,67220,2574421,392809,2173276,642964,1530312,280085.67,3361028,10.0,23.63,0.0084,9684,28.92,39445.52,9.96,0.836
9366,Robinson-Nelson,False,BR,Kathleenberg,AgriTech,2010,https://robinson-nelson.com,Security source wrong forward at moment.,17,robinson-nelson,2023,USD,91152,37483,53669,53532,137,0,137,911,1823,-1686,6380,129656,25025,104631,,91152,357.29,551.38,0.1226,45,165.43,4755.39,1.34,0.5888
9367,Owens and Sons,False,FR,Richardbury,Energy,2008,https://owensandsons.com,High number treatment conference whatever.,22,owens-and-sons,2023,EUR,5682173,3079060,2603113,4308115,-1705002,19750,-1724752,56821,113643,-1838395,789683,3731990,1476231,2255759,,5682173,20.0,74.93,0.0809,23675,20.0,335711.16,2.35,0.4581
9368,Valdez Group,False,TN,New Joan,IoT,2011,https://valdezgroup.com,Military through miss price program.,24,valdez-group,2023,USD,284946,108721,176225,45639,130586,7641,122945,2849,5698,117247,26738,312008,134664,177344,,284946,282.49,706.9,0.0948,121,194.83,1000.0,26.74,0.6185
9369,Garrett Hall and Shaw,False,ZA,New Amber,IoT,2020,https://garretthallandshaw.com,Raise member magazine group sort organization back accept magazine.,27,garrett-hall-and-shaw,2023,USD,307513,63869,243644,70232,173412,6154,167258,3075,6150,161108,24275,376770,218260,158510,,307513,30.19,185.01,0.0656,184,138.58,29187.96,0.83,0.7923
9370,Thompson Johnson and Yang,False,FR,South Christopher,HealthTech,2023,https://thompsonjohnsonandyang.com,Policy late learn force tough include include time.,14,thompson-johnson-and-yang,2023,EUR,1527302,807117,720185,691482,28703,26964,1739,15273,30546,-28807,141695,1026406,51320,975086,127275.17,1527302,10.0,42.88,0.1084,9562,13.31,64646.94,2.19,0.4715
9371,Waters Inc,False,TN,Jenniferhaven,Energy,2012,https://watersinc.com,Improve environment poor notice collection system laugh.,14,waters-inc,2023,USD,1195218,491550,703668,637447,66221,0,66221,11952,23904,42317,16325,646530,241147,405383,,1195218,814.08,407.04,0.0137,930,107.05,53665.71,0.3,0.5887
9372,Garcia Mays and Gardner,False,US,East Leslie,AI/ML,2009,https://garciamaysandgardner.com,Product head oil you current figure speak local include.,24,garcia-mays-and-gardner,2023,USD,223592,78000,145592,174507,-28915,17403,-46318,2235,4471,-50789,2788,259488,73598,185890,,223592,1220.12,5276.8,0.0059,72,258.58,23389.59,0.12,0.6512
9373,Mendoza Mcgrath and Branch,False,NG,Michelleton,HealthTech,2008,https://mendozamcgrathandbranch.com,Outside east middle yourself product building mission his make.,22,mendoza-mcgrath-and-branch,2023,USD,559235,130293,428942,335723,93219,0,93219,5592,11184,82035,48009,414652,141495,273157,46602.92,559235,668.5,2301.96,0.0351,1648,28.27,32319.86,1.49,0.767
9374,Jones LLC,False,DE,Bridgetview,IoT,2011,https://jonesllc.com,Agree choice build growth wall save sport current only.,21,jones-llc,2023,EUR,205288,55562,149726,133957,15769,0,15769,2052,4105,11664,23835,154369,60825,93544,,205288,41.76,108.88,0.0217,94,181.37,1683.44,14.16,0.7293
9375,Conrad-Page,False,EG,Donaldton,SaaS,2013,https://conrad-page.com,Mouth after few development.,16,conrad-page,2023,USD,79214,26107,53107,35550,17557,0,17557,792,1584,15973,26217,245211,47406,197805,6601.17,79214,433.23,1382.54,0.0792,217,30.37,1000.0,26.22,0.6704
9376,Hernandez-Lopez,False,TN,Maryfurt,EdTech,2016,https://hernandez-lopez.com,Model child shake offer spend seem look what enjoy.,18,hernandez-lopez,2023,USD,309663,53712,255951,204563,51388,0,51388,3096,6193,45195,14122,358153,103298,254855,25805.25,309663,503.64,3564.2,0.0208,287,89.63,1000.0,14.12,0.8265
9377,Tucker Douglas and Gray,False,IN,East Alan,AgriTech,2014,https://tuckerdouglasandgray.com,Figure will seek story goal.,25,tucker-douglas-and-gray,2023,USD,6585726,1915999,4669727,3388467,1281260,23343,1257917,65857,131714,1126203,139830,3514123,1139204,2374919,,6585726,20.0,94.53,0.1197,4539,120.9,267834.74,0.52,0.7091
9378,Gibson and Sons,False,CA,West Duaneport,IoT,2020,https://gibsonandsons.com,Evidence tend agree attention feel.,20,gibson-and-sons,2023,USD,557202,124937,432265,168394,263871,0,263871,5572,11144,252727,87284,481532,154073,327459,,557202,20.0,11.53,0.001,262,176.99,52360.07,1.67,0.7758
9379,Wilson Torres and Mccormick,False,BR,Port Michellemouth,Marketplaces,2013,https://wilsontorresandmccormick.com,Interesting lot phone should tend.,16,wilson-torres-and-mccormick,2023,USD,326466,56108,270358,151067,119291,24921,94370,3264,6529,87841,37843,218131,10906,207225,,326466,503.6,951.46,0.001,404,67.19,39491.52,0.96,0.8281
9380,Hogan Inc,False,BR,Harrisonbury,AgriTech,2018,https://hoganinc.com,Develop plan stuff very poor deal.,20,hogan-inc,2023,USD,842897,461355,381542,566415,-184873,19503,-204376,8428,16857,-221233,8557,526206,338182,188024,,842897,1293.26,4880.1,0.1701,375,187.27,39785.59,0.22,0.4527
9381,Smith LLC,False,NG,Poolemouth,Marketplaces,2023,https://smithllc.com,Mrs off trouble pull heavy.,24,smith-llc,2023,USD,177061,67159,109902,131128,-21226,24874,-46100,1770,3541,-49641,25168,204147,98241,105906,,177061,20.0,39.38,0.001,126,116.32,22994.97,1.09,0.6207
9382,Cole Group,False,US,Coxview,Fintech,2013,https://colegroup.com,Ok piece wrong little beat authority.,16,cole-group,2023,USD,4682374,432349,4250025,839897,3410128,0,3410128,46823,93647,3316481,1508649,3862775,1684629,2178146,,4682374,20.0,50.53,0.0409,3070,127.07,41945.4,35.97,0.9077
9383,Ford Leonard and Bush,False,US,South Linda,Cybersecurity,2017,https://fordleonardandbush.com,Travel fall power according.,19,ford-leonard-and-bush,2023,USD,3151825,911263,2240562,852940,1387622,0,1387622,31518,63036,1324586,31246,1651644,300472,1351172,,3151825,1612.7,2368.56,0.001,1355,193.75,84734.21,0.37,0.7109
9384,Joyce Jefferson and Garcia,False,AU,Sheltonfurt,Marketplaces,2012,https://joycejeffersonandgarcia.com,Car agreement language total partner painting.,14,joyce-jefferson-and-garcia,2023,USD,4439428,1797876,2641552,221971,2419581,7708,2411873,44394,88788,2323085,33547,2332473,1476791,855682,,4439428,20.0,10.0,0.0453,1981,186.72,1000.0,33.55,0.595
9385,Booker Rice and Adkins,False,IN,Oliverville,HealthTech,2019,https://bookerriceandadkins.com,Land certain point knowledge will music perhaps rich thank people.,23,booker-rice-and-adkins,2023,USD,244850,146111,98739,115193,-16454,55221,-71675,2448,4897,-76572,47877,367268,68973,298295,20404.17,244850,333.66,1542.35,0.001,364,56.05,24006.12,1.99,0.4033
9386,Stewart Ltd,False,DE,Port Jessehaven,Energy,2008,https://stewartltd.com,Carry card within parent institution time large decade.,18,stewart-ltd,2023,EUR,2132722,732362,1400360,290314,1110046,1296,1108750,21327,42654,1066096,5367,1203556,563600,639956,,2132722,20.0,10.0,0.0136,8886,20.0,31187.03,0.17,0.6566
9387,Palmer Mcclain and Townsend,False,KE,Mcdonaldview,Fintech,2012,https://palmermcclainandtownsend.com,Check leave oil that write.,17,palmer-mcclain-and-townsend,2023,USD,879930,356246,523684,102536,421148,0,421148,8799,17598,403550,33347,552392,478987,73405,,879930,117.9,279.38,0.0735,3666,20.0,7405.24,4.5,0.5951
9388,Lee Ltd,False,DE,Lake Alexstad,Mobility,2019,https://leeltd.com,Movement type party exactly receive nation agency glass.,21,lee-ltd,2023,EUR,567979,109867,458112,28398,429714,0,429714,5679,11359,418355,66389,420541,145735,274806,,567979,20.0,30.19,0.0746,353,133.8,30217.17,2.2,0.8066
9389,Davis King and Becker,False,DE,East Robert,SaaS,2013,https://daviskingandbecker.com,Place forget black certain room office should structure agency.,20,davis-king-and-becker,2023,EUR,390604,140256,250348,130465,119883,32577,87306,3906,7812,79494,26258,239465,200357,39108,32550.33,390604,10.0,24.14,0.0482,2316,14.05,17001.94,1.54,0.6409
9390,Dunn-Nelson,False,NG,Brianville,AgriTech,2022,https://dunn-nelson.com,Class up join job that few all yard.,21,dunn-nelson,2023,USD,136030,38736,97294,16778,80516,7040,73476,1360,2720,70756,5823,214497,76661,137836,,136030,20.0,71.12,0.001,566,20.0,1000.0,5.82,0.7152
9391,Vazquez PLC,False,TN,Georgefurt,Cybersecurity,2009,https://vazquezplc.com,Central season value company pass week day clear.,21,vazquez-plc,2023,USD,1010138,177723,832415,115751,716664,15364,701300,10101,20202,681098,82952,743631,360409,383222,,1010138,371.45,2832.01,0.001,290,289.33,15286.8,5.43,0.8241
9392,Bell Burke and Wright,False,DE,Colefurt,IoT,2020,https://bellburkeandwright.com,Truth door agency indeed radio throw else society industry.,24,bell-burke-and-wright,2023,EUR,424294,142080,282214,271385,10829,0,10829,4242,8485,2344,18603,286885,115453,171432,,424294,20.0,18.47,0.0023,1337,26.43,1000.0,18.6,0.6651
9393,Webb PLC,False,BR,Chanberg,Mobility,2008,https://webbplc.com,Though memory they along chance use return almost.,16,webb-plc,2023,USD,3468148,1521245,1946903,941350,1005553,0,1005553,34681,69362,936191,958854,2881399,667015,2214384,,3468148,120.17,224.01,0.1344,1343,215.09,93944.79,10.21,0.5614
9394,Williams LLC,False,GB,Henryfort,AgriTech,2015,https://williamsllc.com,Similar class short bag trouble last push.,26,williams-llc,2023,USD,2743135,600311,2142824,1803404,339420,0,339420,27431,54862,284558,41674,1504600,529549,975051,,2743135,1040.47,3523.46,0.001,11429,20.0,136845.01,0.3,0.7812
9395,Blankenship Garcia and Vasquez,False,TN,South Catherine,E-commerce,2012,https://blankenshipgarciaandvasquez.com,When safe career writer voice health able.,20,blankenship-garcia-and-vasquez,2023,USD,2364956,885096,1479860,1190899,288961,1301,287660,23649,47299,240361,21173,1298540,578832,719708,,2364956,20.0,27.75,0.082,1550,127.14,119281.47,0.18,0.6257
9396,Alvarado LLC,False,AU,Onealside,Cybersecurity,2017,https://alvaradollc.com,Similar serious seven season may according knowledge nation or official.,20,alvarado-llc,2023,USD,627463,261809,365654,227535,138119,0,138119,6274,12549,125570,50556,430786,289672,141114,,627463,1019.72,1275.49,0.0719,480,108.77,43125.86,1.17,0.5827
9397,Fleming Becker and Webb,False,US,Lake Jamiemouth,E-commerce,2019,https://flemingbeckerandwebb.com,Mission state life bring could force left much exist sure.,17,fleming-becker-and-webb,2023,USD,580123,148334,431789,150181,281608,954,280654,5801,11602,269052,22060,490243,24512,465731,,580123,20.0,18.15,0.0617,354,136.37,1145.71,19.25,0.7443
9398,Cline Peterson and White,False,DE,South Rebecca,Cybersecurity,2021,https://clinepetersonandwhite.com,Onto tax Democrat exist mean test off boy say ago.,28,cline-peterson-and-white,2023,EUR,1134124,348454,785670,342121,443549,0,443549,11341,22682,420867,32893,689136,175381,513755,,1134124,20.0,103.26,0.1587,355,266.06,8780.41,3.75,0.6928
9399,Thompson Ltd,False,IN,West Kevin,AI/ML,2010,https://thompsonltd.com,Idea theory more indicate their say couple.,12,thompson-ltd,2023,USD,197325,80571,116754,104229,12525,27222,-14697,1973,3946,-18643,15090,173351,67379,105972,,197325,729.43,2738.99,0.0228,822,20.0,1000.0,15.09,0.5917
9400,Mason-Morris,False,ZA,Scottchester,AI/ML,2022,https://mason-morris.com,Push figure full participant shake its officer already take rate.,21,mason-morris,2023,USD,997176,332330,664846,422204,242642,9765,232877,9971,19943,212934,26317,687639,34381,653258,,997176,998.97,3850.71,0.0972,344,240.96,41376.57,0.64,0.6667
9401,Phillips and Sons,False,AU,Lake Daniel,E-commerce,2016,https://phillipsandsons.com,Material my moment church democratic.,22,phillips-and-sons,2023,USD,1021449,748324,273125,452465,-179340,0,-179340,10214,20428,-199768,65756,603463,391859,211604,,1021449,1121.29,1246.8,0.001,513,165.89,40059.69,1.64,0.2674
9402,Burns-White,False,BR,Bryantville,SaaS,2015,https://burns-white.com,International six idea system early a maintain space statement.,15,burns-white,2023,USD,501735,324920,176815,211098,-34283,0,-34283,5017,10034,-44317,4058,335688,182775,152913,41811.25,501735,10.0,10.06,0.001,501,83.33,50783.69,0.08,0.3524
9403,Zimmerman and Sons,False,TN,Curtisberg,Cybersecurity,2016,https://zimmermanandsons.com,Physical south traditional personal wrong simply expect.,21,zimmerman-and-sons,2023,USD,2607082,884093,1722989,1693470,29519,18293,11226,26070,52141,-40915,69762,1449944,170652,1279292,,2607082,20.0,51.39,0.0603,595,365.12,152093.99,0.46,0.6609
9404,Gutierrez Inc,False,NG,West Lisachester,AI/ML,2012,https://gutierrezinc.com,Order there management not whether show no church reduce.,21,gutierrez-inc,2023,USD,227404,92306,135098,97435,37663,22061,15602,2274,4548,11054,19243,274383,176596,97787,,227404,1802.23,7474.41,0.0426,694,27.28,25273.71,0.76,0.5941
9405,Leonard Ltd,False,FR,Lake Johnside,E-commerce,2022,https://leonardltd.com,News power available may film vote either always.,19,leonard-ltd,2023,EUR,553482,198760,354722,418365,-63643,0,-63643,5534,11069,-74712,21011,391311,94166,297145,,553482,986.46,629.53,0.0628,447,102.96,27023.65,0.78,0.6409
9406,Schwartz and Sons,False,EG,East John,EdTech,2024,https://schwartzandsons.com,Drive visit far so together.,11,schwartz-and-sons,2023,USD,123930,41024,82906,41772,41134,23222,17912,1239,2478,15434,13909,153413,19146,134267,10327.5,123930,262.08,1602.5,0.0117,82,124.66,11028.03,1.26,0.669
9407,Johnson LLC,False,CA,Bakerport,AgriTech,2020,https://johnsonllc.com,Star husband pass environmental short.,13,johnson-llc,2023,USD,387111,19355,367756,256840,110916,22400,88516,3871,7742,80774,11081,397641,176523,221118,,387111,1460.78,6261.45,0.0452,1187,27.17,10126.26,1.09,0.95
9408,West Inc,False,TN,New Jessica,HealthTech,2014,https://westinc.com,Table trial capital arrive least environment.,21,west-inc,2023,USD,1010680,492640,518040,710353,-192313,11412,-203725,10106,20213,-223938,61531,713987,352990,360997,84223.33,1010680,355.08,967.81,0.0321,3561,23.65,67163.91,0.92,0.5126
9409,Kirk-Williams,False,GB,Schwartzburgh,EdTech,2021,https://kirk-williams.com,Protect thank shake believe similar own fight.,25,kirk-williams,2023,USD,1062885,229751,833134,299108,534026,12046,521980,10628,21257,500723,32577,731296,290155,441141,88573.75,1062885,10.0,47.96,0.0558,1293,68.48,14916.11,2.18,0.7838
9410,Perkins Tyler and Collins,False,US,South Victoria,Energy,2020,https://perkinstylerandcollins.com,Discuss nothing young possible area responsibility only there need.,20,perkins-tyler-and-collins,2023,USD,2017404,762502,1254902,448029,806873,0,806873,20174,40348,766525,67278,1220686,327507,893179,,2017404,20.0,92.41,0.0921,3499,48.04,19231.53,3.5,0.622
9411,Rodriguez Jones and Wilkerson,False,AU,Port Emily,Mobility,2024,https://rodriguezjonesandwilkerson.com,Themselves myself plant first specific city site.,18,rodriguez-jones-and-wilkerson,2023,USD,246719,55173,191546,170046,21500,28817,-7317,2467,4934,-12251,7492,262651,125436,137215,,246719,129.36,406.12,0.001,1027,20.0,39706.12,0.19,0.7764
9412,Bowers Group,False,TN,North Johnton,AgriTech,2010,https://bowersgroup.com,Yeah network pretty democratic national.,28,bowers-group,2023,USD,232463,103566,128897,186155,-57258,56435,-113693,2324,4649,-118342,16148,143198,70197,73001,,232463,20.0,10.0,0.0721,169,114.26,9453.9,1.71,0.5545
9413,Kidd-Anderson,False,GB,West Carolyn,E-commerce,2017,https://kidd-anderson.com,Plant maintain environmental government writer.,14,kidd-anderson,2023,USD,211766,57975,153791,73197,80594,6315,74279,2117,4235,70044,32119,148839,32850,115989,,211766,20.0,28.76,0.1119,109,160.48,1000.0,32.12,0.7262
9414,Webster LLC,False,KE,Aprilville,Mobility,2013,https://websterllc.com,Next far each kitchen her receive.,23,webster-llc,2023,USD,5379780,2750770,2629010,3298771,-669761,13957,-683718,53797,107595,-791313,1076783,3889640,888202,3001438,,5379780,1243.31,4512.02,0.0508,3886,115.36,270088.66,3.99,0.4887
9415,Spence Patterson and Keller,False,GB,Johntown,Cybersecurity,2009,https://spencepattersonandkeller.com,Out sense often affect court citizen public.,17,spence-patterson-and-keller,2023,USD,165354,65816,99538,106910,-7372,3392,-10764,1653,3307,-14071,7292,190690,21578,169112,,165354,20.0,78.41,0.102,84,162.98,21475.1,0.34,0.602
9416,Jefferson Blankenship and Martinez,False,IN,Alexisville,HealthTech,2024,https://jeffersonblankenshipandmartinez.com,Ahead history already ask sort federal crime.,21,jefferson-blankenship-and-martinez,2023,USD,1669349,473452,1195897,801602,394295,6861,387434,16693,33386,354048,109209,1014243,183298,830945,139112.42,1669349,10.0,22.23,0.04,3417,40.7,82143.84,1.33,0.7164
9417,Taylor PLC,False,TN,East Mackenzie,HealthTech,2013,https://taylorplc.com,Pay look subject deal agency heart court from television.,15,taylor-plc,2023,USD,468716,113980,354736,250667,104069,0,104069,4687,9374,94695,21595,301958,64790,237168,39059.67,468716,590.76,1428.62,0.0397,781,49.99,27554.97,0.78,0.7568
9418,Brown-Baker,False,TN,Port Susantown,IoT,2012,https://brown-baker.com,Fight case investment wish picture eight month whose.,23,brown-baker,2023,USD,1492056,776148,715908,744770,-28862,18763,-47625,14920,29841,-77466,55575,872639,385486,487153,,1492056,20.24,134.62,0.001,2181,57.0,58595.95,0.95,0.4798
9419,Miller James and Daniels,False,US,Port Samuelland,Energy,2021,https://millerjamesanddaniels.com,Country by toward once economic.,17,miller-james-and-daniels,2023,USD,439036,144541,294495,286293,8202,15376,-7174,4390,8780,-15954,26079,339820,98834,240986,,439036,861.5,3954.74,0.0138,188,193.98,56832.29,0.46,0.6708
9420,Wright-Turner,False,TN,Taylorview,Fintech,2022,https://wright-turner.com,Marriage since for feel whom near.,25,wright-turner,2023,USD,1586395,756783,829612,102761,726851,0,726851,15863,31727,695124,134984,1124982,405116,719866,,1586395,20.0,119.33,0.0055,6609,20.0,1000.0,134.98,0.523
9421,Wilson Cole and Adams,False,KE,Ellismouth,IoT,2021,https://wilsoncoleandadams.com,Service law sit this offer manager maybe.,23,wilson-cole-and-adams,2023,USD,899446,304582,594864,535685,59179,0,59179,8994,17988,41191,28952,603504,63732,539772,,899446,20.0,78.75,0.1625,2749,27.26,65350.08,0.44,0.6614
9422,Mendoza-Williamson,False,GB,Scottton,EdTech,2019,https://mendoza-williamson.com,Hot position black ten do add thank book again.,24,mendoza-williamson,2023,USD,464079,114764,349315,385969,-36654,0,-36654,4640,9281,-45935,31719,443726,112042,331684,38673.25,464079,76.16,131.6,0.0143,531,72.82,37882.26,0.84,0.7527
9423,Munoz-Rogers,False,TN,Johnville,IoT,2012,https://munoz-rogers.com,Avoid certain compare suddenly image shake.,18,munoz-rogers,2023,USD,1038001,590024,447977,545602,-97625,0,-97625,10380,20760,-118385,33525,559759,211999,347760,,1038001,20.0,127.91,0.0632,318,271.67,74586.15,0.45,0.4316
9424,Jackson-Williams,False,KE,Port Samantha,Cybersecurity,2015,https://jackson-williams.com,Argue what citizen or piece state everyone respond probably.,20,jackson-williams,2023,USD,819477,238335,581142,702686,-121544,8109,-129653,8194,16389,-146042,45678,637606,80473,557133,,819477,20.0,24.68,0.0068,3414,20.0,60656.43,0.75,0.7092
9425,Shields Bush and Castillo,False,DE,Russellville,E-commerce,2023,https://shieldsbushandcastillo.com,Draw share along project generation kind name difficult explain.,10,shields-bush-and-castillo,2023,EUR,1842263,463035,1379228,793307,585921,0,585921,18422,36845,549076,694227,1621549,251715,1369834,,1842263,20.0,10.0,0.001,474,323.45,61865.05,11.22,0.7487
9426,Shaw-Gonzales,False,TN,East Michaelview,AI/ML,2024,https://shaw-gonzales.com,Apply series general pick season adult learn together.,20,shaw-gonzales,2023,USD,3817719,1203783,2613936,2584466,29470,11435,18035,38177,76354,-58319,725497,2731687,1774061,957626,,3817719,20.0,86.88,0.0886,2800,113.62,226528.36,3.2,0.6847
9427,Williams PLC,False,EG,New Matthew,Cybersecurity,2023,https://williamsplc.com,Conference vote population expert personal listen.,13,williams-plc,2023,USD,249183,59779,189404,119030,70374,0,70374,2491,4983,65391,3255,211816,61219,150597,,249183,261.2,1094.16,0.096,96,215.49,26775.98,0.12,0.7601
9428,Wade-Sexton,False,EG,Stonestad,IoT,2013,https://wade-sexton.com,Take all until green less reflect.,18,wade-sexton,2023,USD,1312053,771782,540271,727970,-187699,25036,-212735,13120,26241,-238976,179316,957065,162279,794786,,1312053,1438.15,5877.08,0.0395,1721,63.53,80717.82,2.22,0.4118
9429,Guerra-Gallegos,False,CA,Jonathanport,Energy,2008,https://guerra-gallegos.com,Red seem kid site build break response prevent plant across push.,16,guerra-gallegos,2023,USD,3097261,1088501,2008760,987705,1021055,0,1021055,30972,61945,959110,215671,1949324,1077992,871332,,3097261,1292.55,6968.8,0.0573,1904,135.49,45978.12,4.69,0.6486
9430,Vazquez-Harding,False,IN,Cherylton,Fintech,2015,https://vazquez-harding.com,Type sport then total use situation wide station at quickly.,17,vazquez-harding,2023,USD,1861736,651567,1210169,514977,695192,0,695192,18617,37234,657958,438868,1474108,339222,1134886,,1861736,1008.3,2586.25,0.074,7757,20.0,4623.07,94.93,0.65
9431,Brewer Aguilar and Cooper,False,IN,Katrinaview,AI/ML,2013,https://breweraguilarandcooper.com,Appear operation left contain approach ten key agree new.,15,brewer-aguilar-and-cooper,2023,USD,1522317,896215,626102,392081,234021,0,234021,15223,30446,203575,256088,1084574,54228,1030346,,1522317,228.65,974.91,0.03,393,322.36,69641.62,3.68,0.4113
9432,Holt-Mccarthy,False,US,Duranside,AI/ML,2016,https://holt-mccarthy.com,Those arrive cell base camera stay consider.,19,holt-mccarthy,2023,USD,2036244,1157757,878487,884082,-5595,0,-5595,20362,40724,-46319,22474,1142927,752486,390441,,2036244,336.55,2051.31,0.0511,802,211.53,60750.66,0.37,0.4314
9433,Jordan Adams and Williams,False,KE,Mollyburgh,EdTech,2011,https://jordanadamsandwilliams.com,Glass nation report produce hit.,21,jordan-adams-and-williams,2023,USD,609772,197046,412726,270778,141948,0,141948,6097,12195,129753,9038,338729,186223,152506,50814.33,609772,10.0,10.0,0.0143,748,67.89,60304.45,0.15,0.6769
9434,Lawrence and Sons,False,CA,Lake Brandon,EdTech,2024,https://lawrenceandsons.com,Bring certainly ok approach need chair west.,13,lawrence-and-sons,2023,USD,61763,29963,31800,26894,4906,49084,-44178,617,1235,-45413,3224,34642,1732,32910,5146.92,61763,732.29,2737.65,0.0635,71,71.78,1000.0,3.22,0.5149
9435,Gutierrez Perez and Price,False,ZA,Mendezside,EdTech,2010,https://gutierrezperezandprice.com,Conference product various realize environmental spring young.,15,gutierrez-perez-and-price,2023,USD,231595,18939,212656,103830,108826,7219,101607,2315,4631,96976,15735,164184,46653,117531,19299.58,231595,233.35,776.33,0.0024,330,58.41,2530.03,6.22,0.9182
9436,Vazquez Park and Johnson,False,GB,South Allisontown,HealthTech,2020,https://vazquezparkandjohnson.com,Main kitchen source Mrs even candidate.,17,vazquez-park-and-johnson,2023,USD,988911,204956,783955,450202,333753,47409,286344,9889,19778,266566,56596,698731,271212,427519,82409.25,988911,10.0,41.74,0.001,1155,71.33,61547.09,0.92,0.7927
9437,Newton-Boyd,False,US,West Beth,SaaS,2008,https://newton-boyd.com,Candidate easy health minute lawyer out.,21,newton-boyd,2023,USD,2123802,227015,1896787,662170,1234617,1473,1233144,21238,42476,1190668,401565,1501049,573125,927924,176983.5,2123802,51.16,160.52,0.0314,4510,39.24,55585.16,7.22,0.8931
9438,Acosta-Maynard,False,FR,New Lisa,AgriTech,2017,https://acosta-maynard.com,See series ready final hot life almost.,21,acosta-maynard,2023,EUR,874919,303829,571090,431913,139177,27535,111642,8749,17498,94144,18807,468643,60983,407660,,874919,20.0,25.56,0.0914,370,196.92,46537.51,0.4,0.6527
9439,Johnston-Johnson,False,US,Port David,Marketplaces,2022,https://johnston-johnson.com,Age organization reason enjoy dream name hour main national.,18,johnston-johnson,2023,USD,933441,283705,649736,360951,288785,6712,282073,9334,18668,263405,16832,656823,397612,259211,,933441,20.0,114.51,0.1518,1740,44.68,1000.0,16.83,0.6961
9440,Williams Mccoy and Ross,False,TN,Matthewfurt,HealthTech,2010,https://williamsmccoyandross.com,Concern east throughout nature science.,31,williams-mccoy-and-ross,2023,USD,4046393,904138,3142255,1742553,1399702,33290,1366412,40463,80927,1285485,55736,2115635,1030670,1084965,337199.42,4046393,406.67,2435.53,0.0498,7876,42.81,152721.33,0.36,0.7766
9441,Contreras Brooks and Mcknight,False,AU,Peterside,AgriTech,2015,https://contrerasbrooksandmcknight.com,Color although impact score close old mouth recognize keep choice.,26,contreras-brooks-and-mcknight,2023,USD,4491276,2004283,2486993,2705671,-218678,19896,-238574,44912,89825,-328399,85137,2443698,801407,1642291,,4491276,568.03,3274.01,0.0095,18713,20.0,215859.41,0.39,0.5537
9442,Hernandez and Sons,False,US,Duranport,AgriTech,2010,https://hernandezandsons.com,Mother relationship available condition question region present ability.,19,hernandez-and-sons,2023,USD,313311,106651,206660,24907,181753,0,181753,3133,6266,175487,42868,217389,102749,114640,,313311,20.0,62.37,0.0556,116,224.16,54528.16,0.79,0.6596
9443,Moon Rogers and Robles,False,DE,Lauraburgh,AgriTech,2011,https://moonrogersandrobles.com,Something them wish talk air help add big friend.,25,moon-rogers-and-robles,2023,EUR,141581,45591,95990,96293,-303,6103,-6406,1415,2831,-9237,2329,218516,28717,189799,,141581,876.24,1607.26,0.0073,589,20.0,9256.47,0.25,0.678
9444,Collier Phillips and Simmons,False,US,Shafferport,EdTech,2024,https://collierphillipsandsimmons.com,Draw though glass four big dream.,23,collier-phillips-and-simmons,2023,USD,279718,48621,231097,13985,217112,33319,183793,2797,5594,178199,25959,195360,34785,160575,23309.83,279718,441.68,2222.73,0.039,283,82.28,10573.6,2.46,0.8262
9445,Yoder Daniels and Garcia,False,AU,Parkerburgh,IoT,2023,https://yoderdanielsandgarcia.com,Think among red approach least.,23,yoder-daniels-and-garcia,2023,USD,850152,253371,596781,381151,215630,2502,213128,8501,17003,196125,77383,547938,38630,509308,,850152,20.0,55.1,0.1295,3542,20.0,32611.35,2.37,0.702
9446,Price Sanders and Knight,False,CA,Aliciaton,HealthTech,2023,https://pricesandersandknight.com,Relationship head may country Mrs continue.,25,price-sanders-and-knight,2023,USD,2281086,848283,1432803,431562,1001241,0,1001241,22810,45621,955620,119969,1295771,64788,1230983,190090.5,2281086,10.0,69.23,0.0429,2455,77.41,23440.58,5.12,0.6281
9447,Quinn Ltd,False,GB,Cabrerahaven,SaaS,2021,https://quinnltd.com,Event specific while reveal still itself.,17,quinn-ltd,2023,USD,451067,167623,283444,143218,140226,29244,110982,4510,9021,101961,2484,380110,150563,229547,37588.92,451067,379.8,897.47,0.001,414,90.76,29521.83,0.08,0.6284
9448,Martin Carter and Lopez,False,BR,South Paulside,E-commerce,2020,https://martincarterandlopez.com,Maybe build cell woman a government president newspaper.,22,martin-carter-and-lopez,2023,USD,749947,451577,298370,214589,83781,8229,75552,7499,14998,60554,41355,516813,72881,443932,,749947,346.73,357.76,0.0838,1059,58.98,46507.98,0.89,0.3979
9449,Jenkins Williams and Ortiz,False,IN,Garciachester,HealthTech,2012,https://jenkinswilliamsandortiz.com,Fast share blue stay pay budget case vote activity memory husband.,18,jenkins-williams-and-ortiz,2023,USD,739922,288226,451696,340841,110855,19954,90901,7399,14798,76103,5776,456485,227910,228575,61660.17,739922,142.48,691.19,0.0582,714,86.3,28874.8,0.2,0.6105
9450,Floyd-Kelley,False,IN,East Maryport,SaaS,2018,https://floyd-kelley.com,Number character fine relationship together real yourself.,23,floyd-kelley,2023,USD,447764,209224,238540,402861,-164321,16700,-181021,4477,8955,-189976,75447,468270,60893,407377,37313.67,447764,186.63,1094.27,0.0297,7462,5.0,22464.3,3.36,0.5327
9451,Carter-Walker,False,KE,Josephmouth,Cybersecurity,2012,https://carter-walker.com,Piece fine service improve order research increase often.,21,carter-walker,2023,USD,342873,175056,167817,119051,48766,0,48766,3428,6857,41909,38844,302020,90218,211802,,342873,20.0,124.55,0.1244,616,46.38,5653.14,6.87,0.4894
9452,Christensen-Rodriguez,False,US,Richardview,AI/ML,2013,https://christensen-rodriguez.com,Rule finish easy money control very send plan.,23,christensen-rodriguez,2023,USD,2155650,1000067,1155583,1654595,-499012,17607,-516619,21556,43113,-559732,131942,1271937,385943,885994,,2155650,20.0,83.46,0.0562,558,321.93,171193.1,0.77,0.5361
9453,Tyler-Beck,False,DE,East Deborah,E-commerce,2015,https://tyler-beck.com,Break least south base everybody focus coach part.,10,tyler-beck,2023,EUR,3667229,1531165,2136064,2652995,-516931,10407,-527338,36672,73344,-600682,92130,2115581,795727,1319854,,3667229,20.0,10.0,0.1028,2608,117.15,241297.18,0.38,0.5825
9454,Ingram Inc,False,US,New Jenniferport,IoT,2023,https://ingraminc.com,Surface so individual where gas church everybody wonder white early.,21,ingram-inc,2023,USD,1128909,204159,924750,391964,532786,0,532786,11289,22578,510208,1080367,1808538,1025845,782693,,1128909,20.0,10.0,0.1624,434,216.41,28773.03,37.55,0.8192
9455,Blackburn-Kemp,False,TN,Lopezburgh,Energy,2011,https://blackburn-kemp.com,Particularly race represent market section appear.,19,blackburn-kemp,2023,USD,1047567,450500,597067,853001,-255934,22148,-278082,10475,20951,-299033,204965,818263,395622,422641,,1047567,666.95,646.86,0.0366,650,134.26,71514.85,2.87,0.57
9456,Lowe-Melton,False,KE,New Kara,AgriTech,2020,https://lowe-melton.com,Late southern state scene bad.,10,lowe-melton,2023,USD,156576,57913,98663,38382,60281,2053,58228,1565,3131,55097,36992,309014,114728,194286,,156576,370.85,924.77,0.0803,178,73.11,1000.0,36.99,0.6301
9457,Hanson LLC,False,GB,Schmittmouth,IoT,2009,https://hansonllc.com,Some eight much seem so direction.,16,hanson-llc,2023,USD,746330,290698,455632,117530,338102,26245,311857,7463,14926,296931,74198,613542,154898,458644,,746330,85.21,313.94,0.0839,724,85.84,29328.01,2.53,0.6105
9458,Sanchez Washington and Daniel,False,BR,South Jeffrey,E-commerce,2020,https://sanchezwashingtonanddaniel.com,Through consumer police small gun consider apply traditional baby want education.,12,sanchez-washington-and-daniel,2023,USD,4000401,416950,3583451,3138205,445246,3368,441878,40004,80008,361870,975708,3077777,153888,2923889,,4000401,20.0,98.73,0.001,1599,208.45,236290.97,4.13,0.8958
9459,Johnson and Sons,False,NG,North Kathleen,HealthTech,2008,https://johnsonandsons.com,Also support system list fill less.,13,johnson-and-sons,2023,USD,3226910,598970,2627940,1495617,1132323,23540,1108783,32269,64538,1044245,273098,2079703,514686,1565017,268909.17,3226910,10.0,35.59,0.0676,4014,66.98,147623.93,1.85,0.8144
9460,Carpenter Hobbs and David,False,FR,Nicholemouth,Mobility,2019,https://carpenterhobbsanddavid.com,Head manager majority force realize serve soldier probably protect.,19,carpenter-hobbs-and-david,2023,EUR,960224,333723,626501,109521,516980,0,516980,9602,19204,497776,39398,659310,229804,429506,,960224,1281.75,5546.08,0.072,855,93.49,12200.1,3.23,0.6525
9461,Nelson Inc,False,DE,South Jaredburgh,Marketplaces,2008,https://nelsoninc.com,Real best us decide pass firm policy another.,21,nelson-inc,2023,EUR,1004421,460223,544198,230593,313605,0,313605,10044,20088,293517,98227,657939,276296,381643,,1004421,58.33,103.45,0.0399,4185,20.0,29721.58,3.3,0.5418
9462,Smith PLC,False,EG,Lake Laurenborough,IoT,2021,https://smithplc.com,Person while say anyone station provide level protect.,17,smith-plc,2023,USD,145084,36438,108646,80989,27657,31943,-4286,1450,2901,-7187,14981,173178,69607,103571,,145084,1225.88,3653.59,0.1142,135,89.23,1000.0,14.98,0.7488
9463,Riggs Pittman and Barron,False,TN,Port Angelatown,Fintech,2024,https://riggspittmanandbarron.com,Only painting condition ten debate item outside alone speak.,18,riggs-pittman-and-barron,2023,USD,2431532,506562,1924970,633800,1291170,36739,1254431,24315,48630,1205801,127915,1374429,875714,498715,,2431532,676.95,2274.27,0.1125,977,207.38,42194.14,3.03,0.7917
9464,Long-Bernard,False,TN,Port Andrew,IoT,2018,https://long-bernard.com,Through with several sign crime station growth.,18,long-bernard,2023,USD,350183,106882,243301,142824,100477,20632,79845,3501,7003,72842,1487,216040,68704,147336,,350183,20.0,153.35,0.1439,164,176.97,11520.62,0.13,0.6948
9465,Santiago Group,False,EG,Stephenside,HealthTech,2017,https://santiagogroup.com,Suffer carry leave local officer building meeting research.,30,santiago-group,2023,USD,1601396,533807,1067589,865973,201616,668,200948,16013,32027,168921,162851,1045861,189374,856487,133449.67,1601396,385.09,2423.94,0.0189,1762,75.71,78331.05,2.08,0.6667
9466,Burch Group,False,US,Alfredport,AgriTech,2015,https://burchgroup.com,Want part way if feel land exactly.,13,burch-group,2023,USD,93448,48450,44998,64125,-19127,21432,-40559,934,1868,-42427,3517,132191,51733,80458,,93448,20.0,10.0,0.062,47,163.84,17283.57,0.2,0.4815
9467,Mata Ltd,False,AU,North Amandaberg,AgriTech,2023,https://mataltd.com,Meet painting to shake again financial PM.,21,mata-ltd,2023,USD,192956,53728,139228,93053,46175,0,46175,1929,3859,42316,3852,138114,8585,129529,,192956,1733.47,866.74,0.0746,803,20.0,1000.0,3.85,0.7216
9468,Ellis LLC,False,IN,Port Kristopherville,Fintech,2013,https://ellisllc.com,Street then pretty by later at raise until research store.,34,ellis-llc,2023,USD,4122471,956928,3165543,2267698,897845,0,897845,41224,82449,815396,44256,2282915,421907,1861008,,4122471,1301.29,3563.83,0.0639,17176,20.0,191613.48,0.23,0.7679
9469,Montoya and Sons,False,CA,Port Michealmouth,EdTech,2010,https://montoyaandsons.com,Value gas push give line thousand.,18,montoya-and-sons,2023,USD,207546,65780,141766,224018,-82252,0,-82252,2075,4150,-86402,38105,272238,90908,181330,17295.5,207546,812.75,812.75,0.0348,617,28.0,10173.09,3.75,0.6831
9470,Singh Keller and Peters,False,BR,Port Douglas,EdTech,2023,https://singhkellerandpeters.com,Level artist stage rule shoulder office hotel television white.,13,singh-keller-and-peters,2023,USD,267638,113285,154353,144700,9653,740,8913,2676,5352,3561,24289,166385,22680,143705,22303.17,267638,10.0,47.54,0.0249,889,25.07,11161.55,2.18,0.5767
9471,Morrison-Oneal,False,BR,Schultzport,IoT,2018,https://morrison-oneal.com,Forward end meet work region no already attention.,23,morrison-oneal,2023,USD,367609,18380,349229,252436,96793,22214,74579,3676,7352,67227,8874,225536,91597,133939,,367609,1528.31,3689.92,0.1219,1531,20.0,7983.99,1.11,0.95
9472,Martinez Group,False,TN,Woodwardton,Fintech,2008,https://martinezgroup.com,Exactly can want court lot.,20,martinez-group,2023,USD,274167,99521,174646,105145,69501,33507,35994,2741,5483,30511,44098,286234,119020,167214,,274167,1305.87,3358.53,0.1511,87,261.89,22211.14,1.99,0.637
9473,Ryan Cunningham and Le,False,US,Austinshire,Mobility,2023,https://ryancunninghamandle.com,Major how TV fish forward billion grow field.,25,ryan-cunningham-and-le,2023,USD,444152,234192,209960,85865,124095,12017,112078,4441,8883,103195,17682,373836,142237,231599,,444152,1407.97,7162.76,0.0505,291,126.91,1000.0,17.68,0.4727
9474,Perry-Thornton,False,EG,South Jackton,EdTech,2013,https://perry-thornton.com,Evidence yourself role training plant operation realize relationship.,20,perry-thornton,2023,USD,133278,36038,97240,28625,68615,16494,52121,1332,2665,49456,59797,193725,117906,75819,11106.5,133278,10.0,54.43,0.0028,159,69.67,1000.0,59.8,0.7296
9475,Gomez-Briggs,False,FR,North Pamela,Mobility,2019,https://gomez-briggs.com,Rise summer southern child in along live positive hard indicate old.,18,gomez-briggs,2023,EUR,214455,93496,120959,108695,12264,0,12264,2144,4289,7975,7341,175280,119500,55780,,214455,528.07,1030.78,0.001,107,166.24,1000.0,7.34,0.564
9476,Walker Perez and Anderson,False,US,South Joseph,EdTech,2021,https://walkerperezandanderson.com,Responsibility pass wonder well.,18,walker-perez-and-anderson,2023,USD,480570,189648,290922,210411,80511,0,80511,4805,9611,70900,247680,653876,32693,621183,40047.5,480570,82.02,414.73,0.0544,495,80.87,51585.62,4.8,0.6054
9477,Vaughn Anderson and Collins,False,FR,North Cheyenneport,IoT,2013,https://vaughnandersonandcollins.com,Guy past customer them factor computer since central person media.,15,vaughn-anderson-and-collins,2023,EUR,1181397,301409,879988,464063,415925,0,415925,11813,23627,392298,29213,668792,144099,524693,,1181397,2382.44,11938.2,0.0941,2317,42.48,7706.69,3.79,0.7449
9478,Jackson-Trujillo,False,US,North Stephanieside,HealthTech,2018,https://jackson-trujillo.com,Later improve form media culture.,17,jackson-trujillo,2023,USD,747677,285953,461724,289609,172115,618,171497,7476,14953,156544,124382,562123,265903,296220,62306.42,747677,41.0,157.89,0.0193,2009,31.01,1000.0,124.38,0.6175
9479,Castro-Garcia,False,KE,East Matthew,Cybersecurity,2010,https://castro-garcia.com,Street from number visit maybe get education identify.,15,castro-garcia,2023,USD,715982,197607,518375,606086,-87711,4055,-91766,7159,14319,-106085,69540,501401,120048,381353,,715982,247.12,180.93,0.0311,707,84.34,59521.66,1.17,0.724
9480,Hester Munoz and Mitchell,False,KE,Washingtonstad,EdTech,2024,https://hestermunozandmitchell.com,Address hour join bit south father must foot.,17,hester-munoz-and-mitchell,2023,USD,733121,279167,453954,231621,222333,24535,197798,7331,14662,183136,23252,581049,72007,509042,61093.42,733121,418.22,783.61,0.0604,12218,5.0,39847.32,0.58,0.6192
9481,Moore Ltd,False,EG,West Pamelamouth,EdTech,2014,https://mooreltd.com,Different analysis option suggest rock.,14,moore-ltd,2023,USD,394619,162176,232443,168476,63967,0,63967,3946,7892,56075,21324,240800,12040,228760,32884.92,394619,10.0,62.74,0.001,6576,5.0,1000.0,21.32,0.589
9482,Clark Hall and Garcia,False,EG,Garciastad,SaaS,2014,https://clarkhallandgarcia.com,Yes upon response woman involve.,24,clark-hall-and-garcia,2023,USD,7909334,1142152,6767182,3817223,2949959,12478,2937481,79093,158186,2779295,1153422,5290843,264542,5026301,659111.17,7909334,261.56,1179.81,0.0614,15124,43.58,321187.12,3.59,0.8556
9483,Smith Walker and Holt,False,IN,Bakerburgh,Cybersecurity,2013,https://smithwalkerandholt.com,Watch agency but agency focus effort poor professional behind voice.,19,smith-walker-and-holt,2023,USD,450755,82234,368521,213987,154534,4309,150225,4507,9015,141210,12309,333305,132479,200826,,450755,365.7,1379.78,0.0598,665,56.45,40826.5,0.3,0.8176
9484,Alexander-King,False,AU,Cortezfurt,AgriTech,2017,https://alexander-king.com,New any become past poor.,27,alexander-king,2023,USD,87674,54814,32860,66016,-33156,12714,-45870,876,1753,-47623,31587,85867,30483,55384,,87674,1357.53,5352.83,0.0569,365,20.0,15032.73,2.1,0.3748
9485,Reed Ltd,False,IN,Crystalside,Mobility,2017,https://reedltd.com,Doctor others way improve concern.,12,reed-ltd,2023,USD,369911,213349,156562,287883,-131321,3897,-135218,3699,7398,-142616,14310,388010,199277,188733,,369911,439.08,491.31,0.0274,147,209.3,30919.87,0.46,0.4232
9486,Torres-Parks,False,NG,Smithland,IoT,2008,https://torres-parks.com,Produce consider test kind police.,18,torres-parks,2023,USD,1334756,600589,734167,214360,519807,2955,516852,13347,26695,490157,60721,818549,334493,484056,,1334756,631.74,2650.02,0.0725,750,148.15,24225.36,2.51,0.55
9487,Welch-White,False,AU,Cohenmouth,AgriTech,2023,https://welch-white.com,History call pressure help keep.,20,welch-white,2023,USD,93446,37927,55519,68168,-12649,0,-12649,934,1868,-14517,9720,119254,27412,91842,,93446,947.21,473.6,0.0865,36,214.16,1000.0,9.72,0.5941
9488,Castaneda-Gonzalez,False,TN,Elizabethville,SaaS,2022,https://castaneda-gonzalez.com,Fear add later like smile local serve baby TV memory.,12,castaneda-gonzalez,2023,USD,1351501,293766,1057735,451673,606062,0,606062,13515,27030,579032,88622,948820,503428,445392,112625.08,1351501,167.37,332.83,0.024,2806,40.13,14917.44,5.94,0.7826
9489,Gaines-Watson,False,ZA,Alvaradomouth,AI/ML,2021,https://gaines-watson.com,Evidence according set clearly minute religious program medical it.,16,gaines-watson,2023,USD,1126804,313208,813596,1178291,-364695,17234,-381929,11268,22536,-404465,98406,670095,208816,461279,,1126804,20.0,68.92,0.0965,4695,20.0,102506.73,0.96,0.722
9490,Sanders Rodriguez and Robinson,False,GB,Johnville,EdTech,2018,https://sandersrodriguezandrobinson.com,Check every television nature its road year poor life.,14,sanders-rodriguez-and-robinson,2023,USD,1789873,808394,981479,650949,330530,0,330530,17898,35797,294733,140392,1093706,664123,429583,149156.08,1789873,97.47,342.78,0.0722,29831,5.0,90322.54,1.55,0.5484
9491,Craig-Sanchez,False,FR,Christopherstad,SaaS,2023,https://craig-sanchez.com,Himself measure agreement explain inside.,18,craig-sanchez,2023,EUR,517478,223023,294455,105660,188795,7252,181543,5174,10349,171194,41400,359403,108437,250966,43123.17,517478,586.94,1810.09,0.0661,803,53.65,42784.08,0.97,0.569
9492,Wall PLC,False,TN,Waltersville,E-commerce,2010,https://wallplc.com,Amount industry easy anything himself worker.,19,wall-plc,2023,USD,900323,280667,619656,475403,144253,0,144253,9003,18006,126247,449688,1007437,240613,766824,,900323,101.51,50.76,0.0821,3751,20.0,53641.76,8.38,0.6883
9493,Greene Greer and Weber,False,AU,Kyleville,IoT,2010,https://greenegreerandweber.com,He treatment because chance commercial particular road.,21,greene-greer-and-weber,2023,USD,1258881,488102,770779,161081,609698,2699,606999,12588,25177,581822,139800,887838,59886,827952,,1258881,20.0,25.77,0.0237,495,211.58,1000.0,139.8,0.6123
9494,Holland Ltd,False,AU,Port Annbury,Mobility,2009,https://hollandltd.com,Issue far level determine together ok president address bad.,16,holland-ltd,2023,USD,3040586,1548514,1492072,152029,1340043,45252,1294791,30405,60811,1233980,103695,1763467,272330,1491137,,3040586,571.67,1623.35,0.1008,12669,20.0,20886.27,4.96,0.4907
9495,Jackson PLC,False,ZA,Port Evanshire,AI/ML,2019,https://jacksonplc.com,Across similar likely leader serve all suffer book condition with.,20,jackson-plc,2023,USD,581265,122321,458944,312147,146797,0,146797,5812,11625,135172,26838,425620,92506,333114,,581265,1501.81,3072.54,0.0505,2421,20.0,43110.95,0.62,0.7896
9496,Hall-Garcia,False,FR,Julieshire,Mobility,2015,https://hall-garcia.com,Perhaps employee break method even move whatever.,30,hall-garcia,2023,EUR,636340,251178,385162,372544,12618,11923,695,6363,12726,-12031,16218,386653,45710,340943,,636340,20.0,32.21,0.0127,472,112.3,40828.27,0.4,0.6053
9497,West and Sons,False,BR,Amychester,HealthTech,2019,https://westandsons.com,Rather truth against save learn institution.,27,west-and-sons,2023,USD,306902,73794,233108,130457,102651,0,102651,3069,6138,96513,42492,313250,113283,199967,25575.17,306902,10.0,52.39,0.0305,389,65.66,1000.0,42.49,0.7596
9498,Hunter-Christensen,False,FR,Lake Justin,AgriTech,2019,https://hunter-christensen.com,Opportunity no Mr model finish evidence key later economic reason.,21,hunter-christensen,2023,EUR,277586,112784,164802,139401,25401,36435,-11034,2775,5551,-16585,12543,272884,108860,164024,,277586,20.0,10.0,0.0358,112,206.11,28633.9,0.44,0.5937
9499,Fernandez Ryan and Snyder,False,TN,Nguyenmouth,EdTech,2016,https://fernandezryanandsnyder.com,Senior few increase then mission ahead something natural not population.,31,fernandez-ryan-and-snyder,2023,USD,1154602,412414,742188,213307,528881,0,528881,11546,23092,505789,13430,636576,353539,283037,96216.83,1154602,32.81,80.83,0.0271,883,108.87,44011.94,0.31,0.6428
9500,Barry-Vaughn,False,US,Kathleenmouth,IoT,2010,https://barry-vaughn.com,Plan require force conference risk game shake professional various garden kid.,14,barry-vaughn,2023,USD,1068765,310904,757861,506746,251115,0,251115,10687,21375,229740,43653,622962,269973,352989,,1068765,1416.19,1317.35,0.0903,475,187.43,73941.82,0.59,0.7091
9501,Lewis Group,False,NG,West Kimberly,E-commerce,2024,https://lewisgroup.com,This number candidate exactly across probably.,16,lewis-group,2023,USD,5236975,1551266,3685709,2706563,979146,0,979146,52369,104739,874407,411818,3059853,842021,2217832,,5236975,147.08,609.77,0.1,1572,277.5,249425.31,1.65,0.7038
9502,Clark-Saunders,False,US,Jonesstad,E-commerce,2019,https://clark-saunders.com,Serve mention fund election risk fill success land wall wall.,19,clark-saunders,2023,USD,1211152,728392,482760,549053,-66293,0,-66293,12111,24223,-90516,122364,893551,44677,848874,,1211152,966.21,2577.32,0.0587,1894,53.28,43755.14,2.8,0.3986
9503,Jacobson PLC,False,NG,South Michael,Cybersecurity,2010,https://jacobsonplc.com,Research simple get pick fish bad time position lot suddenly.,12,jacobson-plc,2023,USD,165706,56562,109144,75997,33147,0,33147,1657,3314,29833,12941,156494,7824,148670,,165706,20.0,130.65,0.0455,83,165.86,31678.91,0.41,0.6587
9504,Martinez PLC,False,ZA,Darrylside,Cybersecurity,2011,https://martinezplc.com,Piece reflect cover prevent allow sense tree your for issue.,24,martinez-plc,2023,USD,7246060,1687082,5558978,4428909,1130069,0,1130069,72460,144921,985148,1539381,5287231,2922506,2364725,,7246060,343.13,171.56,0.0439,30191,20.0,343871.94,4.48,0.7672
9505,Patton Inc,False,CA,South Josephstad,Mobility,2016,https://pattoninc.com,Race yet hair job difference almost.,21,patton-inc,2023,USD,1599179,738176,861003,1506668,-645665,26698,-672363,15991,31983,-704346,54903,907631,45381,862250,,1599179,904.67,4734.88,0.1168,545,244.43,112912.13,0.49,0.5384
9506,Alexander-Stevenson,False,IN,Lambmouth,Cybersecurity,2020,https://alexander-stevenson.com,Pay daughter decision computer yourself card religious character.,18,alexander-stevenson,2023,USD,4097561,1419575,2677986,1909399,768587,14716,753871,40975,81951,671920,1087186,3327708,1166646,2161062,,4097561,184.03,344.42,0.0534,3547,96.25,157834.64,6.89,0.6536
9507,Mendez Santana and Huffman,False,BR,Marystad,E-commerce,2015,https://mendezsantanaandhuffman.com,Each lawyer tough other keep.,21,mendez-santana-and-huffman,2023,USD,673028,401468,271560,160362,111198,0,111198,6730,13460,97738,232191,700877,261915,438962,,673028,20.0,55.0,0.0888,208,268.76,2259.11,102.78,0.4035
9508,Cabrera Ross and Alvarez,False,KE,Lake Marissaburgh,Marketplaces,2011,https://cabrerarossandalvarez.com,Avoid foreign become wear movie according common.,19,cabrera-ross-and-alvarez,2023,USD,712352,279018,433334,349928,83406,17048,66358,7123,14247,52111,67538,567403,28370,539033,,712352,20.0,87.86,0.0288,2968,20.0,45713.98,1.48,0.6083
9509,Quinn Ltd,False,TN,West Julieborough,SaaS,2023,https://quinnltd.com,Itself for listen wear finally put.,17,quinn-ltd,2023,USD,1880645,481301,1399344,1091795,307549,0,307549,18806,37612,269937,44545,1094142,115990,978152,156720.42,1880645,57.82,187.04,0.0304,16274,9.63,87878.34,0.51,0.7441
9510,Davis Harrell and Campbell,False,EG,Christychester,SaaS,2009,https://davisharrellandcampbell.com,Woman discussion enjoy story by majority.,22,davis-harrell-and-campbell,2023,USD,981839,84492,897347,726392,170955,0,170955,9818,19636,151319,10544,571325,251463,319862,81819.92,981839,22.08,41.75,0.001,4707,17.38,40663.12,0.26,0.9139
9511,Ramirez-Gallagher,False,IN,Riverastad,SaaS,2015,https://ramirez-gallagher.com,Save mind environmental pull hold week above film.,18,ramirez-gallagher,2023,USD,1163491,386649,776842,106744,670098,30111,639987,11634,23269,616718,30008,730220,227190,503030,96957.58,1163491,388.3,524.28,0.0745,8903,10.89,3515.05,8.54,0.6677
9512,Brown-Wright,False,AU,Colleenfort,SaaS,2017,https://brown-wright.com,Soon high think involve nothing hotel.,29,brown-wright,2023,USD,1296096,423755,872341,465009,407332,3164,404168,12960,25921,378247,83185,910263,182394,727869,108008.0,1296096,10.0,59.76,0.0258,902,119.65,1000.0,83.18,0.6731
9513,Gonzalez Ltd,False,CA,Brookeburgh,AgriTech,2011,https://gonzalezltd.com,Manage chair save ago.,17,gonzalez-ltd,2023,USD,33694,19093,14601,21967,-7366,0,-7366,336,673,-8039,35442,62845,23006,39839,,33694,476.08,238.04,0.0741,11,246.66,22223.38,1.59,0.4333
9514,Webb-Hall,False,NG,North Jeremyview,AgriTech,2008,https://webb-hall.com,Audience hard clear provide imagine.,17,webb-hall,2023,USD,241024,85562,155462,159419,-3957,376,-4333,2410,4820,-9153,55261,243945,49761,194184,,241024,20.0,136.34,0.0447,199,100.45,1000.0,55.26,0.645
9515,Davis-King,False,AU,Porterville,EdTech,2012,https://davis-king.com,Any exactly wish late speak fund girl likely.,20,davis-king,2023,USD,123933,21950,101983,78366,23617,0,23617,1239,2478,21139,10314,108332,31656,76676,10327.75,123933,66.14,317.19,0.0647,2065,5.0,2989.59,3.45,0.8229
9516,Pugh Anthony and Frye,False,GB,Lisaland,Fintech,2008,https://pughanthonyandfrye.com,Teach will treatment black politics.,19,pugh-anthony-and-frye,2023,USD,669864,217454,452410,456491,-4081,17244,-21325,6698,13397,-34722,67444,412834,218264,194570,,669864,1128.89,6348.69,0.0634,1333,41.86,70060.49,0.96,0.6754
9517,Hernandez LLC,False,BR,West Dawn,EdTech,2020,https://hernandezllc.com,Indeed argue rate produce hand particularly learn.,19,hernandez-llc,2023,USD,117958,23489,94469,71513,22956,5383,17573,1179,2359,15214,97279,187769,67118,120651,9829.83,117958,274.33,274.33,0.0052,1965,5.0,17842.65,5.45,0.8009
9518,Todd-Williams,False,TN,Lake Kirstenborough,HealthTech,2009,https://todd-williams.com,Ability ago pressure half hundred smile industry.,25,todd-williams,2023,USD,1361023,382067,978956,175859,803097,18001,785096,13610,27220,757876,68395,938982,159932,779050,113418.58,1361023,10.0,42.45,0.0386,1813,62.54,13964.61,4.9,0.7193
9519,Arellano LLC,False,DE,South Cherylton,AI/ML,2019,https://arellanollc.com,Dream try do thank cup early pull recent start election old.,17,arellano-llc,2023,EUR,352475,228162,124313,181964,-57651,18394,-76045,3524,7049,-83094,30391,356600,45087,311513,,352475,20.0,50.19,0.1118,343,85.61,32001.09,0.95,0.3527
9520,Jackson Dominguez and Spencer,False,NG,Allisonchester,AI/ML,2020,https://jacksondominguezandspencer.com,Final only group color ten.,20,jackson-dominguez-and-spencer,2023,USD,1821256,660214,1161042,1079791,81251,0,81251,18212,36425,44826,280847,1308514,391589,916925,,1821256,352.68,1986.92,0.0273,3019,50.26,96668.02,2.91,0.6375
9521,Campbell-Marshall,False,BR,Brianville,AgriTech,2008,https://campbell-marshall.com,Wait teach stay whom significant young tonight include can.,21,campbell-marshall,2023,USD,417764,134792,282972,229770,53202,5689,47513,4177,8355,39158,13678,359557,38284,321273,,417764,1226.26,722.31,0.0215,585,59.48,8614.87,1.59,0.6773
9522,Jensen Booth and Roberts,False,BR,Jenniferview,Mobility,2008,https://jensenboothandroberts.com,Fill action likely happy forget admit.,30,jensen-booth-and-roberts,2023,USD,2865866,1232810,1633056,2194358,-561302,1090,-562392,28658,57317,-619709,163884,1736887,660152,1076735,,2865866,1425.67,5972.1,0.107,1481,161.18,182272.65,0.9,0.5698
9523,Parker-Nelson,False,GB,Louismouth,Energy,2018,https://parker-nelson.com,Huge goal word fast under.,18,parker-nelson,2023,USD,2139255,472008,1667247,622363,1044884,31823,1013061,21392,42785,970276,342619,1481846,601300,880546,,2139255,1354.61,3083.58,0.0689,8913,20.0,30848.87,11.11,0.7794
9524,Mccarty PLC,False,GB,Bryanfurt,IoT,2018,https://mccartyplc.com,Seat same day than reveal upon last professor may.,24,mccarty-plc,2023,USD,653808,226766,427042,206930,220112,22271,197841,6538,13076,184765,38103,460565,98226,362339,,653808,20.0,24.78,0.0909,186,291.66,11443.44,3.33,0.6532
9525,Hansen-Kelly,False,FR,Perezside,Energy,2017,https://hansen-kelly.com,Exist tonight game position hand find success top occur.,16,hansen-kelly,2023,EUR,936467,362599,573868,633733,-59865,23581,-83446,9364,18729,-102175,117618,710112,195199,514913,,936467,20.0,45.89,0.1264,3901,20.0,75805.18,1.55,0.6128
9526,Lowe-Simon,False,ZA,East Nathanchester,Energy,2014,https://lowe-simon.com,Here market many each inside join everybody various century former.,22,lowe-simon,2023,USD,738461,254558,483903,48867,435036,1990,433046,7384,14769,418277,14817,562722,180420,382302,,738461,63.02,372.9,0.0901,3076,20.0,10992.09,1.35,0.6553
9527,Walker-Calderon,False,DE,Stephenview,Cybersecurity,2015,https://walker-calderon.com,Easy reflect water miss how truth minute occur.,12,walker-calderon,2023,EUR,1493144,613226,879918,1236011,-356093,394,-356487,14931,29862,-386349,249630,1097631,546685,550946,,1493144,702.4,1496.56,0.115,1761,70.63,79394.79,3.14,0.5893
9528,Moore Lawrence and Garza,False,CA,West Chadmouth,Cybersecurity,2021,https://moorelawrenceandgarza.com,Voice human from kind share throughout tree pass away ahead.,14,moore-lawrence-and-garza,2023,USD,3135192,1306456,1828736,1068577,760159,0,760159,31351,62703,697456,10023,1722454,701584,1020870,,3135192,764.64,3697.14,0.001,1416,184.42,90240.15,0.11,0.5833
9529,Sloan-Bishop,False,GB,Tracystad,EdTech,2009,https://sloan-bishop.com,Area someone officer happy speak.,17,sloan-bishop,2023,USD,2401079,942428,1458651,795672,662979,9821,653158,24010,48021,605137,33359,1350446,440589,909857,200089.92,2401079,266.72,1350.56,0.034,4174,47.93,49720.95,0.67,0.6075
9530,Williamson and Sons,False,DE,Morganside,IoT,2022,https://williamsonandsons.com,Decision behavior best concern stuff responsibility race notice.,18,williamson-and-sons,2023,EUR,2325792,305631,2020161,457922,1562239,32434,1529805,23257,46515,1483290,154484,1355235,867614,487621,,2325792,1016.02,8015.18,0.0681,983,197.13,49902.81,3.1,0.8686
9531,Horn Group,False,IN,Morganshire,AgriTech,2008,https://horngroup.com,Take wife a factor myself since produce oil may action.,16,horn-group,2023,USD,139653,61340,78313,20380,57933,15486,42447,1396,2793,39654,7819,97292,26846,70446,,139653,1467.66,6071.26,0.0295,107,108.4,32482.67,0.24,0.5608
9532,Reed Moore and Pitts,False,NG,Sanchezport,AI/ML,2009,https://reedmooreandpitts.com,Family soon out bank clearly eye value entire.,22,reed-moore-and-pitts,2023,USD,1139859,372808,767051,524841,242210,0,242210,11398,22797,219413,152343,787478,125074,662404,,1139859,367.72,183.86,0.0557,728,130.41,39193.51,3.89,0.6729
9533,Little-Long,False,AU,South Daniel,Energy,2023,https://little-long.com,Might democratic subject last hair amount with nice create five his.,19,little-long,2023,USD,1071259,359654,711605,357055,354550,0,354550,10712,21425,333125,91349,691727,388856,302871,,1071259,20.0,80.05,0.001,1651,54.04,41484.3,2.2,0.6643
9534,Cervantes Group,False,US,South Kimberly,AI/ML,2023,https://cervantesgroup.com,Head to office citizen positive line.,23,cervantes-group,2023,USD,305382,77204,228178,120525,107653,7166,100487,3053,6107,94380,1384,236824,23493,213331,,305382,20.0,10.0,0.0526,144,176.64,11122.55,0.12,0.7472
9535,Garcia-Alvarez,False,US,North Janetchester,IoT,2013,https://garcia-alvarez.com,Goal sell item music material explain early hospital.,18,garcia-alvarez,2023,USD,574281,222163,352118,656135,-304017,0,-304017,5742,11485,-315502,43235,405328,265777,139551,,574281,20.0,66.31,0.0822,585,81.7,92478.94,0.47,0.6131
9536,Farley Ramsey and Beasley,False,US,North Jessica,Marketplaces,2011,https://farleyramseyandbeasley.com,Community argue fly here account loss foreign we national claim.,19,farley-ramsey-and-beasley,2023,USD,265968,108571,157397,131921,25476,0,25476,2659,5319,20157,8486,222214,124937,97277,,265968,643.06,1157.19,0.0655,1108,20.0,24619.63,0.34,0.5918
9537,Perry Hall and Hall,False,KE,Smithtown,Cybersecurity,2010,https://perryhallandhall.com,Least operation tough agent low important possible tell spring city.,25,perry-hall-and-hall,2023,USD,2505893,776033,1729860,1561753,168107,0,168107,25058,50117,117990,293753,1692409,1435503,256906,,2505893,1048.11,3586.14,0.0845,1096,190.5,130530.66,2.25,0.6903
9538,Green-Obrien,False,NG,New Rebeccabury,Cybersecurity,2017,https://green-obrien.com,Suggest kind herself professor degree particularly.,18,green-obrien,2023,USD,435345,279869,155476,295449,-139973,11375,-151348,4353,8706,-160054,12024,357068,17853,339215,,435345,20.0,140.94,0.0653,161,224.73,69902.04,0.17,0.3571
9539,Mejia PLC,False,DE,Rossberg,Fintech,2010,https://mejiaplc.com,Shake popular example receive owner.,19,mejia-plc,2023,EUR,927622,506536,421086,311482,109604,5447,104157,9276,18552,85605,25096,505908,262759,243149,,927622,1853.42,12168.74,0.0834,516,149.52,32197.38,0.78,0.4539
9540,Lloyd LLC,False,DE,Daniellefurt,Marketplaces,2012,https://lloydllc.com,Same himself worker human free occur.,19,lloyd-llc,2023,EUR,306851,155451,151400,327829,-176429,15674,-192103,3068,6137,-198240,28685,243851,120322,123529,,306851,20.0,28.52,0.001,186,137.23,31587.05,0.91,0.4934
9541,Harris-Chavez,False,AU,Stanleyburgh,Energy,2020,https://harris-chavez.com,Thing range food lawyer such foot ask onto style.,17,harris-chavez,2023,USD,855145,186746,668399,588803,79596,0,79596,8551,17102,62494,75345,625981,82823,543158,,855145,1125.55,1459.15,0.0484,3563,20.0,64215.19,1.17,0.7816
9542,Tran-Rice,False,FR,Rushton,Fintech,2018,https://tran-rice.com,Day along call probably what fund.,18,tran-rice,2023,EUR,2117397,648152,1469245,1987106,-517861,0,-517861,21173,42347,-560208,154594,1220902,529326,691576,,2117397,90.45,385.25,0.1873,1522,115.86,142361.34,1.09,0.6939
9543,Meadows-Taylor,False,NG,Espinozaborough,AgriTech,2018,https://meadows-taylor.com,Ten contain if degree.,22,meadows-taylor,2023,USD,585350,245907,339443,132783,206660,0,206660,5853,11707,194953,25870,502197,25109,477088,,585350,1753.05,876.52,0.0389,940,51.86,1000.0,25.87,0.5799
9544,Kelly Inc,False,NG,West Michaelland,SaaS,2018,https://kellyinc.com,Like reveal song allow example we let.,18,kelly-inc,2023,USD,1595697,677207,918490,979875,-61385,24945,-86330,15956,31913,-118243,8259,916019,282505,633514,132974.75,1595697,93.93,331.47,0.0153,4976,26.72,62101.97,0.13,0.5756
9545,Moore-Gonzalez,False,GB,Andersonport,Energy,2015,https://moore-gonzalez.com,View operation media decision nice activity amount coach he line.,21,moore-gonzalez,2023,USD,674264,235445,438819,318903,119916,36072,83844,6742,13485,70359,16025,446343,229439,216904,,674264,20.0,38.88,0.0458,551,101.95,18383.24,0.87,0.6508
9546,White-Bowman,False,GB,Jeffreyfurt,Marketplaces,2011,https://white-bowman.com,Article type say minute idea good follow.,18,white-bowman,2023,USD,3867282,1266499,2600783,2838221,-237438,20067,-257505,38672,77345,-334850,332986,2421431,1421839,999592,,3867282,1603.87,5431.26,0.001,16113,20.0,231699.35,1.44,0.6725
9547,Mills-White,False,FR,Snyderside,IoT,2020,https://mills-white.com,Word happy able TV memory.,15,mills-white,2023,EUR,3097609,1212007,1885602,1881546,4056,28486,-24430,30976,61952,-86382,91720,1702024,793018,909006,,3097609,1163.9,6266.44,0.0641,1542,167.39,174197.2,0.53,0.6087
9548,Collins Wilson and Sanders,False,US,New Billyside,AgriTech,2022,https://collinswilsonandsanders.com,Share ground talk power experience.,18,collins-wilson-and-sanders,2023,USD,967716,353662,614054,739330,-125276,36445,-161721,9677,19354,-181075,62337,628020,55874,572146,,967716,20.0,29.35,0.0042,4032,20.0,42820.12,1.46,0.6345
9549,Booth Ltd,False,AU,East Jenny,Marketplaces,2013,https://boothltd.com,Production administration whatever close rise we street ask other heavy.,25,booth-ltd,2023,USD,3112668,1254853,1857815,1180563,677252,0,677252,31126,62253,614999,23068,1581883,507773,1074110,,3112668,117.24,517.68,0.0589,2362,109.78,89717.14,0.26,0.5969
9550,Kennedy-Shaffer,False,GB,North Kyleview,SaaS,2018,https://kennedy-shaffer.com,Anyone subject step method give road music.,10,kennedy-shaffer,2023,USD,4879324,1913640,2965684,2165646,800038,4764,795274,48793,97586,697688,315166,2900402,539848,2360554,406610.33,4879324,231.03,1213.5,0.0143,4057,100.2,193538.17,1.63,0.6078
9551,Everett Walker and Johnson,False,DE,Lake Martha,IoT,2023,https://everettwalkerandjohnson.com,World weight include prepare way tend on.,18,everett-walker-and-johnson,2023,EUR,550719,215052,335667,264203,71464,0,71464,5507,11014,60450,19856,347380,90551,256829,,550719,20.0,44.32,0.0494,585,78.42,31665.07,0.63,0.6095
9552,Rivera-Clark,False,BR,Janeport,SaaS,2023,https://rivera-clark.com,Weight perhaps environment into effort report toward these.,21,rivera-clark,2023,USD,483146,111548,371598,166835,204763,28068,176695,4831,9662,167033,27443,445365,22268,423097,40262.17,483146,248.72,2032.36,0.0191,583,69.0,21084.03,1.3,0.7691
9553,Evans-Carpenter,False,EG,South Michaelview,AgriTech,2019,https://evans-carpenter.com,Else animal military decide miss something not concern prove play.,18,evans-carpenter,2023,USD,260921,36296,224625,190361,34264,25505,8759,2609,5218,3541,11885,178645,75106,103539,,260921,368.51,1244.76,0.0691,338,64.17,1000.0,11.88,0.8609
9554,Mcguire Miller and Moore,False,ZA,South Raymond,AgriTech,2017,https://mcguiremillerandmoore.com,Wait draw parent apply my pressure big general appear short.,25,mcguire-miller-and-moore,2023,USD,158414,53002,105412,54771,50641,0,50641,1584,3168,47473,2675,152822,50572,102250,,158414,824.75,6741.28,0.001,196,67.22,34365.05,0.08,0.6654
9555,Ayala-Salazar,False,EG,Stewartmouth,Cybersecurity,2009,https://ayala-salazar.com,His condition assume home model professional.,21,ayala-salazar,2023,USD,923445,242365,681080,621084,59996,18557,41439,9234,18468,22971,11513,653919,437741,216178,,923445,324.49,1747.01,0.0987,3847,20.0,79400.29,0.14,0.7375
9556,Howe Jackson and Mitchell,False,NG,Murrayton,Marketplaces,2012,https://howejacksonandmitchell.com,Religious adult success brother sort land modern back city order.,14,howe-jackson-and-mitchell,2023,USD,790692,166712,623980,39534,584446,6220,578226,7906,15813,562413,87828,524968,211152,313816,,790692,1593.16,3856.97,0.0972,3294,20.0,1000.0,87.83,0.7892
9557,Smith Powell and Rhodes,False,BR,Smithchester,EdTech,2010,https://smithpowellandrhodes.com,Any community should common type drop nice upon couple.,14,smith-powell-and-rhodes,2023,USD,787566,236724,550842,372720,178122,18644,159478,7875,15751,143727,14746,605541,292640,312901,65630.5,787566,236.34,368.08,0.0475,834,78.67,52296.54,0.28,0.6994
9558,Rios-Chase,False,EG,Millershire,Fintech,2017,https://rios-chase.com,Include school author professor center follow more information would east.,20,rios-chase,2023,USD,1006138,329144,676994,280186,396808,0,396808,10061,20122,376686,36179,722984,36149,686835,,1006138,20.0,50.85,0.001,1267,66.13,20107.86,1.8,0.6729
9559,Brown-Campbell,False,TN,Sotomouth,Cybersecurity,2010,https://brown-campbell.com,Say stand ten debate would report add our role.,22,brown-campbell,2023,USD,4514080,1399611,3114469,2969629,144840,0,144840,45140,90281,54559,91834,2543525,556222,1987303,,4514080,93.45,95.31,0.0411,6373,59.02,272673.92,0.34,0.6899
9560,Allen-Black,False,KE,Nicolebury,IoT,2018,https://allen-black.com,To common while wrong pay top friend attorney focus happy.,21,allen-black,2023,USD,1015062,406710,608352,570242,38110,10584,27526,10150,20301,7225,191004,802760,256303,546457,,1015062,317.49,158.74,0.0578,4229,20.0,52501.01,3.64,0.5993
9561,Davidson Rich and Bailey,False,ZA,North Melissabury,EdTech,2016,https://davidsonrichandbailey.com,Within reveal within hit garden see foot level.,15,davidson-rich-and-bailey,2023,USD,98870,42027,56843,40211,16632,4432,12200,988,1977,10223,4311,207563,143617,63946,8239.17,98870,429.32,2273.45,0.0141,95,86.11,1000.0,4.31,0.5749
9562,Dunn Perez and Ortega,False,TN,Port Thomasside,Mobility,2020,https://dunnperezandortega.com,Sit peace his Democrat experience friend under describe computer ten.,19,dunn-perez-and-ortega,2023,USD,2863584,1586054,1277530,1606012,-328482,0,-328482,28635,57271,-385753,124309,1745007,785921,959086,,2863584,20.0,128.89,0.0743,3033,78.67,119549.97,1.04,0.4461
9563,Fox-Dominguez,False,TN,New Joshua,HealthTech,2021,https://fox-dominguez.com,Create watch mind happen green.,19,fox-dominguez,2023,USD,1080229,538410,541819,573425,-31606,30570,-62176,10802,21604,-83780,263131,941712,336320,605392,90019.08,1080229,653.96,2821.13,0.04,18003,5.0,49348.67,5.33,0.5016
9564,Richards-Anthony,False,GB,Samuelland,EdTech,2018,https://richards-anthony.com,Pretty international marriage southern though TV arm see specific chance.,26,richards-anthony,2023,USD,1060568,475029,585539,701754,-116215,362,-116577,10605,21211,-137788,25716,690555,159408,531147,88380.67,1060568,123.55,805.27,0.0345,17676,5.0,71723.51,0.36,0.5521
9565,Buckley-Nguyen,False,ZA,East Johnton,IoT,2020,https://buckley-nguyen.com,Minute easy majority and dream that by sit culture office.,34,buckley-nguyen,2023,USD,1083630,179903,903727,574724,329003,0,329003,10836,21672,307331,65483,701127,328777,372350,,1083630,794.67,699.28,0.001,336,268.45,59462.54,1.1,0.834
9566,Sheppard LLC,False,US,Hallmouth,E-commerce,2015,https://sheppardllc.com,Especially my improve yard teacher these major.,19,sheppard-llc,2023,USD,1763608,875094,888514,545493,343021,6091,336930,17636,35272,301658,205730,1271819,140218,1131601,,1763608,1483.43,782.27,0.0248,1894,77.57,46881.14,4.39,0.5038
9567,Cardenas Sellers and Long,False,US,North Samuel,HealthTech,2020,https://cardenassellersandlong.com,See face message son pretty.,23,cardenas-sellers-and-long,2023,USD,3022451,461998,2560453,297176,2263277,16712,2246565,30224,60449,2186116,158415,1837203,582919,1254284,251870.92,3022451,438.1,934.49,0.001,4404,57.18,1000.0,158.42,0.8471
9568,Collier Sullivan and Moore,False,FR,Lake Lisa,Cybersecurity,2017,https://colliersullivanandmoore.com,New commercial third show president middle inside after act simple.,19,collier-sullivan-and-moore,2023,EUR,555751,348033,207718,207468,250,0,250,5557,11115,-10865,11892,367875,235540,132335,,555751,20.0,159.51,0.064,1037,44.66,1000.0,11.89,0.3738
9569,Wheeler-Lewis,False,US,Amyview,HealthTech,2019,https://wheeler-lewis.com,Speak identify also amount pattern culture main me.,8,wheeler-lewis,2023,USD,451380,228165,223215,195597,27618,19508,8110,4513,9027,-917,4099,333392,185181,148211,37615.0,451380,611.06,3006.87,0.0377,425,88.4,20240.57,0.2,0.4945
9570,Christian-Richards,False,EG,Port Michaelfort,AI/ML,2022,https://christian-richards.com,Describe east early through consumer chair medical parent middle short.,16,christian-richards,2023,USD,3080388,1069808,2010580,819169,1191411,0,1191411,30803,61607,1129804,236442,1801173,153052,1648121,,3080388,20.0,96.58,0.001,12834,20.0,72803.28,3.25,0.6527
9571,Henry Diaz and Smith,False,US,Smithmouth,EdTech,2020,https://henrydiazandsmith.com,Bill TV know could mission maintain free per citizen.,20,henry-diaz-and-smith,2023,USD,781629,212064,569565,354302,215263,15699,199564,7816,15632,183932,12077,430729,97505,333224,65135.75,781629,143.85,385.35,0.0135,876,74.34,42650.28,0.28,0.7287
9572,Robinson-Bishop,False,NG,West Stanleyburgh,Energy,2009,https://robinson-bishop.com,Need course protect line bed forward set important.,20,robinson-bishop,2023,USD,1865383,452219,1413164,1683856,-270692,0,-270692,18653,37307,-307999,79612,1081413,587140,494273,,1865383,988.24,1080.63,0.0392,7772,20.0,158604.5,0.5,0.7576
9573,Miller-Lawson,False,CA,Sullivanmouth,SaaS,2020,https://miller-lawson.com,While close cover remain woman bad TV short model.,24,miller-lawson,2023,USD,681520,203873,477647,423847,53800,0,53800,6815,13630,40170,31031,476731,194914,281817,56793.33,681520,277.62,741.6,0.0139,838,67.76,47916.44,0.65,0.7009
9574,Alexander Underwood and Garcia,False,DE,Gibbsport,SaaS,2020,https://alexanderunderwoodandgarcia.com,Camera bank magazine win international alone.,24,alexander-underwood-and-garcia,2023,EUR,1502858,460127,1042731,1256791,-214060,0,-214060,15028,30057,-244117,391601,1247873,590479,657394,125238.17,1502858,10.0,58.19,0.001,2148,58.29,99976.33,3.92,0.6938
9575,Wise Ltd,False,TN,Morriston,EdTech,2021,https://wiseltd.com,Base player language quality individual career development.,22,wise-ltd,2023,USD,199765,50085,149680,61781,87899,2815,85084,1997,3995,81089,8790,273143,40553,232590,16647.08,199765,151.8,309.6,0.0876,152,108.94,14739.54,0.6,0.7493
9576,Bowman-Aguirre,False,US,East Andrewberg,E-commerce,2009,https://bowman-aguirre.com,Stand suffer institution miss economy radio without think property authority.,19,bowman-aguirre,2023,USD,2148397,611402,1536995,878038,658957,0,658957,21483,42967,615990,104717,1222825,469389,753436,,2148397,1413.43,2472.1,0.1182,946,189.15,69587.7,1.5,0.7154
9577,Day Cannon and Nichols,False,GB,East Jasonland,Cybersecurity,2024,https://daycannonandnichols.com,Stay product baby painting give past yeah especially across.,13,day-cannon-and-nichols,2023,USD,889239,284822,604417,249315,355102,30668,324434,8892,17784,306650,7299,516395,219367,297028,,889239,520.06,2016.62,0.001,3705,20.0,15337.16,0.48,0.6797
9578,Gray Ltd,False,BR,North Troyshire,Fintech,2021,https://grayltd.com,Science fine and fight source knowledge water better.,13,gray-ltd,2023,USD,2138202,732439,1405763,993601,412162,14358,397804,21382,42764,355040,230237,1417658,542339,875319,,2138202,256.24,991.98,0.001,2385,74.68,50112.52,4.59,0.6575
9579,Moyer-Glover,False,IN,Elizabethhaven,SaaS,2011,https://moyer-glover.com,Process fly building live book hundred onto perform way game.,24,moyer-glover,2023,USD,231263,81449,149814,162068,-12254,5658,-17912,2312,4625,-22537,2177,263205,113195,150010,19271.92,231263,499.81,837.68,0.0285,459,41.95,21494.46,0.1,0.6478
9580,Lane-Watson,False,US,Michelleville,EdTech,2009,https://lane-watson.com,Job live point conference though final soon.,13,lane-watson,2023,USD,897207,328441,568766,286228,282538,4127,278411,8972,17944,260467,15471,478268,249464,228804,74767.25,897207,160.65,1316.02,0.0219,864,86.46,28554.25,0.54,0.6339
9581,Patton Preston and Tran,False,KE,New Annamouth,Fintech,2013,https://pattonprestonandtran.com,Accept similar couple believe check.,21,patton-preston-and-tran,2023,USD,4597160,453231,4143929,3121742,1022187,15512,1006675,45971,91943,914732,204678,2620218,219659,2400559,,4597160,625.37,2012.67,0.0565,19154,20.0,261584.7,0.78,0.9014
9582,Richardson PLC,False,US,New Ryanside,Cybersecurity,2015,https://richardsonplc.com,Anything take behavior help carry modern report local college.,26,richardson-plc,2023,USD,3946980,1136694,2810286,1360724,1449562,0,1449562,39469,78939,1370623,151138,2201724,110086,2091638,,3946980,192.45,1221.1,0.001,2416,136.12,109597.91,1.38,0.712
9583,Fuentes Ltd,False,BR,Tammyshire,SaaS,2012,https://fuentesltd.com,Second according arm true.,17,fuentes-ltd,2023,USD,6784775,2932250,3852525,4048425,-195900,27479,-223379,67847,135695,-359074,115482,3605792,1786307,1819485,565397.92,6784775,41.58,41.58,0.001,14914,37.91,357696.5,0.32,0.5678
9584,Burgess Martinez and Dean,False,CA,Gonzalesbury,HealthTech,2008,https://burgessmartinezanddean.com,Particularly might sort note together degree day company.,19,burgess-martinez-and-dean,2023,USD,599270,216114,383156,325189,57967,0,57967,5992,11985,45982,114863,576383,134570,441813,49939.17,599270,169.48,1111.12,0.0418,782,63.84,76934.7,1.49,0.6394
9585,Johnson LLC,False,KE,Porterhaven,AgriTech,2018,https://johnsonllc.com,National call easy small outside probably take process beautiful.,26,johnson-llc,2023,USD,45835,15374,30461,26426,4035,0,4035,458,916,3119,75137,175653,68131,107522,,45835,1549.86,5893.56,0.0826,25,152.22,1000.0,75.14,0.6646
9586,Walker-Wallace,False,GB,South Davidborough,Cybersecurity,2014,https://walker-wallace.com,Field near force response decade education cover.,33,walker-wallace,2023,USD,2058833,429092,1629741,603690,1026051,1235,1024816,20588,41176,983640,146638,1357192,172524,1184668,,2058833,156.75,656.52,0.0107,8578,20.0,30286.28,4.84,0.7916
9587,Williams and Sons,False,AU,East Johnchester,Mobility,2019,https://williamsandsons.com,Your miss lead ever low writer together.,26,williams-and-sons,2023,USD,1445905,439686,1006219,654572,351647,0,351647,14459,28918,322729,53894,779609,271309,508300,,1445905,889.18,711.77,0.062,6024,20.0,59524.95,0.91,0.6959
9588,Ferguson Inc,False,KE,North Christian,Mobility,2019,https://fergusoninc.com,To military you song.,19,ferguson-inc,2023,USD,4529760,1029181,3500579,1139627,2360952,6834,2354118,45297,90595,2263523,1178873,3487078,856670,2630408,,4529760,1333.5,2791.92,0.007,2295,164.44,118894.14,9.92,0.7728
9589,Lynch Wright and Lewis,False,DE,Zunigatown,Fintech,2013,https://lynchwrightandlewis.com,As first whatever behind individual building.,21,lynch-wright-and-lewis,2023,EUR,2646682,607705,2038977,304861,1734116,29926,1704190,26466,52933,1651257,203039,1562581,751319,811262,,2646682,342.08,477.54,0.0283,1289,171.05,1000.0,203.04,0.7704
9590,Klein Payne and Kim,False,TN,North Frank,SaaS,2009,https://kleinpayneandkim.com,Field us senior their discover.,14,klein-payne-and-kim,2023,USD,741356,151494,589862,156032,433830,0,433830,7413,14827,419003,5097,401423,110161,291262,61779.67,741356,10.0,11.14,0.0225,1619,38.15,6126.62,0.83,0.7957
9591,Scott Pearson and Davis,False,KE,North Feliciastad,Cybersecurity,2021,https://scottpearsonanddavis.com,Final later wish chance certain collection start.,28,scott-pearson-and-davis,2023,USD,906084,244595,661489,446667,214822,31711,183111,9060,18121,164990,49256,596030,261357,334673,,906084,807.27,2485.45,0.0517,255,295.19,16429.87,3.0,0.7301
9592,Gibson-Johnson,False,US,Abigailhaven,HealthTech,2022,https://gibson-johnson.com,Popular impact west but try ok.,20,gibson-johnson,2023,USD,3325740,1112147,2213593,1767505,446088,11931,434157,33257,66514,367643,31089,1717437,582294,1135143,277145.0,3325740,10.0,64.32,0.035,4185,66.22,114550.81,0.27,0.6656
9593,Bennett-Adkins,False,CA,West Ryan,Mobility,2017,https://bennett-adkins.com,Cover personal enter minute culture field dog able.,18,bennett-adkins,2023,USD,1415991,238780,1177211,70799,1106412,0,1106412,14159,28319,1078093,64532,801732,98884,702848,,1415991,80.43,93.2,0.0609,5899,20.0,32041.58,2.01,0.8314
9594,Rodriguez-Key,False,BR,Richardsonmouth,E-commerce,2016,https://rodriguez-key.com,Consumer identify type chance prove.,19,rodriguez-key,2023,USD,628371,296830,331541,474983,-143442,20545,-163987,6283,12567,-176554,26776,514275,76215,438060,,628371,291.04,1142.23,0.0037,2618,20.0,21523.49,1.24,0.5276
9595,Mathis-Nunez,False,AU,East Carolynbury,AgriTech,2012,https://mathis-nunez.com,Light picture once six sort the risk maybe.,30,mathis-nunez,2023,USD,333363,105968,227395,189324,38071,23139,14932,3333,6667,8265,9214,295896,78436,217460,,333363,664.79,3516.7,0.1503,430,64.51,38058.11,0.24,0.6821
9596,Lewis Ltd,False,US,Lawrencefurt,E-commerce,2017,https://lewisltd.com,Nation return myself police between tree social rate business push support.,21,lewis-ltd,2023,USD,2060139,834599,1225540,755692,469848,2548,467300,20601,41202,426098,124017,1332578,947640,384938,,2060139,157.55,78.78,0.1037,8583,20.0,44193.21,2.81,0.5949
9597,Coleman Inc,False,ZA,Kevinchester,AI/ML,2017,https://colemaninc.com,Will new series debate what cup.,19,coleman-inc,2023,USD,1735971,902860,833111,375371,457740,5705,452035,17359,34719,417316,171895,1223623,855565,368058,,1735971,563.91,913.22,0.0821,672,215.0,34790.81,4.94,0.4799
9598,Bell Inc,False,ZA,East Ross,AgriTech,2018,https://bellinc.com,Far ground perform many agency forget bag.,19,bell-inc,2023,USD,137590,39879,97711,57312,40399,10702,29697,1375,2751,26946,9838,187885,46954,140931,,137590,20.0,77.98,0.0446,169,67.75,14748.83,0.67,0.7102
9599,Le-Adams,False,DE,Henryborough,AI/ML,2010,https://le-adams.com,Spend staff bar rich eight conference with public.,15,le-adams,2023,EUR,2976088,1848996,1127092,303173,823919,0,823919,29760,59521,764398,57733,1636264,1164260,472004,,2976088,20.0,58.73,0.0836,1126,220.14,87759.38,0.66,0.3787
9600,Mcdaniel-Peterson,False,FR,Chadland,AI/ML,2008,https://mcdaniel-peterson.com,Control popular guy word media strategy.,22,mcdaniel-peterson,2023,EUR,574727,272821,301906,254840,47066,6565,40501,5747,11494,29007,6575,493200,189189,304011,,574727,665.0,1647.48,0.0246,2394,20.0,50437.61,0.13,0.5253
9601,Tate Weeks and Noble,False,BR,North Kaitlyn,AI/ML,2011,https://tateweeksandnoble.com,Start national trial officer their service sport hotel.,15,tate-weeks-and-noble,2023,USD,1089283,270216,819067,947899,-128832,0,-128832,10892,21785,-150617,25335,717414,290495,426919,,1089283,948.87,2393.81,0.0647,958,94.66,37553.36,0.67,0.7519
9602,Yang-Smith,False,ZA,North Carlbury,AI/ML,2020,https://yang-smith.com,Pay pressure anything option next.,21,yang-smith,2023,USD,659321,59127,600194,261144,339050,9910,329140,6593,13186,315954,73750,510447,316244,194203,,659321,288.88,604.9,0.0366,226,242.94,1000.0,73.75,0.9103
9603,Valdez-Hudson,False,CA,Port Carlafurt,Marketplaces,2019,https://valdez-hudson.com,Shoulder certainly Democrat dark rest rate.,19,valdez-hudson,2023,USD,743273,265431,477842,407729,70113,0,70113,7432,14865,55248,15666,388243,60914,327329,,743273,1155.31,1077.64,0.0094,3096,20.0,1000.0,15.67,0.6429
9604,Rivers PLC,False,NG,Brianshire,EdTech,2017,https://riversplc.com,Decision recently picture others smile.,22,rivers-plc,2023,USD,229033,74425,154608,179977,-25369,0,-25369,2290,4580,-29949,20167,181401,74841,106560,19086.08,229033,134.18,533.26,0.0602,238,79.93,27598.92,0.73,0.675
9605,Ochoa-Lopez,False,IN,North James,E-commerce,2020,https://ochoa-lopez.com,Over ability step mean board school region far wide.,14,ochoa-lopez,2023,USD,197238,78078,119160,9861,109299,10116,99183,1972,3944,95239,5760,105135,32745,72390,,197238,742.27,3337.57,0.0379,75,217.22,1000.0,5.76,0.6041
9606,Russell-Conway,False,TN,Calvinshire,HealthTech,2013,https://russell-conway.com,Deep at could choose score accept pressure memory worker education.,18,russell-conway,2023,USD,305111,105579,199532,91173,108359,45824,62535,3051,6102,56433,41624,372906,132645,240261,25425.92,305111,10.0,44.13,0.0211,772,32.92,1000.0,41.62,0.654
9607,Stevens Ltd,False,KE,Gillespieport,Marketplaces,2019,https://stevensltd.com,Hand this at heavy Mrs cold somebody example serve.,22,stevens-ltd,2023,USD,257110,62658,194452,206254,-11802,0,-11802,2571,5142,-16944,31368,287867,140706,147161,,257110,20.0,58.91,0.0261,60,354.58,1000.0,31.37,0.7563
9608,Fox Inc,False,GB,New Devin,Fintech,2023,https://foxinc.com,Charge win scene community positive sell call.,23,fox-inc,2023,USD,779100,142060,637040,346729,290311,10514,279797,7791,15582,264215,10965,421874,21093,400781,,779100,1698.42,8051.55,0.0621,185,350.58,6648.62,1.65,0.8177
9609,Johns Ford and Kemp,False,KE,Port Michael,Mobility,2009,https://johnsfordandkemp.com,Break travel relate kitchen respond institution trip while.,21,johns-ford-and-kemp,2023,USD,756615,266233,490382,488530,1852,19570,-17718,7566,15132,-32850,110511,607821,204231,403590,,756615,297.18,148.59,0.0655,726,86.73,1000.0,110.51,0.6481
9610,Noble Ltd,False,CA,Scottchester,Cybersecurity,2021,https://nobleltd.com,Rock democratic lay four drop interview effect outside ok four.,21,noble-ltd,2023,USD,3936207,1331173,2605034,2361450,243584,0,243584,39362,78724,164860,142231,2181179,109058,2072121,,3936207,336.98,767.57,0.001,2458,133.44,201511.48,0.71,0.6618
9611,Ortega PLC,False,TN,New Vanessaport,SaaS,2015,https://ortegaplc.com,Glass help hear begin tend usually middle exist democratic.,14,ortega-plc,2023,USD,1966523,815941,1150582,1558500,-407918,0,-407918,19665,39330,-447248,27321,1023915,547967,475948,163876.92,1966523,10.0,18.31,0.0051,32775,5.0,118123.9,0.23,0.5851
9612,Brown-Mcguire,False,AU,Alicemouth,Energy,2011,https://brown-mcguire.com,Environmental color world nature apply well at perhaps every everyone.,24,brown-mcguire,2023,USD,797078,389793,407285,308951,98334,0,98334,7970,15941,82393,193551,639868,282739,357129,,797078,32.06,155.33,0.1266,728,91.2,57707.71,3.35,0.511
9613,Hernandez-Wilkerson,False,AU,New Nicholas,Energy,2012,https://hernandez-wilkerson.com,Night middle course task trip back data.,14,hernandez-wilkerson,2023,USD,870408,196211,674197,363795,310402,0,310402,8704,17408,292994,67905,692135,219368,472767,,870408,707.0,2868.87,0.0446,764,94.85,58408.57,1.16,0.7746
9614,Morris Ltd,False,IN,East Donaldmouth,AI/ML,2021,https://morrisltd.com,Cup which section article maybe agree assume skin.,19,morris-ltd,2023,USD,739532,279022,460510,451246,9264,3435,5829,7395,14790,-8961,27550,447438,226271,221167,,739532,737.2,2114.37,0.0785,702,87.78,26341.43,1.05,0.6227
9615,Carr Ltd,False,US,Curtishaven,Mobility,2008,https://carrltd.com,Result it small free go yes special.,14,carr-ltd,2023,USD,1409503,706156,703347,272558,430789,21977,408812,14095,28190,380622,89199,909442,559934,349508,,1409503,20.0,41.7,0.0736,832,141.12,35449.25,2.52,0.499
9616,Rojas PLC,False,IN,Port Rhondaborough,Mobility,2012,https://rojasplc.com,Accept expect computer nothing mother role gas leader kid.,30,rojas-plc,2023,USD,4365508,1126704,3238804,2752150,486654,14404,472250,43655,87310,384940,362076,2680096,1297413,1382683,,4365508,206.0,686.53,0.1023,1650,220.43,243760.88,1.49,0.7419
9617,Cordova Lopez and Hernandez,False,AU,Justinside,Energy,2020,https://cordovalopezandhernandez.com,Expert its not house maintain somebody age prevent scene.,22,cordova-lopez-and-hernandez,2023,USD,1066687,230177,836510,803027,33483,0,33483,10666,21333,12150,144882,772380,159858,612522,,1066687,114.88,369.66,0.0177,528,168.17,58508.17,2.48,0.7842
9618,Brown Ltd,False,US,East Heatherton,HealthTech,2014,https://brownltd.com,Until trip think eye manage young strong prevent.,20,brown-ltd,2023,USD,136712,62794,73918,141429,-67511,25113,-92624,1367,2734,-95358,6067,142114,19079,123035,11392.67,136712,10.0,60.43,0.0392,2278,5.0,42264.44,0.14,0.5407
9619,Nicholson Singleton and Reed,False,CA,Jessicaport,Fintech,2019,https://nicholsonsingletonandreed.com,Within foreign share approach may floor view industry.,17,nicholson-singleton-and-reed,2023,USD,412180,89578,322602,326801,-4199,13696,-17895,4121,8243,-26138,40972,283291,61207,222084,,412180,31.19,194.51,0.112,215,159.58,42125.58,0.97,0.7827
9620,Gomez-Williamson,False,NG,Richardsonfort,E-commerce,2008,https://gomez-williamson.com,Rate attorney garden house cultural though protect again.,28,gomez-williamson,2023,USD,1797018,497925,1299093,1213020,86073,23653,62420,17970,35940,26480,138504,1145812,809703,336109,,1797018,2386.84,6022.32,0.0449,519,288.43,93207.94,1.49,0.7229
9621,Murray Guerrero and Taylor,False,FR,North Jeremyburgh,E-commerce,2014,https://murrayguerreroandtaylor.com,Public rise card southern affect owner set moment ever.,15,murray-guerrero-and-taylor,2023,EUR,715547,320189,395358,177594,217764,0,217764,7155,14310,203454,60113,422414,131912,290502,,715547,461.83,230.92,0.0042,2981,20.0,4203.66,14.3,0.5525
9622,Cobb-Foster,False,BR,Susanberg,SaaS,2010,https://cobb-foster.com,Lot network talk stay red already.,29,cobb-foster,2023,USD,344121,212188,131933,214998,-83065,4559,-87624,3441,6882,-94506,16479,268748,121629,147119,28676.75,344121,10.0,36.02,0.0404,462,61.94,39131.07,0.42,0.3834
9623,Bailey Larson and Lane,False,EG,Port Pamela,EdTech,2010,https://baileylarsonandlane.com,Drug wait drop imagine off whether.,20,bailey-larson-and-lane,2023,USD,310471,100350,210121,46101,164020,11927,152093,3104,6209,145884,18212,255035,54761,200274,25872.58,310471,10.0,80.72,0.0197,511,50.57,1000.0,18.21,0.6768
9624,Eaton-Sanchez,False,TN,South Charlesview,Mobility,2011,https://eaton-sanchez.com,List sing history again account body sister choice significant interest.,20,eaton-sanchez,2023,USD,1471207,382590,1088617,161904,926713,19720,906993,14712,29424,877569,37041,849910,480083,369827,,1471207,707.19,2882.97,0.001,759,161.45,33032.22,1.12,0.7399
9625,Preston Group,False,CA,Quinnborough,Energy,2009,https://prestongroup.com,Risk month majority quite box manager she cell federal who.,25,preston-group,2023,USD,1465184,554100,911084,1054683,-143599,0,-143599,14651,29303,-172902,6919,795882,449166,346716,,1465184,20.0,31.31,0.001,733,166.35,53547.2,0.13,0.6218
9626,Perkins and Sons,False,CA,Wilsonland,AI/ML,2022,https://perkinsandsons.com,Social company next fine writer can.,20,perkins-and-sons,2023,USD,2347952,378136,1969816,920427,1049389,3040,1046349,23479,46959,999390,89832,1338012,611815,726197,,2347952,20.0,36.85,0.1585,8145,24.02,85061.58,1.06,0.839
9627,Rodgers Solomon and Garcia,False,KE,South Cassandra,SaaS,2019,https://rodgerssolomonandgarcia.com,Make would similar hear theory cause.,17,rodgers-solomon-and-garcia,2023,USD,1236668,389359,847309,290226,557083,0,557083,12366,24733,532350,118353,788466,588165,200301,103055.67,1236668,375.12,1679.26,0.0398,3466,29.73,28163.22,4.2,0.6852
9628,Anthony-Nelson,False,GB,Guzmanhaven,HealthTech,2016,https://anthony-nelson.com,Tree business unit as sense what because left.,16,anthony-nelson,2023,USD,1029050,362441,666609,234258,432351,0,432351,10290,20581,411770,42893,618582,164459,454123,85754.17,1029050,344.18,941.84,0.0451,17150,5.0,26559.45,1.61,0.6478
9629,Stewart Torres and Smith,False,IN,Matthewland,Fintech,2014,https://stewarttorresandsmith.com,Product report arm despite store meeting clearly necessary.,20,stewart-torres-and-smith,2023,USD,456012,184063,271949,270655,1294,1883,-589,4560,9120,-9709,45990,274046,13702,260344,,456012,950.41,475.2,0.1086,1900,20.0,15458.99,2.97,0.5964
9630,Johnson PLC,False,DE,West Thomasport,IoT,2018,https://johnsonplc.com,Situation month month ahead mention Congress early.,29,johnson-plc,2023,EUR,152295,74437,77858,51667,26191,14583,11608,1522,3045,8563,47031,145191,75398,69793,,152295,20.0,40.25,0.0797,153,82.83,1000.0,47.03,0.5112
9631,Nguyen Group,False,IN,Jacksonshire,Mobility,2016,https://nguyengroup.com,Rise market each tonight family somebody.,22,nguyen-group,2023,USD,415085,208959,206126,39077,167049,10788,156261,4150,8301,147960,55487,310935,39045,271890,,415085,726.62,363.31,0.001,334,103.45,1000.0,55.49,0.4966
9632,Johnson Wright and Howard,False,US,Kristenhaven,Cybersecurity,2020,https://johnsonwrightandhoward.com,Plan someone animal chair sound heavy across hand company.,17,johnson-wright-and-howard,2023,USD,1187986,456592,731394,812048,-80654,881,-81535,11879,23759,-105294,62636,711430,247836,463594,,1187986,20.0,57.89,0.0696,943,104.89,80258.38,0.78,0.6157
9633,Sawyer-Arnold,False,IN,Bennettfurt,Cybersecurity,2019,https://sawyer-arnold.com,Consider let treat dog.,26,sawyer-arnold,2023,USD,1352523,513987,838536,687173,151363,0,151363,13525,27050,124313,86703,858377,358708,499669,,1352523,400.7,1454.42,0.0974,590,190.94,37615.12,2.31,0.62
9634,Mendez Sanders and Campbell,False,DE,Kellyberg,Fintech,2018,https://mendezsandersandcampbell.com,Sure question store any great realize worry.,20,mendez-sanders-and-campbell,2023,EUR,1480678,98433,1382245,394686,987559,0,987559,14806,29613,957946,213542,1036456,501726,534730,,1480678,20.0,108.69,0.0645,6169,20.0,45507.86,4.69,0.9335
9635,Kemp and Sons,False,ZA,North Stevenburgh,Mobility,2009,https://kempandsons.com,Large red several view although option.,22,kemp-and-sons,2023,USD,3945037,1406454,2538583,1737736,800847,0,800847,39450,78900,721947,1985545,4056381,996844,3059537,,3945037,497.71,1152.22,0.1444,1529,215.01,134782.62,14.73,0.6435
9636,Robinson Vaughn and Thompson,False,CA,Annfort,Cybersecurity,2022,https://robinsonvaughnandthompson.com,Play democratic politics American child.,27,robinson-vaughn-and-thompson,2023,USD,2516283,945828,1570455,1627055,-56600,12825,-69425,25162,50325,-119750,306258,1659218,489608,1169610,,2516283,20.0,34.65,0.0415,10484,20.0,148076.96,2.07,0.6241
9637,Roman Inc,False,FR,New Lisa,IoT,2010,https://romaninc.com,Religious attack challenge anyone mouth.,30,roman-inc,2023,EUR,1973037,566698,1406339,1616410,-210071,0,-210071,19730,39460,-249531,136241,1208214,533341,674873,,1973037,162.67,526.35,0.1231,8220,20.0,156067.52,0.87,0.7128
9638,Richard Porter and Vargas,False,AU,East Melinda,Marketplaces,2024,https://richardporterandvargas.com,Next old the beyond mission ask sister.,16,richard-porter-and-vargas,2023,USD,408170,112960,295210,43982,251228,0,251228,4081,8163,243065,24503,265888,39770,226118,,408170,20.0,135.19,0.1387,136,249.07,1842.36,13.3,0.7233
9639,Bond Ltd,False,BR,Christopherborough,IoT,2020,https://bondltd.com,Suddenly draw already deal little least.,22,bond-ltd,2023,USD,980097,298788,681309,365840,315469,26828,288641,9800,19601,269040,47411,644770,370216,274554,,980097,20.0,61.13,0.001,489,166.74,68578.43,0.69,0.6951
9640,Olson-Cowan,False,TN,New Amy,Cybersecurity,2017,https://olson-cowan.com,Money until name Republican quickly might walk Democrat.,13,olson-cowan,2023,USD,1826330,308855,1517475,329958,1187517,12533,1174984,18263,36526,1138458,90976,1102586,318107,784479,,1826330,20.0,101.59,0.001,1722,88.38,13961.92,6.52,0.8309
9641,Baker-Wallace,False,ZA,Simpsonhaven,Energy,2014,https://baker-wallace.com,East trouble million clear none type old.,20,baker-wallace,2023,USD,3357071,1865855,1491216,2390538,-899322,8345,-907667,33570,67141,-974808,210812,1890219,1168493,721726,,3357071,20.0,116.17,0.0123,13987,20.0,175141.32,1.2,0.4442
9642,Lopez Carrillo and Perez,False,TN,Crystalmouth,E-commerce,2020,https://lopezcarrilloandperez.com,Impact me staff air hope majority age offer.,24,lopez-carrillo-and-perez,2023,USD,815894,375808,440086,402434,37652,0,37652,8158,16317,21335,68025,555321,32242,523079,,815894,370.22,1781.37,0.033,3399,20.0,65232.25,1.04,0.5394
9643,Ball and Sons,False,FR,East Coreyfort,AI/ML,2015,https://ballandsons.com,Fly no wife anything listen house capital hundred those use.,20,ball-and-sons,2023,EUR,758007,291813,466194,451034,15160,6676,8484,7580,15160,-6676,47093,472028,258094,213934,,758007,906.11,4152.27,0.0943,258,244.35,59776.9,0.79,0.615
9644,Ryan and Sons,False,DE,East Thomasfurt,E-commerce,2023,https://ryanandsons.com,Role now box federal read development.,22,ryan-and-sons,2023,EUR,843369,414226,429143,208044,221099,0,221099,8433,16867,204232,15820,619889,303613,316276,,843369,521.85,3278.94,0.097,1811,38.79,37504.96,0.42,0.5088
9645,Johnson-Richardson,False,IN,Port Antonio,Marketplaces,2022,https://johnson-richardson.com,Trial sit would be Democrat.,19,johnson-richardson,2023,USD,1649481,918074,731407,1547421,-816014,2464,-818478,16494,32989,-851467,11772,929626,483552,446074,,1649481,1641.63,12162.92,0.062,834,164.71,103422.31,0.11,0.4434
9646,Williams Patton and Harris,False,TN,Bradleyton,AI/ML,2008,https://williamspattonandharris.com,Know firm scene feeling money development manager state conference.,15,williams-patton-and-harris,2023,USD,1395233,647530,747703,498621,249082,11456,237626,13952,27904,209722,33311,831202,324824,506378,,1395233,918.41,3376.89,0.0451,978,118.82,37382.63,0.89,0.5359
9647,Phelps-Anderson,False,CA,South Bobby,Marketplaces,2022,https://phelps-anderson.com,True care within coach ok capital.,16,phelps-anderson,2023,USD,196242,59773,136469,105356,31113,9876,21237,1962,3924,17313,19675,316177,15808,300369,,196242,20.0,94.91,0.0089,119,137.24,25650.24,0.77,0.6954
9648,Hester Ltd,False,US,Richardsonhaven,HealthTech,2015,https://hesterltd.com,Tv economy just really dream suddenly class.,15,hester-ltd,2023,USD,1490213,561203,929010,739124,189886,17337,172549,14902,29804,142745,372330,1226537,608698,617839,124184.42,1490213,353.87,2393.31,0.001,1812,68.5,35517.77,10.48,0.6234
9649,Sampson Inc,False,ZA,Lake Jasonhaven,Cybersecurity,2023,https://sampsoninc.com,Work American know fine look think outside anyone consumer message.,19,sampson-inc,2023,USD,1235402,430478,804924,61770,743154,0,743154,12354,24708,718446,378419,1088930,324057,764873,,1235402,561.96,1820.08,0.1185,5147,20.0,1000.0,378.42,0.6515
9650,Montoya Inc,False,EG,Kimburgh,Cybersecurity,2010,https://montoyainc.com,Process such total life challenge he.,24,montoya-inc,2023,USD,804331,336154,468177,403652,64525,0,64525,8043,16086,48439,30070,552711,261543,291168,,804331,20.0,23.4,0.1243,996,67.29,14847.95,2.03,0.5821
9651,Guzman Bradley and Gardner,False,NG,Ballside,AgriTech,2015,https://guzmanbradleyandgardner.com,Six deep man writer eat somebody back since find.,12,guzman-bradley-and-gardner,2023,USD,54866,12968,41898,23320,18578,0,18578,548,1097,17481,10340,166087,20964,145123,,54866,768.89,1944.81,0.001,62,73.52,1000.0,10.34,0.7636
9652,Russell-Strong,False,US,West Elizabeth,Marketplaces,2011,https://russell-strong.com,As thus smile institution risk together create kind bit.,11,russell-strong,2023,USD,316004,117958,198046,142843,55203,25262,29941,3160,6320,23621,13991,318406,106006,212400,,316004,569.29,284.64,0.0425,1316,20.0,4645.74,3.01,0.6267
9653,Johnson Johnson and Smith,False,KE,Josephport,HealthTech,2013,https://johnsonjohnsonandsmith.com,Suggest worker section cost despite property often special notice police never.,17,johnson-johnson-and-smith,2023,USD,401125,135815,265310,125507,139803,0,139803,4011,8022,131781,44372,387915,195200,192715,33427.08,401125,706.48,4209.19,0.0608,1819,18.37,1000.0,44.37,0.6614
9654,Ortiz-Martin,False,US,Samanthamouth,IoT,2019,https://ortiz-martin.com,Herself trouble democratic strong put city paper.,24,ortiz-martin,2023,USD,1211165,477762,733403,482232,251171,16350,234821,12111,24223,210598,46731,714310,159194,555116,,1211165,283.91,1225.05,0.0452,5046,20.0,66999.62,0.7,0.6055
9655,Chandler Garcia and Dixon,False,TN,Clementsville,Mobility,2015,https://chandlergarciaanddixon.com,Professor officer result participant business.,22,chandler-garcia-and-dixon,2023,USD,1145349,534635,610714,409720,200994,3731,197263,11453,22906,174357,4264,691249,270829,420420,,1145349,506.58,1891.63,0.1246,4772,20.0,1000.0,4.26,0.5332
9656,Savage Parker and Cooper,False,DE,Kyleton,EdTech,2012,https://savageparkerandcooper.com,Level avoid shake road next parent.,19,savage-parker-and-cooper,2023,EUR,2479184,981921,1497263,1005036,492227,13336,478891,24791,49583,429308,157514,1523582,249156,1274426,206598.67,2479184,10.0,35.9,0.0136,1829,112.94,100961.03,1.56,0.6039
9657,Conley Kelley and Williams,False,ZA,Denisechester,Cybersecurity,2023,https://conleykelleyandwilliams.com,Some fund southern sign your.,21,conley-kelley-and-williams,2023,USD,373677,138154,235523,141499,94024,36631,57393,3736,7473,49920,13476,304958,132581,172377,,373677,473.91,1308.59,0.07,297,104.84,2280.62,5.91,0.6303
9658,Martin Reilly and Baker,False,DE,Lake Ronald,Marketplaces,2012,https://martinreillyandbaker.com,They set detail assume draw just fast west party.,20,martin-reilly-and-baker,2023,EUR,458044,175126,282918,179600,103318,32027,71291,4580,9160,62131,8995,246081,186879,59202,,458044,1358.24,6777.76,0.0658,199,191.67,14184.99,0.63,0.6177
9659,Miller-Buchanan,False,DE,Robertburgh,IoT,2020,https://miller-buchanan.com,Medical leave risk job instead create hand I film risk.,18,miller-buchanan,2023,EUR,273125,153802,119323,107677,11646,0,11646,2731,5462,6184,12038,276165,162940,113225,,273125,575.4,2082.61,0.101,109,207.74,16313.0,0.74,0.4369
9660,Clarke Smith and Mckinney,False,IN,Lauriemouth,AgriTech,2009,https://clarkesmithandmckinney.com,General possible year information better.,15,clarke-smith-and-mckinney,2023,USD,981871,662401,319470,578256,-258786,0,-258786,9818,19637,-278423,41314,607597,279654,327943,,981871,1137.87,2328.86,0.084,4091,20.0,38522.75,1.07,0.3254
9661,Valencia-Hawkins,False,GB,South Richardmouth,AI/ML,2012,https://valencia-hawkins.com,Feeling town against fish myself reflect however.,21,valencia-hawkins,2023,USD,1276735,327707,949028,726814,222214,14342,207872,12767,25534,182338,14072,733447,188161,545286,,1276735,1095.92,3569.51,0.101,422,251.78,78432.71,0.18,0.7433
9662,Salazar-Jones,False,CA,South William,EdTech,2013,https://salazar-jones.com,Speak trade such career sense age various.,13,salazar-jones,2023,USD,324188,116072,208116,254189,-46073,0,-46073,3241,6483,-52556,48770,211326,72437,138889,27015.67,324188,631.61,1615.91,0.0333,308,87.68,33632.3,1.45,0.642
9663,Larson Group,False,TN,East Ryanview,Mobility,2020,https://larsongroup.com,Specific time wrong help security family north game run hope.,25,larson-group,2023,USD,640421,212002,428419,71686,356733,29029,327704,6404,12808,314896,34072,422439,143493,278946,,640421,20.0,46.42,0.001,288,184.91,1000.0,34.07,0.669
9664,Harding Douglas and Carroll,False,KE,North Christopherside,IoT,2013,https://hardingdouglasandcarroll.com,Democratic effort magazine among consider hit.,21,harding-douglas-and-carroll,2023,USD,501799,210364,291435,225227,66208,28259,37949,5017,10035,27914,19052,302058,214176,87882,,501799,758.07,3648.48,0.0432,2090,20.0,22582.81,0.84,0.5808
9665,Perez-Logan,False,IN,Kellyville,HealthTech,2022,https://perez-logan.com,Personal thought deal traditional car store government call.,21,perez-logan,2023,USD,3629109,1669528,1959581,2054081,-94500,0,-94500,36291,72582,-167082,56009,2055630,888405,1167225,302425.75,3629109,791.52,5207.19,0.0288,6207,48.72,174303.43,0.32,0.54
9666,Wright Elliott and Flores,False,EG,New Joshuaberg,EdTech,2013,https://wrightelliottandflores.com,Side catch house establish meeting early development trouble store administration.,25,wright-elliott-and-flores,2023,USD,651250,247993,403257,224702,178555,31850,146705,6512,13025,133680,248084,637935,31896,606039,54270.83,651250,364.2,2740.32,0.0564,2978,18.22,1000.0,248.08,0.6192
9667,Smith Dunn and Avery,False,DE,New Shannonville,Cybersecurity,2018,https://smithdunnandavery.com,Hope action white fear beyond.,26,smith-dunn-and-avery,2023,EUR,606700,266105,340595,157818,182777,0,182777,6067,12134,170643,20075,445385,135101,310284,,606700,484.51,242.26,0.001,196,257.73,19074.0,1.05,0.5614
9668,Norman Inc,False,BR,Erikaville,HealthTech,2009,https://normaninc.com,Task security and strategy brother movement door important bank paper like.,15,norman-inc,2023,USD,367256,117240,250016,83174,166842,3926,162916,3672,7345,155571,5949,194377,79568,114809,30604.67,367256,595.33,3615.76,0.0202,243,125.8,19343.29,0.31,0.6808
9669,Johnson and Sons,False,GB,Webstermouth,EdTech,2013,https://johnsonandsons.com,Trade baby help happy chance someone their must.,15,johnson-and-sons,2023,USD,826634,126416,700218,338849,361369,8868,352501,8266,16532,335969,347444,803469,404874,398595,68886.17,826634,607.69,2869.09,0.0336,1175,58.6,25359.74,13.7,0.8471
9670,Skinner Inc,False,US,Port Joshua,IoT,2011,https://skinnerinc.com,Former accept reduce nation rather continue serve say president.,18,skinner-inc,2023,USD,987909,475857,512052,1139517,-627465,13849,-641314,9879,19758,-661072,216675,740588,201586,539002,,987909,1514.21,5859.17,0.0735,468,175.82,97856.46,2.21,0.5183
9671,Hart-Olson,False,IN,Dawnland,Cybersecurity,2008,https://hart-olson.com,Contain history seven process look include door entire next government.,26,hart-olson,2023,USD,1456909,555700,901209,396633,504576,0,504576,14569,29138,475438,88206,966378,225599,740779,,1456909,335.2,516.84,0.0871,644,188.37,35381.92,2.49,0.6186
9672,Malone-Conway,False,FR,Saramouth,Energy,2014,https://malone-conway.com,Treat risk sense expect nice include thought.,14,malone-conway,2023,EUR,998505,355588,642917,308394,334523,2509,332014,9985,19970,312044,41141,641918,426196,215722,,998505,422.95,2263.04,0.104,1109,74.99,41432.65,0.99,0.6439
9673,Garcia Turner and Bright,False,DE,Jonesland,HealthTech,2024,https://garciaturnerandbright.com,Trade executive here general true crime religious yard piece.,23,garcia-turner-and-bright,2023,EUR,1144464,509026,635438,485622,149816,0,149816,11444,22889,126927,204260,803451,290015,513436,95372.0,1144464,453.79,805.08,0.0038,1726,55.24,9936.29,20.56,0.5552
9674,Jacobson PLC,False,IN,East Robert,AgriTech,2012,https://jacobsonplc.com,Increase PM fact compare nearly yes price significant.,14,jacobson-plc,2023,USD,365423,43391,322032,146609,175423,0,175423,3654,7308,168115,14498,338123,118087,220036,,365423,1612.73,7542.93,0.0583,598,50.89,17176.8,0.84,0.8813
9675,Murphy-Olson,False,DE,Theodoreberg,AgriTech,2023,https://murphy-olson.com,Onto through able with painting page speech similar real.,25,murphy-olson,2023,EUR,1545378,607135,938243,318094,620149,0,620149,15453,30907,589242,179510,1149479,359010,790469,,1545378,265.67,810.64,0.0113,928,138.75,17102.58,10.5,0.6071
9676,Alexander-Brown,False,BR,West Katie,Fintech,2024,https://alexander-brown.com,Song establish research once anything read cultural ever right speak who.,18,alexander-brown,2023,USD,506450,243882,262568,388751,-126183,0,-126183,5064,10129,-136312,32538,380691,87591,293100,,506450,91.36,227.67,0.0986,95,440.12,23174.3,1.4,0.5184
9677,Bryant-Morales,False,GB,South Michael,IoT,2008,https://bryant-morales.com,Realize human rich quite difficult particular while.,20,bryant-morales,2023,USD,1743258,652982,1090276,807867,282409,0,282409,17432,34865,247544,192270,1177592,441811,735781,,1743258,938.73,3120.6,0.0776,7263,20.0,89503.05,2.15,0.6254
9678,Hatfield LLC,False,AU,West Anthonystad,Marketplaces,2023,https://hatfieldllc.com,Town paper relationship music fine particularly cultural.,23,hatfield-llc,2023,USD,461159,153060,308099,181878,126221,0,126221,4611,9223,116998,26102,447500,196470,251030,,461159,20.0,10.0,0.0684,143,268.55,1000.0,26.1,0.6681
9679,Mendoza Inc,False,CA,West Jameschester,E-commerce,2010,https://mendozainc.com,Performance simple religious tend method analysis.,17,mendoza-inc,2023,USD,1298493,533637,764856,457027,307829,0,307829,12984,25969,281860,21060,701528,173699,527829,,1298493,20.0,76.55,0.0666,454,238.32,21298.43,0.99,0.589
9680,Young Ltd,False,CA,Lake Stephanie,AgriTech,2018,https://youngltd.com,Wide matter management successful police along single strategy region cause particularly.,21,young-ltd,2023,USD,84048,28076,55972,71366,-15394,9114,-24508,840,1680,-26188,15266,67221,7092,60129,,84048,1110.27,4974.99,0.1255,43,162.15,1000.0,15.27,0.666
9681,Maddox-Watson,False,GB,Port Tricia,Energy,2009,https://maddox-watson.com,Reduce fact operation finish whose condition machine case.,23,maddox-watson,2023,USD,8391511,3501350,4890161,6754965,-1864804,0,-1864804,83915,167830,-2032634,106371,4311761,1611415,2700346,,8391511,87.87,89.78,0.0927,8347,83.77,599102.53,0.18,0.5828
9682,Stuart-Flynn,False,EG,Christopherland,E-commerce,2021,https://stuart-flynn.com,Bad fine attack the machine science employee poor produce.,14,stuart-flynn,2023,USD,757105,400576,356529,452911,-96382,0,-96382,7571,15142,-111524,40674,478837,288289,190548,,757105,20.0,20.72,0.1185,701,89.97,33779.17,1.2,0.4709
9683,Wells Gonzales and Holden,False,KE,Smithbury,Cybersecurity,2010,https://wellsgonzalesandholden.com,Read fire sometimes that where probably price couple fund.,17,wells-gonzales-and-holden,2023,USD,574925,102588,472337,492981,-20644,0,-20644,5749,11498,-32142,20004,447730,103149,344581,,574925,20.0,91.76,0.0108,454,105.45,16494.06,1.21,0.8216
9684,Terrell Coffey and Carlson,False,DE,Dunnfurt,AI/ML,2015,https://terrellcoffeyandcarlson.com,Right benefit top available buy book lot sister fast significant card.,22,terrell-coffey-and-carlson,2023,EUR,983285,504707,478578,337624,140954,7881,133073,9832,19665,113408,36698,651076,82223,568853,,983285,1032.41,2956.24,0.001,1163,70.42,39046.04,0.94,0.4867
9685,Rose-Vasquez,False,FR,Matthewmouth,SaaS,2008,https://rose-vasquez.com,Responsibility send about poor idea thing.,14,rose-vasquez,2023,EUR,2511243,914655,1596588,749573,847015,28270,818745,25112,50224,768521,57093,1414904,70745,1344159,209270.25,2511243,384.17,958.15,0.0513,41854,5.0,43182.09,1.32,0.6358
9686,Walker Inc,False,ZA,Lake Madison,Energy,2017,https://walkerinc.com,Economic star high nature dinner cost PM more art yes.,26,walker-inc,2023,USD,1647047,400880,1246167,485436,760731,0,760731,16470,32940,727791,391815,1280120,64006,1216114,,1647047,1326.23,1021.18,0.0278,631,217.46,21614.16,18.13,0.7566
9687,Smith-Armstrong,False,DE,Woodland,EdTech,2012,https://smith-armstrong.com,Consider establish without physical home.,22,smith-armstrong,2023,EUR,696437,87615,608822,138042,470780,0,470780,6964,13928,456852,61229,580349,226887,353462,58036.42,696437,10.0,10.0,0.001,2538,22.86,1000.0,61.23,0.8742
9688,Zavala-Zamora,False,GB,West Laurabury,Energy,2012,https://zavala-zamora.com,Increase seek room choose compare language doctor.,22,zavala-zamora,2023,USD,1354933,363106,991827,781061,210766,28054,182712,13549,27098,155614,90355,960580,48029,912551,,1354933,20.0,20.16,0.001,1239,91.13,60204.43,1.5,0.732
9689,Hardy Miller and Hill,False,GB,North Melody,Mobility,2022,https://hardymillerandhill.com,Thousand them improve unit part occur.,22,hardy-miller-and-hill,2023,USD,1538634,573373,965261,357687,607574,10190,597384,15386,30772,566612,134065,1000310,257490,742820,,1538634,47.93,23.96,0.069,2705,47.39,1000.0,134.06,0.6273
9690,Terry Group,False,EG,Jessicaton,Mobility,2014,https://terrygroup.com,Quite body economy onto yard risk.,22,terry-group,2023,USD,282934,102582,180352,124185,56167,0,56167,2829,5658,50509,13379,344171,185387,158784,,282934,72.97,415.69,0.0626,153,153.19,46803.14,0.29,0.6374
9691,Silva-Boone,False,DE,West Davidfort,Fintech,2021,https://silva-boone.com,World system current every even international give subject reach.,22,silva-boone,2023,EUR,1238506,447611,790895,1173049,-382154,0,-382154,12385,24770,-406924,29880,791533,238183,553350,,1238506,1178.69,2994.05,0.0427,949,108.66,134835.92,0.22,0.6386
9692,Smith-Bond,False,ZA,Carpentertown,AI/ML,2009,https://smith-bond.com,Whether security east break strategy.,21,smith-bond,2023,USD,102724,38670,64054,72173,-8119,0,-8119,1027,2054,-10173,1021,222332,99177,123155,,102724,417.35,1327.7,0.0764,428,20.0,7442.38,0.14,0.6236
9693,Foster Schneider and Wolf,False,TN,South Aaron,Energy,2017,https://fosterschneiderandwolf.com,Daughter five first off sell class evening ever decision.,31,foster-schneider-and-wolf,2023,USD,2855123,1565813,1289310,1875787,-586477,49920,-636397,28551,57102,-693499,76850,1563566,884226,679340,,2855123,20.0,10.0,0.0265,11896,20.0,191147.27,0.4,0.4516
9694,Bass Ashley and Cummings,False,ZA,South Rhonda,Mobility,2008,https://bassashleyandcummings.com,Herself agency son eat page class spring newspaper herself my.,13,bass-ashley-and-cummings,2023,USD,1617404,505265,1112139,606522,505617,11531,494086,16174,32348,461738,96991,939284,176058,763226,,1617404,20.0,137.34,0.1412,6739,20.0,50259.23,1.93,0.6876
9695,Reeves Ltd,False,AU,Carpenterfort,Mobility,2008,https://reevesltd.com,Laugh learn of ten administration pick social.,24,reeves-ltd,2023,USD,2464527,848784,1615743,923621,692122,27821,664301,24645,49290,615011,124930,1376113,461313,914800,,2464527,819.2,2715.44,0.0314,1593,128.92,71324.9,1.75,0.6556
9696,Jimenez Mckee and Powell,False,DE,Chelseaview,AI/ML,2019,https://jimenezmckeeandpowell.com,Doctor positive but doctor across work either involve.,13,jimenez-mckee-and-powell,2023,EUR,1655722,292999,1362723,947371,415352,20059,395293,16557,33114,362179,118912,986754,375381,611373,,1655722,929.07,3872.84,0.001,487,282.88,92031.61,1.29,0.823
9697,Conner-Duncan,False,US,Toddchester,EdTech,2020,https://conner-duncan.com,Nothing save air new one market body story night explain dark.,17,conner-duncan,2023,USD,315028,91375,223653,307718,-84065,0,-84065,3150,6300,-90365,12300,185077,34927,150150,26252.33,315028,347.87,1487.8,0.0345,5250,5.0,21824.13,0.56,0.7099
9698,Adams Dixon and Thompson,False,AU,Port Williamstad,SaaS,2018,https://adamsdixonandthompson.com,Half but call president maybe age scene travel coach century.,16,adams-dixon-and-thompson,2023,USD,963439,406497,556942,565157,-8215,0,-8215,9634,19268,-27483,37887,646433,35626,610807,80286.58,963439,514.56,1222.3,0.0866,872,92.04,42672.54,0.89,0.5781
9699,Mitchell Ltd,False,KE,East Connie,E-commerce,2013,https://mitchellltd.com,Recent fine my position start strong.,14,mitchell-ltd,2023,USD,654274,262835,391439,522840,-131401,0,-131401,6542,13085,-144486,5535,417681,57263,360418,,654274,20.0,111.39,0.0712,574,94.98,43320.33,0.13,0.5983
9700,Hoover-Dougherty,False,KE,Samanthaville,AI/ML,2017,https://hoover-dougherty.com,Each civil thank in less single style our describe.,22,hoover-dougherty,2023,USD,571284,307791,263493,111156,152337,8775,143562,5712,11425,132137,23418,426989,280580,146409,,571284,20.0,10.0,0.0526,2380,20.0,52416.16,0.45,0.4612
9701,Ramirez Burton and Henderson,False,GB,West Donaldchester,Marketplaces,2017,https://ramirezburtonandhenderson.com,Guess street old manage than group owner.,20,ramirez-burton-and-henderson,2023,USD,316104,173577,142527,166718,-24191,0,-24191,3161,6322,-30513,14082,329175,16458,312717,,316104,555.27,2600.56,0.1131,292,89.98,1000.0,14.08,0.4509
9702,Montoya and Sons,False,FR,North Barry,Cybersecurity,2009,https://montoyaandsons.com,High writer reason wall PM fund.,15,montoya-and-sons,2023,EUR,1518978,610457,908521,75948,832573,0,832573,15189,30379,802194,45262,834093,403162,430931,,1518978,1150.24,4816.63,0.001,1642,77.06,1000.0,45.26,0.5981
9703,Cox-Aguilar,False,BR,Danielsstad,Mobility,2017,https://cox-aguilar.com,Among gas business ago peace floor human very call.,26,cox-aguilar,2023,USD,789120,466145,322975,543284,-220309,0,-220309,7891,15782,-236091,7058,478126,159975,318151,,789120,754.38,1221.54,0.0764,2257,29.13,41921.67,0.17,0.4093
9704,Clarke PLC,False,ZA,Jamesmouth,SaaS,2012,https://clarkeplc.com,Trade actually election change old window official whether century.,23,clarke-plc,2023,USD,694196,267264,426932,337520,89412,0,89412,6941,13883,75529,37835,413167,61813,351354,57849.67,694196,133.01,676.62,0.0391,1996,28.97,10165.05,3.72,0.615
9705,Moore-Lynch,False,EG,West Jeffreyton,AgriTech,2008,https://moore-lynch.com,Organization piece bar glass watch production today.,22,moore-lynch,2023,USD,2015914,860034,1155880,284595,871285,0,871285,20159,40318,830967,75446,1217485,248341,969144,,2015914,119.14,185.9,0.035,8399,20.0,2933.18,25.72,0.5734
9706,Sims Salinas and Nelson,False,BR,Rebeccaberg,Marketplaces,2021,https://simssalinasandnelson.com,He service program matter current where.,14,sims-salinas-and-nelson,2023,USD,849635,249145,600490,634891,-34401,0,-34401,8496,16992,-51393,55597,536416,299294,237122,,849635,219.59,310.75,0.0693,435,162.69,64068.35,0.87,0.7068
9707,Bailey-Marshall,False,EG,Ramirezside,E-commerce,2024,https://bailey-marshall.com,Speech in go seem model wall for relate.,10,bailey-marshall,2023,USD,4172078,933235,3238843,1621792,1617051,0,1617051,41720,83441,1533610,268700,2415610,374080,2041530,,4172078,20.0,23.82,0.1061,17383,20.0,116144.6,2.31,0.7763
9708,Williams Davies and Russell,False,GB,New Ronald,Energy,2022,https://williamsdaviesandrussell.com,Star assume agent sort help husband professor who agency.,19,williams-davies-and-russell,2023,USD,759166,186043,573123,476676,96447,0,96447,7591,15183,81264,251748,719296,206659,512637,,759166,375.82,569.63,0.0763,336,188.23,66077.46,3.81,0.7549
9709,Jones Ltd,False,TN,Benjaminburgh,HealthTech,2019,https://jonesltd.com,Half smile bed final large.,20,jones-ltd,2023,USD,294567,147839,146728,105001,41727,28152,13575,2945,5891,7684,7772,324802,150276,174526,24547.25,294567,75.43,274.73,0.001,498,49.21,15899.75,0.49,0.4981
9710,Weber Hernandez and Nelson,False,KE,West Frederick,SaaS,2021,https://weberhernandezandnelson.com,Reduce explain travel expert upon artist chance.,19,weber-hernandez-and-nelson,2023,USD,1613880,704769,909111,167104,742007,0,742007,16138,32277,709730,8785,908275,286069,622206,134490.0,1613880,860.6,5597.62,0.0058,2187,61.48,25328.23,0.35,0.5633
9711,Ballard Kelly and Schwartz,False,GB,Port Reneefort,SaaS,2009,https://ballardkellyandschwartz.com,Could use standard local then plant.,25,ballard-kelly-and-schwartz,2023,USD,2950707,1207532,1743175,1870184,-127009,0,-127009,29507,59014,-186023,521043,2158130,563399,1594731,245892.25,2950707,252.48,1400.14,0.001,9199,26.73,219804.54,2.37,0.5908
9712,Mcgee Group,False,DE,Powellberg,Cybersecurity,2020,https://mcgeegroup.com,Relate cost rich present field still civil task.,23,mcgee-group,2023,EUR,378326,180366,197960,18916,179044,2983,176061,3783,7566,168495,6862,382201,162527,219674,,378326,424.7,1360.22,0.1083,1576,20.0,9950.8,0.69,0.5233
9713,Jones Group,False,DE,East Paulaburgh,AI/ML,2019,https://jonesgroup.com,Early require upon write since loss ability.,26,jones-group,2023,EUR,454629,171404,283225,423279,-140054,4744,-144798,4546,9092,-153890,20281,274860,147854,127006,,454629,986.63,5520.83,0.1044,637,59.39,18809.55,1.08,0.623
9714,Vasquez-Rodriguez,False,BR,Lake Luis,Energy,2016,https://vasquez-rodriguez.com,Job trial however outside project center against administration visit respond.,13,vasquez-rodriguez,2023,USD,2331678,1244572,1087106,1194708,-107602,0,-107602,23316,46633,-154235,45340,1359148,129278,1229870,,2331678,539.97,1165.67,0.0306,9715,20.0,92705.63,0.49,0.4662
9715,Perez Craig and Nguyen,False,TN,South Sarah,Cybersecurity,2010,https://perezcraigandnguyen.com,Likely guy foot safe exactly rich hold.,23,perez-craig-and-nguyen,2023,USD,489700,112422,377278,127662,249616,17111,232505,4897,9794,222711,8569,433050,44344,388706,,489700,603.31,2506.89,0.001,2040,20.0,5275.08,1.62,0.7704
9716,Ortiz Martinez and Pitts,False,IN,East Danielside,IoT,2022,https://ortizmartinezandpitts.com,Say answer go always.,22,ortiz-martinez-and-pitts,2023,USD,344279,104308,239971,295347,-55376,13271,-68647,3442,6885,-75532,10327,192164,17579,174585,,344279,20.0,21.62,0.0302,240,119.13,35963.02,0.29,0.697
9717,Mayo Ramirez and Terry,False,IN,Lake Shannon,E-commerce,2023,https://mayoramirezandterry.com,Together college two of treatment kid maintain crime indeed.,22,mayo-ramirez-and-terry,2023,USD,763351,151552,611799,490521,121278,0,121278,7633,15267,106011,27195,416470,146306,270164,,763351,190.39,95.2,0.0924,284,223.96,11691.2,2.33,0.8015
9718,Rodgers Ochoa and Carter,False,BR,West Kayla,IoT,2014,https://rodgersochoaandcarter.com,Professor above likely first soldier modern.,17,rodgers-ochoa-and-carter,2023,USD,308621,81420,227201,251526,-24325,38056,-62381,3086,6172,-68553,3081,329768,128740,201028,,308621,964.72,1751.2,0.13,223,115.25,1000.0,3.08,0.7362
9719,Wood-Johnson,False,FR,Ronaldmouth,AI/ML,2014,https://wood-johnson.com,Doctor arrive lead avoid right they choice phone dream respond.,24,wood-johnson,2023,EUR,904233,287193,617040,404054,212986,28192,184794,9042,18084,166710,24035,508375,135249,373126,,904233,1122.29,1183.62,0.1145,3767,20.0,20172.79,1.19,0.6824
9720,Chavez and Sons,False,KE,Summerfort,Cybersecurity,2023,https://chavezandsons.com,If question loss southern section coach yard.,28,chavez-and-sons,2023,USD,765473,191455,574018,199720,374298,17993,356305,7654,15309,340996,7319,418448,234757,183691,,765473,20.0,17.34,0.033,377,169.01,8612.4,0.85,0.7499
9721,Ryan Inc,False,ZA,Thomaston,IoT,2016,https://ryaninc.com,System speak seem memory finally town place.,14,ryan-inc,2023,USD,332436,141822,190614,101064,89550,0,89550,3324,6648,82902,22929,297706,74454,223252,,332436,1117.34,5245.8,0.001,646,42.82,2450.75,9.36,0.5734
9722,Sanchez Santos and Jacobs,False,KE,West Jamesstad,Fintech,2016,https://sanchezsantosandjacobs.com,Successful figure idea save paper consider set toward administration time.,21,sanchez-santos-and-jacobs,2023,USD,5449545,1954377,3495168,2729640,765528,20492,745036,54495,108990,636046,105099,2842850,2558565,284285,,5449545,683.27,3522.73,0.001,3404,133.41,228727.96,0.46,0.6414
9723,Osborne Ltd,False,KE,New Eileenstad,Cybersecurity,2024,https://osborneltd.com,Executive heart table interest follow factor family bill stand down.,20,osborne-ltd,2023,USD,1512236,682800,829436,619219,210217,40825,169392,15122,30244,139148,221759,1155866,405630,750236,,1512236,895.4,5080.45,0.0754,468,269.09,35109.08,6.32,0.5485
9724,Ryan LLC,False,TN,Onealport,SaaS,2018,https://ryanllc.com,Example together west type mouth yes dinner seven.,15,ryan-llc,2023,USD,617896,129312,488584,594593,-106009,6783,-112792,6178,12357,-125149,107055,535645,63728,471917,51491.33,617896,286.49,286.49,0.0514,965,53.31,27440.55,3.9,0.7907
9725,Davis-Lopez,False,CA,Tracychester,SaaS,2017,https://davis-lopez.com,Your individual drop couple student special reach detail say.,16,davis-lopez,2023,USD,311026,122079,188947,144239,44708,0,44708,3110,6220,38488,66968,342890,301676,41214,25918.83,311026,167.72,1040.35,0.0458,511,50.71,17208.2,3.89,0.6075
9726,Schwartz Edwards and Pena,False,KE,Williamsberg,Cybersecurity,2014,https://schwartzedwardsandpena.com,Theory final area dinner around.,19,schwartz-edwards-and-pena,2023,USD,89014,20274,68740,25932,42808,29354,13454,890,1780,11674,3101,246169,90197,155972,,89014,20.0,96.75,0.0392,59,125.18,4982.83,0.62,0.7722
9727,Dennis Ltd,False,GB,Perkinsburgh,Energy,2021,https://dennisltd.com,Trial the admit cost.,21,dennis-ltd,2023,USD,1241126,442881,798245,255971,542274,0,542274,12411,24822,517452,65264,806422,268656,537766,,1241126,20.0,67.63,0.161,364,283.79,24170.84,2.7,0.6432
9728,Donovan-Anthony,False,IN,North Kimberly,EdTech,2012,https://donovan-anthony.com,Left authority mission strong several need.,10,donovan-anthony,2023,USD,171635,46802,124833,129397,-4564,0,-4564,1716,3432,-7996,26692,127645,63942,63703,14302.92,171635,10.0,33.11,0.0506,158,90.23,4857.57,5.49,0.7273
9729,Barnes-Turner,False,GB,West Tracyton,Cybersecurity,2015,https://barnes-turner.com,Save class standard brother democratic both ok.,25,barnes-turner,2023,USD,1856766,449912,1406854,1089677,317177,0,317177,18567,37135,280042,183766,1158066,479475,678591,,1856766,416.11,708.97,0.0133,1315,117.61,99815.14,1.84,0.7577
9730,Cook Cohen and Davis,False,KE,East Amberbury,AgriTech,2020,https://cookcohenanddavis.com,Hope near food difference must common.,22,cook-cohen-and-davis,2023,USD,668738,245085,423653,414364,9289,0,9289,6687,13374,-4085,13481,485588,207149,278439,,668738,377.06,1602.17,0.0969,403,138.04,14527.62,0.93,0.6335
9731,Leonard-Byrd,False,FR,New Christina,HealthTech,2011,https://leonard-byrd.com,Quickly interesting project where enjoy.,16,leonard-byrd,2023,EUR,3540996,1513829,2027167,1401004,626163,12870,613293,35409,70819,542474,196672,2032091,806174,1225917,295083.0,3540996,544.06,4841.61,0.021,59016,5.0,132598.51,1.48,0.5725
9732,Smith-Hamilton,False,GB,Cameronfort,Cybersecurity,2010,https://smith-hamilton.com,Imagine partner training message too arrive drop security note.,22,smith-hamilton,2023,USD,524557,232443,292114,350602,-58488,27619,-86107,5245,10491,-96598,28285,488269,203987,284282,,524557,20.0,34.42,0.001,176,248.23,1000.0,28.28,0.5569
9733,Mitchell Group,False,BR,Lorifurt,Fintech,2018,https://mitchellgroup.com,Pick mouth off with measure.,19,mitchell-group,2023,USD,2119573,913097,1206476,1138915,67561,0,67561,21195,42391,25170,66525,1145098,836512,308586,,2119573,630.44,2181.03,0.0451,1235,142.93,101532.07,0.66,0.5692
9734,Harrison-Dalton,False,KE,Buchananport,AgriTech,2018,https://harrison-dalton.com,Gas work image development federal action.,27,harrison-dalton,2023,USD,636378,61312,575066,342184,232882,13883,218999,6363,12727,206272,9839,337853,179469,158384,,636378,875.24,4172.97,0.0671,2651,20.0,38150.32,0.26,0.9037
9735,Whitehead Group,False,DE,North David,AgriTech,2008,https://whiteheadgroup.com,Move party able offer buy identify spend continue understand.,13,whitehead-group,2023,EUR,259336,30165,229171,92016,137155,20687,116468,2593,5186,111282,4286,243078,44592,198486,,259336,20.0,126.81,0.001,148,145.19,1000.0,4.29,0.8837
9736,Mcclain-Rios,False,US,Austinfurt,Cybersecurity,2010,https://mcclain-rios.com,Wide music past marriage middle really group.,12,mcclain-rios,2023,USD,991900,371584,620316,255387,364929,3183,361746,9919,19838,341908,37933,689678,161057,528621,,991900,474.34,1147.91,0.0969,1421,58.13,1919.0,19.77,0.6254
9737,Brady Perez and Cooke,False,GB,Smithbury,Marketplaces,2022,https://bradyperezandcooke.com,For cold represent address contain.,22,brady-perez-and-cooke,2023,USD,1145464,353611,791853,171515,620338,50,620288,11454,22909,597379,18190,655463,59282,596181,,1145464,2241.4,8764.35,0.0105,868,109.97,16297.01,1.12,0.6913
9738,Snyder PLC,False,TN,East Ashleystad,Cybersecurity,2013,https://snyderplc.com,Report machine hope Democrat series.,19,snyder-plc,2023,USD,564929,143332,421597,449474,-27877,43179,-71056,5649,11298,-82354,25140,506144,305480,200664,,564929,1325.1,2800.52,0.0622,174,269.26,26822.26,0.94,0.7463
9739,Buck Hernandez and Moreno,False,GB,West Ronald,EdTech,2024,https://buckhernandezandmoreno.com,Since doctor over record enough.,17,buck-hernandez-and-moreno,2023,USD,640433,148029,492404,207570,284834,7384,277450,6404,12808,264642,90405,417118,30587,386531,53369.42,640433,10.0,18.62,0.001,10673,5.0,6169.89,14.65,0.7689
9740,Hammond Richards and Phillips,False,ZA,Charlesberg,AgriTech,2023,https://hammondrichardsandphillips.com,Or left democratic hot care will loss she my organization.,14,hammond-richards-and-phillips,2023,USD,450115,85056,365059,215245,149814,49,149765,4501,9002,140763,65769,335924,132477,203447,,450115,1207.41,1447.09,0.1264,91,409.07,27353.2,2.4,0.811
9741,Wagner-Wilson,False,IN,Lake George,HealthTech,2013,https://wagner-wilson.com,Fish according respond voice government team accept example compare popular.,21,wagner-wilson,2023,USD,873823,223319,650504,490292,160212,38782,121430,8738,17476,103954,17173,549809,222583,327226,72818.58,873823,187.13,987.98,0.001,2632,27.66,11531.0,1.49,0.7444
9742,Bell PLC,False,CA,North Cassandra,Energy,2022,https://bellplc.com,Good more exactly by action beautiful degree choose writer.,22,bell-plc,2023,USD,1837508,355500,1482008,392453,1089555,29478,1060077,18375,36750,1023327,302560,1345244,736899,608345,,1837508,726.76,2343.07,0.0382,695,220.17,1000.0,302.56,0.8065
9743,Simmons LLC,False,ZA,Pachecomouth,AI/ML,2023,https://simmonsllc.com,Commercial city explain show local.,22,simmons-llc,2023,USD,431427,95690,335737,32219,303518,0,303518,4314,8628,294890,18511,320849,78139,242710,,431427,134.29,887.73,0.0731,167,214.52,22257.17,0.83,0.7782
9744,Osborne-Caldwell,False,FR,Christopherfort,AI/ML,2024,https://osborne-caldwell.com,Bill floor bit message generation general last indicate sense prove.,18,osborne-caldwell,2023,EUR,715830,336571,379259,434247,-54988,186,-55174,7158,14316,-69490,6975,391924,76242,315682,,715830,20.0,75.86,0.05,423,140.73,48325.64,0.14,0.5298
9745,Dean Harrison and Bishop,False,NG,Evanschester,HealthTech,2012,https://deanharrisonandbishop.com,Six class whom man major.,17,dean-harrison-and-bishop,2023,USD,158238,20327,137911,68385,69526,0,69526,1582,3164,66362,5806,199753,127695,72058,13186.5,158238,419.15,1840.99,0.1117,129,101.47,1000.0,5.81,0.8715
9746,Wright Blair and Duncan,False,DE,South Laura,Mobility,2024,https://wrightblairandduncan.com,Left woman fight mission.,20,wright-blair-and-duncan,2023,EUR,630588,125433,505155,165487,339668,0,339668,6305,12611,327057,32792,411802,71878,339924,,630588,20.0,50.83,0.0607,507,103.51,1000.0,32.79,0.8011
9747,Fernandez-Smith,False,BR,West William,AI/ML,2023,https://fernandez-smith.com,Themselves true get Mrs simply.,25,fernandez-smith,2023,USD,445058,236965,208093,165576,42517,18002,24515,4450,8901,15614,39741,422380,65915,356465,,445058,1164.13,8418.84,0.0676,136,270.74,1000.0,39.74,0.4676
9748,Barnett Christensen and Joseph,False,US,Port Cindy,E-commerce,2017,https://barnettchristensenandjoseph.com,Agreement require phone future operation job condition.,23,barnett-christensen-and-joseph,2023,USD,3972084,1887686,2084398,3120592,-1036194,23664,-1059858,39720,79441,-1139299,244564,2285388,1357306,928082,,3972084,1222.35,2577.53,0.0621,1889,175.19,304244.22,0.8,0.5248
9749,Taylor-Thomas,False,FR,West Caitlinside,Energy,2024,https://taylor-thomas.com,Thing trial tend particularly wind garden to enough himself west.,15,taylor-thomas,2023,EUR,948147,538418,409729,421477,-11748,19832,-31580,9481,18962,-50542,28619,657211,109757,547454,,948147,1868.76,4488.01,0.1211,3950,20.0,56927.18,0.5,0.4321
9750,Huff and Sons,False,US,East Staceyside,Energy,2010,https://huffandsons.com,Scene expert thousand type name human reach challenge easy development.,17,huff-and-sons,2023,USD,1139049,423158,715891,781794,-65903,0,-65903,11390,22780,-88683,13437,684490,233640,450850,,1139049,20.0,127.66,0.2108,4746,20.0,61627.91,0.22,0.6285
9751,Jackson Inc,False,ZA,Bakerland,EdTech,2016,https://jacksoninc.com,Work imagine pick beat whom concern be.,23,jackson-inc,2023,USD,407989,90605,317384,147242,170142,5521,164621,4079,8159,156462,5022,217274,20122,197152,33999.08,407989,262.37,1064.2,0.045,830,40.93,1000.0,5.02,0.7779
9752,Schmidt-Garcia,False,KE,Lisaborough,Marketplaces,2019,https://schmidt-garcia.com,View treat shake dinner down about continue.,30,schmidt-garcia,2023,USD,649696,163591,486105,485822,283,4753,-4470,6496,12993,-17463,48552,406510,99334,307176,,649696,1196.83,3780.3,0.1017,269,200.99,61482.02,0.79,0.7482
9753,Wood Young and Hernandez,False,TN,Lake Rogerfort,AgriTech,2022,https://woodyoungandhernandez.com,Station model heart child speech.,16,wood-young-and-hernandez,2023,USD,251413,139392,112021,53436,58585,0,58585,2514,5028,53557,8862,192130,31863,160267,,251413,930.73,930.37,0.022,142,147.26,1000.0,8.86,0.4456
9754,Fischer Gutierrez and Nichols,False,ZA,Holmesborough,IoT,2016,https://fischergutierrezandnichols.com,Left actually person model record simply.,17,fischer-gutierrez-and-nichols,2023,USD,3572132,1255408,2316724,1781480,535244,4907,530337,35721,71442,458895,454073,2366222,770982,1595240,,3572132,1681.86,6072.2,0.0884,4727,62.97,155366.28,2.92,0.6486
9755,Perkins-Miller,False,TN,Carrieland,SaaS,2018,https://perkins-miller.com,Building memory send successful suddenly trip movement case.,16,perkins-miller,2023,USD,535958,117250,418708,350159,68549,0,68549,5359,10719,57830,17165,377683,56005,321678,44663.17,535958,185.72,787.85,0.0412,851,52.47,20637.18,0.83,0.7812
9756,Watts and Sons,False,NG,Olivermouth,Energy,2022,https://wattsandsons.com,Evening discover product hand sort.,29,watts-and-sons,2023,USD,740755,229729,511026,471227,39799,0,39799,7407,14815,24984,90957,558589,280386,278203,,740755,584.69,752.72,0.0582,3086,20.0,66142.09,1.38,0.6899
9757,Acevedo Romero and Ferrell,False,KE,Lake Anthony,AgriTech,2020,https://acevedoromeroandferrell.com,Two TV feel chance reason here several later class suggest.,24,acevedo-romero-and-ferrell,2023,USD,340932,153536,187396,113372,74024,42222,31802,3409,6818,24984,35081,275053,13752,261301,,340932,352.93,1759.14,0.102,1420,20.0,1000.0,35.08,0.5497
9758,Johnson Williams and Hammond,False,DE,Lake Ryanmouth,Marketplaces,2015,https://johnsonwilliamsandhammond.com,Treatment argue beautiful fact player within over allow rich.,23,johnson-williams-and-hammond,2023,EUR,2199128,479044,1720084,1580282,139802,0,139802,21991,43982,95820,40637,1239554,254088,985466,,2199128,20.0,116.96,0.0495,3137,58.41,110872.36,0.37,0.7822
9759,Allen Horton and Flores,False,US,Lake Kimport,IoT,2022,https://allenhortonandflores.com,Agree skill minute check spring management.,19,allen-horton-and-flores,2023,USD,767249,181848,585401,389962,195439,0,195439,7672,15344,180095,72739,498405,34126,464279,,767249,1328.32,3778.22,0.0444,409,156.18,65772.52,1.11,0.763
9760,Sloan Garner and Young,False,GB,West Raymond,EdTech,2020,https://sloangarnerandyoung.com,Discover idea politics attention middle themselves.,28,sloan-garner-and-young,2023,USD,279330,109486,169844,147244,22600,12235,10365,2793,5586,4779,14427,335572,114217,221355,23277.5,279330,485.39,2204.4,0.0351,255,91.02,2982.32,4.84,0.608
9761,Church LLC,False,AU,South Brian,Fintech,2009,https://churchllc.com,Send agent those list especially happen environment pass direction.,20,church-llc,2023,USD,1703141,542574,1160567,627047,533520,0,533520,17031,34062,499458,398170,1329710,748039,581671,,1703141,20.0,26.56,0.1351,677,209.36,28446.1,14.0,0.6814
9762,Miller Savage and Wilson,False,NG,North Johnfort,SaaS,2012,https://millersavageandwilson.com,Push include nice reflect be become use account for with.,20,miller-savage-and-wilson,2023,USD,907625,171932,735693,691673,44020,13212,30808,9076,18152,12656,76029,683757,177147,506610,75635.42,907625,534.63,994.21,0.1051,716,105.53,37492.5,2.03,0.8106
9763,Clark-Garcia,False,TN,Georgefurt,Fintech,2020,https://clark-garcia.com,Spring standard none support health leave speech middle.,18,clark-garcia,2023,USD,645947,375432,270515,199270,71245,0,71245,6459,12918,58327,24247,371024,18551,352473,,645947,20.0,16.3,0.0052,732,73.45,9797.84,2.47,0.4188
9764,Harrington Lester and Cochran,False,TN,Emilystad,HealthTech,2008,https://harringtonlesterandcochran.com,Be leader organization concern.,21,harrington-lester-and-cochran,2023,USD,5337815,2208677,3129138,1287128,1842010,24052,1817958,53378,106756,1711202,31520,2771407,1526351,1245056,444817.92,5337815,257.0,319.62,0.001,7857,56.61,100957.94,0.31,0.5862
9765,Martinez-Ashley,False,FR,Randolphmouth,Energy,2018,https://martinez-ashley.com,Particularly teacher four bag door actually partner treat training history.,20,martinez-ashley,2023,EUR,2293869,1157485,1136384,1007571,128813,0,128813,22938,45877,82936,170038,1335662,812120,523542,,2293869,171.92,736.21,0.0777,730,261.59,74306.17,2.29,0.4954
9766,Bell King and Hutchinson,False,CA,Port Charlene,E-commerce,2022,https://bellkingandhutchinson.com,Walk establish share tell hand change edge without bit.,13,bell-king-and-hutchinson,2023,USD,2160735,1127730,1033005,1104981,-71976,24426,-96402,21607,43214,-139616,248965,1463429,394870,1068559,,2160735,793.06,2467.32,0.1036,9003,20.0,102046.26,2.44,0.4781
9767,Lam-Campbell,False,BR,Annaton,AI/ML,2021,https://lam-campbell.com,Degree look service leave past let arrive lot century gas watch.,18,lam-campbell,2023,USD,1304663,411593,893070,599072,293998,17062,276936,13046,26093,250843,101227,918211,439973,478238,,1304663,44.72,46.84,0.05,5257,20.68,27109.27,3.73,0.6845
9768,Richards Pierce and Gonzalez,False,IN,West James,E-commerce,2023,https://richardspierceandgonzalez.com,Guy skin area do have minute.,19,richards-pierce-and-gonzalez,2023,USD,2054349,507743,1546606,743222,803384,0,803384,20543,41086,762298,310797,1484783,1052677,432106,,2054349,20.0,61.64,0.0382,8559,20.0,79223.6,3.92,0.7528
9769,Conner Inc,False,BR,Caitlinchester,AI/ML,2020,https://connerinc.com,Let fine respond news lot model put.,20,conner-inc,2023,USD,4134893,1000698,3134195,2649232,484963,0,484963,41348,82697,402266,221645,2438769,451377,1987392,,4134893,138.31,561.0,0.1286,16614,20.74,229668.23,0.97,0.758
9770,Hall Group,False,CA,Erinland,E-commerce,2019,https://hallgroup.com,Evening century pay nothing money power first make he certain.,18,hall-group,2023,USD,1927289,702251,1225038,576419,648619,12573,636046,19272,38545,597501,346606,1507343,534526,972817,,1927289,20.0,69.52,0.1009,983,163.3,21995.56,15.76,0.6356
9771,Wade-Sutton,False,EG,South Christian,E-commerce,2011,https://wade-sutton.com,Good experience sing color half peace answer only.,22,wade-sutton,2023,USD,339191,70726,268465,154221,114244,0,114244,3391,6783,107461,8220,296398,226282,70116,,339191,954.06,2116.79,0.0066,333,84.75,24057.97,0.34,0.7915
9772,Matthews Hughes and Cochran,False,GB,North Jennifer,AgriTech,2023,https://matthewshughesandcochran.com,Hope example worker out surface dark.,23,matthews-hughes-and-cochran,2023,USD,6855,2220,4635,3927,708,48936,-48228,68,137,-48365,4239,129938,53714,76224,,6855,20.0,110.36,0.0391,2,271.87,1000.0,4.24,0.6761
9773,Hughes-Leonard,False,TN,North Karenland,AgriTech,2008,https://hughes-leonard.com,Would Congress individual should probably shoulder it.,27,hughes-leonard,2023,USD,381144,230596,150548,221844,-71296,12343,-83639,3811,7622,-91261,30723,298909,123959,174950,,381144,674.02,337.01,0.1593,1588,20.0,35025.76,0.88,0.395
9774,Woodard-Turner,False,US,Johnsonborough,SaaS,2020,https://woodard-turner.com,Activity future laugh benefit it current onto spend.,20,woodard-turner,2023,USD,522391,79304,443087,26119,416968,0,416968,5223,10447,406521,60945,408987,20449,388538,43532.58,522391,10.0,18.25,0.0118,569,76.41,16297.44,3.74,0.8482
9775,Patel-Contreras,False,NG,Port Lydiamouth,Mobility,2018,https://patel-contreras.com,Since report edge tonight most worker budget thus.,15,patel-contreras,2023,USD,2708706,1454300,1254406,937141,317265,0,317265,27087,54174,263091,458626,1986110,263115,1722995,,2708706,20.0,16.95,0.001,2665,84.69,57908.15,7.92,0.4631
9776,Patel PLC,False,NG,Ashleymouth,Energy,2024,https://patelplc.com,Pull simple nor nice class among.,20,patel-plc,2023,USD,635231,160777,474454,169529,304925,0,304925,6352,12704,292221,39440,438072,92647,345425,,635231,1007.34,4410.16,0.1518,313,168.75,30004.88,1.31,0.7469
9777,Contreras and Sons,False,GB,Lake Christina,AgriTech,2009,https://contrerasandsons.com,Morning do similar between step.,16,contreras-and-sons,2023,USD,212396,85093,127303,135958,-8655,29261,-37916,2123,4247,-42163,6466,196563,109459,87104,,212396,20.0,88.71,0.0124,58,304.64,18850.53,0.34,0.5994
9778,Harris and Sons,False,CA,Stewartburgh,Fintech,2021,https://harrisandsons.com,Question fine dinner start shake short choose because personal system.,24,harris-and-sons,2023,USD,1492969,593402,899567,905842,-6275,36788,-43063,14929,29859,-72922,5547,808878,256817,552061,,1492969,1065.27,5497.95,0.077,6220,20.0,61133.74,0.09,0.6025
9779,Mason Novak and Rose,False,TN,East Daniel,E-commerce,2016,https://masonnovakandrose.com,Itself decade else table million possible worry provide then page.,19,mason-novak-and-rose,2023,USD,1338857,315085,1023772,105930,917842,6851,910991,13388,26777,884214,418209,1233162,507364,725798,,1338857,584.72,5361.26,0.0794,841,132.65,14532.2,28.78,0.7647
9780,Rose Gomez and Ramos,False,CA,West Vanessaside,Fintech,2012,https://rosegomezandramos.com,Blood little special travel south nature politics thought parent.,24,rose-gomez-and-ramos,2023,USD,1131227,529451,601776,475631,126145,21909,104236,11312,22624,81612,114812,752748,364826,387922,,1131227,150.34,266.58,0.0546,919,102.52,39496.88,2.91,0.532
9781,Lopez Group,False,GB,Albertmouth,AgriTech,2017,https://lopezgroup.com,Decide impact unit decision recently include.,18,lopez-group,2023,USD,349550,157610,191940,201867,-9927,31169,-41096,3495,6991,-48087,8400,285722,123639,162083,,349550,20.0,66.21,0.0698,762,38.19,23675.34,0.35,0.5491
9782,Burke Group,False,IN,Hutchinsonchester,Fintech,2024,https://burkegroup.com,Wonder question true whom ready five professor case.,24,burke-group,2023,USD,494147,204196,289951,299712,-9761,0,-9761,4941,9882,-19643,110435,419706,115264,304442,,494147,20.0,44.46,0.0449,2058,20.0,3692.65,29.91,0.5868
9783,Hamilton-Taylor,False,KE,Laurenfurt,IoT,2023,https://hamilton-taylor.com,Upon adult century plant blood set sister raise his.,17,hamilton-taylor,2023,USD,1604625,513333,1091292,338449,752843,62021,690822,16046,32092,658730,23950,1014813,495441,519372,,1604625,20.0,10.0,0.0228,3184,41.99,59414.23,0.4,0.6801
9784,Hill Johnson and Craig,False,IN,Nicoleborough,SaaS,2012,https://hilljohnsonandcraig.com,Dream thought continue personal seem almost under address late.,22,hill-johnson-and-craig,2023,USD,1615218,661301,953917,870313,83604,0,83604,16152,32304,51300,106405,946130,47306,898824,134601.5,1615218,248.85,434.17,0.0261,2171,61.99,91358.55,1.16,0.5906
9785,Baker-Weeks,False,AU,Lake Jamesport,EdTech,2014,https://baker-weeks.com,Color staff any three ten these short prove inside scientist.,34,baker-weeks,2023,USD,244587,111731,132856,124239,8617,14097,-5480,2445,4891,-10371,5598,318878,193669,125209,20382.25,244587,203.85,848.99,0.001,758,26.87,15328.2,0.37,0.5432
9786,Wilson and Sons,False,NG,Hayesfurt,Energy,2021,https://wilsonandsons.com,Big effort my start ground theory catch yes.,21,wilson-and-sons,2023,USD,589440,228123,361317,179723,181594,9799,171795,5894,11788,160007,17557,492845,160684,332161,,589440,663.46,2407.98,0.0833,2456,20.0,1000.0,17.56,0.613
9787,Molina LLC,False,US,Coleberg,AI/ML,2015,https://molinallc.com,Itself major indeed add medical finish according language.,24,molina-llc,2023,USD,1743227,502947,1240280,590218,650062,0,650062,17432,34864,615198,112704,999705,195702,804003,,1743227,1560.2,7284.48,0.1124,2156,67.37,22205.16,5.08,0.7115
9788,Bell LLC,False,CA,Hoffmanshire,Mobility,2009,https://bellllc.com,Environmental black name task fear apply step affect.,20,bell-llc,2023,USD,2902026,1180478,1721548,1546489,175059,71023,104036,29020,58040,45996,200463,1798876,411567,1387309,,2902026,2118.75,1059.38,0.0258,1053,229.62,150447.21,1.33,0.5932
9789,Lynch Hall and Blake,False,ZA,Lindseyburgh,Fintech,2022,https://lynchhallandblake.com,Hear city shake security total stuff what.,22,lynch-hall-and-blake,2023,USD,506235,123977,382258,109291,272967,31265,241702,5062,10124,231578,9693,413829,183616,230213,,506235,20.0,56.83,0.1739,2109,20.0,5299.01,1.83,0.7551
9790,Taylor-Butler,False,US,Robertsstad,EdTech,2021,https://taylor-butler.com,Easy move evidence share hand door student senior offer.,15,taylor-butler,2023,USD,902925,174120,728805,543961,184844,0,184844,9029,18058,166786,42833,598648,332438,266210,75243.75,902925,48.2,143.54,0.0791,1166,64.51,46361.58,0.92,0.8072
9791,Ortiz and Sons,False,DE,South Stephenview,SaaS,2017,https://ortizandsons.com,Many responsibility laugh near hold simple hundred example give.,19,ortiz-and-sons,2023,EUR,3676333,1457400,2218933,2647596,-428663,0,-428663,36763,73526,-502189,219036,2225536,526942,1698594,306361.08,3676333,832.28,1355.16,0.0033,4141,73.97,261712.17,0.84,0.6036
9792,Martin Martin and Riddle,False,AU,Stevenside,AgriTech,2012,https://martinmartinandriddle.com,News century treatment other development name.,18,martin-martin-and-riddle,2023,USD,132040,62256,69784,51647,18137,28901,-10764,1320,2640,-13404,1640,120790,7254,113536,,132040,1896.76,4661.94,0.0507,550,20.0,28031.81,0.06,0.5285
9793,Fuller Martinez and Hunt,False,DE,New Gary,AI/ML,2021,https://fullermartinezandhunt.com,Newspaper tax ball stuff reach authority media.,20,fuller-martinez-and-hunt,2023,EUR,1089787,204431,885356,331098,554258,0,554258,10897,21795,532463,75906,716164,103211,612953,,1089787,20.0,61.73,0.0821,466,194.75,33749.63,2.25,0.8124
9794,Gillespie Young and Moss,False,US,Kaylaburgh,HealthTech,2009,https://gillespieyoungandmoss.com,Necessary recognize world stay west.,20,gillespie-young-and-moss,2023,USD,955337,361986,593351,848301,-254950,14260,-269210,9553,19106,-288316,20012,584579,29228,555351,79611.42,955337,392.31,1216.47,0.0802,1086,73.24,76346.67,0.26,0.6211
9795,Sullivan Bradley and Morgan,False,AU,Garretttown,Cybersecurity,2018,https://sullivanbradleyandmorgan.com,Apply truth along talk room hundred have own American radio.,22,sullivan-bradley-and-morgan,2023,USD,4476545,1360520,3116025,2427932,688093,14136,673957,44765,89530,584427,66474,2490022,1160637,1329385,,4476545,20.0,10.0,0.1202,1938,192.48,182987.03,0.36,0.6961
9796,Carney-Carter,False,ZA,Lake Phyllistown,SaaS,2015,https://carney-carter.com,Film whose bad upon kitchen almost ground fact.,25,carney-carter,2023,USD,1101987,310433,791554,678603,112951,0,112951,11019,22039,90912,30007,775186,82221,692965,91832.25,1101987,10.0,26.11,0.0567,1401,65.53,40048.96,0.75,0.7183
9797,Jones Group,False,US,Port Oscarstad,IoT,2016,https://jonesgroup.com,Will lead reason a more thank child few worry blood.,23,jones-group,2023,USD,653334,140052,513282,454491,58791,6989,51802,6533,13066,38736,103374,615845,290781,325064,,653334,1411.68,9330.16,0.0354,420,129.5,24632.17,4.2,0.7856
9798,Martin Ltd,False,ZA,Carlosburgh,Fintech,2014,https://martinltd.com,Southern after stand leg economy across human increase support find yet.,18,martin-ltd,2023,USD,142520,73221,69299,53576,15723,7693,8030,1425,2850,5180,26759,209955,115285,94670,,142520,347.09,283.51,0.0907,281,42.16,1000.0,26.76,0.4862
9799,Moran Wright and Kramer,False,IN,Port Kaylatown,Marketplaces,2008,https://moranwrightandkramer.com,Least few into price will wish.,15,moran-wright-and-kramer,2023,USD,889352,288676,600676,321931,278745,3620,275125,8893,17787,257338,94188,682229,396435,285794,,889352,2137.43,11085.26,0.1359,417,177.64,11400.93,8.26,0.6754
9800,Roth Hunter and Dennis,False,KE,Port Jeffreyland,Energy,2010,https://rothhunteranddennis.com,Church training enter concern if drug wife a lawyer identify.,29,roth-hunter-and-dennis,2023,USD,747911,221714,526197,619426,-93229,0,-93229,7479,14958,-108187,45948,476840,39411,437429,,747911,20.0,58.5,0.0198,2127,29.29,75837.64,0.61,0.7036
9801,Castaneda Baxter and Gibson,False,KE,North Nicholashaven,Mobility,2023,https://castanedabaxterandgibson.com,Stay yet side trouble she here investment picture peace.,23,castaneda-baxter-and-gibson,2023,USD,2497773,924111,1573662,1451304,122358,8337,114021,24977,49955,64066,12545,1310831,325140,985691,,2497773,194.71,540.7,0.0724,1440,144.47,147380.89,0.09,0.63
9802,Price-Bass,False,KE,North Masonbury,Mobility,2012,https://price-bass.com,Reach type evidence pattern week building.,27,price-bass,2023,USD,2011945,445259,1566686,1204195,362491,0,362491,20119,40238,322253,98113,1142004,546335,595669,,2011945,20.0,55.78,0.0198,608,275.36,118538.19,0.83,0.7787
9803,Dominguez-Jackson,False,IN,South Michaelchester,E-commerce,2012,https://dominguez-jackson.com,Them father remain reflect loss.,19,dominguez-jackson,2023,USD,2749220,414216,2335004,1577330,757674,0,757674,27492,54984,702690,22892,1539262,762190,777072,,2749220,1507.18,6634.09,0.001,11455,20.0,119136.16,0.19,0.8493
9804,Beck LLC,False,NG,Aaronfurt,AgriTech,2011,https://beckllc.com,Trade remember wish customer change need follow.,18,beck-llc,2023,USD,1660542,410139,1250403,988109,262294,16907,245387,16605,33210,212177,60411,925409,366235,559174,,1660542,818.66,4684.91,0.0385,1045,132.39,56884.49,1.06,0.753
9805,Hicks-Mclaughlin,False,DE,Beardhaven,E-commerce,2020,https://hicks-mclaughlin.com,Recently enjoy have feel network institution surface fear.,24,hicks-mclaughlin,2023,EUR,4901423,2011219,2890204,2747652,142552,6233,136319,49014,98028,38291,958462,3475401,1262840,2212561,,4901423,397.86,1725.43,0.0335,6010,67.96,275671.58,3.48,0.5897
9806,Fox Ferguson and Mason,False,KE,North Kara,AgriTech,2024,https://foxfergusonandmason.com,Knowledge in stage visit something.,18,fox-ferguson-and-mason,2023,USD,229598,73562,156036,120017,36019,0,36019,2295,4591,31428,40247,213720,70290,143430,,229598,308.91,814.97,0.0636,173,110.03,1000.0,40.25,0.6796
9807,Lee Smith and Curtis,False,US,East Jasmine,AgriTech,2018,https://leesmithandcurtis.com,Case health reality you however.,15,lee-smith-and-curtis,2023,USD,844931,168027,676904,399955,276949,32068,244881,8449,16898,227983,285946,859916,291443,568473,,844931,1702.42,10715.48,0.0115,1126,62.48,31800.48,8.99,0.8011
9808,Green-Torres,False,US,North Sara,Mobility,2014,https://green-torres.com,I within when increase check raise similar beyond.,20,green-torres,2023,USD,797535,233126,564409,128489,435920,0,435920,7975,15950,419970,99326,509398,72117,437281,,797535,498.04,763.27,0.0998,3323,20.0,10094.3,9.84,0.7077
9809,Tucker-Harris,False,CA,Jadechester,Energy,2023,https://tucker-harris.com,Tend just outside point attention never dinner hair remain then.,25,tucker-harris,2023,USD,7693622,2483676,5209946,4919683,290263,19197,271066,76936,153872,117194,168002,4150274,2096715,2053559,,7693622,816.41,2132.04,0.0045,32056,20.0,437084.85,0.38,0.6772
9810,Leon LLC,False,IN,East Mark,AI/ML,2008,https://leonllc.com,Sign if company film health month.,18,leon-llc,2023,USD,1305506,675545,629961,527714,102247,0,102247,13055,26110,76137,97581,755069,400000,355069,,1305506,20.0,18.0,0.0419,919,118.31,15576.58,6.26,0.4825
9811,Jackson PLC,False,KE,North Johnburgh,E-commerce,2023,https://jacksonplc.com,Sometimes away deal smile choose may million individual actually.,14,jackson-plc,2023,USD,1150825,382373,768452,573834,194618,0,194618,11508,23016,171602,19187,766002,561587,204415,,1150825,20.0,64.12,0.0807,4795,20.0,85619.34,0.22,0.6677
9812,Weber-Lane,False,BR,East Edward,Marketplaces,2015,https://weber-lane.com,Tend matter sea design my soldier lot space small.,21,weber-lane,2023,USD,1854629,478755,1375874,162490,1213384,1224,1212160,18546,37092,1175068,91618,1098850,233820,865030,,1854629,20.0,116.49,0.1011,1488,103.86,1000.0,91.62,0.7419
9813,Blackwell-Daniel,False,KE,West Cynthiachester,AgriTech,2008,https://blackwell-daniel.com,Notice scene happy pass learn fact step middle purpose pull despite.,22,blackwell-daniel,2023,USD,318042,128511,189531,15902,173629,16846,156783,3180,6360,150423,47056,377971,132182,245789,,318042,20.0,59.88,0.021,440,60.21,17418.89,2.7,0.5959
9814,Hanson LLC,False,CA,Blanchardhaven,IoT,2009,https://hansonllc.com,Increase true long paper.,22,hanson-llc,2023,USD,836447,193668,642779,291400,351379,2060,349319,8364,16728,332591,6377,513235,236710,276525,,836447,1014.69,834.93,0.018,655,106.28,7583.82,0.84,0.7685
9815,Robinson Morse and Jordan,False,GB,West Donald,Marketplaces,2021,https://robinsonmorseandjordan.com,Report whom marriage wish believe.,21,robinson-morse-and-jordan,2023,USD,1518906,493654,1025252,1185446,-160194,3086,-163280,15189,30378,-193658,91915,887225,331464,555761,,1518906,1177.97,588.98,0.001,1048,120.68,109759.17,0.84,0.675
9816,Sanders Long and Dixon,False,US,Port Kristieville,HealthTech,2016,https://sanderslonganddixon.com,Federal student sure budget.,22,sanders-long-and-dixon,2023,USD,817341,382334,435007,429506,5501,17926,-12425,8173,16346,-28771,15029,434485,37532,396953,68111.75,817341,593.61,1017.14,0.001,5255,12.96,26414.92,0.57,0.5322
9817,Wilkins Group,False,IN,Roweburgh,HealthTech,2009,https://wilkinsgroup.com,Marriage relationship easy car those different hundred space ground interview.,21,wilkins-group,2023,USD,3025053,1796739,1228314,1499882,-271568,8644,-280212,30250,60501,-340713,139909,1696554,577211,1119343,252087.75,3025053,343.58,686.98,0.0292,50417,5.0,99615.75,1.4,0.406
9818,Page-Hernandez,False,AU,Susanton,EdTech,2010,https://page-hernandez.com,Add on professional teacher article answer center picture.,27,page-hernandez,2023,USD,463515,95810,367705,135382,232323,7650,224673,4635,9270,215403,27014,395711,197169,198542,38626.25,463515,56.52,392.92,0.0733,1265,30.53,9752.99,2.77,0.7933
9819,Thomas and Sons,False,CA,North Amy,AI/ML,2012,https://thomasandsons.com,Road prove before indeed until.,19,thomas-and-sons,2023,USD,3306391,1380911,1925480,165319,1760161,12848,1747313,33063,66127,1681186,542390,2273024,1440646,832378,,3306391,1637.48,8019.91,0.0344,13776,20.0,6610.06,82.06,0.5824
9820,Dawson Miller and Russo,False,CA,Khanmouth,AI/ML,2016,https://dawsonmillerandrusso.com,Certainly way need senior president learn throughout identify popular probably place.,23,dawson-miller-and-russo,2023,USD,2289051,613336,1675715,1647034,28681,11202,17479,22890,45781,-28302,413064,1700619,896974,803645,,2289051,883.28,3546.61,0.001,9537,20.0,158562.5,2.61,0.7321
9821,Johnson-Doyle,False,KE,Garciachester,SaaS,2022,https://johnson-doyle.com,Strategy real capital though if area rise television chair today.,16,johnson-doyle,2023,USD,613277,277715,335562,328109,7453,23522,-16069,6132,12265,-28334,4262,431818,41460,390358,51106.42,613277,757.06,1868.88,0.001,566,90.15,1000.0,4.26,0.5472
9822,Russell-Gates,False,DE,Chambersburgh,AgriTech,2012,https://russell-gates.com,Station product will today hold apply process current administration.,19,russell-gates,2023,EUR,554633,247904,306729,270417,36312,19089,17223,5546,11092,6131,55622,345236,182577,162659,,554633,279.15,139.57,0.0406,190,242.65,32300.81,1.72,0.553
9823,Gregory Foster and Castillo,False,US,North Robertoville,EdTech,2011,https://gregoryfosterandcastillo.com,Answer staff answer skin organization.,18,gregory-foster-and-castillo,2023,USD,117049,45171,71878,70133,1745,11283,-9538,1170,2340,-11878,11013,122558,55849,66709,9754.08,117049,188.64,892.85,0.0403,1157,8.43,1000.0,11.01,0.6141
9824,Parker-Black,False,KE,New Nicole,Cybersecurity,2022,https://parker-black.com,Suffer support suggest three report sea along stand glass several.,20,parker-black,2023,USD,368491,123257,245234,218880,26354,24832,1522,3684,7369,-5847,18482,295884,26437,269447,,368491,186.77,308.71,0.0431,1535,20.0,25899.49,0.71,0.6655
9825,Gibson Medina and Morton,False,BR,West Peter,Mobility,2023,https://gibsonmedinaandmorton.com,Goal explain determine evidence become grow half room.,16,gibson-medina-and-morton,2023,USD,1387180,399030,988150,513008,475142,17971,457171,13871,27743,429428,17889,773088,437845,335243,,1387180,20.0,45.04,0.049,2071,55.8,66203.35,0.27,0.7123
9826,King Wagner and Allen,False,IN,Robertsmouth,AI/ML,2021,https://kingwagnerandallen.com,Their Mr approach shoulder fly enter.,24,king-wagner-and-allen,2023,USD,591573,86348,505225,341094,164131,0,164131,5915,11831,152300,20599,338598,16929,321669,,591573,174.24,1165.57,0.0722,2464,20.0,19290.78,1.07,0.854
9827,Lopez Daugherty and Pierce,False,EG,East Christopher,E-commerce,2019,https://lopezdaughertyandpierce.com,Attorney mouth wait outside response over.,16,lopez-daugherty-and-pierce,2023,USD,413550,182595,230955,261777,-30822,0,-30822,4135,8271,-39093,3675,373774,93616,280158,,413550,1557.18,778.59,0.001,185,185.72,6747.6,0.54,0.5585
9828,Ball-Harris,False,FR,East Kyle,Marketplaces,2017,https://ball-harris.com,American anything memory defense game former rule nor.,31,ball-harris,2023,EUR,598094,272233,325861,551573,-225712,0,-225712,5980,11961,-237673,35775,390431,103365,287066,,598094,20.0,33.62,0.0923,2492,20.0,32469.92,1.1,0.5448
9829,Green-Avila,False,FR,Steventon,AI/ML,2021,https://green-avila.com,Writer them simple not Mrs civil.,14,green-avila,2023,EUR,804125,112489,691636,560492,131144,0,131144,8041,16082,115062,10500,560803,291759,269044,,804125,599.98,1496.17,0.001,1763,37.99,37284.77,0.28,0.8601
9830,Dalton Group,False,ZA,Lake Alexis,AgriTech,2024,https://daltongroup.com,Future live civil brother fly weight.,28,dalton-group,2023,USD,419295,227972,191323,277436,-86113,32299,-118412,4192,8385,-126797,36393,423715,21185,402530,,419295,561.32,511.64,0.0254,1747,20.0,1000.0,36.39,0.4563
9831,Zamora PLC,False,ZA,Johnsonhaven,HealthTech,2014,https://zamoraplc.com,Around class someone large painting environmental surface note bit.,18,zamora-plc,2023,USD,349459,30752,318707,114476,204231,5728,198503,3494,6989,191514,23328,326790,189427,137363,29121.58,349459,206.19,925.47,0.0049,1894,15.37,23094.14,1.01,0.912
9832,Greene Eaton and Elliott,False,US,Christopherview,AI/ML,2024,https://greeneeatonandelliott.com,Opportunity television head put no event adult program imagine away.,18,greene-eaton-and-elliott,2023,USD,1115701,482015,633686,795301,-161615,11612,-173227,11157,22314,-195541,14835,622734,206143,416591,,1115701,607.52,1953.36,0.0989,4648,20.0,52170.16,0.28,0.568
9833,Jones Carey and Hunter,False,AU,South Joshua,Cybersecurity,2012,https://jonescareyandhunter.com,Project government term high popular eight see most so.,22,jones-carey-and-hunter,2023,USD,1377588,527884,849704,68879,780825,28479,752346,13775,27551,724795,106405,940579,266413,674166,,1377588,20.0,10.0,0.1122,842,136.23,13159.36,8.09,0.6168
9834,Mills-King,False,KE,Julieberg,E-commerce,2024,https://mills-king.com,Lose southern expert enter realize scene reality value against along.,20,mills-king,2023,USD,1712635,784779,927856,1147140,-219284,0,-219284,17126,34252,-253536,60561,1072311,84556,987755,,1712635,20.0,54.49,0.0793,1394,102.31,80871.57,0.75,0.5418
9835,George-Rodriguez,False,TN,Port Rachelchester,Cybersecurity,2024,https://george-rodriguez.com,Class nice item whose size.,21,george-rodriguez,2023,USD,3244923,2009703,1235220,1803197,-567977,8051,-576028,32449,64898,-640926,65696,1837699,201013,1636686,,3244923,65.59,378.3,0.0702,2032,133.02,167147.3,0.39,0.3807
9836,Morris Group,False,AU,New Keith,AgriTech,2011,https://morrisgroup.com,Common teacher have pressure hour water argue imagine take.,23,morris-group,2023,USD,552832,247136,305696,89031,216665,36445,180220,5528,11056,169164,11120,358537,251393,107144,,552832,68.12,34.06,0.0378,628,73.27,1000.0,11.12,0.553
9837,Koch-Edwards,False,KE,Tiffanyton,Energy,2013,https://koch-edwards.com,Reveal middle go play improve institution ever describe.,20,koch-edwards,2023,USD,401990,131446,270544,230875,39669,27649,12020,4019,8039,3981,27028,378978,219908,159070,,401990,214.32,435.75,0.0494,165,202.32,40323.0,0.67,0.673
9838,Gilbert Kim and Hopkins,False,DE,East Laura,Marketplaces,2015,https://gilbertkimandhopkins.com,Education suggest talk treat door foot television create focus call.,16,gilbert-kim-and-hopkins,2023,EUR,853008,182176,670832,223019,447813,21370,426443,8530,17060,409383,10114,523206,251180,272026,,853008,1516.59,2202.59,0.001,1775,40.04,1000.0,10.11,0.7864
9839,White-Silva,False,GB,Kathrynmouth,Energy,2008,https://white-silva.com,Into never street send stage and nice.,21,white-silva,2023,USD,2801765,839705,1962060,140088,1821972,0,1821972,28017,56035,1765937,60096,1507987,186422,1321565,,2801765,875.02,437.51,0.001,9324,25.04,29989.21,2.0,0.7003
9840,Rose Vargas and Rodriguez,False,ZA,Crosbyberg,Marketplaces,2019,https://rosevargasandrodriguez.com,Senior worker whom street member important positive future cell.,20,rose-vargas-and-rodriguez,2023,USD,4925235,1374750,3550485,2849858,700627,0,700627,49252,98504,602123,57588,2532578,1793539,739039,,4925235,878.92,3170.35,0.1014,2463,166.61,211479.31,0.27,0.7209
9841,Sherman Browning and Robinson,False,ZA,Steventown,AI/ML,2020,https://shermanbrowningandrobinson.com,Heart suddenly a entire heart laugh woman information available address.,21,sherman-browning-and-robinson,2023,USD,707754,208117,499637,288983,210654,12173,198481,7077,14155,184326,126600,640847,308044,332803,,707754,1222.27,6652.58,0.024,380,154.87,1000.0,126.6,0.7059
9842,Gomez Inc,False,ZA,Lake Matthewmouth,IoT,2016,https://gomezinc.com,Church degree result recently name mission safe discussion.,14,gomez-inc,2023,USD,984439,351797,632642,967594,-334952,0,-334952,9844,19688,-354640,48558,605245,378147,227098,,984439,20.0,10.0,0.0738,4101,20.0,94266.19,0.52,0.6426
9843,Harris and Sons,False,GB,Port Danielmouth,Mobility,2021,https://harrisandsons.com,Woman lead field once walk stop dog ask view treatment.,14,harris-and-sons,2023,USD,1063447,552023,511424,569351,-57927,13806,-71733,10634,21268,-93001,23965,616388,87612,528776,,1063447,20.0,101.17,0.0574,4431,20.0,73744.06,0.32,0.4809
9844,Kirk Stevenson and Lin,False,EG,Jonesport,AgriTech,2024,https://kirkstevensonandlin.com,Choose bar something by rich leg while book.,28,kirk-stevenson-and-lin,2023,USD,290900,156715,134185,80856,53329,3884,49445,2909,5818,43627,12445,302374,136403,165971,,290900,197.39,550.22,0.0032,65,371.61,1094.09,11.37,0.4613
9845,Clark Rodriguez and Rivers,False,DE,New Kathrynport,Fintech,2022,https://clarkrodriguezandrivers.com,Full station certain believe mother.,18,clark-rodriguez-and-rivers,2023,EUR,9850862,2606061,7244801,5971349,1273452,25087,1248365,98508,197017,1051348,106860,5170459,2387884,2782575,,9850862,1099.78,5005.27,0.0424,5316,154.4,486082.97,0.22,0.7354
9846,Smith-Thomas,False,DE,Taylorview,Cybersecurity,2008,https://smith-thomas.com,Someone kid present five white even training pass door hundred.,20,smith-thomas,2023,EUR,202758,19063,183695,48166,135529,0,135529,2027,4055,131474,6904,301426,111813,189613,,202758,20.0,56.14,0.0194,844,20.0,1000.0,6.9,0.906
9847,Flores Rodriguez and Hanson,False,TN,Lake Austinchester,Energy,2013,https://floresrodriguezandhanson.com,Moment just bad box career black anyone eat information.,11,flores-rodriguez-and-hanson,2023,USD,6144826,3137489,3007337,4886005,-1878668,0,-1878668,61448,122896,-2001564,723327,3975932,1249460,2726472,,6144826,20.0,46.96,0.0446,16281,31.45,431440.43,1.68,0.4894
9848,Mccoy-Johnson,False,KE,North Christinaton,EdTech,2010,https://mccoy-johnson.com,Indicate ability that right though.,17,mccoy-johnson,2023,USD,278655,115866,162789,170344,-7555,1518,-9073,2786,5573,-14646,13764,242615,26137,216478,23221.25,278655,526.76,2328.64,0.0365,449,51.7,30674.13,0.45,0.5842
9849,Gordon Ramsey and Benson,False,CA,Mejiaview,Fintech,2024,https://gordonramseyandbenson.com,Smile travel class important leader when mind college answer.,17,gordon-ramsey-and-benson,2023,USD,1066954,697878,369076,563273,-194197,19718,-213915,10669,21339,-235254,15342,653061,40206,612855,,1066954,1418.49,4531.23,0.001,500,177.74,64828.08,0.24,0.3459
9850,George Fox and Morris,False,AU,Hughesstad,Fintech,2022,https://georgefoxandmorris.com,Worker money toward season member full time surface guy father camera.,19,george-fox-and-morris,2023,USD,1887878,533066,1354812,1589120,-234308,11308,-245616,18878,37757,-283373,43899,1095544,84941,1010603,,1887878,20.0,48.94,0.056,1382,113.82,138809.22,0.32,0.7176
9851,Velez Smith and Nielsen,False,NG,Pamelafort,AI/ML,2012,https://velezsmithandnielsen.com,Dog coach control do pick life make might.,11,velez-smith-and-nielsen,2023,USD,537057,95661,441396,406634,34762,42699,-7937,5370,10741,-18678,96211,461018,259988,201030,,537057,1390.89,7212.79,0.0203,229,195.21,35010.39,2.75,0.8219
9852,Greer Valencia and Molina,False,IN,Crystalmouth,HealthTech,2020,https://greervalenciaandmolina.com,Person oil new evening full begin Mr play.,23,greer-valencia-and-molina,2023,USD,431021,179973,251048,21551,229497,14307,215190,4310,8620,206570,15040,325990,170068,155922,35918.42,431021,316.95,1193.35,0.0715,467,76.91,27487.18,0.55,0.5824
9853,White and Sons,False,CA,South Nancy,E-commerce,2017,https://whiteandsons.com,Above especially apply itself life his.,21,white-and-sons,2023,USD,1915718,534049,1381669,635978,745691,18967,726724,19157,38314,688410,116631,1203367,327585,875782,,1915718,229.81,2163.05,0.1159,7982,20.0,79830.24,1.46,0.7212
9854,Castillo Ltd,False,TN,Lake Cassie,IoT,2008,https://castilloltd.com,Long fall daughter follow society item civil president.,16,castillo-ltd,2023,USD,339998,46909,293089,242741,50348,0,50348,3399,6799,43549,14433,233548,108551,124997,,339998,408.1,1265.03,0.0486,85,330.23,35717.85,0.4,0.862
9855,Brown-Brennan,False,TN,North Scottside,HealthTech,2015,https://brown-brennan.com,Office such high great clearly put tend particular country find.,16,brown-brennan,2023,USD,745086,250578,494508,417660,76848,31966,44882,7450,14901,29981,119631,639093,31954,607139,62090.5,745086,10.0,23.33,0.0532,12418,5.0,31083.37,3.85,0.6637
9856,Holder Martinez and Jones,False,GB,South Christopher,Mobility,2012,https://holdermartinezandjones.com,Fire mention beat carry attorney agency weight region ahead difficult.,18,holder-martinez-and-jones,2023,USD,3535848,1437736,2098112,739789,1358323,17405,1340918,35358,70716,1270202,80479,1869181,910830,958351,,3535848,1184.37,592.18,0.0906,14732,20.0,65030.64,1.24,0.5934
9857,Thompson Ltd,False,DE,Amyborough,Marketplaces,2023,https://thompsonltd.com,Front trade suggest defense possible actually few within.,16,thompson-ltd,2023,EUR,144687,61755,82932,9952,72980,11124,61856,1446,2893,58963,35873,157076,50706,106370,,144687,671.04,1037.09,0.0105,75,160.26,1000.0,35.87,0.5732
9858,Pennington-Mccann,False,FR,Summersfurt,Mobility,2024,https://pennington-mccann.com,Prevent prevent alone quite weight order future.,15,pennington-mccann,2023,EUR,1000492,322779,677713,653912,23801,3507,20294,10004,20009,285,87737,753445,293279,460166,,1000492,914.4,457.2,0.001,4168,20.0,53059.27,1.65,0.6774
9859,Benjamin Rose and Jones,False,KE,New Ronaldburgh,SaaS,2012,https://benjaminroseandjones.com,Manager deep job town effort difficult.,16,benjamin-rose-and-jones,2023,USD,965418,328745,636673,644792,-8119,16844,-24963,9654,19308,-44271,57082,704037,81554,622483,80451.5,965418,10.0,13.2,0.0067,1192,67.44,59122.79,0.97,0.6595
9860,Jones LLC,False,GB,Lake Donnaburgh,EdTech,2023,https://jonesllc.com,Economy pattern identify beautiful look more hold appear entire require any.,15,jones-llc,2023,USD,1137017,369905,767112,608682,158430,0,158430,11370,22740,135690,174172,860205,207423,652782,94751.42,1137017,116.12,400.07,0.0375,18950,5.0,16840.96,10.34,0.6747
9861,Shaffer Group,False,BR,Martintown,IoT,2009,https://shaffergroup.com,Country choose fight stock difference enough purpose local read.,22,shaffer-group,2023,USD,1013583,420834,592749,240453,352296,12099,340197,10135,20271,319926,33624,718224,254022,464202,,1013583,421.24,1145.53,0.1039,2686,31.44,30469.85,1.1,0.5848
9862,Castillo Group,False,US,Armstrongbury,Cybersecurity,2021,https://castillogroup.com,Anyone major long upon account likely.,19,castillo-group,2023,USD,845642,326308,519334,511971,7363,4841,2522,8456,16912,-14390,59375,670721,260498,410223,,845642,53.13,254.2,0.1138,720,97.87,38274.43,1.55,0.6141
9863,Torres PLC,False,CA,Aaronview,AgriTech,2022,https://torresplc.com,Field game head into least democratic about probably style find.,22,torres-plc,2023,USD,133248,68651,64597,99884,-35287,6044,-41331,1332,2664,-43995,4250,236208,88153,148055,,133248,1318.22,8636.52,0.0971,148,74.9,25208.65,0.17,0.4848
9864,Taylor Sims and Phillips,False,US,Cooperbury,Marketplaces,2016,https://taylorsimsandphillips.com,Describe next rule citizen onto effort woman former audience here.,18,taylor-sims-and-phillips,2023,USD,1765866,422852,1343014,172874,1170140,6296,1163844,17658,35317,1128527,66465,1120249,352827,767422,,1765866,933.52,3810.02,0.0273,7357,20.0,1000.0,66.46,0.7605
9865,Lee Hoffman and Smith,False,AU,Williamfort,Mobility,2022,https://leehoffmanandsmith.com,Behavior probably big what whole quickly court cup page recent.,20,lee-hoffman-and-smith,2023,USD,1778283,532619,1245664,483538,762126,0,762126,17782,35565,726561,7263,915013,564456,350557,,1778283,20.0,79.31,0.001,670,221.03,64253.92,0.11,0.7005
9866,Romero Carter and Adams,False,KE,East Lisa,E-commerce,2016,https://romerocarterandadams.com,Goal if treatment rich leave onto focus stage article discuss.,15,romero-carter-and-adams,2023,USD,1530427,76521,1453906,1039654,414252,27449,386803,15304,30608,356195,53692,854184,117188,736996,,1530427,20.0,86.2,0.1056,718,177.49,71834.54,0.75,0.95
9867,Riley West and Newman,False,FR,Russellburgh,Marketplaces,2022,https://rileywestandnewman.com,Offer I wide kid third.,28,riley-west-and-newman,2023,EUR,998738,538842,459896,108395,351501,12996,338505,9987,19974,318531,123009,722167,197909,524258,,998738,20.0,57.31,0.0508,649,128.14,7719.77,15.93,0.4605
9868,Roy Combs and Johnson,False,TN,North Michaelfurt,Mobility,2018,https://roycombsandjohnson.com,Thought ago still ahead on.,18,roy-combs-and-johnson,2023,USD,407586,62787,344799,259676,85123,11929,73194,4075,8151,65043,10990,341317,228074,113243,,407586,20.0,10.0,0.0225,355,95.5,48065.59,0.23,0.846
9869,Park Townsend and Moore,False,CA,Delgadomouth,EdTech,2024,https://parktownsendandmoore.com,General feeling born mean floor.,24,park-townsend-and-moore,2023,USD,194806,54573,140233,115479,24754,0,24754,1948,3896,20858,16228,178451,36081,142370,16233.83,194806,97.89,361.42,0.0639,171,94.66,1000.0,16.23,0.7199
9870,Sandoval Mccarty and Raymond,False,FR,Jacobland,AI/ML,2009,https://sandovalmccartyandraymond.com,Toward know company include accept over dog.,15,sandoval-mccarty-and-raymond,2023,EUR,2507018,990236,1516782,1576373,-59591,7272,-66863,25070,50140,-117003,234429,1642627,823417,819210,,2507018,377.17,1458.88,0.1377,10445,20.0,155351.81,1.51,0.605
9871,Mcdonald Group,False,EG,Lake Matthew,Cybersecurity,2014,https://mcdonaldgroup.com,Yet new station public head Congress structure.,16,mcdonald-group,2023,USD,1377063,364898,1012165,492456,519709,0,519709,13770,27541,492168,10180,813253,40662,772591,,1377063,937.62,2987.88,0.001,478,239.71,40597.11,0.25,0.735
9872,Henderson and Sons,False,EG,Lucasville,AI/ML,2010,https://hendersonandsons.com,Nearly should international challenge price town reduce.,25,henderson-and-sons,2023,USD,1201039,278160,922879,165434,757445,0,757445,12010,24020,733425,31157,798547,261363,537184,,1201039,20.0,60.98,0.0891,378,264.71,25328.82,1.23,0.7684
9873,Blair-Russell,False,CA,West Cheryl,IoT,2010,https://blair-russell.com,Any standard rate woman man trial against not fall little fall.,22,blair-russell,2023,USD,1247594,281173,966421,618516,347905,9484,338421,12475,24951,313470,41370,702536,225185,477351,,1247594,20.0,41.37,0.001,481,216.12,56406.12,0.73,0.7746
9874,Adams Cole and Robinson,False,CA,Sawyerberg,Mobility,2009,https://adamscoleandrobinson.com,Believe that summer front themselves space space see.,22,adams-cole-and-robinson,2023,USD,439825,209189,230636,220802,9834,0,9834,4398,8796,1038,5519,284208,15354,268854,,439825,658.16,1527.41,0.001,1832,20.0,58462.96,0.09,0.5244
9875,Dawson-Reynolds,False,NG,Velazquezfort,IoT,2017,https://dawson-reynolds.com,Decision minute here for start listen job site strategy late.,16,dawson-reynolds,2023,USD,295555,119694,175861,129345,46516,53827,-7311,2955,5911,-13222,11586,331990,86862,245128,,295555,20.0,62.4,0.1447,1231,20.0,36888.58,0.31,0.595
9876,Kirk-Moore,False,CA,Lopeztown,AI/ML,2020,https://kirk-moore.com,Color leg direction part it keep lay defense decision.,23,kirk-moore,2023,USD,511774,150856,360918,456961,-96043,15106,-111149,5117,10235,-121384,8390,396306,176341,219965,,511774,539.13,1214.21,0.1018,808,52.78,44422.5,0.19,0.7052
9877,Bradley Ltd,False,GB,New Daniel,Energy,2014,https://bradleyltd.com,Whether true person population above add can ability.,20,bradley-ltd,2023,USD,2189649,931520,1258129,1903680,-645551,1836,-647387,21896,43792,-691179,228388,1393896,702313,691583,,2189649,724.64,780.9,0.1903,912,199.88,159671.54,1.43,0.5746
9878,Rogers Hall and Hurley,False,NG,Tammyton,AgriTech,2024,https://rogershallandhurley.com,Wait camera able effort kid very bag as point.,24,rogers-hall-and-hurley,2023,USD,202562,76527,126035,111619,14416,22050,-7634,2025,4051,-11685,13905,134084,91296,42788,,202562,230.61,245.02,0.1016,47,357.59,1000.0,13.9,0.6222
9879,Porter Ltd,False,EG,South Andrewshire,Energy,2014,https://porterltd.com,Assume center want partner state with question theory information rise.,17,porter-ltd,2023,USD,1473784,535838,937946,989616,-51670,45870,-97540,14737,29475,-127015,732659,1550378,436877,1113501,,1473784,1730.6,4988.67,0.001,635,193.11,62498.56,11.72,0.6364
9880,Mooney Group,False,NG,Brianton,SaaS,2012,https://mooneygroup.com,Across money news total visit end since event.,18,mooney-group,2023,USD,2466903,775417,1691486,879909,811577,5296,806281,24669,49338,756943,349935,1777569,913659,863910,205575.25,2466903,142.5,771.47,0.0524,7804,26.34,59884.55,5.84,0.6857
9881,Flores PLC,False,US,Harrisport,Marketplaces,2023,https://floresplc.com,Color myself really seem amount.,23,flores-plc,2023,USD,338350,123421,214929,253455,-38526,24884,-63410,3383,6767,-70177,30925,228090,52058,176032,,338350,595.31,725.12,0.1109,210,133.87,51715.1,0.6,0.6352
9882,Hall Fitzgerald and George,False,TN,Lake Lisa,Fintech,2012,https://hallfitzgeraldandgeorge.com,Work college crime power rest lay.,15,hall-fitzgerald-and-george,2023,USD,410374,131987,278387,209461,68926,0,68926,4103,8207,60719,88505,311926,107765,204161,,410374,945.05,933.69,0.0908,175,194.69,18048.17,4.9,0.6784
9883,Luna Johnson and Casey,False,DE,Marioburgh,IoT,2020,https://lunajohnsonandcasey.com,Child free campaign listen star.,24,luna-johnson-and-casey,2023,EUR,1144842,219741,925101,469307,455794,39235,416559,11448,22896,393663,12442,646427,178142,468285,,1144842,736.5,2293.23,0.0865,631,151.11,74800.13,0.17,0.8081
9884,Nelson Branch and Ashley,False,BR,Lake Kathrynfort,Fintech,2013,https://nelsonbranchandashley.com,Enough while trial management beautiful improve ready likely everything.,23,nelson-branch-and-ashley,2023,USD,743005,278142,464863,505001,-40138,20732,-60870,7430,14860,-75730,17735,463768,68727,395041,,743005,184.52,565.2,0.0104,749,82.57,16715.45,1.06,0.6257
9885,Hughes-Eaton,False,FR,New Shannonborough,Marketplaces,2008,https://hughes-eaton.com,Enjoy wrong beautiful action firm red throughout visit.,22,hughes-eaton,2023,EUR,355863,127594,228269,248294,-20025,370,-20395,3558,7117,-27512,30760,297368,126404,170964,,355863,454.16,1574.08,0.0769,76,389.42,22323.6,1.38,0.6415
9886,Newton Bryant and Wolfe,False,BR,Harpermouth,E-commerce,2010,https://newtonbryantandwolfe.com,Strategy teacher car glass difference.,22,newton-bryant-and-wolfe,2023,USD,1563250,403268,1159982,178625,981357,0,981357,15632,31265,950092,446955,1257140,672858,584282,,1563250,1180.8,5429.6,0.0509,497,261.71,18472.69,24.2,0.742
9887,Thornton Ltd,False,NG,Tracytown,AI/ML,2011,https://thorntonltd.com,Continue he score challenge amount.,16,thornton-ltd,2023,USD,1112176,155060,957116,319077,638039,0,638039,11121,22243,615796,75297,797695,492459,305236,,1112176,1201.85,5711.99,0.1071,1024,90.44,38228.99,1.97,0.8606
9888,Floyd Johnson and Scott,False,GB,Murrayfort,IoT,2024,https://floydjohnsonandscott.com,Try surface top my away force great serve stuff.,19,floyd-johnson-and-scott,2023,USD,1076724,449033,627691,508578,119113,8863,110250,10767,21534,88716,97037,640044,165331,474713,,1076724,96.99,53.96,0.0823,388,231.17,24785.33,3.92,0.583
9889,Brown Group,False,BR,West Stevenmouth,Energy,2011,https://browngroup.com,Finally amount organization available kind address work grow.,19,brown-group,2023,USD,2698054,701758,1996296,870864,1125432,15060,1110372,26980,53961,1056411,238758,1656674,567093,1089581,,2698054,20.0,87.38,0.1218,1404,160.07,49626.37,4.81,0.7399
9890,Miller Frazier and Smith,False,NG,Bonillaborough,HealthTech,2008,https://millerfrazierandsmith.com,Question apply foreign page reach resource often pressure themselves half.,17,miller-frazier-and-smith,2023,USD,2943137,742708,2200429,2748218,-547789,0,-547789,29431,58862,-606651,14989,1545673,77283,1468390,245261.42,2943137,159.7,1185.49,0.1122,6215,39.46,229861.1,0.07,0.7476
9891,Flores Kidd and Hinton,False,BR,South Sharon,Mobility,2008,https://floreskiddandhinton.com,His control often team cell teach cause important.,19,flores-kidd-and-hinton,2023,USD,470558,23527,447031,306487,140544,22092,118452,4705,9411,109041,7610,353777,178411,175366,,470558,982.26,2582.28,0.001,1258,31.15,13556.29,0.56,0.95
9892,Brown Gallagher and Alvarez,False,TN,Wilsonmouth,Energy,2009,https://browngallagherandalvarez.com,Attack citizen arm gun account write.,15,brown-gallagher-and-alvarez,2023,USD,417615,179278,238337,301287,-62950,0,-62950,4176,8352,-71302,5482,226332,106495,119837,,417615,55.58,115.52,0.084,171,202.4,1000.0,5.48,0.5707
9893,Brooks-Thomas,False,FR,North Christine,SaaS,2022,https://brooks-thomas.com,Along fire even again measure rest.,19,brooks-thomas,2023,EUR,1161063,558754,602309,889670,-287361,6252,-293613,11610,23221,-316834,868821,1631406,579415,1051991,96755.25,1161063,221.75,650.5,0.0383,6050,15.99,67924.56,12.79,0.5188
9894,Baker Group,False,KE,West Alicia,HealthTech,2015,https://bakergroup.com,Rest somebody others tax reduce to case step build.,24,baker-group,2023,USD,397775,132491,265284,257205,8079,0,8079,3977,7955,124,36358,416197,31532,384665,33147.92,397775,335.62,1279.91,0.012,972,34.1,34076.2,1.07,0.6669
9895,Holt-Daniels,False,EG,Lake Anne,HealthTech,2012,https://holt-daniels.com,Mr group design wall a fund yourself focus.,24,holt-daniels,2023,USD,732190,270047,462143,267496,194647,27688,166959,7321,14643,152316,33347,418488,116059,302429,61015.83,732190,276.44,460.43,0.0243,3242,18.82,30889.66,1.08,0.6312
9896,Flores Cline and Osborne,False,TN,Lake Paige,AI/ML,2015,https://floresclineandosborne.com,Want morning different worker wrong law from lot contain clear.,24,flores-cline-and-osborne,2023,USD,1028640,449642,578998,760103,-181105,0,-181105,10286,20572,-201677,15946,687078,296391,390687,,1028640,194.82,782.2,0.0246,2672,32.07,70884.71,0.22,0.5629
9897,Thompson-Soto,False,DE,Salasside,AgriTech,2024,https://thompson-soto.com,Stay store ground again worker world.,27,thompson-soto,2023,EUR,112962,28506,84456,128227,-43771,865,-44636,1129,2259,-46895,2963,223341,11167,212174,,112962,680.74,1688.17,0.031,64,146.48,48018.46,0.06,0.7476
9898,Jackson and Sons,False,BR,North Johnland,Energy,2017,https://jacksonandsons.com,A anyone real fast tough reality deep marriage more good.,20,jackson-and-sons,2023,USD,1315837,321554,994283,602364,391919,22310,369609,13158,26316,343293,9531,847433,443124,404309,,1315837,775.42,387.71,0.0043,494,221.71,61439.68,0.16,0.7556
9899,Johnson Phelps and Dominguez,False,KE,Port Traci,Mobility,2009,https://johnsonphelpsanddominguez.com,Must suddenly me wide though per dream social attention research.,26,johnson-phelps-and-dominguez,2023,USD,1350835,367169,983666,494831,488835,11173,477662,13508,27016,450646,53601,771413,513656,257757,,1350835,990.93,3504.06,0.0023,1160,97.04,30791.65,1.74,0.7282
9900,Ballard-Watson,False,DE,New Jamiechester,Cybersecurity,2018,https://ballard-watson.com,Watch career Republican year could everybody recently career recognize.,23,ballard-watson,2023,EUR,1774481,897049,877432,1247126,-369694,19016,-388710,17744,35489,-424199,105020,1113205,318759,794446,,1774481,20.0,121.18,0.0264,7393,20.0,101451.01,1.04,0.4945
9901,Rose PLC,False,US,Murphymouth,Energy,2023,https://roseplc.com,Cup though expert activity on director deep card day add.,21,rose-plc,2023,USD,185462,86221,99241,85382,13859,0,13859,1854,3709,10150,38817,193537,78006,115531,,185462,1085.36,4547.33,0.018,67,228.98,29837.36,1.3,0.5351
9902,Davis-Thomas,False,CA,New Jill,Mobility,2024,https://davis-thomas.com,Upon network population statement number show unit weight Mr garden.,18,davis-thomas,2023,USD,972600,234239,738361,809561,-71200,32191,-103391,9726,19452,-122843,272517,823976,324686,499290,,972600,2306.15,5652.89,0.0642,326,248.08,71192.47,3.83,0.7592
9903,Watson Franklin and Mckinney,False,KE,West Jennifershire,Energy,2024,https://watsonfranklinandmckinney.com,Message prevent first able ahead senior.,14,watson-franklin-and-mckinney,2023,USD,2054202,942140,1112062,495538,616524,0,616524,20542,41084,575440,29562,1224238,115200,1109038,,2054202,67.14,397.91,0.0124,1299,131.72,11780.31,2.51,0.5414
9904,Pacheco Ltd,False,AU,Michaelport,Cybersecurity,2015,https://pachecoltd.com,First town show natural radio shoulder.,30,pacheco-ltd,2023,USD,2854364,791581,2062783,789344,1273439,19405,1254034,28543,57087,1196947,83206,1537307,193358,1343949,,2854364,20.0,49.38,0.0918,1250,190.25,84875.22,0.98,0.7227
9905,Johnson Foley and Kemp,False,DE,Cunninghamville,E-commerce,2019,https://johnsonfoleyandkemp.com,Inside former research production stand official.,24,johnson-foley-and-kemp,2023,EUR,143907,44137,99770,23670,76100,20617,55483,1439,2878,52605,11057,151330,69006,82324,,143907,555.17,1465.56,0.039,247,48.44,1000.0,11.06,0.6933
9906,Ramirez PLC,False,ZA,Karamouth,Mobility,2008,https://ramirezplc.com,Husband attack next positive every those special bag site interesting.,23,ramirez-plc,2023,USD,304586,108267,196319,174639,21680,28379,-6699,3045,6091,-12790,4199,199370,113196,86174,,304586,1748.42,8067.01,0.1202,1269,20.0,7394.8,0.57,0.6445
9907,Adkins Knight and Walker,False,AU,East Anna,Mobility,2022,https://adkinsknightandwalker.com,Owner per than at sure respond.,26,adkins-knight-and-walker,2023,USD,954951,225137,729814,639090,90724,3973,86751,9549,19099,67652,26834,583486,29174,554312,,954951,455.54,227.77,0.001,1649,48.24,66488.38,0.4,0.7642
9908,May Stevens and Nelson,False,DE,New Scott,Cybersecurity,2011,https://maystevensandnelson.com,From usually side early project tend significant.,18,may-stevens-and-nelson,2023,EUR,2103190,423116,1680074,1311593,368481,0,368481,21031,42063,326418,113806,1174009,58700,1115309,,2103190,103.97,382.51,0.0206,2507,69.89,82061.89,1.39,0.7988
9909,Davis Rodriguez and Velez,False,AU,South Joseph,HealthTech,2014,https://davisrodriguezandvelez.com,Always message account own song.,21,davis-rodriguez-and-velez,2023,USD,363280,118849,244431,149799,94632,25274,69358,3632,7265,62093,27198,342481,109778,232703,30273.33,363280,218.5,531.64,0.0219,874,34.62,1000.0,27.2,0.6728
9910,Berry Hart and White,False,FR,Yangtown,E-commerce,2018,https://berryhartandwhite.com,Until bit start theory company case smile so behind behind.,21,berry-hart-and-white,2023,EUR,1456666,487308,969358,72833,896525,0,896525,14566,29133,867392,183762,1065628,174804,890824,,1456666,1304.19,6179.09,0.0562,6069,20.0,20859.31,8.81,0.6655
9911,Martinez Olsen and Stanley,False,CA,New John,Marketplaces,2009,https://martinezolsenandstanley.com,Similar project whom small evening cup beyond.,28,martinez-olsen-and-stanley,2023,USD,410561,98850,311711,148749,162962,10287,152675,4105,8211,144464,22494,234670,46633,188037,,410561,752.64,2347.3,0.0591,491,69.59,31933.4,0.7,0.7592
9912,Brandt-Giles,False,BR,North Richard,E-commerce,2022,https://brandt-giles.com,Region find control class total no give.,29,brandt-giles,2023,USD,2525467,827759,1697708,590074,1107634,1434,1106200,25254,50509,1055691,732750,2157404,507883,1649521,,2525467,414.15,2580.53,0.1016,2278,92.36,69553.1,10.54,0.6722
9913,Garcia-Huang,False,BR,Port Timothy,SaaS,2019,https://garcia-huang.com,Experience real deep law ability there decision year.,20,garcia-huang,2023,USD,1353550,438529,915021,809443,105578,40095,65483,13535,27071,38412,7218,775710,433100,342610,112795.83,1353550,163.44,858.93,0.001,2671,42.22,66665.23,0.11,0.676
9914,Atkinson-Moore,False,GB,Lake Taylor,Marketplaces,2010,https://atkinson-moore.com,Difficult whose field affect point official series work.,18,atkinson-moore,2023,USD,1320428,633547,686881,178371,508510,26150,482360,13204,26408,455952,39728,750198,199154,551044,,1320428,957.59,7154.84,0.0305,3149,34.94,1000.0,39.73,0.5202
9915,Henson Rodriguez and Peters,False,NG,East Holly,Mobility,2015,https://hensonrodriguezandpeters.com,Dinner ahead about response sport.,24,henson-rodriguez-and-peters,2023,USD,523665,236991,286674,200436,86238,0,86238,5236,10473,75765,21199,367162,87506,279656,,523665,1391.74,3340.2,0.0983,1278,34.14,10877.91,1.95,0.5474
9916,Martin-Davis,False,NG,North Maria,AgriTech,2016,https://martin-davis.com,Process report agree against seek sometimes assume move generation determine.,28,martin-davis,2023,USD,624217,291553,332664,502360,-169696,0,-169696,6242,12484,-182180,30855,400783,162969,237814,,624217,20.0,34.0,0.0611,2600,20.0,65614.64,0.47,0.5329
9917,Manning LLC,False,IN,Dudleyville,SaaS,2017,https://manningllc.com,Camera wind power security vote against go music treatment now.,20,manning-llc,2023,USD,61374,14790,46584,25478,21106,0,21106,613,1227,19879,4949,75445,34291,41154,5114.5,61374,240.43,240.43,0.0419,412,12.4,11360.71,0.44,0.759
9918,Mills Group,False,CA,Jessebury,AI/ML,2014,https://millsgroup.com,Fact responsibility coach crime dark mean movie face.,25,mills-group,2023,USD,1057450,585644,471806,172191,299615,0,299615,10574,21149,278466,158349,777488,419127,358361,,1057450,20.0,64.76,0.001,241,364.92,23529.66,6.73,0.4462
9919,Turner Group,False,FR,Fuentesview,Fintech,2017,https://turnergroup.com,Writer inside national edge force let in represent special language.,24,turner-group,2023,EUR,2289915,333628,1956287,114495,1841792,1772,1840020,22899,45798,1794222,50256,1239082,179466,1059616,,2289915,523.92,2035.04,0.1185,4359,43.77,36292.03,1.38,0.8543
9920,Andrews Figueroa and Jenkins,False,FR,Port Kaylaton,AgriTech,2023,https://andrewsfigueroaandjenkins.com,Quite oil miss soon wrong ability fear.,18,andrews-figueroa-and-jenkins,2023,EUR,331866,110459,221407,265334,-43927,3440,-47367,3318,6637,-54004,42183,291055,126868,164187,,331866,173.22,671.83,0.0389,1382,20.0,47125.69,0.9,0.6672
9921,Stephens-Williams,False,US,North Rebekahville,Marketplaces,2011,https://stephens-williams.com,Sell event tough knowledge traditional contain bed image relate close.,15,stephens-williams,2023,USD,1378807,424629,954178,1271249,-317071,0,-317071,13788,27576,-344647,80457,937327,462036,475291,,1378807,688.93,1704.9,0.0884,883,129.99,137977.86,0.58,0.692
9922,Orr Walker and Brown,False,AU,East Tonyaland,HealthTech,2015,https://orrwalkerandbrown.com,No administration will nation production finish trade measure herself we.,17,orr-walker-and-brown,2023,USD,890797,332769,558028,647044,-89016,0,-89016,8907,17815,-106831,37517,489171,240824,248347,74233.08,890797,10.0,29.23,0.0121,1122,66.15,47365.39,0.79,0.6264
9923,Melton-Taylor,False,BR,East Edward,E-commerce,2009,https://melton-taylor.com,Put east purpose hotel group investment reach.,26,melton-taylor,2023,USD,372616,121577,251039,18630,232409,0,232409,3726,7452,224957,36499,422678,172151,250527,,372616,20.0,91.44,0.0797,149,207.9,1000.0,36.5,0.6737
9924,Walker-Hardy,False,DE,Keyberg,Energy,2022,https://walker-hardy.com,Marriage technology study thing spend weight.,18,walker-hardy,2023,EUR,5499722,3222292,2277430,1932776,344654,19926,324728,54997,109994,214734,211133,3050449,1266594,1783855,,5499722,602.38,1631.75,0.0174,22915,20.0,176470.14,1.2,0.4141
9925,Smith Butler and Alvarez,False,FR,Lake Jenniferview,E-commerce,2020,https://smithbutlerandalvarez.com,Image physical fight suddenly.,15,smith-butler-and-alvarez,2023,EUR,809843,368455,441388,349886,91502,23035,68467,8098,16196,52271,28893,484162,116231,367931,,809843,964.6,2241.16,0.0802,2570,26.25,47977.98,0.6,0.545
9926,Miller Heath and Morales,False,AU,West Elizabeth,AI/ML,2010,https://millerheathandmorales.com,Together face arm nation voice after since quickly table.,18,miller-heath-and-morales,2023,USD,1340254,553659,786595,505871,280724,42463,238261,13402,26805,211456,77493,868847,86264,782583,,1340254,20.0,46.61,0.0985,893,125.05,49181.71,1.58,0.5869
9927,Mclaughlin Johnson and Barnes,False,ZA,Meyermouth,SaaS,2022,https://mclaughlinjohnsonandbarnes.com,Seem shoulder great car authority he thousand charge war trade.,24,mclaughlin-johnson-and-barnes,2023,USD,1014689,293656,721033,98144,622889,12520,610369,10146,20293,590076,53909,737304,36865,700439,84557.42,1014689,10.0,42.43,0.0199,917,92.19,1000.0,53.91,0.7106
9928,Silva-Cowan,False,EG,East Amy,IoT,2022,https://silva-cowan.com,My social another if total them decide.,27,silva-cowan,2023,USD,1007256,268332,738924,260610,478314,2345,475969,10072,20145,455824,76478,666640,284098,382542,,1007256,2134.11,6639.47,0.0932,995,84.31,56267.64,1.36,0.7336
9929,Avery-Jones,False,NG,Port Kevinmouth,SaaS,2012,https://avery-jones.com,Either evidence present next discuss alone garden actually single.,19,avery-jones,2023,USD,2124485,502177,1622308,1103055,519253,0,519253,21244,42489,476764,20585,1278009,63900,1214109,177040.42,2124485,445.69,1183.27,0.0532,1601,110.58,72392.71,0.28,0.7636
9930,Stewart Mitchell and Fuller,False,DE,Kathleenmouth,Marketplaces,2017,https://stewartmitchellandfuller.com,Dog situation compare baby thus each away every fear movement.,30,stewart-mitchell-and-fuller,2023,EUR,134957,26500,108457,42959,65498,23810,41688,1349,2699,38989,17634,130573,14674,115899,,134957,20.0,126.98,0.0272,40,278.0,15173.57,1.16,0.8036
9931,Lee Williams and Hayes,False,AU,Santiagobury,Marketplaces,2016,https://leewilliamsandhayes.com,Thank despite red drop society none never top quite.,19,lee-williams-and-hayes,2023,USD,1572640,622795,949845,557109,392736,40935,351801,15726,31452,320349,256391,1065213,344772,720441,,1572640,919.5,3498.43,0.1031,6552,20.0,42894.91,5.98,0.604
9932,Chang Ltd,False,CA,Watsonstad,Energy,2024,https://changltd.com,Might moment physical food agree social rock behind next arrive computer.,25,chang-ltd,2023,USD,1243975,380246,863729,813149,50580,15582,34998,12439,24879,10119,280587,1049660,154746,894914,,1243975,135.48,120.31,0.0289,318,325.18,82676.78,3.39,0.6943
9933,Morales LLC,False,IN,Lake Shannonside,AgriTech,2021,https://moralesllc.com,Republican explain country imagine happen.,21,morales-llc,2023,USD,146471,78581,67890,84844,-16954,0,-16954,1464,2929,-19883,4306,139432,73175,66257,,146471,438.01,2020.05,0.0673,44,275.36,1000.0,4.31,0.4635
9934,Mckee Inc,False,EG,Samanthaport,IoT,2017,https://mckeeinc.com,Knowledge activity again decide seven guy thus edge threat.,13,mckee-inc,2023,USD,255438,82573,172865,64545,108320,0,108320,2554,5108,103212,17830,284800,117040,167760,,255438,765.9,3528.97,0.0296,543,39.19,1000.0,17.83,0.6767
9935,Gordon Hall and Hamilton,False,US,Port Jamieberg,EdTech,2021,https://gordonhallandhamilton.com,Indicate mouth nature room although glass forget product.,22,gordon-hall-and-hamilton,2023,USD,1662761,602545,1060216,139274,920942,0,920942,16627,33255,887687,211103,1196673,498305,698368,138563.42,1662761,518.09,1944.76,0.0184,2581,53.68,1000.0,211.1,0.6376
9936,Braun-Mata,False,ZA,Port Andrew,Energy,2017,https://braun-mata.com,Mouth data treatment yeah anything account within good culture major.,19,braun-mata,2023,USD,413695,213930,199765,271377,-71612,7675,-79287,4136,8273,-87560,58344,409781,132165,277616,,413695,20.0,152.84,0.0338,380,90.57,1000.0,58.34,0.4829
9937,Kemp-Morales,False,US,North Williamfort,Fintech,2021,https://kemp-morales.com,Bank who letter thank share.,15,kemp-morales,2023,USD,2915116,1005235,1909881,1943683,-33802,20400,-54202,29151,58302,-112504,401759,2046108,1130659,915449,,2915116,20.0,21.53,0.0448,1507,161.16,140318.64,2.86,0.6552
9938,Johnson-White,False,DE,West Debbie,HealthTech,2018,https://johnson-white.com,Time represent everybody traditional practice ago than.,22,johnson-white,2023,EUR,1881067,749085,1131982,768343,363639,29881,333758,18810,37621,296137,88118,1159433,511828,647605,156755.58,1881067,195.76,572.09,0.001,2357,66.5,82271.81,1.07,0.6018
9939,Garcia-Willis,False,EG,Blanchardton,EdTech,2023,https://garcia-willis.com,Expect debate style practice word assume deep.,17,garcia-willis,2023,USD,768267,185254,583013,324908,258105,0,258105,7682,15365,242740,65619,607724,102536,505188,64022.25,768267,10.0,60.79,0.0213,942,67.9,2141.22,30.65,0.7589
9940,Browning Group,False,NG,Lake Brookeborough,Marketplaces,2014,https://browninggroup.com,Recognize west character ten ago why there.,16,browning-group,2023,USD,199058,65745,133313,117248,16065,0,16065,1990,3981,12084,5051,266732,143952,122780,,199058,359.88,742.75,0.0209,829,20.0,1000.0,5.05,0.6697
9941,Johnson Smith and Short,False,FR,Lake Justin,E-commerce,2023,https://johnsonsmithandshort.com,Safe education wrong staff attorney possible though arm difficult important.,22,johnson-smith-and-short,2023,EUR,816334,173312,643022,236287,406735,0,406735,8163,16326,390409,13688,470839,46522,424317,,816334,81.69,211.63,0.0324,3401,20.0,64991.11,0.21,0.7877
9942,Webster Sanchez and Olson,False,CA,Edwinshire,Mobility,2013,https://webstersanchezandolson.com,Thing low morning hand child book story.,13,webster-sanchez-and-olson,2023,USD,1268822,323414,945408,502068,443340,0,443340,12688,25376,417964,17860,679426,409353,270073,,1268822,118.08,369.04,0.001,378,279.24,64901.57,0.28,0.7451
9943,Quinn Jones and Green,False,KE,Williamsonside,Cybersecurity,2012,https://quinnjonesandgreen.com,Travel young home view history same practice job.,23,quinn-jones-and-green,2023,USD,517989,80138,437851,428413,9438,0,9438,5179,10359,-921,57208,324446,52909,271537,,517989,638.35,1105.51,0.0878,2158,20.0,30950.93,1.85,0.8453
9944,Li Moore and Hoffman,False,BR,North Danielberg,Mobility,2015,https://limooreandhoffman.com,Message safe gas science he.,18,li-moore-and-hoffman,2023,USD,1929979,554211,1375768,1580120,-204352,9371,-213723,19299,38599,-252322,75775,1112129,473268,638861,,1929979,537.09,2394.33,0.0179,8041,20.0,112338.24,0.67,0.7128
9945,Dawson Lane and Swanson,False,FR,West Natalieview,AI/ML,2020,https://dawsonlaneandswanson.com,Event ground play they safe address each indicate six so.,18,dawson-lane-and-swanson,2023,EUR,367361,149117,218244,354283,-136039,19442,-155481,3673,7347,-162828,11277,348161,17408,330753,,367361,20.0,10.0,0.0315,1530,20.0,18247.16,0.62,0.5941
9946,Brewer-Roberts,False,NG,Maryfurt,Cybersecurity,2014,https://brewer-roberts.com,Foot while sometimes money old week candidate fast difficult crime.,12,brewer-roberts,2023,USD,203221,54369,148852,94587,54265,26703,27562,2032,4064,23498,578,117352,16181,101171,,203221,20.0,49.66,0.079,40,417.04,6494.7,0.09,0.7325
9947,Villarreal Santiago and Williams,False,ZA,North Austin,SaaS,2012,https://villarrealsantiagoandwilliams.com,Sit suffer not great economy material.,20,villarreal-santiago-and-williams,2023,USD,395270,170175,225095,19763,205332,0,205332,3952,7905,197427,15762,309264,88453,220811,32939.17,395270,394.8,2001.99,0.0254,510,64.58,28851.31,0.55,0.5695
9948,Dyer Spencer and Bautista,False,KE,Lake Johnnyville,Fintech,2018,https://dyerspencerandbautista.com,Miss million inside piece.,16,dyer-spencer-and-bautista,2023,USD,606532,268745,337787,30326,307461,0,307461,6065,12130,295331,49317,451377,202984,248393,,606532,1358.82,2885.0,0.0252,592,85.3,13113.77,3.76,0.5569
9949,Anderson-Silva,False,NG,West Johnburgh,E-commerce,2017,https://anderson-silva.com,Pull yes cause very me second lead draw wrong.,25,anderson-silva,2023,USD,562871,150986,411885,492548,-80663,22598,-103261,5628,11257,-114518,6678,432507,55363,377144,,562871,353.27,176.64,0.0787,322,145.33,59867.9,0.11,0.7318
9950,Hall LLC,False,BR,Port Margaret,HealthTech,2015,https://hallllc.com,Local between sense form movie conference available with.,24,hall-llc,2023,USD,532853,140892,391961,199678,192283,0,192283,5328,10657,181626,7641,308882,37712,271170,44404.42,532853,398.61,2159.94,0.001,388,114.22,1000.0,7.64,0.7356
9951,Hill-Klein,False,DE,East Melindaview,HealthTech,2017,https://hill-klein.com,Never someone kid move result mission issue.,13,hill-klein,2023,EUR,715179,77983,637196,800303,-163107,37452,-200559,7151,14303,-214862,7889,472500,24506,447994,59598.25,715179,908.29,3977.39,0.0043,11919,5.0,63949.79,0.12,0.891
9952,Martinez Inc,False,FR,Lake Kaylaton,Energy,2019,https://martinezinc.com,Suffer best everybody fast ask institution.,21,martinez-inc,2023,EUR,462169,86209,375960,301493,74467,0,74467,4621,9243,65224,71009,420610,217972,202638,,462169,314.18,1355.29,0.035,204,188.2,3137.24,22.63,0.8135
9953,Ware LLC,False,FR,North Charlesmouth,AI/ML,2019,https://warellc.com,Nothing bag begin cover across concern.,18,ware-llc,2023,EUR,579950,126527,453423,416204,37219,9487,27732,5799,11599,16133,4095,461887,212806,249081,,579950,557.48,1033.53,0.001,2416,20.0,31892.91,0.13,0.7818
9954,Weber Willis and Valdez,False,BR,New Zachary,Cybersecurity,2016,https://weberwillisandvaldez.com,With letter democratic nor mention.,23,weber-willis-and-valdez,2023,USD,1267115,763578,503537,837686,-334149,33271,-367420,12671,25342,-392762,15116,688831,34441,654390,,1267115,769.35,3603.6,0.0282,405,260.23,48080.28,0.31,0.3974
9955,Schmitt-Holmes,False,NG,South Lauren,EdTech,2021,https://schmitt-holmes.com,World force change term economy party coach simply.,19,schmitt-holmes,2023,USD,202361,83260,119101,61508,57593,6975,50618,2023,4047,46571,8530,220044,149861,70183,16863.42,202361,197.25,644.15,0.068,879,19.17,27997.5,0.3,0.5886
9956,Valdez Price and Perez,False,AU,Petersonchester,Energy,2008,https://valdezpriceandperez.com,Knowledge which debate chair remain on college high small.,24,valdez-price-and-perez,2023,USD,1256188,658463,597725,62809,534916,0,534916,12561,25123,509793,26459,808188,439699,368489,,1256188,918.84,5071.29,0.0555,438,238.62,1000.0,26.46,0.4758
9957,Mercado-Rodriguez,False,EG,Port Victor,EdTech,2017,https://mercado-rodriguez.com,Approach may risk response know tend wall data music example.,22,mercado-rodriguez,2023,USD,583839,227602,356237,84061,272176,15359,256817,5838,11676,245141,25429,354575,17728,336847,48653.25,583839,559.01,1392.18,0.001,9730,5.0,18122.88,1.4,0.6102
9958,Brown Walters and Harrell,False,IN,East Megan,Energy,2023,https://brownwaltersandharrell.com,Among thank hotel only rather food.,22,brown-walters-and-harrell,2023,USD,3691320,1088844,2602476,1893016,709460,0,709460,36913,73826,635634,105832,2013761,200275,1813486,,3691320,1222.56,5061.51,0.0457,7843,39.22,166834.65,0.63,0.705
9959,Brown Ltd,False,ZA,Popetown,AgriTech,2020,https://brownltd.com,Street free minute building until century not us budget remember.,33,brown-ltd,2023,USD,956889,476489,480400,760028,-279628,0,-279628,9568,19137,-298765,96264,662846,33142,629704,,956889,20.0,10.0,0.1506,1727,46.17,61847.87,1.56,0.502
9960,Beck Cox and Hernandez,False,GB,Markburgh,Cybersecurity,2011,https://beckcoxandhernandez.com,Enjoy nearly national central top coach natural conference.,19,beck-cox-and-hernandez,2023,USD,315067,100515,214552,153159,61393,7867,53526,3150,6301,47225,20169,337424,186625,150799,,315067,20.0,70.42,0.0606,1312,20.0,1765.51,11.42,0.681
9961,Stephens Group,False,CA,Gregorytown,Cybersecurity,2019,https://stephensgroup.com,Activity example yourself best south end.,19,stephens-group,2023,USD,236991,124573,112418,176135,-63717,16094,-79811,2369,4739,-84550,10680,154009,110021,43988,,236991,252.4,1091.52,0.0447,987,20.0,8875.42,1.2,0.4744
9962,Walters Group,False,NG,East Catherine,AgriTech,2010,https://waltersgroup.com,Drug method moment group staff.,13,walters-group,2023,USD,436672,178948,257724,184386,73338,25082,48256,4366,8733,39523,44162,447832,215228,232604,,436672,1943.82,10535.63,0.0751,1819,20.0,7020.94,6.29,0.5902
9963,Garrett Inc,False,BR,New Jennifer,Mobility,2016,https://garrettinc.com,Lay day and medical defense body Mr peace fast possible.,18,garrett-inc,2023,USD,1650904,367419,1283485,918827,364658,0,364658,16509,33018,331640,31116,895448,464784,430664,,1650904,76.24,385.97,0.001,6878,20.0,93879.16,0.33,0.7774
9964,Cook-Vasquez,False,ZA,New John,IoT,2011,https://cook-vasquez.com,Air information simply same must play recently.,17,cook-vasquez,2023,USD,1229199,488956,740243,595164,145079,0,145079,12291,24583,120496,55986,818966,712135,106831,,1229199,27.24,128.3,0.0724,507,201.76,30853.2,1.81,0.6022
9965,Houston Johnson and Myers,False,TN,New Scott,Fintech,2022,https://houstonjohnsonandmyers.com,None know painting those science image lay number.,19,houston-johnson-and-myers,2023,USD,438575,154227,284348,220719,63629,19178,44451,4385,8771,35680,20827,291316,74084,217232,,438575,146.22,619.9,0.0385,485,75.35,4469.04,4.66,0.6483
9966,Carroll Cummings and Roberts,False,US,Barryside,E-commerce,2008,https://carrollcummingsandroberts.com,On ball music agree toward cover mind.,24,carroll-cummings-and-roberts,2023,USD,3048548,152427,2896121,3114860,-218739,0,-218739,30485,60970,-279709,212596,1793274,1069225,724049,,3048548,506.11,320.65,0.1424,956,265.48,274678.59,0.77,0.95
9967,Black-Mendoza,False,GB,Port Darryl,HealthTech,2010,https://black-mendoza.com,Eye many beautiful over traditional.,19,black-mendoza,2023,USD,1098826,54941,1043885,1012870,31015,22225,8790,10988,21976,-13186,56334,795763,218954,576809,91568.83,1098826,578.21,3547.63,0.024,1752,52.25,59040.51,0.95,0.95
9968,Adams Group,False,NG,Lake Steve,Marketplaces,2011,https://adamsgroup.com,Interest rule too others floor happen money free.,21,adams-group,2023,USD,239049,82790,156259,74671,81588,0,81588,2390,4780,76808,43344,165506,8275,157231,,239049,146.67,406.54,0.0447,78,254.27,1000.0,43.34,0.6537
9969,Howard-Glenn,False,TN,North Danielborough,IoT,2010,https://howard-glenn.com,Five live their thought dream wife hand science build.,25,howard-glenn,2023,USD,130074,52769,77305,52065,25240,4044,21196,1300,2601,18595,16003,165696,69221,96475,,130074,45.34,216.54,0.0443,541,20.0,1000.0,16.0,0.5943
9970,Johnson Giles and Acevedo,False,BR,Lindaland,AgriTech,2011,https://johnsongilesandacevedo.com,Ground amount method go boy popular.,18,johnson-giles-and-acevedo,2023,USD,42207,20531,21676,15183,6493,0,6493,422,844,5649,6765,78663,18508,60155,,42207,599.46,1725.88,0.2086,20,173.93,24360.64,0.28,0.5136
9971,Taylor-Brennan,False,DE,Port Ashleyburgh,AgriTech,2016,https://taylor-brennan.com,Condition yet sign board member change.,23,taylor-brennan,2023,EUR,178326,88632,89694,94535,-4841,0,-4841,1783,3566,-8407,641,183480,104170,79310,,178326,1283.31,4020.76,0.0609,115,128.12,23527.74,0.03,0.503
9972,Miller PLC,False,BR,Lake Caleb,Mobility,2020,https://millerplc.com,Beyond among street thought degree music wait.,23,miller-plc,2023,USD,1562508,283850,1278658,898175,380483,15989,364494,15625,31250,333244,75138,870369,364319,506050,,1562508,421.76,526.38,0.0445,690,188.53,64152.27,1.17,0.8183
9973,Cruz-Howell,False,ZA,West Dillon,SaaS,2016,https://cruz-howell.com,Race me store military.,20,cruz-howell,2023,USD,6881572,3824333,3057239,4623387,-1566148,29712,-1595860,68815,137631,-1733491,277777,3853283,775261,3078022,573464.33,6881572,476.09,3010.81,0.0193,6270,91.46,378087.17,0.73,0.4443
9974,Smith LLC,False,NG,Hudsonborough,EdTech,2023,https://smithllc.com,Service including cover author stand fear sing five bed.,25,smith-llc,2023,USD,668151,92987,575164,93209,481955,3746,478209,6681,13363,464846,47006,542433,297903,244530,55679.25,668151,10.0,39.54,0.104,11135,5.0,45889.79,1.02,0.8608
9975,Wallace Mccormick and White,False,AU,Beasleystad,Mobility,2017,https://wallacemccormickandwhite.com,Sound whose late research officer figure house real pick.,26,wallace-mccormick-and-white,2023,USD,1261921,274414,987507,147347,840160,8984,831176,12619,25238,805938,68762,871363,187927,683436,,1261921,1441.48,9779.43,0.1403,5258,20.0,15884.78,4.33,0.7825
9976,Joseph and Sons,False,US,Alvaradostad,Cybersecurity,2012,https://josephandsons.com,Word human decade wind ready who.,22,joseph-and-sons,2023,USD,453080,159032,294048,148598,145450,904,144546,4530,9061,135485,15830,334087,47790,286297,,453080,20.0,57.54,0.001,1887,20.0,18824.47,0.84,0.649
9977,Palmer Perry and Simon,False,KE,Davischester,Cybersecurity,2012,https://palmerperryandsimon.com,Me care government already least as.,21,palmer-perry-and-simon,2023,USD,404095,90023,314072,20204,293868,11941,281927,4040,8081,273846,122195,367201,106753,260448,,404095,896.24,3866.89,0.0649,194,173.0,7761.62,15.74,0.7772
9978,Bolton Brooks and Gomez,False,NG,Collinshaven,Energy,2017,https://boltonbrooksandgomez.com,Technology hard cover prepare mention.,25,bolton-brooks-and-gomez,2023,USD,1029896,572566,457330,250034,207296,24948,182348,10298,20597,161751,166840,683440,158415,525025,,1029896,557.86,2745.08,0.0429,463,185.22,1000.0,166.84,0.4441
9979,Wiley Browning and Riley,False,BR,Mirandaburgh,Marketplaces,2015,https://wileybrowningandriley.com,Dream Mrs crime Mr ready off begin head from.,23,wiley-browning-and-riley,2023,USD,1701220,559609,1141611,938266,203345,0,203345,17012,34024,169321,19437,924506,335494,589012,,1701220,1284.63,642.32,0.0939,720,196.72,117780.28,0.17,0.6711
9980,Gibson Barrett and Dean,False,DE,Amyfort,SaaS,2012,https://gibsonbarrettanddean.com,Energy develop little point increase generation white visit smile service attack.,19,gibson-barrett-and-dean,2023,EUR,291204,102600,188604,195123,-6519,0,-6519,2912,5824,-12343,9126,252065,83658,168407,24267.0,291204,358.85,2118.58,0.001,413,58.67,16325.41,0.56,0.6477
9981,Murphy Frazier and West,False,TN,East Sean,Marketplaces,2019,https://murphyfrazierandwest.com,They memory federal beat early.,15,murphy-frazier-and-west,2023,USD,304059,121787,182272,100589,81683,39276,42407,3040,6081,36326,24522,374413,265027,109386,,304059,343.45,480.35,0.0795,350,72.33,1344.41,18.24,0.5995
9982,Cook and Sons,False,ZA,Jordanmouth,SaaS,2020,https://cookandsons.com,Learn television face radio.,13,cook-and-sons,2023,USD,1946016,629101,1316915,559990,756925,15335,741590,19460,38920,702670,27745,1002913,482683,520230,162168.0,1946016,10.0,15.81,0.0689,32433,5.0,28706.33,0.97,0.6767
9983,Sanchez Hernandez and Walton,False,ZA,Lopezchester,HealthTech,2011,https://sanchezhernandezandwalton.com,True including employee a point economy effort child.,18,sanchez-hernandez-and-walton,2023,USD,1129374,416610,712764,710506,2258,0,2258,11293,22587,-20329,35132,711577,140813,570764,94114.5,1129374,52.97,155.76,0.0082,1696,55.47,62076.33,0.57,0.6311
9984,Brooks Williams and Hogan,False,NG,South Pamelahaven,EdTech,2021,https://brookswilliamsandhogan.com,Product organization type personal.,18,brooks-williams-and-hogan,2023,USD,383901,139093,244808,125815,118993,7523,111470,3839,7678,103792,47679,329616,206106,123510,31991.75,383901,539.59,1417.13,0.0412,1634,19.57,1000.0,47.68,0.6377
9985,Huang Inc,False,TN,Amymouth,Mobility,2022,https://huanginc.com,Sea full ok carry impact see certainly reveal Congress.,13,huang-inc,2023,USD,4649719,941659,3708060,2742471,965589,0,965589,46497,92994,872595,92997,2467652,1491321,976331,,4649719,20.0,28.5,0.0157,16138,24.01,245464.24,0.38,0.7975
9986,Cruz Johnson and Taylor,False,FR,North Nicoleville,IoT,2020,https://cruzjohnsonandtaylor.com,Pretty talk brother car their.,17,cruz-johnson-and-taylor,2023,EUR,460431,92534,367897,194096,173801,16443,157358,4604,9208,148150,78221,331853,143537,188316,,460431,20.0,51.36,0.0795,1918,20.0,41002.54,1.91,0.799
9987,Edwards Wiley and Johnson,False,TN,Port Amy,Energy,2021,https://edwardswileyandjohnson.com,Talk forward yes cut all alone adult.,25,edwards-wiley-and-johnson,2023,USD,7190740,3009859,4180881,1459784,2721097,27,2721070,71907,143814,2577256,252934,4002996,1883173,2119823,,7190740,184.43,345.32,0.0893,3031,197.69,123692.39,2.04,0.5814
9988,Edwards-Brown,False,FR,Port Andrea,SaaS,2012,https://edwards-brown.com,Reality enjoy expert a news cultural fire many there.,17,edwards-brown,2023,EUR,698331,273683,424648,260475,164173,36648,127525,6983,13966,113559,78315,466807,215623,251184,58194.25,698331,145.6,273.59,0.001,11638,5.0,1000.0,78.32,0.6081
9989,Carney Thompson and Johnson,False,CA,Silvastad,Cybersecurity,2020,https://carneythompsonandjohnson.com,Sit could account happen organization hand activity particularly first business.,23,carney-thompson-and-johnson,2023,USD,13520224,5050841,8469383,2614904,5854479,3088,5851391,135202,270404,5580987,369547,7240065,2924180,4315885,,13520224,2067.82,7954.15,0.0808,5240,214.98,221856.23,1.67,0.6264
9990,Carroll Group,False,DE,Port Heather,AgriTech,2013,https://carrollgroup.com,Decide when they magazine reality share.,17,carroll-group,2023,EUR,462595,197873,264722,267581,-2859,2698,-5557,4625,9251,-14808,9780,285257,176811,108446,,462595,20.0,108.62,0.0394,420,91.58,55570.01,0.18,0.5723
9991,Miller Cox and Anderson,False,AU,Bethberg,SaaS,2012,https://millercoxandanderson.com,Ago western approach sport social suddenly lead sing.,17,miller-cox-and-anderson,2023,USD,667114,233280,433834,375608,58226,0,58226,6671,13342,44884,31096,452188,154451,297737,55592.83,667114,523.06,2446.65,0.0526,1627,34.16,63470.37,0.49,0.6503
9992,Moran-Ibarra,False,AU,Port Denise,HealthTech,2012,https://moran-ibarra.com,However community family student bar citizen Congress rock appear.,12,moran-ibarra,2023,USD,1065382,551410,513972,67695,446277,3165,443112,10653,21307,421805,101182,779575,500271,279304,88781.83,1065382,411.8,1233.82,0.001,1499,59.19,1000.0,101.18,0.4824
9993,Peters-Cole,False,BR,Linside,Cybersecurity,2015,https://peters-cole.com,Own save resource myself include.,21,peters-cole,2023,USD,3603790,654444,2949346,203455,2745891,1549,2744342,36037,72075,2672267,270885,2260736,312072,1948664,,3603790,483.7,1380.71,0.0644,9760,30.77,12044.8,22.49,0.8184
9994,Flores-Jackson,False,IN,Tammymouth,IoT,2009,https://flores-jackson.com,Would property number sea near property government center.,27,flores-jackson,2023,USD,865871,420699,445172,419744,25428,41924,-16496,8658,17317,-33813,30642,502186,196066,306120,,865871,245.16,152.47,0.0015,256,281.44,44253.76,0.69,0.5141
9995,Holmes PLC,False,FR,East Madelineton,EdTech,2022,https://holmesplc.com,Crime group friend pass report section point use health they.,21,holmes-plc,2023,EUR,1125122,452426,672696,962247,-289551,9537,-299088,11251,22502,-321590,129818,821606,739445,82161,93760.17,1125122,662.14,997.02,0.0463,1431,65.49,54585.49,2.38,0.5979
9996,Vaughn Brown and Daugherty,False,TN,Port Debra,AI/ML,2015,https://vaughnbrownanddaugherty.com,Cup participant behavior drop she.,26,vaughn-brown-and-daugherty,2023,USD,819613,239454,580159,588151,-7992,26479,-34471,8196,16392,-50863,114921,565855,51859,513996,,819613,880.16,1898.25,0.0333,768,88.84,33787.44,3.4,0.7078
9997,Nguyen Williams and Malone,False,TN,Byrdtown,Mobility,2019,https://nguyenwilliamsandmalone.com,Mission imagine apply war buy.,25,nguyen-williams-and-malone,2023,USD,230795,91496,139299,93865,45434,0,45434,2307,4615,40819,16366,270460,36875,233585,,230795,464.55,232.28,0.0077,114,167.69,20230.07,0.81,0.6036
9998,Forbes Group,False,KE,East Josephshire,Cybersecurity,2008,https://forbesgroup.com,Cultural region institution cause check less interview six business occur.,20,forbes-group,2023,USD,487425,168848,318577,214480,104097,0,104097,4874,9748,94349,3042,286531,130628,155903,,487425,1271.66,3530.06,0.1408,1961,20.71,1000.0,3.04,0.6536
9999,Mcguire Zimmerman and Simmons,False,FR,East Elizabethside,Mobility,2022,https://mcguirezimmermanandsimmons.com,Produce difficult herself parent training assume.,8,mcguire-zimmerman-and-simmons,2023,EUR,729886,149878,580008,256737,323271,0,323271,7298,14597,308674,70911,476150,189409,286741,,729886,20.0,10.0,0.0542,3041,20.0,30694.98,2.31,0.7947
10000,Mathews Sanchez and Buckley,False,KE,New William,Fintech,2018,https://mathewssanchezandbuckley.com,Serious never debate seem it.,30,mathews-sanchez-and-buckley,2023,USD,1878400,929822,948578,1271071,-322493,0,-322493,18784,37568,-360061,86001,1026550,366326,660224,,1878400,234.08,1640.41,0.001,946,165.34,107706.47,0.8,0.505
